year2,state,fage4,Firms,Estabs,Emp,Denom,Estabs_Entry,Estabs_Entry_Rate,Estabs_Exit,Estabs_Exit_Rate,Job_Creation,Job_Creation_Births,Job_Creation_Continuers,Job_Creation_Rate_Births,Job_Creation_Rate,Job_Destruction,Job_Destruction_Deaths,Job_Destruction_Continuers,Job_Destruction_Rate_Deaths,Job_Destruction_Rate,Net_Job_Creation,Net_Job_Creation_Rate,Reallocation_Rate,d_flag,firmdeath_firms,firmdeath_estabs,firmdeath_emp
1977,01,a) 0,8821,9493,56760,28730,9294,195.8,0,0,56061,56061,0,195.1,195.1,0,0,0,0,0,56061,195.1,0,0,,,
1977,01,l) Left Censored,43550,53359,900537,905180,1340,2.4,8057,14.1,135461,33808,101653,3.7,15,144746,58891,85855,6.5,16,-9285,-1,30,0,5623,5641,36602
1977,02,a) 0,1570,1709,12495,6306,1678,196.4,0,0,12378,12378,0,196.3,196.3,0,0,0,0,0,12378,196.3,0,0,,,
1977,02,l) Left Censored,4910,6016,94669,101828,350,5.3,1564,23.5,25167,6881,18286,6.8,24.7,39485,13504,25981,13.3,38.8,-14318,-14.1,49.4,0,1035,1039,6757
1977,04,a) 0,7748,8419,51174,25948,8258,196.2,0,0,50452,50452,0,194.4,194.4,0,0,0,0,0,50452,194.4,0,0,,,
1977,04,l) Left Censored,28729,35694,553377,563604,1121,2.9,6230,16.2,96974,20193,76781,3.6,17.2,117429,45366,72063,8,20.8,-20455,-3.6,34.4,0,4332,4357,29116
1977,05,a) 0,6308,6616,31758,16121,6478,195.8,0,0,31274,31274,0,194,194,0,0,0,0,0,31274,194,0,0,,,
1977,05,l) Left Censored,29191,34086,519352,513588,813,2.2,5455,14.9,88454,13253,75201,2.6,17.2,76925,32531,44394,6.3,15,11529,2.2,30,0,3970,3994,19678
1977,06,a) 0,72181,79059,519516,263661,77667,196.5,0,0,511711,511711,0,194.1,194.1,0,0,0,0,0,511711,194.1,0,0,,,
1977,06,l) Left Censored,290706,359707,6293790,6221299,10520,2.7,60589,15.7,1227667,267453,960214,4.3,19.7,1082685,488562,594123,7.9,17.4,144982,2.3,34.8,0,39693,39932,276475
1977,08,a) 0,10666,11384,63114,31789,11243,197.5,0,0,62650,62650,0,197.1,197.1,0,0,0,0,0,62650,197.1,0,0,,,
1977,08,l) Left Censored,40976,48803,751028,754761,1631,3.1,8248,15.8,135593,30620,104973,4.1,18,143058,62313,80745,8.3,19,-7465,-1,36,0,5673,5694,37131
1977,09,a) 0,7483,8030,45800,22967,8022,199.8,0,0,45667,45667,0,198.8,198.8,0,0,0,0,0,45667,198.8,0,0,,,
1977,09,l) Left Censored,46396,53380,1058010,1037033,1131,2,6634,11.8,169183,24190,144993,2.3,16.3,127228,47273,79955,4.6,12.3,41955,4,24.6,0,4248,4263,24208
1977,10,a) 0,1580,1746,9769,4970,1695,194.2,0,0,9599,9599,0,193.1,193.1,0,0,0,0,0,9599,193.1,0,0,,,
1977,10,l) Left Censored,8339,9719,213366,215889,259,2.5,1250,12.2,25218,4661,20557,2.2,11.7,30264,9058,21206,4.2,14,-5046,-2.3,23.4,0,807,810,5417
1977,11,a) 0,1735,1897,14793,7479,1857,195.8,0,0,14629,14629,0,195.6,195.6,0,0,0,0,0,14629,195.6,0,0,,,
1977,11,l) Left Censored,11292,13144,282085,288552,405,2.9,1855,13.3,44795,13201,31594,4.6,15.5,57729,20610,37119,7.1,20,-12934,-4.5,31,0,1131,1135,9899
1977,12,a) 0,30846,33087,228649,116148,32458,196.2,0,0,225003,225003,0,193.7,193.7,0,0,0,0,0,225003,193.7,0,0,,,
1977,12,l) Left Censored,121124,149004,2190252,2200508,4358,2.7,27045,16.8,397871,94995,302876,4.3,18.1,418383,191982,226401,8.7,19,-20512,-0.9,36.2,0,19132,19236,120706
1977,13,a) 0,13866,14887,83397,42200,14608,196.3,0,0,82395,82395,0,195.2,195.2,0,0,0,0,0,82395,195.2,0,0,,,
1977,13,l) Left Censored,64585,81027,1409484,1410264,2965,3.4,13166,15.2,237531,64359,173172,4.6,16.8,239090,97339,141751,6.9,17,-1559,-0.2,33.6,0,8877,8911,56643
1977,15,a) 0,2495,2852,20047,10160,2795,196,0,0,19775,19775,0,194.6,194.6,0,0,0,0,0,19775,194.6,0,0,,,
1977,15,l) Left Censored,12290,15062,241060,243222,511,3.2,2150,13.5,35810,7817,27993,3.2,14.7,40134,19811,20323,8.1,16.5,-4324,-1.8,29.4,0,1422,1438,10556
1977,16,a) 0,3133,3309,16796,8478,3259,197,0,0,16637,16637,0,196.2,196.2,0,0,0,0,0,16637,196.2,0,0,,,
1977,16,l) Left Censored,12972,15481,242326,222941,470,2.8,2500,15.1,75479,7722,67757,3.5,33.9,36709,15378,21331,6.9,16.5,38770,17.4,33,0,1738,1749,9788
1977,17,a) 0,24561,26718,181698,91971,26203,196.1,0,0,179454,179454,0,195.1,195.1,0,0,0,0,0,179454,195.1,0,0,,,
1977,17,l) Left Censored,150999,178220,3737428,3719733,4577,2.4,25527,13.5,566369,113546,452823,3.1,15.2,530978,202049,328929,5.4,14.3,35391,0.9,28.6,0,16751,16871,107141
1977,18,a) 0,11472,12584,82140,41809,12360,196.4,0,0,80663,80663,0,192.9,192.9,0,0,0,0,0,80663,192.9,0,0,,,
1977,18,l) Left Censored,67552,82598,1626361,1627633,2066,2.4,11454,13.1,218164,41372,176792,2.5,13.4,220707,81202,139505,5,13.6,-2543,-0.2,26.8,0,7438,7499,50182
1977,19,a) 0,8296,8925,48870,24655,8803,197.3,0,0,48430,48430,0,196.4,196.4,0,0,0,0,0,48430,196.4,0,0,,,
1977,19,l) Left Censored,46459,55117,788867,784464,1351,2.3,7961,13.6,120682,19700,100982,2.5,15.4,111876,50775,61101,6.5,14.3,8806,1.1,28.6,0,5274,5295,31820
1977,20,a) 0,6993,7476,63621,32210,7355,196.8,0,0,62823,62823,0,195,195,0,0,0,0,0,62823,195,0,0,,,
1977,20,l) Left Censored,37473,44306,620221,623358,1179,2.5,6944,14.7,97111,24030,73081,3.9,15.6,103384,44771,58613,7.2,16.6,-6273,-1,31.2,0,4706,4729,26825
1977,21,a) 0,7951,8494,45804,23144,8335,196.3,0,0,45320,45320,0,195.8,195.8,0,0,0,0,0,45320,195.8,0,0,,,
1977,21,l) Left Censored,42235,50082,870940,862209,1376,2.6,7697,14.4,148171,28315,119856,3.3,17.2,130708,52001,78707,6,15.2,17463,2,30.4,0,5214,5226,31052
1977,22,a) 0,9636,10310,62440,31753,10105,196,0,0,61374,61374,0,193.3,193.3,0,0,0,0,0,61374,193.3,0,0,,,
1977,22,l) Left Censored,49316,59719,959583,960566,1697,2.7,8216,13,161946,35029,126917,3.6,16.9,163911,61750,102161,6.4,17.1,-1965,-0.2,33.8,0,5819,5852,37703
1977,23,a) 0,2921,3148,17760,9022,3103,197.1,0,0,17476,17476,0,193.7,193.7,0,0,0,0,0,17476,193.7,0,0,,,
1977,23,l) Left Censored,16008,18525,274787,274853,338,1.7,2749,13.9,42404,9544,32860,3.5,15.4,42535,16956,25579,6.2,15.5,-131,-0.1,30.8,0,1756,1762,9457
1977,24,a) 0,8703,9431,55695,28265,9265,196.5,0,0,54860,54860,0,194.1,194.1,0,0,0,0,0,54860,194.1,0,0,,,
1977,24,l) Left Censored,48854,59238,1070724,1084407,1742,2.8,8105,13,167880,32520,135360,3,15.5,195246,65776,129470,6.1,18,-27366,-2.5,31,0,5202,5223,33840
1977,25,a) 0,11739,12759,103400,52145,12522,196.3,0,0,102511,102511,0,196.6,196.6,0,0,0,0,0,102511,196.6,0,0,,,
1977,25,l) Left Censored,81967,95956,1847037,1829436,2168,2.1,12039,11.9,286943,54122,232821,3,15.7,251741,104349,147392,5.7,13.8,35202,1.9,27.6,0,7820,7849,55353
1977,26,a) 0,18247,20121,126720,64062,19763,196.4,0,0,125316,125316,0,195.6,195.6,0,0,0,0,0,125316,195.6,0,0,,,
1977,26,l) Left Censored,104579,126910,2591490,2556699,3408,2.5,18173,13.5,407378,73454,333924,2.9,15.9,337796,129324,208472,5.1,13.2,69582,2.7,26.4,0,11444,11516,71034
1977,27,a) 0,9839,10673,71682,36366,10505,196.9,0,0,70633,70633,0,194.2,194.2,0,0,0,0,0,70633,194.2,0,0,,,
1977,27,l) Left Censored,55650,66287,1211029,1194529,1730,2.5,8977,12.8,211746,37944,173802,3.2,17.7,178745,73208,105537,6.1,15,33001,2.7,30,0,5779,5833,43594
1977,28,a) 0,5770,6133,33709,17111,6003,195.8,0,0,33197,33197,0,194,194,0,0,0,0,0,33197,194,0,0,,,
1977,28,l) Left Censored,29001,34570,547264,542973,878,2.4,5252,14.2,89613,14928,74685,2.7,16.5,81031,34706,46325,6.4,14.9,8582,1.6,29.8,0,3728,3754,22449
1977,29,a) 0,12354,13219,76465,38707,12989,196.5,0,0,75517,75517,0,195.1,195.1,0,0,0,0,0,75517,195.1,0,0,,,
1977,29,l) Left Censored,67511,81553,1432642,1430529,2104,2.4,12456,14.3,221334,38015,183319,2.7,15.5,217108,89617,127491,6.3,15.2,4226,0.3,30.4,0,8281,8321,47534
1977,30,a) 0,3210,3376,16235,8249,3323,196.9,0,0,15973,15973,0,193.6,193.6,0,0,0,0,0,15973,193.6,0,0,,,
1977,30,l) Left Censored,13423,15546,174736,170252,347,2.1,2397,14.4,37835,7036,30799,4.1,22.2,28867,13323,15544,7.8,17,8968,5.2,34,0,1670,1675,9899
1977,31,a) 0,4750,5050,26326,13267,4974,197,0,0,26119,26119,0,196.9,196.9,0,0,0,0,0,26119,196.9,0,0,,,
1977,31,l) Left Censored,26641,31041,447143,438336,768,2.3,4374,13.3,89920,12391,77529,2.8,20.5,72305,29267,43038,6.7,16.5,17615,4,33,0,2971,2982,19346
1977,32,a) 0,2730,2907,17865,8985,2867,197.2,0,0,17761,17761,0,197.7,197.7,0,0,0,0,0,17761,197.7,0,0,,,
1977,32,l) Left Censored,10142,11775,217427,215189,391,3.1,2044,16.2,39410,7010,32400,3.3,18.3,34933,15357,19576,7.1,16.2,4477,2.1,32.4,0,1465,1469,9485
1977,33,a) 0,2765,2929,14657,7388,2882,196.8,0,0,14538,14538,0,196.8,196.8,0,0,0,0,0,14538,196.8,0,0,,,
1977,33,l) Left Censored,13788,15520,247465,246384,322,2,2063,12.6,36659,5608,31051,2.3,14.9,34497,14599,19898,5.9,14,2162,0.9,28,0,1400,1407,8623
1977,34,a) 0,17463,18295,101397,52772,17885,195.5,0,0,97251,97251,0,184.3,184.3,0,0,0,0,0,97251,184.3,0,0,,,
1977,34,l) Left Censored,107175,123342,2198340,2206227,2792,2.1,17341,13.2,330850,81058,249792,3.7,15,346624,131558,215066,6,15.7,-15774,-0.7,30,0,11014,11057,63980
1977,35,a) 0,4141,4375,23129,11696,4287,196,0,0,22867,22867,0,195.5,195.5,0,0,0,0,0,22867,195.5,0,0,,,
1977,35,l) Left Censored,16763,19801,251089,254720,602,2.8,3459,16.2,44236,10407,33829,4.1,17.4,51497,22137,29360,8.7,20.2,-7261,-2.8,34.8,0,2421,2429,13603
1977,36,a) 0,41121,43694,251939,128112,42731,195.6,0,0,247654,247654,0,193.3,193.3,0,0,0,0,0,247654,193.3,0,0,,,
1977,36,l) Left Censored,271106,309585,5284541,5306854,5336,1.6,44902,13.6,796986,154421,642565,2.9,15,841611,323854,517757,6.1,15.9,-44625,-0.9,30,0,31294,31402,181801
1977,37,a) 0,13574,14606,83739,43006,14330,196.2,0,0,81466,81466,0,189.4,189.4,0,0,0,0,0,81466,189.4,0,0,,,
1977,37,l) Left Censored,70938,87915,1667255,1676692,2404,2.6,12387,13.3,225123,51023,174100,3,13.4,243998,88097,155901,5.3,14.6,-18875,-1.2,26.8,0,8384,8412,51648
1977,38,a) 0,2107,2193,11055,5571,2163,197.3,0,0,10968,10968,0,196.9,196.9,0,0,0,0,0,10968,196.9,0,0,,,
1977,38,l) Left Censored,11070,12724,138157,141075,272,2,1871,13.8,18585,3269,15316,2.3,13.2,24420,10832,13588,7.7,17.3,-5835,-4.1,26.4,0,1170,1175,7566
1977,39,a) 0,20802,23052,141615,71730,22620,196.3,0,0,139771,139771,0,194.9,194.9,0,0,0,0,0,139771,194.9,0,0,,,
1977,39,l) Left Censored,131228,166025,3400271,3364898,4951,2.8,21859,12.5,522369,115379,406990,3.4,15.5,451622,171098,280524,5.1,13.4,70747,2.1,26.8,0,13726,13812,90134
1977,40,a) 0,8986,9471,55111,27889,9310,196.6,0,0,54444,54444,0,195.2,195.2,0,0,0,0,0,54444,195.2,0,0,,,
1977,40,l) Left Censored,41350,49000,691388,693765,1216,2.3,7817,14.9,110579,23889,86690,3.4,15.9,115332,50346,64986,7.3,16.6,-4753,-0.7,31.8,0,5626,5652,32495
1977,41,a) 0,9097,9743,53648,27173,9619,197.5,0,0,52951,52951,0,194.9,194.9,0,0,0,0,0,52951,194.9,0,0,,,
1977,41,l) Left Censored,37468,44257,642123,644915,1351,2.8,7492,15.8,102682,18852,83830,2.9,15.9,108265,50465,57800,7.8,16.8,-5583,-0.9,31.8,0,4972,4997,30325
1977,42,a) 0,22347,24335,154882,78785,23835,195.9,0,0,152194,152194,0,193.2,193.2,0,0,0,0,0,152194,193.2,0,0,,,
1977,42,l) Left Censored,152146,184372,3695424,3668779,4648,2.4,22690,11.7,557871,121993,435878,3.3,15.2,504582,183802,320780,5,13.8,53289,1.4,27.6,0,14433,14526,94367
1977,44,a) 0,2326,2437,12162,6085,2435,199.8,0,0,12155,12155,0,199.8,199.8,0,0,0,0,0,12155,199.8,0,0,,,
1977,44,l) Left Censored,15247,17022,345869,318337,335,1.9,2227,12.4,94159,6131,88028,1.9,29.6,39094,14848,24246,4.7,12.3,55065,17.3,24.6,0,1452,1462,7106
1977,45,a) 0,7019,7465,36236,18401,7308,195.8,0,0,35671,35671,0,193.9,193.9,0,0,0,0,0,35671,193.9,0,0,,,
1977,45,l) Left Censored,35329,42708,803210,809537,1130,2.5,6094,13.5,101274,24027,77247,3,12.5,113927,41938,71989,5.2,14.1,-12653,-1.6,25,0,4204,4229,23887
1977,46,a) 0,2162,2286,11499,5819,2242,196.2,0,0,11360,11360,0,195.2,195.2,0,0,0,0,0,11360,195.2,0,0,,,
1977,46,l) Left Censored,11720,13319,183811,166137,259,1.8,2013,14.1,60425,14502,45923,8.7,36.4,25076,10499,14577,6.3,15.1,35349,21.3,30.2,0,1255,1255,6637
1977,47,a) 0,11281,12154,87001,43970,11916,196.1,0,0,86062,86062,0,195.7,195.7,0,0,0,0,0,86062,195.7,0,0,,,
1977,47,l) Left Censored,54334,66184,1226121,1229590,1844,2.6,10117,14.3,181548,35498,146050,2.9,14.8,188486,74336,114150,6,15.3,-6938,-0.5,29.6,0,6941,6971,44016
1977,48,a) 0,40081,43514,265052,134490,42727,196.4,0,0,261124,261124,0,194.2,194.2,0,0,0,0,0,261124,194.2,0,0,,,
1977,48,l) Left Censored,174424,220240,3724801,3711013,7076,3,34101,14.5,679479,172940,506539,4.7,18.3,651904,264045,387859,7.1,17.6,27575,0.7,35.2,0,23575,23750,157804
1977,49,a) 0,4261,4512,23990,12113,4430,196.4,0,0,23754,23754,0,196.1,196.1,0,0,0,0,0,23754,196.1,0,0,,,
1977,49,l) Left Censored,17008,20042,332345,327542,643,3,3305,15.4,68940,14979,53961,4.6,21,59333,26057,33276,8,18.1,9607,2.9,36.2,0,2147,2167,15813
1977,50,a) 0,1688,1792,8603,4318,1771,197.7,0,0,8570,8570,0,198.5,198.5,0,0,0,0,0,8570,198.5,0,0,,,
1977,50,l) Left Censored,8797,9817,136464,134688,143,1.4,1347,12.9,22739,5156,17583,3.8,16.9,19186,8799,10387,6.5,14.2,3553,2.7,28.4,0,909,912,4669
1977,51,a) 0,11421,12258,72984,36948,12059,196.8,0,0,72072,72072,0,195.1,195.1,0,0,0,0,0,72072,195.1,0,0,,,
1977,51,l) Left Censored,61131,75896,1318502,1323735,2354,2.9,10720,13.4,210821,55306,155515,4.2,15.9,221288,79434,141854,6,16.7,-10467,-0.8,31.8,0,6985,7027,42951
1977,53,a) 0,12903,13916,76845,38933,13669,196.5,0,0,75825,75825,0,194.8,194.8,0,0,0,0,0,75825,194.8,0,0,,,
1977,53,l) Left Censored,53323,63940,950951,943418,1901,2.8,10117,14.8,166887,36486,130401,3.9,17.7,151821,65408,86413,6.9,16.1,15066,1.6,32.2,0,6565,6595,39509
1977,54,a) 0,3974,4241,23879,12084,4132,194.9,0,0,23590,23590,0,195.2,195.2,0,0,0,0,0,23590,195.2,0,0,,,
1977,54,l) Left Censored,22577,26647,448002,447153,647,2.3,3800,13.4,75000,17847,57153,4,16.8,73301,31646,41655,7.1,16.4,1699,0.4,32.8,0,2463,2478,13568
1977,55,a) 0,10685,11627,66707,33982,11440,196.8,0,0,65450,65450,0,192.6,192.6,0,0,0,0,0,65450,192.6,0,0,,,
1977,55,l) Left Censored,65169,76033,1368577,1367261,1691,2.1,9807,12.2,173298,31245,142053,2.3,12.7,170665,69944,100721,5.1,12.5,2633,0.2,25,0,6219,6269,38462
1977,56,a) 0,1911,2015,10765,5429,1983,196.8,0,0,10673,10673,0,196.6,196.6,0,0,0,0,0,10673,196.6,0,0,,,
1977,56,l) Left Censored,7748,8746,98532,97563,277,3,1373,14.7,20825,4709,16116,4.8,21.3,18886,8866,10020,9.1,19.4,1939,1.9,38.8,0,926,928,6309
1978,01,a) 0,8298,8500,46926,23580,8408,197.8,0,0,46692,46692,0,198,198,0,0,0,0,0,46692,198,0,0,,,
1978,01,b) 1,6471,7193,57404,56988,121,1.5,2331,28,17938,1285,16653,2.3,31.5,17105,11444,5661,20.1,30,833,1.5,60,0,1778,1784,7769
1978,01,l) Left Censored,39399,49403,927869,914141,1731,3.4,5671,11,148436,24134,124302,2.6,16.2,120979,43780,77199,4.8,13.2,27457,3,26.4,0,3889,3904,23173
1978,02,a) 0,1436,1447,7339,3685,1433,198.1,0,0,7309,7309,0,198.3,198.3,0,0,0,0,0,7309,198.3,0,0,,,
1978,02,b) 1,1093,1233,15914,14145,23,1.6,492,33.4,7584,361,7223,2.6,53.6,4046,2786,1260,19.7,28.6,3538,25,57.2,0,323,323,1674
1978,02,l) Left Censored,4232,5330,86952,90772,343,6,992,17.5,21111,5399,15712,5.9,23.3,28751,12296,16455,13.5,31.7,-7640,-8.4,46.6,0,514,519,5313
1978,04,a) 0,6357,6416,38081,19042,6415,200,0,0,38078,38078,0,200,200,0,0,0,0,0,38078,200,0,0,,,
1978,04,b) 1,4943,5607,48910,49748,96,1.4,2752,39.3,17300,1151,16149,2.3,34.8,18975,13654,5321,27.4,38.1,-1675,-3.3,69.6,0,1741,1762,7714
1978,04,l) Left Censored,23847,30998,571056,561437,1232,3.7,5596,16.8,107627,21012,86615,3.7,19.2,88389,43210,45179,7.7,15.7,19238,3.5,31.4,0,3144,3169,20593
1978,05,a) 0,5056,5073,24121,12061,5073,200,0,0,24121,24121,0,200,200,0,0,0,0,0,24121,200,0,0,,,
1978,05,b) 1,4008,4313,28370,29804,37,0.7,2198,40.2,7698,476,7222,1.6,25.8,10565,7999,2566,26.8,35.4,-2867,-9.6,51.6,0,1465,1465,5179
1978,05,l) Left Censored,24635,29542,511206,514623,822,2.6,5010,15.7,75811,11543,64268,2.2,14.7,82645,39660,42985,7.7,16.1,-6834,-1.4,29.4,0,2954,2969,16496
1978,06,a) 0,66369,66956,380614,191623,66264,197.9,0,0,377982,377982,0,197.3,197.3,0,0,0,0,0,377982,197.3,0,0,,,
1978,06,b) 1,52509,59578,498862,507427,939,1.4,19769,28.5,157206,11177,146029,2.2,31,174336,93126,81210,18.4,34.4,-17130,-3.4,62,0,13684,13736,61116
1978,06,l) Left Censored,256125,326086,6362577,6323414,13804,4,47136,13.7,1146789,207176,939613,3.3,18.1,1068462,435385,633077,6.9,16.9,78327,1.2,33.8,0,27766,27989,186832
1978,08,a) 0,8832,8879,47549,23775,8879,200,0,0,47549,47549,0,200,200,0,0,0,0,0,47549,200,0,0,,,
1978,08,b) 1,7064,7858,62255,62417,154,1.6,3479,36.2,20785,1528,19257,2.4,33.3,21109,15298,5811,24.5,33.8,-324,-0.5,66.6,0,2295,2295,9181
1978,08,l) Left Censored,34330,42476,767198,757667,1760,3.9,7634,16.7,144740,24288,120452,3.2,19.1,125679,59637,66042,7.9,16.6,19061,2.5,33.2,0,4411,4445,29244
1978,09,a) 0,6501,6519,29993,15050,6478,198.7,0,0,29887,29887,0,198.6,198.6,0,0,0,0,0,29887,198.6,0,0,,,
1978,09,b) 1,5866,6437,48143,46974,72,1,1613,22.3,13134,1466,11668,3.1,28,10795,6372,4423,13.6,23,2339,5,46,0,1133,1134,4305
1978,09,l) Left Censored,43128,50252,1061625,1059680,1531,3,4658,9,149870,21357,128513,2,14.1,145980,57334,88646,5.4,13.8,3890,0.3,27.6,0,3158,3174,27983
1978,10,a) 0,1151,1158,5851,2942,1143,197.4,0,0,5819,5819,0,197.8,197.8,0,0,0,0,0,5819,197.8,0,0,,,
1978,10,b) 1,1080,1252,9334,9543,22,1.5,506,33.8,2880,648,2232,6.8,30.2,3297,2574,723,27,34.5,-417,-4.3,60.4,0,404,404,1719
1978,10,l) Left Censored,7470,8879,207768,210537,290,3.1,1127,12.1,50271,2918,47353,1.4,23.9,55808,38264,17544,18.2,26.5,-5537,-2.6,47.8,0,827,828,32505
1978,11,a) 0,1447,1451,8764,4404,1437,198.1,0,0,8720,8720,0,198,198,0,0,0,0,0,8720,198,0,0,,,
1978,11,b) 1,1388,1557,28641,28453,53,3.1,385,22.3,5259,1278,3981,4.5,18.5,4883,2658,2225,9.3,17.2,376,1.3,34.4,0,237,239,1527
1978,11,l) Left Censored,10392,12236,279922,274232,460,3.6,1370,10.8,48560,6798,41762,2.5,17.7,37179,14067,23112,5.1,13.6,11381,4.1,27.2,0,885,899,6622
1978,12,a) 0,29063,29250,163285,82176,28906,197.6,0,0,162219,162219,0,197.4,197.4,0,0,0,0,0,162219,197.4,0,0,,,
1978,12,b) 1,22526,24877,200259,213782,357,1.2,8308,28.7,63804,4672,59132,2.2,29.8,90850,40122,50728,18.8,42.5,-27046,-12.7,59.6,0,6442,6457,29591
1978,12,l) Left Censored,108132,136634,2200876,2195431,5779,4,18019,12.6,394287,74279,320008,3.4,18,383397,150690,232707,6.9,17.5,10890,0.5,35,0,12441,12510,81021
1978,13,a) 0,12478,12550,65023,32733,12392,197.5,0,0,64580,64580,0,197.3,197.3,0,0,0,0,0,64580,197.3,0,0,,,
1978,13,b) 1,10055,11131,85264,84535,180,1.4,3823,29.4,26280,2485,23795,2.9,31.1,24822,16525,8297,19.5,29.4,1458,1.7,58.8,0,2936,2944,11627
1978,13,l) Left Censored,58508,75241,1465613,1437234,3005,3.8,8706,11.1,249892,49322,200570,3.4,17.4,193135,76520,116615,5.3,13.4,56757,4,26.8,0,5773,5802,40591
1978,15,a) 0,2307,2327,14724,7405,2303,197.9,0,0,14638,14638,0,197.7,197.7,0,0,0,0,0,14638,197.7,0,0,,,
1978,15,b) 1,1858,2262,20182,20073,75,2.9,636,24.9,5736,590,5146,2.9,28.6,5518,3238,2280,16.1,27.5,218,1.1,55,0,459,459,1774
1978,15,l) Left Censored,11223,13968,240501,240775,455,3.1,1554,10.7,35808,6750,29058,2.8,14.9,36355,16900,19455,7,15.1,-547,-0.2,29.8,0,946,960,5808
1978,16,a) 0,2603,2607,12978,6489,2607,200,0,0,12978,12978,0,200,200,0,0,0,0,0,12978,200,0,0,,,
1978,16,b) 1,2056,2232,14853,15727,35,1.3,1043,37.7,4459,264,4195,1.7,28.4,6207,4509,1698,28.7,39.5,-1748,-11.1,56.8,0,673,674,2666
1978,16,l) Left Censored,10973,13491,202060,221728,420,2.9,2245,15.5,37736,8497,29239,3.8,17,77071,16260,60811,7.3,34.8,-39335,-17.8,34,0,1239,1247,7330
1978,17,a) 0,21532,21752,121023,60978,21481,197.5,0,0,120090,120090,0,196.9,196.9,0,0,0,0,0,120090,196.9,0,0,,,
1978,17,b) 1,18997,21286,182193,181622,342,1.4,5612,23.4,47056,4470,42586,2.5,25.9,45914,27295,18619,15,25.3,1142,0.6,50.6,0,4110,4122,17740
1978,17,l) Left Censored,138014,165464,3773993,3755076,5663,3.3,18385,10.7,544694,94492,450202,2.5,14.5,506859,174127,332732,4.6,13.5,37835,1,27,0,12277,12406,80773
1978,18,a) 0,10398,10498,55019,27623,10401,198.2,0,0,54793,54793,0,198.4,198.4,0,0,0,0,0,54793,198.4,0,0,,,
1978,18,b) 1,8702,9836,80623,81245,166,1.5,2827,25.2,20226,1738,18488,2.1,24.9,21470,13036,8434,16,26.4,-1244,-1.5,49.8,0,2036,2040,8941
1978,18,l) Left Censored,61921,77144,1694150,1660069,2523,3.2,7902,9.9,253320,33907,219413,2,15.3,185158,64453,120705,3.9,11.2,68162,4.1,22.4,0,5284,5321,31969
1978,19,a) 0,7309,7347,37028,18601,7275,198,0,0,36855,36855,0,198.1,198.1,0,0,0,0,0,36855,198.1,0,0,,,
1978,19,b) 1,6418,7068,49419,49063,81,1,1896,23.7,12258,567,11691,1.2,25,11545,6759,4786,13.8,23.5,713,1.5,47,0,1409,1412,4895
1978,19,l) Left Censored,42298,51153,789805,789186,1632,3.1,5530,10.4,109839,17533,92306,2.2,13.9,108600,34917,73683,4.4,13.8,1239,0.1,27.6,0,3930,3952,20573
1978,20,a) 0,6298,6325,32596,16382,6261,198,0,0,32428,32428,0,197.9,197.9,0,0,0,0,0,32428,197.9,0,0,,,
1978,20,b) 1,5324,5872,41346,52487,116,1.7,1663,24.9,11174,1434,9740,2.7,21.3,33456,7671,25785,14.6,63.7,-22282,-42.4,42.6,0,1269,1271,5980
1978,20,l) Left Censored,34102,41128,627249,623115,1473,3.4,4601,10.8,96545,17399,79146,2.8,15.5,88276,33895,54381,5.4,14.2,8269,1.3,28.4,0,3148,3159,17885
1978,21,a) 0,7115,7147,37409,18784,7077,198,0,0,37250,37250,0,198.3,198.3,0,0,0,0,0,37250,198.3,0,0,,,
1978,21,b) 1,5815,6359,43717,44477,73,1,2122,28.6,11889,796,11093,1.8,26.7,13409,8687,4722,19.5,30.1,-1520,-3.4,53.4,0,1617,1617,6398
1978,21,l) Left Censored,38468,46682,875379,873200,1932,4,5286,10.9,134695,22116,112579,2.5,15.4,130336,51438,78898,5.9,14.9,4359,0.5,29.8,0,3616,3628,18658
1978,22,a) 0,7822,7849,44953,22477,7849,200,0,0,44953,44953,0,200,200,0,0,0,0,0,44953,200,0,0,,,
1978,22,b) 1,6483,7215,61087,61461,94,1.1,3000,34.2,20328,1152,19176,1.9,33.1,21076,13014,8062,21.2,34.3,-748,-1.2,66.2,0,1985,1987,8990
1978,22,l) Left Censored,42400,52984,1002457,978986,1518,2.7,7691,13.6,188329,28658,159671,2.9,19.2,141387,60173,81214,6.1,14.4,46942,4.8,28.8,0,4360,4384,27259
1978,23,a) 0,2794,2806,11847,5947,2788,198.7,0,0,11800,11800,0,198.4,198.4,0,0,0,0,0,11800,198.4,0,0,,,
1978,23,b) 1,2253,2488,17697,17706,24,0.9,662,23.5,4050,573,3477,3.2,22.9,4068,2197,1871,12.4,23,-18,-0.1,45.8,0,480,480,1658
1978,23,l) Left Censored,14608,17206,279741,273427,606,3.4,1871,10.5,46255,6654,39601,2.4,16.9,33626,12274,21352,4.5,12.3,12629,4.6,24.6,0,1327,1332,6671
1978,24,a) 0,7436,7513,37408,18789,7428,197.7,0,0,37239,37239,0,198.2,198.2,0,0,0,0,0,37239,198.2,0,0,,,
1978,24,b) 1,6670,7407,58952,57144,109,1.3,2093,24.9,18656,1320,17336,2.3,32.6,15040,9305,5735,16.3,26.3,3616,6.3,52.6,0,1499,1503,5842
1978,24,l) Left Censored,44913,55487,1078648,1074386,2062,3.6,5781,10.1,165428,30589,134839,2.8,15.4,156903,53677,103226,5,14.6,8525,0.8,29.2,0,3723,3741,23430
1978,25,a) 0,10406,10516,58194,29312,10373,197.3,0,0,57765,57765,0,197.1,197.1,0,0,0,0,0,57765,197.1,0,0,,,
1978,25,b) 1,9211,10337,111515,106982,207,1.8,2532,21.9,32722,4518,28204,4.2,30.6,23655,14111,9544,13.2,22.1,9067,8.5,44.2,0,1814,1815,9609
1978,25,l) Left Censored,75801,89639,1925948,1886562,2629,2.8,8919,9.6,308095,52612,255483,2.8,16.3,229323,96766,132557,5.1,12.2,78772,4.1,24.4,0,5804,5857,38898
1978,26,a) 0,16516,16660,91645,46071,16486,197.9,0,0,91148,91148,0,197.8,197.8,0,0,0,0,0,91148,197.8,0,0,,,
1978,26,b) 1,14063,15919,130844,128347,233,1.3,4273,23.7,36111,2910,33201,2.3,28.1,31116,19477,11639,15.2,24.2,4995,3.9,48.4,0,2946,2960,13268
1978,26,l) Left Censored,95354,118060,2664058,2619046,4388,3.6,13160,10.7,392551,72716,319835,2.8,15,302527,119129,183398,4.5,11.6,90024,3.4,23.2,0,8635,8677,55896
1978,27,a) 0,8975,9032,50252,25282,8943,198,0,0,49940,49940,0,197.5,197.5,0,0,0,0,0,49940,197.5,0,0,,,
1978,27,b) 1,7747,8622,73320,72239,127,1.3,2098,21.8,20718,1095,19623,1.5,28.7,18556,10176,8380,14.1,25.7,2162,3,51.4,0,1509,1517,6880
1978,27,l) Left Censored,51045,61904,1249110,1230109,2044,3.2,6398,10,214762,32636,182126,2.7,17.5,176759,57532,119227,4.7,14.4,38003,3.1,28.8,0,4361,4383,27357
1978,28,a) 0,5017,5037,26875,13514,4962,197,0,0,26723,26723,0,197.7,197.7,0,0,0,0,0,26723,197.7,0,0,,,
1978,28,b) 1,4147,4578,34041,33577,103,1.9,1590,29.7,10227,1395,8832,4.2,30.5,9298,5814,3484,17.3,27.7,929,2.8,55.4,0,1163,1165,4209
1978,28,l) Left Censored,25909,31590,546888,547334,1120,3.4,4104,12.4,83084,14738,68346,2.7,15.2,83976,28166,55810,5.1,15.3,-892,-0.1,30.4,0,2637,2646,13774
1978,29,a) 0,11131,11185,58922,29543,11097,198.4,0,0,58758,58758,0,198.9,198.9,0,0,0,0,0,58758,198.9,0,0,,,
1978,29,b) 1,9155,10111,77629,76760,193,1.7,3198,27.4,21518,2044,19474,2.7,28,19780,12385,7395,16.1,25.8,1738,2.2,51.6,0,2428,2436,8639
1978,29,l) Left Censored,61060,75415,1456250,1444549,2764,3.5,8821,11.2,229923,38254,191669,2.6,15.9,206520,80976,125544,5.6,14.3,23403,1.6,28.6,0,5840,5861,32257
1978,30,a) 0,2459,2466,13426,6715,2464,199.8,0,0,13423,13423,0,199.9,199.9,0,0,0,0,0,13423,199.9,0,0,,,
1978,30,b) 1,2107,2294,14298,15090,30,1.1,1033,36.5,4066,135,3931,0.9,26.9,5650,4250,1400,28.2,37.4,-1584,-10.5,53.8,0,638,638,2579
1978,30,l) Left Censored,11390,13562,169115,171571,396,2.7,2234,15.3,29227,2581,26646,1.5,17,34138,15374,18764,9,19.9,-4911,-2.9,34,0,1278,1282,7181
1978,31,a) 0,4032,4058,20104,10145,4011,197.7,0,0,19918,19918,0,196.3,196.3,0,0,0,0,0,19918,196.3,0,0,,,
1978,31,b) 1,3615,3955,25152,25621,61,1.4,1091,24.3,6383,766,5617,3,24.9,7321,4521,2800,17.6,28.6,-938,-3.7,49.8,0,798,812,3595
1978,31,l) Left Censored,24386,28881,436109,441529,932,3.1,3066,10.2,72049,9555,62494,2.2,16.3,82888,28712,54176,6.5,18.8,-10839,-2.5,32.6,0,2153,2163,11553
1978,32,a) 0,2349,2404,16470,8236,2403,199.9,0,0,16468,16468,0,200,200,0,0,0,0,0,16468,200,0,0,,,
1978,32,b) 1,1795,1978,20567,19144,23,0.9,895,36.7,8088,175,7913,0.9,42.2,5241,3841,1400,20.1,27.4,2847,14.8,54.8,0,556,556,2375
1978,32,l) Left Censored,8428,10086,231330,223833,415,3.8,1980,18.1,48246,8420,39826,3.8,21.6,33252,19445,13807,8.7,14.9,14994,6.7,29.8,0,1077,1081,9013
1978,33,a) 0,2623,2630,12354,6201,2606,198.2,0,0,12306,12306,0,198.5,198.5,0,0,0,0,0,12306,198.5,0,0,,,
1978,33,b) 1,2094,2280,16176,15419,47,1.8,679,26.1,5387,1248,4139,8.1,34.9,3873,2635,1238,17.1,25.1,1514,9.8,50.2,0,506,510,1928
1978,33,l) Left Censored,12711,14516,266794,256987,479,3.2,1462,9.7,47745,11687,36058,4.5,18.6,28131,10526,17605,4.1,10.9,19614,7.7,21.8,0,1022,1024,5286
1978,34,a) 0,14916,15004,68688,34605,14791,197.2,0,0,68166,68166,0,197,197,0,0,0,0,0,68166,197,0,0,,,
1978,34,b) 1,13352,14254,100242,100768,144,0.9,4048,24.9,26835,1067,25768,1.1,26.6,27886,17048,10838,16.9,27.7,-1051,-1.1,53.2,0,2840,2841,11084
1978,34,l) Left Censored,98813,115205,2232551,2212705,4124,3.5,12236,10.3,350122,68248,281874,3.1,15.8,310431,122883,187548,5.6,14,39691,1.8,28,0,7935,7975,47319
1978,35,a) 0,3126,3144,17289,8651,3143,199.9,0,0,17277,17277,0,199.7,199.7,0,0,0,0,0,17277,199.7,0,0,,,
1978,35,b) 1,2705,2965,21080,21995,56,1.5,1377,37.5,6487,493,5994,2.2,29.5,8316,6160,2156,28,37.8,-1829,-8.3,59,0,930,932,3843
1978,35,l) Left Censored,13990,17134,255091,252338,621,3.4,3042,16.5,49804,7763,42041,3.1,19.7,44298,23620,20678,9.4,17.6,5506,2.1,35.2,0,1785,1787,13673
1978,36,a) 0,35850,36063,176245,88595,35627,197.6,0,0,175301,175301,0,197.9,197.9,0,0,0,0,0,175301,197.9,0,0,,,
1978,36,b) 1,31357,34031,263490,257207,350,0.9,9705,25,82376,9964,72412,3.9,32,69809,40407,29402,15.7,27.1,12567,4.9,54.2,0,7206,7212,28311
1978,36,l) Left Censored,245855,283666,5327759,5316221,7774,2.6,33674,11.4,845164,129887,715277,2.4,15.9,822087,313315,508772,5.9,15.5,23077,0.4,31,0,23626,23720,143761
1978,37,a) 0,12708,12814,61887,31084,12681,197.9,0,0,61606,61606,0,198.2,198.2,0,0,0,0,0,61606,198.2,0,0,,,
1978,37,b) 1,9969,11028,82946,83400,126,1,3599,28.1,21050,1451,19599,1.7,25.2,21957,15097,6860,18.1,26.3,-907,-1.1,50.4,0,2793,2794,10727
1978,37,l) Left Censored,64963,82237,1709426,1685460,2921,3.4,8533,10,242642,44964,197678,2.7,14.4,194710,76433,118277,4.5,11.6,47932,2.8,23.2,0,5733,5768,33130
1978,38,a) 0,1830,1834,8270,4147,1819,198.4,0,0,8247,8247,0,198.9,198.9,0,0,0,0,0,8247,198.9,0,0,,,
1978,38,b) 1,1591,1683,11282,11117,21,1.1,508,26.2,3148,218,2930,2,28.3,2817,1928,889,17.3,25.3,331,3,50.6,0,364,364,1385
1978,38,l) Left Censored,10182,11866,143448,140806,363,3,1201,9.8,21969,2839,19130,2,15.6,16684,6196,10488,4.4,11.8,5285,3.8,23.6,0,825,829,3942
1978,39,a) 0,18360,18470,95545,48029,18267,197.8,0,0,95033,95033,0,197.9,197.9,0,0,0,0,0,95033,197.9,0,0,,,
1978,39,b) 1,15878,18193,139692,140346,297,1.4,4967,24.1,36320,3375,32945,2.4,25.9,37628,24080,13548,17.2,26.8,-1308,-0.9,51.8,0,3592,3609,15175
1978,39,l) Left Censored,120659,156192,3432917,3414707,5866,3.6,15705,9.7,484211,79760,404451,2.3,14.2,447793,139504,308289,4.1,13.1,36418,1.1,26.2,0,10018,10058,56080
1978,40,a) 0,7197,7245,38486,19244,7244,200,0,0,38485,38485,0,200,200,0,0,0,0,0,38485,200,0,0,,,
1978,40,b) 1,5783,6341,49725,52125,126,1.6,3051,38.6,13364,944,12420,1.8,25.6,18163,13102,5061,25.1,34.8,-4799,-9.2,51.2,0,2049,2057,8359
1978,40,l) Left Censored,34620,42402,687235,688049,1385,3,7492,16.4,111271,20150,91121,2.9,16.2,112898,58248,54650,8.5,16.4,-1627,-0.2,32.4,0,4295,4303,28263
1978,41,a) 0,8986,9030,45884,23059,8936,197.9,0,0,45650,45650,0,198,198,0,0,0,0,0,45650,198,0,0,,,
1978,41,b) 1,6677,7362,61941,57677,107,1.3,2411,28.2,22940,1977,20963,3.4,39.8,14412,9808,4604,17,25,8528,14.8,50,0,1736,1737,6153
1978,41,l) Left Censored,33451,40486,692119,666895,1705,4,5417,12.8,136907,22145,114762,3.3,20.5,86458,42241,44217,6.3,13,50449,7.5,26,0,3547,3564,21700
1978,42,a) 0,19369,19533,101024,50717,19330,197.9,0,0,100614,100614,0,198.4,198.4,0,0,0,0,0,100614,198.4,0,0,,,
1978,42,b) 1,17518,19567,155140,154672,334,1.5,4916,22.4,40983,4139,36844,2.7,26.5,40046,23769,16277,15.4,25.9,937,0.6,51.8,0,3424,3443,14537
1978,42,l) Left Censored,140057,172514,3662754,3674260,5642,3.2,17439,9.8,552846,94076,458770,2.6,15,575858,211817,364041,5.8,15.7,-23012,-0.7,30,0,11350,11416,104513
1978,44,a) 0,1969,1978,12280,6151,1964,198.6,0,0,12259,12259,0,199.3,199.3,0,0,0,0,0,12259,199.3,0,0,,,
1978,44,b) 1,1789,1892,12477,12251,19,0.9,537,24.8,4034,389,3645,3.2,32.9,3581,2429,1152,19.8,29.2,453,3.7,58.4,0,383,384,1751
1978,44,l) Left Censored,14134,15973,308829,327321,516,3.1,1551,9.4,51349,8062,43287,2.5,15.7,88333,16055,72278,4.9,27,-36984,-11.3,31.4,0,1055,1056,6237
1978,45,a) 0,6457,6494,32776,16461,6420,197.7,0,0,32630,32630,0,198.2,198.2,0,0,0,0,0,32630,198.2,0,0,,,
1978,45,b) 1,5154,5617,37559,36944,88,1.3,1869,28.6,11423,1132,10291,3.1,30.9,10192,6699,3493,18.1,27.6,1231,3.3,55.2,0,1446,1448,4704
1978,45,l) Left Censored,32257,40001,843084,822540,1522,3.7,4226,10.2,128921,31139,97782,3.8,15.7,87832,32927,54905,4,10.7,41089,5,21.4,0,2946,2955,13889
1978,46,a) 0,1989,1993,9236,4648,1978,198.5,0,0,9177,9177,0,197.4,197.4,0,0,0,0,0,9177,197.4,0,0,,,
1978,46,b) 1,1598,1728,11574,11484,18,0.9,557,27.8,3326,155,3171,1.3,29,3145,2055,1090,17.9,27.4,181,1.6,54.8,0,391,391,1504
1978,46,l) Left Censored,10778,12409,150241,166823,419,3.3,1307,10.2,24819,3457,21362,2.1,14.9,57982,7021,50961,4.2,34.8,-33163,-19.9,29.8,0,914,915,4161
1978,47,a) 0,9864,9917,52442,26349,9808,197.8,0,0,52187,52187,0,198.1,198.1,0,0,0,0,0,52187,198.1,0,0,,,
1978,47,b) 1,8227,9123,73615,79934,135,1.3,3057,28.8,22471,1782,20689,2.2,28.1,35109,14336,20773,17.9,43.9,-12638,-15.8,56.2,0,2322,2327,10687
1978,47,l) Left Censored,49368,61367,1260549,1244283,2124,3.3,6910,10.8,196886,33523,163363,2.7,15.8,164355,64334,100021,5.2,13.2,32531,2.6,26.4,0,4628,4645,27763
1978,48,a) 0,32516,32924,191536,95775,32922,200,0,0,191522,191522,0,200,200,0,0,0,0,0,191522,200,0,0,,,
1978,48,b) 1,26021,29600,247304,254163,558,1.5,13486,36.9,77277,5897,71380,2.3,30.4,90994,65686,25308,25.8,35.8,-13717,-5.4,60.8,0,8650,8711,40973
1978,48,l) Left Censored,145483,191892,3770862,3739482,7087,3.4,32944,16,688395,129235,559160,3.5,18.4,625634,291809,333825,7.8,16.7,62761,1.7,33.4,0,17908,17991,133458
1978,49,a) 0,3373,3392,19882,9941,3392,200,0,0,19882,19882,0,200,200,0,0,0,0,0,19882,200,0,0,,,
1978,49,b) 1,2762,3030,22122,22678,53,1.4,1439,38.2,7159,440,6719,1.9,31.6,8270,6366,1904,28.1,36.5,-1111,-4.9,63.2,0,852,852,3815
1978,49,l) Left Censored,14488,17593,334557,332730,680,3.6,2916,15.5,58417,11622,46795,3.5,17.6,54763,24652,30111,7.4,16.5,3654,1.1,33,0,1549,1558,11055
1978,50,a) 0,1652,1656,10125,5076,1639,197.9,0,0,10098,10098,0,198.9,198.9,0,0,0,0,0,10098,198.9,0,0,,,
1978,50,b) 1,1351,1455,9636,9117,10,0.6,337,20.8,2867,38,2829,0.4,31.4,1829,885,944,9.7,20.1,1038,11.3,40.2,0,254,256,689
1978,50,l) Left Censored,8075,9115,137789,136945,264,2.8,951,10,22960,3745,19215,2.7,16.8,21271,11359,9912,8.3,15.5,1689,1.3,31,0,707,712,4284
1978,51,a) 0,10729,10803,53434,26824,10707,198.2,0,0,53220,53220,0,198.4,198.4,0,0,0,0,0,53220,198.4,0,0,,,
1978,51,b) 1,8666,9571,77139,75069,175,1.6,2777,25.5,23762,3135,20627,4.2,31.7,19622,11480,8142,15.3,26.1,4140,5.6,52.2,0,2098,2099,7548
1978,51,l) Left Censored,56146,71307,1346185,1331799,2744,3.7,7283,9.9,208951,37453,171498,2.8,15.7,180178,70782,109396,5.3,13.5,28773,2.2,27,0,4782,4808,34791
1978,53,a) 0,12419,12498,72928,36610,12366,197.9,0,0,72636,72636,0,198.4,198.4,0,0,0,0,0,72636,198.4,0,0,,,
1978,53,b) 1,9454,10508,86377,81340,157,1.3,3421,28.1,31938,1752,30186,2.2,39.3,21864,14133,7731,17.4,26.9,10074,12.4,53.8,0,2406,2409,9739
1978,53,l) Left Censored,47685,58671,1040080,995207,2500,4.1,7716,12.6,224790,29935,194855,3,22.6,135043,59461,75582,6,13.6,89747,9,27.2,0,4627,4648,30999
1978,54,a) 0,3359,3378,15376,7775,3324,196.8,0,0,15202,15202,0,195.5,195.5,0,0,0,0,0,15202,195.5,0,0,,,
1978,54,b) 1,2929,3187,22529,23198,31,0.8,1050,28.3,5345,214,5131,0.9,23,6683,3874,2809,16.7,28.8,-1338,-5.8,46,0,753,755,2465
1978,54,l) Left Censored,20629,24732,415493,431188,822,3.2,2706,10.5,52041,8193,43848,1.9,12.1,83432,20146,63286,4.7,19.3,-31391,-7.2,24.2,0,1725,1729,8815
1978,55,a) 0,10113,10236,54300,27251,10141,198.1,0,0,54099,54099,0,198.5,198.5,0,0,0,0,0,54099,198.5,0,0,,,
1978,55,b) 1,8492,9487,70070,67793,148,1.4,2177,20.7,18827,909,17918,1.3,27.8,14273,8888,5385,13.1,21.1,4554,6.7,42.2,0,1571,1572,5778
1978,55,l) Left Censored,60247,71313,1421183,1394344,2247,3,6947,9.4,198238,28913,169325,2.1,14.2,144561,58716,85845,4.2,10.4,53677,3.8,20.8,0,4790,4817,28983
1978,56,a) 0,1655,1658,8820,4411,1657,199.9,0,0,8819,8819,0,199.9,199.9,0,0,0,0,0,8819,199.9,0,0,,,
1978,56,b) 1,1282,1385,11129,10910,16,0.9,602,35.4,3880,387,3493,3.5,35.6,3442,2341,1101,21.5,31.5,438,4.1,63,0,394,394,1401
1978,56,l) Left Censored,6533,7591,104407,101194,311,3.8,1369,16.8,24501,4700,19801,4.6,24.2,18074,9924,8150,9.8,17.9,6427,6.3,35.8,0,784,786,4658
1979,01,a) 0,7376,7442,47091,23626,7389,198.6,0,0,46931,46931,0,198.6,198.6,0,0,0,0,0,46931,198.6,0,0,,,
1979,01,b) 1,5987,6244,45467,46002,60,0.8,2154,29.2,13799,1037,12762,2.3,30,14869,8990,5879,19.5,32.3,-1070,-2.3,60,0,1788,1788,7701
1979,01,c) 2,5345,6096,54640,55875,300,4.5,1306,19.7,12622,2813,9809,5,22.6,15092,6885,8207,12.3,27,-2470,-4.4,45.2,0,993,997,5094
1979,01,l) Left Censored,36022,46173,935914,930479,1687,3.5,4646,9.7,146004,24411,121593,2.6,15.7,135134,48857,86277,5.3,14.5,10870,1.2,29,0,3118,3129,22936
1979,02,a) 0,1350,1371,7473,3742,1365,199.1,0,0,7462,7462,0,199.4,199.4,0,0,0,0,0,7462,199.4,0,0,,,
1979,02,b) 1,928,942,6284,6750,7,0.6,462,38.7,2163,88,2075,1.3,32,3094,2013,1081,29.8,45.8,-931,-13.8,64,0,354,354,1639
1979,02,c) 2,920,1059,12021,13936,88,7.7,243,21.2,2868,676,2192,4.9,20.6,6698,1514,5184,10.9,48.1,-3830,-27.5,41.2,0,163,163,1091
1979,02,l) Left Censored,3860,4926,82102,84394,344,6.7,695,13.6,16421,3459,12962,4.1,19.5,21006,8564,12442,10.1,24.9,-4585,-5.4,39,0,387,390,2830
1979,04,a) 0,7709,7800,51000,26035,7625,195.5,0,0,49931,49931,0,191.8,191.8,0,0,0,0,0,49931,191.8,0,0,,,
1979,04,b) 1,5550,5620,45620,43151,26,0.4,830,13.8,15238,318,14920,0.7,35.3,10299,4429,5870,10.3,23.9,4939,11.4,47.8,0,38,38,537
1979,04,c) 2,4476,5156,51747,50177,252,4.7,721,13.4,14497,2158,12339,4.3,28.9,11357,4561,6796,9.1,22.6,3140,6.3,45.2,0,21,25,478
1979,04,l) Left Censored,22590,30158,619830,594820,1326,4.3,2330,7.6,122112,23364,98748,3.9,20.5,72092,22153,49939,3.7,12.1,50020,8.4,24.2,0,59,69,437
1979,05,a) 0,5458,5527,30034,15228,5398,195.3,0,0,29612,29612,0,194.5,194.5,0,0,0,0,0,29612,194.5,0,0,,,
1979,05,b) 1,4351,4382,25293,25106,13,0.3,716,15.1,6655,103,6552,0.4,26.5,6280,2416,3864,9.6,25,375,1.5,50,1,10,11,
1979,05,c) 2,3586,3886,27632,28111,161,3.9,596,14.5,5632,997,4635,3.5,20,6589,2898,3691,10.3,23.4,-957,-3.4,40,1,3,3,
1979,05,l) Left Censored,23238,28182,519585,515105,858,3,2346,8.1,71756,12592,59164,2.4,13.9,62796,17289,45507,3.4,12.2,8960,1.7,24.4,0,53,59,2047
1979,06,a) 0,67070,67911,406715,203957,67548,198.9,0,0,405516,405516,0,198.8,198.8,0,0,0,0,0,405516,198.8,0,0,,,
1979,06,b) 1,49248,50132,367129,372710,336,0.6,15881,27.1,120143,4283,115860,1.1,32.2,131304,77831,53473,20.9,35.2,-11161,-3,64.4,0,12429,12445,64786
1979,06,c) 2,45098,52044,499543,498917,3878,7,10675,19.1,136607,29328,107279,5.9,27.4,135355,65692,69663,13.2,27.1,1252,0.3,54.2,0,7556,7578,42609
1979,06,l) Left Censored,236487,308585,6635399,6492655,18219,5.7,34070,10.7,1194215,281350,912865,4.3,18.4,908727,332021,576706,5.1,14,285488,4.4,28,0,21916,22066,150057
1979,08,a) 0,10318,10395,59952,30363,10208,196.4,0,0,59179,59179,0,194.9,194.9,0,0,0,0,0,59179,194.9,0,0,,,
1979,08,b) 1,7543,7611,52952,50825,30,0.4,1318,16,16692,1206,15486,2.4,32.8,12438,5606,6832,11,24.5,4254,8.3,49,0,25,27,458
1979,08,c) 2,6271,7033,63053,62696,274,3.7,1116,15,15606,2153,13453,3.4,24.9,14891,6759,8132,10.8,23.8,715,1.1,47.6,0,20,30,276
1979,08,l) Left Censored,32306,40605,809898,788610,1575,3.8,3617,8.7,143361,27208,116153,3.5,18.2,100784,35443,65341,4.5,12.8,42577,5.4,25.6,0,61,66,2690
1979,09,a) 0,6160,6202,31471,15744,6189,199.6,0,0,31454,31454,0,199.8,199.8,0,0,0,0,0,31454,199.8,0,0,,,
1979,09,b) 1,5165,5242,32656,32161,25,0.4,1242,21,9723,234,9489,0.7,30.2,8732,4070,4662,12.7,27.2,991,3,54.4,0,976,977,3352
1979,09,c) 2,5227,5805,47452,47518,286,4.7,851,13.9,10340,1700,8640,3.6,21.8,10472,4726,5746,9.9,22,-132,-0.2,43.6,0,601,601,2396
1979,09,l) Left Censored,40419,47590,1098578,1078952,1468,3,3938,8.1,147996,29146,118850,2.7,13.7,108743,36817,71926,3.4,10.1,39253,3.6,20.2,0,2583,2589,16235
1979,10,a) 0,1146,1156,6512,3262,1150,199,0,0,6500,6500,0,199.3,199.3,0,0,0,0,0,6500,199.3,0,0,,,
1979,10,b) 1,902,912,5761,5881,6,0.6,239,23.1,1731,52,1679,0.9,29.4,1971,1070,901,18.2,33.5,-240,-4.1,58.8,0,183,183,824
1979,10,c) 2,927,1084,9151,9208,43,3.7,193,16.6,1973,174,1799,1.9,21.4,2086,874,1212,9.5,22.7,-113,-1.3,42.8,0,143,150,684
1979,10,l) Left Censored,6947,8410,182843,194996,346,4,771,8.9,21126,4704,16422,2.4,10.8,45432,6228,39204,3.2,23.3,-24306,-12.5,21.6,0,483,487,2470
1979,11,a) 0,1371,1385,9411,4706,1384,199.9,0,0,9410,9410,0,200,200,0,0,0,0,0,9410,200,0,0,,,
1979,11,b) 1,1143,1153,11783,10264,11,0.8,292,22.4,5255,105,5150,1,51.2,2216,1155,1061,11.3,21.6,3039,29.6,43.2,0,228,228,946
1979,11,c) 2,1216,1372,29090,27492,77,5.3,235,16.1,6566,880,5686,3.2,23.9,3370,1369,2001,5,12.3,3196,11.6,24.6,0,155,155,789
1979,11,l) Left Censored,9638,11509,293625,287964,400,3.4,1080,9.1,43247,4440,38807,1.5,15,31924,12528,19396,4.4,11.1,11323,3.9,22.2,0,670,671,4810
1979,12,a) 0,28773,28987,167574,84112,28805,198.7,0,0,166925,166925,0,198.5,198.5,0,0,0,0,0,166925,198.5,0,0,,,
1979,12,b) 1,21588,21892,158347,159837,139,0.5,6940,27.1,51539,2056,49483,1.3,32.2,54518,32016,22502,20,34.1,-2979,-1.9,64.4,0,5730,5730,27242
1979,12,c) 2,18795,21121,189347,193922,1116,4.9,4575,19.9,46573,8366,38207,4.3,24,55723,28738,26985,14.8,28.7,-9150,-4.7,48,0,3494,3498,20888
1979,12,l) Left Censored,98267,128091,2268938,2233636,5913,4.5,13842,10.5,392785,87937,304848,3.9,17.6,322181,122093,200088,5.5,14.4,70604,3.2,28.8,0,9493,9594,66380
1979,13,a) 0,11491,11626,63710,31999,11525,198.3,0,0,63423,63423,0,198.2,198.2,0,0,0,0,0,63423,198.2,0,0,,,
1979,13,b) 1,9054,9209,61759,63199,86,0.8,3225,29.6,18205,1007,17198,1.6,28.8,21085,12684,8401,20.1,33.4,-2880,-4.6,57.6,0,2713,2713,10870
1979,13,c) 2,8400,9483,83989,84249,515,5,2018,19.6,20531,4401,16130,5.2,24.4,21051,10074,10977,12,25,-520,-0.6,48.8,0,1581,1584,7449
1979,13,l) Left Censored,53618,71097,1487759,1476792,3196,4.4,7007,9.6,225772,56323,169449,3.8,15.3,203837,66937,136900,4.5,13.8,21935,1.5,27.6,0,4483,4500,28450
1979,15,a) 0,2379,2417,15156,7605,2402,198.8,0,0,15103,15103,0,198.6,198.6,0,0,0,0,0,15103,198.6,0,0,,,
1979,15,b) 1,1818,1848,16159,15924,12,0.6,453,21.7,4365,169,4196,1.1,27.4,3895,1860,2035,11.7,24.5,470,2.9,49,0,357,357,1583
1979,15,c) 2,1616,2029,18960,19522,130,6.1,338,15.8,4022,825,3197,4.2,20.6,5145,2309,2836,11.8,26.4,-1123,-5.8,41.2,0,231,231,1172
1979,15,l) Left Censored,10359,13251,249278,244761,604,4.4,1261,9.3,40707,8234,32473,3.4,16.6,31673,11447,20226,4.7,12.9,9034,3.7,25.8,0,810,819,5820
1979,16,a) 0,2799,2824,15884,8135,2747,194.5,0,0,15499,15499,0,190.5,190.5,0,0,0,0,0,15499,190.5,0,0,,,
1979,16,b) 1,2176,2187,14323,14643,9,0.4,433,18,3189,68,3121,0.5,21.8,3828,1510,2318,10.3,26.1,-639,-4.3,43.6,0,9,9,23
1979,16,c) 2,1805,1998,14230,14507,76,3.6,315,14.9,3288,693,2595,4.8,22.7,3842,1561,2281,10.8,26.5,-554,-3.8,45.4,0,6,6,26
1979,16,l) Left Censored,10418,12998,228562,215218,427,3.2,981,7.4,56769,32091,24678,14.9,26.4,30081,8725,21356,4.1,14,26688,12.4,28,0,18,19,320
1979,17,a) 0,19817,19999,122495,61474,19870,198.7,0,0,122042,122042,0,198.5,198.5,0,0,0,0,0,122042,198.5,0,0,,,
1979,17,b) 1,16695,17003,117697,119018,92,0.5,4485,23.1,31409,1729,29680,1.5,26.4,34051,17126,16925,14.4,28.6,-2642,-2.2,52.8,0,3586,3587,14082
1979,17,c) 2,16256,18476,173399,177232,839,4.2,3395,17.1,34097,6499,27598,3.7,19.2,41763,19046,22717,10.7,23.6,-7666,-4.4,38.4,0,2411,2412,12005
1979,17,l) Left Censored,126710,154851,3842547,3805882,5659,3.5,15484,9.7,562631,104787,457844,2.8,14.8,489302,176545,312757,4.6,12.9,73329,1.9,25.8,0,10192,10243,73119
1979,18,a) 0,9642,9720,50881,25507,9654,198.6,0,0,50749,50749,0,199,199,0,0,0,0,0,50749,199,0,0,,,
1979,18,b) 1,7930,8109,57511,56278,65,0.7,2319,24.9,18431,1428,17003,2.5,32.7,15965,8277,7688,14.7,28.4,2466,4.3,56.8,0,1888,1896,6846
1979,18,c) 2,7453,8586,76831,77540,428,4.7,1553,16.9,16777,2823,13954,3.6,21.6,18195,8810,9385,11.4,23.5,-1418,-1.9,43.2,0,1172,1180,6353
1979,18,l) Left Censored,56879,72531,1705058,1699379,2464,3.3,6739,9,220724,39981,180743,2.4,13,209366,62449,146917,3.7,12.3,11358,0.7,24.6,0,4506,4523,28239
1979,19,a) 0,6251,6383,34506,17304,6341,198.7,0,0,34405,34405,0,198.8,198.8,0,0,0,0,0,34405,198.8,0,0,,,
1979,19,b) 1,5572,5645,34891,35873,41,0.6,1634,25.2,8917,510,8407,1.4,24.9,10880,5853,5027,16.3,30.3,-1963,-5.4,49.8,0,1314,1314,4768
1979,19,c) 2,5435,6093,45892,47634,252,3.8,1147,17.4,8697,1661,7036,3.5,18.3,12180,6169,6011,13,25.6,-3483,-7.3,36.6,0,889,890,4312
1979,19,l) Left Censored,38568,47427,802396,795460,1307,2.7,4819,9.8,106831,16161,90670,2,13.4,92958,33581,59377,4.2,11.7,13873,1.7,23.4,0,3282,3342,17759
1979,20,a) 0,5668,5705,29771,14954,5656,198.3,0,0,29635,29635,0,198.2,198.2,0,0,0,0,0,29635,198.2,0,0,,,
1979,20,b) 1,4743,4787,28448,30379,17,0.3,1460,26.3,7469,80,7389,0.3,24.6,11331,5784,5547,19,37.3,-3862,-12.7,49.2,0,1200,1200,4931
1979,20,c) 2,4459,4980,39045,39581,215,4,1010,18.7,9166,2228,6938,5.6,23.2,10237,4974,5263,12.6,25.9,-1071,-2.7,46.4,0,736,737,3312
1979,20,l) Left Censored,31393,38568,648569,637889,1330,3.3,3749,9.4,98899,14553,84346,2.3,15.5,77538,29123,48415,4.6,12.2,21361,3.3,24.4,0,2512,2523,13778
1979,21,a) 0,6628,6691,38493,19278,6662,199.1,0,0,38431,38431,0,199.4,199.4,0,0,0,0,0,38431,199.4,0,0,,,
1979,21,b) 1,5269,5329,36529,37115,28,0.4,1737,27.8,10289,262,10027,0.7,27.7,11461,6585,4876,17.7,30.9,-1172,-3.2,55.4,0,1465,1465,5534
1979,21,c) 2,4924,5506,44278,43803,280,4.7,1051,17.7,11612,3367,8245,7.7,26.5,10661,5395,5266,12.3,24.3,951,2.2,48.6,0,819,819,3847
1979,21,l) Left Censored,35408,43864,891473,882735,1626,3.6,4218,9.3,135922,24968,110954,2.8,15.4,118445,39875,78570,4.5,13.4,17477,2,26.8,0,2867,2880,19656
1979,22,a) 0,9311,9395,59164,29938,9208,196,0,0,58453,58453,0,195.2,195.2,0,0,0,0,0,58453,195.2,0,0,,,
1979,22,b) 1,6889,6927,58428,53839,19,0.3,973,13.1,22012,379,21633,0.7,40.9,12834,4707,8127,8.7,23.8,9178,17.1,47.6,1,5,5,
1979,22,c) 2,5853,6544,62508,61898,257,3.7,918,13.4,16679,3405,13274,5.5,26.9,15458,6949,8509,11.2,25,1221,1.9,50,1,17,18,
1979,22,l) Left Censored,40310,51365,1035774,1019738,1716,3.3,3623,6.9,163678,27304,136374,2.7,16.1,131605,39056,92549,3.8,12.9,32073,3.2,25.8,0,35,53,1109
1979,23,a) 0,2383,2400,11513,5769,2388,199,0,0,11489,11489,0,199.2,199.2,0,0,0,0,0,11489,199.2,0,0,,,
1979,23,b) 1,2123,2146,11556,11664,14,0.6,622,25.1,3208,168,3040,1.4,27.5,3424,1920,1504,16.5,29.4,-216,-1.9,55,0,486,486,1550
1979,23,c) 2,1911,2139,17411,17491,87,3.8,395,17.1,3133,747,2386,4.3,17.9,3293,1423,1870,8.1,18.8,-160,-0.9,35.8,0,275,275,856
1979,23,l) Left Censored,13457,16118,276383,277923,565,3.4,1573,9.4,35755,6982,28773,2.5,12.9,38834,11763,27071,4.2,14,-3079,-1.1,25.8,0,1083,1089,6174
1979,24,a) 0,7175,7250,38641,19436,7210,198.9,0,0,38410,38410,0,197.6,197.6,0,0,0,0,0,38410,197.6,0,0,,,
1979,24,b) 1,5634,5742,42615,40551,56,0.8,1699,25.6,15660,824,14836,2,38.6,11531,6779,4752,16.7,28.4,4129,10.2,56.8,0,1330,1332,5146
1979,24,c) 2,5725,6460,56396,57275,351,5.1,1228,17.7,13049,2340,10709,4.1,22.8,14806,6481,8325,11.3,25.9,-1757,-3.1,45.6,0,876,878,4157
1979,24,l) Left Censored,41495,52450,1091688,1084159,2139,4,4956,9.2,155444,31696,123748,2.9,14.3,140386,52103,88283,4.8,12.9,15058,1.4,25.8,0,3239,3270,20646
1979,25,a) 0,9983,10073,57385,28749,10013,198.8,0,0,57273,57273,0,199.2,199.2,0,0,0,0,0,57273,199.2,0,0,,,
1979,25,b) 1,8246,8415,64204,60994,71,0.7,2010,21.2,21268,2024,19244,3.3,34.9,14847,8225,6622,13.5,24.3,6421,10.6,48.6,0,1598,1599,6199
1979,25,c) 2,7964,9115,107009,109087,448,4.6,1563,16.1,22177,3528,18649,3.2,20.3,26333,9814,16519,9,24.1,-4156,-3.8,40.6,0,1133,1135,4902
1979,25,l) Left Censored,70713,84715,1976350,1950420,2720,3.1,7341,8.4,286094,53169,232925,2.7,14.7,234235,70403,163832,3.6,12,51859,2.7,24,0,4775,4799,34622
1979,26,a) 0,15275,15438,85567,42898,15339,198.7,0,0,85338,85338,0,198.9,198.9,0,0,0,0,0,85338,198.9,0,0,,,
1979,26,b) 1,12868,13084,118076,116882,62,0.4,3405,22.9,27404,732,26672,0.6,23.4,25016,13819,11197,11.8,21.4,2388,2,42.8,0,2663,2663,11226
1979,26,c) 2,12229,14040,129908,129476,705,4.7,2402,16.1,29270,4583,24687,3.5,22.6,28406,13089,15317,10.1,21.9,864,0.7,43.8,0,1722,1727,7958
1979,26,l) Left Censored,87607,110759,2730091,2695809,4098,3.6,10871,9.5,367799,70170,297629,2.6,13.6,299235,99561,199674,3.7,11.1,68564,2.5,22.2,0,7126,7180,49965
1979,27,a) 0,8577,8694,54769,28108,8631,198.6,0,0,53323,53323,0,189.7,189.7,0,0,0,0,0,53323,189.7,0,0,,,
1979,27,b) 1,7112,7213,53069,51905,47,0.6,1720,21.2,16391,2005,14386,3.9,31.6,14062,7131,6931,13.7,27.1,2329,4.5,54.2,0,1326,1326,5663
1979,27,c) 2,6627,7493,70067,71669,273,3.4,1324,16.4,14935,2219,12716,3.1,20.8,18139,8265,9874,11.5,25.3,-3204,-4.5,41.6,0,991,994,4768
1979,27,l) Left Censored,47057,58097,1294501,1270706,1878,3.1,5455,9.1,199318,34577,164741,2.7,15.7,151730,50668,101062,4,11.9,47588,3.8,23.8,0,3603,3620,22972
1979,28,a) 0,5038,5073,27770,13935,5022,198,0,0,27671,27671,0,198.6,198.6,0,0,0,0,0,27671,198.6,0,0,,,
1979,28,b) 1,3678,3709,24846,26251,14,0.3,1251,28.6,6020,186,5834,0.7,22.9,8830,5086,3744,19.4,33.6,-2810,-10.7,45.8,0,1047,1047,4353
1979,28,c) 2,3559,4030,33481,33617,290,6.7,763,17.7,7785,1868,5917,5.6,23.2,8056,3402,4654,10.1,24,-271,-0.8,46.4,0,580,580,2539
1979,28,l) Left Censored,23911,29730,560275,553091,1288,4.2,2978,9.7,88970,15308,73662,2.8,16.1,74601,26004,48597,4.7,13.5,14369,2.6,27,0,2107,2118,12653
1979,29,a) 0,10330,10423,57126,28640,10366,198.9,0,0,56972,56972,0,198.9,198.9,0,0,0,0,0,56972,198.9,0,0,,,
1979,29,b) 1,8301,8392,56160,58103,39,0.4,2671,27.3,15737,497,15240,0.9,27.1,19622,12639,6983,21.8,33.8,-3885,-6.7,54.2,0,2196,2196,11147
1979,29,c) 2,7829,8771,73172,75188,407,4.3,1644,17.4,15123,2920,12203,3.9,20.1,19155,9788,9367,13,25.5,-4032,-5.4,40.2,0,1226,1228,6160
1979,29,l) Left Censored,56030,70584,1495742,1473972,2523,3.5,7025,9.6,218199,34460,183739,2.3,14.8,174659,59151,115508,4,11.8,43540,3,23.6,0,4557,4616,25779
1979,30,a) 0,2870,2899,14987,7607,2825,194.9,0,0,14761,14761,0,194,194,0,0,0,0,0,14761,194,0,0,,,
1979,30,b) 1,2108,2123,13743,13923,9,0.4,357,15.5,3365,26,3339,0.2,24.2,3724,1466,2258,10.5,26.7,-359,-2.5,48.4,1,2,2,
1979,30,c) 2,1895,2088,14397,14351,100,4.6,306,14,3324,386,2938,2.7,23.2,3231,1318,1913,9.2,22.5,93,0.7,45,1,4,4,
1979,30,l) Left Censored,10800,12988,184938,176905,390,2.9,1026,7.7,36761,4009,32752,2.3,20.8,20694,5972,14722,3.4,11.7,16067,9.1,23.4,0,14,14,196
1979,31,a) 0,3751,3788,19344,9686,3776,199.4,0,0,19316,,,,199.4,0,0,0,0,0,19316,199.4,0,1,,,
1979,31,b) 1,3107,3143,20520,20396,14,0.4,861,23.9,5578,,,,27.3,5329,2977,2352,14.6,26.1,249,1.2,52.2,1,674,674,2259
1979,31,c) 2,3067,3385,24103,24495,137,3.7,655,17.9,4952,748,4204,3.1,20.2,5735,3111,2624,12.7,23.4,-783,-3.2,40.4,0,468,468,2028
1979,31,l) Left Censored,22406,26918,437235,436289,681,2.4,2531,9.1,63130,7499,55631,1.7,14.5,61238,16701,44537,3.8,14,1892,0.5,28,0,1654,1660,8265
1979,32,a) 0,2972,2987,22376,11277,2920,195.5,0,0,22199,22199,0,196.9,196.9,0,0,0,0,0,22199,196.9,0,0,,,
1979,32,b) 1,2015,2068,20768,19567,5,0.2,340,15.2,7481,27,7454,0.1,38.2,5078,2003,3075,10.2,26,2403,12.2,52,0,22,22,172
1979,32,c) 2,1618,1814,22225,21872,81,4.3,249,13.1,5067,665,4402,3,23.2,4361,1612,2749,7.4,19.9,706,3.3,39.8,0,13,13,106
1979,32,l) Left Censored,8062,9919,256394,242838,545,5.4,777,7.8,55455,15052,40403,6.2,22.8,28343,9444,18899,3.9,11.7,27112,11.1,23.4,0,55,56,564
1979,33,a) 0,2338,2357,12435,6228,2345,199,0,0,12414,12414,0,199.3,199.3,0,0,0,0,0,12414,199.3,0,0,,,
1979,33,b) 1,1988,2000,12279,12281,8,0.3,594,25.6,3493,171,3322,1.4,28.4,3496,1931,1565,15.7,28.5,-3,-0.1,56.8,0,456,456,1516
1979,33,c) 2,1817,2005,16701,16451,88,4.1,340,15.9,3772,537,3235,3.3,22.9,3272,1590,1682,9.7,19.9,500,3,39.8,0,252,252,1107
1979,33,l) Left Censored,11778,13685,279085,272727,495,3.5,1262,9,43776,6355,37421,2.3,16.1,31060,10490,20570,3.8,11.4,12716,4.7,22.8,0,869,875,4784
1979,34,a) 0,14950,15040,71943,36104,14944,198.7,0,0,71679,71679,0,198.5,198.5,0,0,0,0,0,71679,198.5,0,0,,,
1979,34,b) 1,11623,11764,71227,69684,54,0.4,3036,22.7,23108,1117,21991,1.6,33.2,20022,10517,9505,15.1,28.7,3086,4.5,57.4,0,2310,2311,8299
1979,34,c) 2,11701,12557,98187,98588,673,5,2157,16.1,22290,3822,18468,3.9,22.6,23092,10806,12286,11,23.4,-802,-0.8,45.2,0,1596,1599,7848
1979,34,l) Left Censored,91939,108698,2264685,2247993,3880,3.5,9900,8.8,332307,73927,258380,3.3,14.8,298924,100232,198692,4.5,13.3,33383,1.5,26.6,0,6389,6412,40711
1979,35,a) 0,3716,3770,22641,11455,3689,195.7,0,0,22373,22373,0,195.3,195.3,0,0,0,0,0,22373,195.3,0,0,,,
1979,35,b) 1,2690,2715,18154,17853,13,0.4,442,15.1,5520,67,5453,0.4,30.9,4917,1897,3020,10.6,27.5,603,3.4,55,1,13,13,
1979,35,c) 2,2399,2657,20290,20715,111,4,421,15,4628,635,3993,3.1,22.3,5477,2177,3300,10.5,26.4,-849,-4.1,44.6,1,3,3,
1979,35,l) Left Censored,13211,16448,266666,261205,658,3.9,1446,8.6,45871,8698,37173,3.3,17.6,34949,12669,22280,4.9,13.4,10922,4.2,26.8,0,20,25,745
1979,36,a) 0,33963,34157,175445,88324,33957,198.8,0,0,174242,174242,0,197.3,197.3,0,0,0,0,0,174242,197.3,0,0,,,
1979,36,b) 1,28190,28513,181070,180131,120,0.4,7139,22.1,55609,2273,53336,1.3,30.9,53731,25940,27791,14.4,29.8,1878,1.1,59.6,0,5705,5705,20123
1979,36,c) 2,26930,29616,248985,254743,1328,4.2,5373,16.9,55255,9497,45758,3.7,21.7,66771,27709,39062,10.9,26.2,-11516,-4.5,43.4,0,4144,4157,20300
1979,36,l) Left Censored,225343,263220,5293343,5306209,7634,2.8,27071,9.9,732861,130184,602677,2.5,13.8,758592,255184,503408,4.8,14.3,-25731,-0.5,27.6,0,19101,19202,122101
1979,37,a) 0,11707,11798,60345,30241,11727,198.8,0,0,60208,60208,0,199.1,199.1,0,0,0,0,0,60208,199.1,0,0,,,
1979,37,b) 1,9395,9535,59543,60822,55,0.5,3115,27.9,17563,919,16644,1.5,28.9,20121,12315,7806,20.2,33.1,-2558,-4.2,57.8,0,2543,2543,10045
1979,37,c) 2,8440,9475,81074,82032,411,4,1830,17.9,16359,1862,14497,2.3,19.9,18275,9732,8543,11.9,22.3,-1916,-2.4,39.8,0,1407,1407,6570
1979,37,l) Left Censored,59816,77791,1768039,1737456,2873,3.6,6964,8.7,244747,51593,193154,3,14.1,183581,63946,119635,3.7,10.6,61166,3.5,21.2,0,4664,4684,28138
1979,38,a) 0,1822,1835,9615,4839,1827,199.1,0,0,9552,9552,0,197.4,197.4,0,0,0,0,0,9552,197.4,0,0,,,
1979,38,b) 1,1376,1385,7706,7923,6,0.4,411,25.5,1858,59,1799,0.7,23.5,2292,1264,1028,16,28.9,-434,-5.4,47,0,319,319,1080
1979,38,c) 2,1360,1443,10037,10578,64,4.1,286,18.3,2010,372,1638,3.5,19,3092,1660,1432,15.7,29.2,-1082,-10.2,38,0,202,202,885
1979,38,l) Left Censored,9415,11128,150405,146826,366,3.2,1034,9,25751,4495,21256,3.1,17.5,18593,6499,12094,4.4,12.7,7158,4.8,25.4,0,725,726,4626
1979,39,a) 0,17533,17695,101018,50700,17589,198.8,0,0,100637,100637,0,198.5,198.5,0,0,0,0,0,100637,198.5,0,0,,,
1979,39,b) 1,14110,14342,97772,96560,112,0.7,3952,24.1,29810,1550,28260,1.6,30.9,27385,16643,10742,17.2,28.4,2425,2.5,56.8,0,3138,3139,13180
1979,39,c) 2,13796,16134,139467,139546,749,4.4,2663,15.5,29633,5503,24130,3.9,21.2,29790,14231,15559,10.2,21.3,-157,-0.1,42.4,0,1891,1892,9041
1979,39,l) Left Censored,111433,147487,3499308,3463935,5517,3.6,13604,9,464566,90422,374144,2.6,13.4,393820,137160,256660,4,11.4,70746,2,22.8,0,8319,8369,52686
1979,40,a) 0,8336,8410,48142,24304,8259,196.4,0,0,47676,47676,0,196.2,196.2,0,0,0,0,0,47676,196.2,0,0,,,
1979,40,b) 1,6220,6282,43117,42712,22,0.3,1011,14.9,11696,232,11464,0.5,27.4,10886,4679,6207,11,25.5,810,1.9,51,0,18,18,368
1979,40,c) 2,5188,5776,48605,49208,286,4.7,877,14.5,10453,1580,8873,3.2,21.2,11659,5403,6256,11,23.7,-1206,-2.5,42.4,0,9,9,91
1979,40,l) Left Censored,32824,40931,726583,705747,1417,3.4,3103,7.5,126473,21657,104816,3.1,17.9,84801,26885,57916,3.8,12,41672,5.9,24,0,64,71,776
1979,41,a) 0,8409,8474,44913,22499,8432,199,0,0,44828,44828,0,199.2,199.2,0,0,0,0,0,44828,199.2,0,0,,,
1979,41,b) 1,6472,6535,42222,43877,27,0.3,2348,30.2,12134,560,11574,1.3,27.7,15443,8768,6675,20,35.2,-3309,-7.5,55.4,0,1876,1876,7106
1979,41,c) 2,5611,6290,53824,57608,409,6,1389,20.3,11940,2864,9076,5,20.7,19508,7791,11717,13.5,33.9,-7568,-13.2,41.4,0,1018,1022,5284
1979,41,l) Left Censored,30642,37976,731084,710625,1879,4.8,4137,10.5,144112,23872,120240,3.4,20.3,103194,36364,66830,5.1,14.5,40918,5.8,29,0,2786,2790,17712
1979,42,a) 0,18378,18626,100185,50273,18506,198.7,0,0,99825,99825,0,198.6,198.6,0,0,0,0,0,99825,198.6,0,0,,,
1979,42,b) 1,15260,15501,108786,106704,113,0.6,3847,21.9,32278,1643,30635,1.5,30.3,28113,14106,14007,13.2,26.3,4165,4,52.6,0,3015,3018,10816
1979,42,c) 2,15273,17331,152955,153265,842,4.6,2833,15.4,32395,6203,26192,4,21.1,33015,14359,18656,9.4,21.5,-620,-0.4,42.2,0,2016,2020,9222
1979,42,l) Left Censored,129684,162914,3645274,3650552,5341,3.2,14320,8.5,473908,81251,392657,2.2,13,484466,146805,337661,4,13.3,-10558,-0.3,26,0,9359,9423,58723
1979,44,a) 0,1888,1899,10231,5120,1892,199.3,0,0,10223,10223,0,199.7,199.7,0,0,0,0,0,10223,199.7,0,0,,,
1979,44,b) 1,1536,1553,12017,12262,9,0.5,402,22.8,3734,49,3685,0.4,30.5,4224,1733,2491,14.1,34.4,-490,-3.9,61,0,322,322,1342
1979,44,c) 2,1563,1661,13174,12855,73,4.1,288,16.2,3321,805,2516,6.3,25.8,2683,1127,1556,8.8,20.9,638,4.9,41.8,0,210,210,806
1979,44,l) Left Censored,13286,15164,306955,307569,477,3.1,1227,7.9,40917,7638,33279,2.5,13.3,42145,11481,30664,3.7,13.7,-1228,-0.4,26.6,0,808,810,5222
1979,45,a) 0,5722,5777,30215,15184,5731,198.4,0,0,30062,30062,0,198,198,0,0,0,0,0,30062,198,0,0,,,
1979,45,b) 1,4750,4799,34135,34580,18,0.3,1591,28.2,9320,246,9074,0.7,27,10209,6083,4126,17.6,29.5,-889,-2.5,54,0,1298,1298,4761
1979,45,c) 2,4248,4697,33406,35304,217,4.2,1058,20.5,6796,1258,5538,3.6,19.2,10591,5417,5174,15.3,30,-3795,-10.8,38.4,0,809,822,4067
1979,45,l) Left Censored,29630,37733,865647,853748,1408,3.6,3506,9,117394,20223,97171,2.4,13.8,93595,26782,66813,3.1,11,23799,2.8,22,0,2416,2437,13367
1979,46,a) 0,1768,1784,9701,4866,1771,198.5,0,0,9670,9670,0,198.7,198.7,0,0,0,0,0,9670,198.7,0,0,,,
1979,46,b) 1,1521,1533,8556,8822,6,0.3,442,25,2343,69,2274,0.8,26.6,2874,1576,1298,17.9,32.6,-531,-6,53.2,0,340,340,1331
1979,46,c) 2,1356,1484,10523,10989,67,4.2,287,17.9,2290,307,1983,2.8,20.8,3221,1913,1308,17.4,29.3,-931,-8.5,41.6,0,221,221,918
1979,46,l) Left Censored,9912,11616,156729,153388,413,3.4,1139,9.5,25164,4812,20352,3.1,16.4,18482,6415,12067,4.2,12,6682,4.4,24,0,766,767,3890
1979,47,a) 0,9339,9437,51970,26068,9390,199,0,0,51805,51805,0,198.7,198.7,0,0,0,0,0,51805,198.7,0,0,,,
1979,47,b) 1,7143,7223,50080,50983,35,0.4,2557,29.8,15612,319,15293,0.6,30.6,17417,10471,6946,20.5,34.2,-1805,-3.6,61.2,0,2130,2130,9058
1979,47,c) 2,6841,7763,76908,75175,397,4.7,1650,19.5,23448,3350,20098,4.5,31.2,19982,8666,11316,11.5,26.6,3466,4.6,53.2,0,1230,1230,5946
1979,47,l) Left Censored,44983,57348,1278914,1268978,2164,3.6,5897,9.9,183699,41032,142667,3.2,14.5,163827,53677,110150,4.2,12.9,19872,1.6,25.8,0,3827,3839,23241
1979,48,a) 0,38639,39237,250437,126945,38394,195.7,0,0,246984,246984,0,194.6,194.6,0,0,0,0,0,246984,194.6,0,0,,,
1979,48,b) 1,28132,28680,216369,210186,175,0.6,4558,14.8,67204,2950,64254,1.4,32,54838,23102,31736,11,26.1,12366,5.9,52.2,0,48,49,740
1979,48,c) 2,23624,27298,248537,248392,1250,4.4,3682,12.9,60045,10883,49162,4.4,24.2,59754,24019,35735,9.7,24.1,291,0.1,48.2,0,42,46,737
1979,48,l) Left Censored,138200,186840,3961586,3865681,7771,4.1,13988,7.4,716201,158223,557978,4.1,18.5,524390,152400,371990,3.9,13.6,191811,4.9,27.2,0,218,286,7965
1979,49,a) 0,3785,3827,23376,11805,3757,196.3,0,0,23143,23143,0,196,196,0,0,0,0,0,23143,196,0,0,,,
1979,49,b) 1,2916,2940,22159,21955,14,0.4,471,14.9,6511,276,6235,1.3,29.7,6103,2118,3985,9.6,27.8,408,1.9,55.6,0,7,8,120
1979,49,c) 2,2526,2787,22108,22214,120,4.1,378,13,5545,1320,4225,5.9,25,5756,2016,3740,9.1,25.9,-211,-0.9,50,0,6,6,41
1979,49,l) Left Censored,13874,17168,345136,339149,669,3.9,1176,6.8,56588,12258,44330,3.6,16.7,44614,13557,31057,4,13.2,11974,3.5,26.4,0,24,27,489
1979,50,a) 0,1448,1459,6890,3456,1449,198.6,0,0,6869,6869,0,198.8,198.8,0,0,0,0,0,6869,198.8,0,0,,,
1979,50,b) 1,1289,1295,7737,8845,4,0.3,340,23.1,2086,46,2040,0.5,23.6,4302,1192,3110,13.5,48.6,-2216,-25,47.2,0,271,271,892
1979,50,c) 2,1177,1291,9304,9452,62,4.5,217,15.8,1834,355,1479,3.8,19.4,2129,875,1254,9.3,22.5,-295,-3.1,38.8,0,168,168,626
1979,50,l) Left Censored,7430,8512,140378,139067,238,2.7,803,9.1,19445,3087,16358,2.2,14,16823,6110,10713,4.4,12.1,2622,1.9,24.2,0,601,607,3879
1979,51,a) 0,9987,10072,54518,27317,10022,199,0,0,54402,54402,0,199.2,199.2,0,0,0,0,0,54402,199.2,0,0,,,
1979,51,b) 1,8010,8147,55293,54243,68,0.7,2585,27.3,18842,787,18055,1.5,34.7,16742,10142,6600,18.7,30.9,2100,3.8,61.8,0,2109,2109,8595
1979,51,c) 2,7348,8312,77205,78716,435,4.9,1571,17.6,17550,3099,14451,3.9,22.3,20573,8994,11579,11.4,26.1,-3023,-3.8,44.6,0,1207,1207,5532
1979,51,l) Left Censored,51755,67418,1364041,1352567,2581,3.7,6221,9,196786,41537,155249,3.1,14.5,173839,54521,119318,4,12.9,22947,1.6,25.8,0,4083,4106,23256
1979,53,a) 0,11628,11709,65065,32592,11649,199,0,0,64947,64947,0,199.3,199.3,0,0,0,0,0,64947,199.3,0,0,,,
1979,53,b) 1,9039,9154,61852,67583,44,0.4,3095,28.6,19487,551,18936,0.8,28.8,30949,11413,19536,16.9,45.8,-11462,-17,57.6,0,2365,2365,9065
1979,53,c) 2,8109,9159,75755,80715,611,6.2,1834,18.6,18080,3671,14409,4.5,22.4,27999,9529,18470,11.8,34.7,-9919,-12.3,44.8,0,1287,1290,6299
1979,53,l) Left Censored,44194,55386,1015522,1026438,3020,5.3,5963,10.5,185284,36043,149241,3.5,18.1,207116,77905,129211,7.6,20.2,-21832,-2.1,36.2,0,3828,3857,25072
1979,54,a) 0,3289,3308,16384,8220,3282,198.4,0,0,16329,16329,0,198.6,198.6,0,0,0,0,0,16329,198.6,0,0,,,
1979,54,b) 1,2448,2474,16408,15766,12,0.4,848,29,5688,160,5528,1,36.1,4404,2647,1757,16.8,27.9,1284,8.2,55.8,0,681,681,2158
1979,54,c) 2,2497,2761,23336,22923,148,5,525,17.7,5841,724,5117,3.2,25.5,5014,2580,2434,11.3,21.9,827,3.6,43.8,0,408,411,1632
1979,54,l) Left Censored,19050,23280,471071,442832,907,3.8,2208,9.2,104438,11562,92876,2.6,23.6,47961,15618,32343,3.5,10.8,56477,12.8,21.6,0,1440,1444,7098
1979,55,a) 0,8843,8918,47549,23824,8873,199,0,0,47450,47450,0,199.2,199.2,0,0,0,0,0,47450,199.2,0,0,,,
1979,55,b) 1,8014,8159,55033,55652,36,0.4,1978,21.5,13071,507,12564,0.9,23.5,14308,7626,6682,13.7,25.7,-1237,-2.2,47,0,1524,1525,6040
1979,55,c) 2,7382,8383,68264,69072,376,4.2,1410,15.8,14118,2872,11246,4.2,20.4,15734,7739,7995,11.2,22.8,-1616,-2.4,40.8,0,981,987,4963
1979,55,l) Left Censored,55939,67334,1451253,1435131,2091,3,5811,8.4,185280,31895,153385,2.2,12.9,153036,48302,104734,3.4,10.7,32244,2.2,21.4,0,3939,3951,22298
1979,56,a) 0,1867,1886,10669,5392,1851,196.3,0,0,10554,,,,195.7,0,0,0,0,0,10554,195.7,0,1,,,
1979,56,b) 1,1429,1436,9958,9756,5,0.3,232,15,2988,,,,30.6,2583,921,1662,9.4,26.5,405,4.1,53,1,4,4,28
1979,56,c) 2,1148,1253,10990,11075,47,3.6,182,13.8,2531,392,2139,3.5,22.9,2701,1040,1661,9.4,24.4,-170,-1.5,45.8,0,5,6,109
1979,56,l) Left Censored,6207,7344,107693,105802,324,4.3,601,8.1,19780,4481,15299,4.2,18.7,15997,4584,11413,4.3,15.1,3783,3.6,30.2,0,16,16,135
1980,01,a) 0,6677,6743,35973,18121,6667,197.7,0,0,35705,35705,0,197,197,0,0,0,0,0,35705,197,0,0,,,
1980,01,b) 1,5344,5463,43004,45020,29,0.4,1891,29.2,10412,697,9715,1.5,23.1,14443,7740,6703,17.2,32.1,-4031,-9,46.2,0,1562,1565,6496
1980,01,c) 2,4902,5178,42748,43906,223,3.9,1230,21.6,10576,1295,9281,2.9,24.1,12891,6093,6798,13.9,29.4,-2315,-5.3,48.2,0,1008,1009,4981
1980,01,d) 3,4574,5316,46904,50374,252,4.4,994,17.4,8299,2139,6160,4.2,16.5,15238,6905,8333,13.7,30.2,-6939,-13.7,33,0,711,711,3874
1980,01,l) Left Censored,32997,43152,911940,923456,1459,3.3,4311,9.7,114376,21285,93091,2.3,12.4,137410,37315,100095,4,14.9,-23034,-2.5,24.8,0,2791,2801,18404
1980,02,a) 0,1153,1161,5769,2901,1150,198.1,0,0,5737,5737,0,197.8,197.8,0,0,0,0,0,5737,197.8,0,0,,,
1980,02,b) 1,954,982,6379,6791,11,0.9,346,29.4,2116,61,2055,0.9,31.2,2939,1547,1392,22.8,43.3,-823,-12.1,62.4,0,262,262,1278
1980,02,c) 2,771,787,5451,5861,45,5.2,196,22.7,1214,162,1052,2.8,20.7,2033,934,1099,15.9,34.7,-819,-14,41.4,0,157,157,800
1980,02,d) 3,751,884,12474,12233,46,4.7,207,21.3,2957,427,2530,3.5,24.2,2474,973,1501,8,20.2,483,4,40.4,0,127,130,581
1980,02,l) Left Censored,3453,4510,78246,80096,225,4.8,597,12.7,12229,2496,9733,3.1,15.3,15928,4434,11494,5.5,19.9,-3699,-4.6,30.6,0,340,343,1947
1980,04,a) 0,7680,7721,44744,22534,7673,198.8,0,0,44420,44420,0,197.1,197.1,0,0,0,0,0,44420,197.1,0,0,,,
1980,04,b) 1,5783,5903,44887,47845,58,0.8,1815,26.5,12759,598,12161,1.2,26.7,18675,9441,9234,19.7,39,-5916,-12.3,53.4,0,1507,1508,8041
1980,04,c) 2,4503,4559,36699,40651,141,2.8,1112,21.9,7367,858,6509,2.1,18.1,15270,7316,7954,18,37.6,-7903,-19.5,36.2,0,903,903,5615
1980,04,d) 3,3791,4479,46183,48707,202,4.2,843,17.5,8815,1756,7059,3.6,18.1,13863,5433,8430,11.2,28.5,-5048,-10.4,36.2,0,596,598,3734
1980,04,l) Left Censored,20605,28490,630167,624908,1315,4.5,2892,9.9,99584,24772,74812,4,15.9,89066,26541,62525,4.2,14.3,10518,1.6,28.6,0,1757,1766,11373
1980,05,a) 0,4675,4721,24879,12509,4680,198.3,0,0,24740,24740,0,197.8,197.8,0,0,0,0,0,24740,197.8,0,0,,,
1980,05,b) 1,4019,4101,26572,28051,28,0.6,1361,28.3,6081,357,5724,1.3,21.7,9039,4507,4532,16.1,32.2,-2958,-10.5,43.4,0,1117,1117,3899
1980,05,c) 2,3529,3574,22130,23669,105,2.6,857,21.6,4343,389,3954,1.6,18.3,7421,3722,3699,15.7,31.4,-3078,-13.1,36.6,0,697,699,3086
1980,05,d) 3,3068,3362,25524,26602,113,3.1,633,17.4,4446,577,3869,2.2,16.7,6601,2999,3602,11.3,24.8,-2155,-8.1,33.4,0,460,460,1872
1980,05,l) Left Censored,21319,26194,520952,520167,702,2.6,2606,9.6,72826,10021,62805,1.9,14,71256,20676,50580,4,13.7,1570,0.3,27.4,0,1697,1705,8889
1980,06,a) 0,64675,65354,377474,189540,64822,198.4,0,0,375868,375868,0,198.3,198.3,0,0,0,0,0,375868,198.3,0,0,,,
1980,06,b) 1,50323,51383,374073,389962,333,0.6,15532,26,112404,5905,106499,1.5,28.8,144182,77149,67033,19.8,37,-31778,-8.2,57.6,0,12262,12285,62642
1980,06,c) 2,41007,41996,344118,353597,2054,4.5,9711,21.1,94486,27835,66651,7.9,26.7,113443,56423,57020,16,32.1,-18957,-5.4,53.4,0,7700,7707,46088
1980,06,d) 3,38914,45537,488313,493367,2338,4.8,8520,17.5,124742,20571,104171,4.2,25.3,134850,58484,76366,11.9,27.3,-10108,-2,50.6,0,5551,5617,35570
1980,06,l) Left Censored,216397,289879,6658880,6643959,12297,4.1,30124,10.1,1016614,232462,784152,3.5,15.3,986772,317934,668838,4.8,14.9,29842,0.4,29.8,0,18859,18964,137215
1980,08,a) 0,9723,9789,54125,27260,9710,198.4,0,0,53731,53731,0,197.1,197.1,0,0,0,0,0,53731,197.1,0,0,,,
1980,08,b) 1,7610,7736,55956,57437,68,0.7,2488,27.4,16829,1282,15547,2.2,29.3,19790,11048,8742,19.2,34.5,-2961,-5.2,58.6,0,2030,2032,9167
1980,08,c) 2,6057,6142,46605,49428,184,2.7,1541,22.4,10199,1072,9127,2.2,20.6,15844,8076,7768,16.3,32.1,-5645,-11.5,41.2,0,1253,1253,6549
1980,08,d) 3,5261,6031,55965,59415,265,4.1,1250,19.1,11099,1909,9190,3.2,18.7,17998,8765,9233,14.8,30.3,-6899,-11.6,37.4,0,888,893,5487
1980,08,l) Left Censored,29646,38030,808631,808334,1598,4.1,4032,10.3,119571,27398,92173,3.4,14.8,118977,44989,73988,5.6,14.7,594,0.1,29.4,0,2412,2428,21015
1980,09,a) 0,5913,5971,30368,15208,5942,199,0,0,30321,30321,0,199.4,199.4,0,0,0,0,0,30321,199.4,0,0,,,
1980,09,b) 1,4891,4943,31691,31356,19,0.3,1173,21.1,8954,,,,28.6,8283,4259,4024,13.6,26.4,671,2.2,52.8,1,898,898,3363
1980,09,c) 2,4437,4532,29931,31332,154,3.2,816,16.7,5339,789,4550,2.5,17,8140,3086,5054,9.8,26,-2801,-9,34,0,646,646,2513
1980,09,d) 3,4611,5168,46802,47112,191,3.5,799,14.6,9385,,,,19.9,10005,3864,6141,8.2,21.2,-620,-1.3,39.8,1,558,559,2464
1980,09,l) Left Censored,37764,45052,1113670,1105107,1284,2.8,3747,8.1,139096,27306,111790,2.5,12.6,121970,36662,85308,3.3,11,17126,1.6,22,0,2452,2492,15229
1980,10,a) 0,1035,1050,6065,3039,1043,198.7,0,0,6052,6052,0,199.1,199.1,0,0,0,0,0,6052,199.1,0,0,,,
1980,10,b) 1,902,920,5933,6213,8,0.8,233,22.4,1627,45,1582,0.7,26.2,2187,1332,855,21.4,35.2,-560,-9,52.4,0,184,184,1067
1980,10,c) 2,743,756,4851,5292,25,3,170,20.4,911,189,722,3.6,17.2,1792,787,1005,14.9,33.9,-881,-16.7,34.4,0,137,137,667
1980,10,d) 3,821,965,8674,8895,33,3.2,144,14.1,1455,175,1280,2,16.4,1896,696,1200,7.8,21.3,-441,-4.9,32.8,0,94,94,385
1980,10,l) Left Censored,6455,7860,185338,184008,233,2.9,769,9.5,21437,4681,16756,2.5,11.7,18777,6391,12386,3.5,10.2,2660,1.5,20.4,0,472,497,2527
1980,11,a) 0,1385,1394,9578,4820,1380,198,0,0,9517,9517,0,197.4,197.4,0,0,0,0,0,9517,197.4,0,0,,,
1980,11,b) 1,1091,1110,9031,9186,14,1.1,278,22.3,2993,191,2802,2.1,32.6,3303,1701,1602,18.5,36,-310,-3.4,65.2,0,220,220,1427
1980,11,c) 2,1007,1023,11767,11769,46,4.2,166,15.3,2778,238,2540,2,23.6,2782,1108,1674,9.4,23.6,-4,0,47.2,0,131,131,756
1980,11,d) 3,1073,1219,27513,28280,61,4.7,213,16.4,3329,419,2910,1.5,11.8,4863,1355,3508,4.8,17.2,-1534,-5.4,23.6,0,139,139,709
1980,11,l) Left Censored,9017,10854,298004,295566,381,3.4,1025,9.2,57874,6474,51400,2.2,19.6,52998,26002,26996,8.8,17.9,4876,1.7,35.8,0,605,609,4496
1980,12,a) 0,29480,29716,160090,80673,29438,198.1,0,0,158835,158835,0,196.9,196.9,0,0,0,0,0,158835,196.9,0,0,,,
1980,12,b) 1,21409,21756,159343,164338,91,0.4,6870,27,44272,1240,43032,0.8,26.9,54262,31637,22625,19.3,33,-9990,-6.1,53.8,0,5749,5754,26302
1980,12,c) 2,18025,18410,140342,148908,837,4.2,4138,20.6,31113,4865,26248,3.3,20.9,48245,23963,24282,16.1,32.4,-17132,-11.5,41.8,0,3442,3445,20685
1980,12,d) 3,16386,18730,182659,185539,943,4.7,3265,16.4,40089,6165,33924,3.3,21.6,45849,20206,25643,10.9,24.7,-5760,-3.1,43.2,0,2392,2403,13891
1980,12,l) Left Censored,90155,120693,2325540,2297484,5002,4,12075,9.7,380409,110010,270399,4.8,16.6,324296,112111,212185,4.9,14.1,56113,2.5,28.2,0,7916,7962,55359
1980,13,a) 0,10793,10893,60498,30369,10792,198.1,0,0,60259,60259,0,198.4,198.4,0,0,0,0,0,60259,198.4,0,0,,,
1980,13,b) 1,8522,8709,59128,61093,49,0.5,2794,27.4,16828,835,15993,1.4,27.5,20757,12065,8692,19.7,34,-3929,-6.5,55,0,2372,2372,10225
1980,13,c) 2,7458,7631,55253,58190,287,3.4,1769,21,11938,1436,10502,2.5,20.5,17811,9477,8334,16.3,30.6,-5873,-10.1,41,0,1462,1462,8213
1980,13,d) 3,7248,8292,83542,83339,351,4,1484,16.7,22301,2625,19676,3.1,26.8,21895,10175,11720,12.2,26.3,406,0.5,52.6,0,1042,1044,5515
1980,13,l) Left Censored,49517,67143,1479709,1484536,2665,3.9,6463,9.4,193293,47303,145990,3.2,13,202946,62376,140570,4.2,13.7,-9653,-0.7,26,0,3954,3994,23798
1980,15,a) 0,2444,2473,14888,7505,2452,198.3,0,0,14767,14767,0,196.8,196.8,0,0,0,0,0,14767,196.8,0,0,,,
1980,15,b) 1,1837,1882,15776,16045,14,0.7,510,23.7,4453,324,4129,2,27.8,4990,2454,2536,15.3,31.1,-537,-3.3,55.6,0,413,414,2055
1980,15,c) 2,1558,1591,13140,14050,60,3.5,302,17.6,2593,265,2328,1.9,18.5,4412,2746,1666,19.5,31.4,-1819,-12.9,37,0,239,239,2234
1980,15,d) 3,1436,1819,17588,18194,88,4.6,286,14.9,2864,645,2219,3.5,15.7,4076,1688,2388,9.3,22.4,-1212,-6.7,31.4,0,184,186,945
1980,15,l) Left Censored,9654,12668,242897,245788,528,4.1,1078,8.3,29892,7489,22403,3,12.2,35674,10123,25551,4.1,14.5,-5782,-2.3,24.4,0,624,635,4466
1980,16,a) 0,2553,2568,13715,6897,2536,197.5,0,0,13637,13637,0,197.7,197.7,0,0,0,0,0,13637,197.7,0,0,,,
1980,16,b) 1,2026,2055,13163,14473,9,0.4,703,28.8,2928,145,2783,1,20.2,5547,3118,2429,21.5,38.3,-2619,-18.1,40.4,0,570,572,2555
1980,16,c) 2,1734,1755,11896,13023,61,3.1,452,22.9,1891,163,1728,1.3,14.5,4144,1831,2313,14.1,31.8,-2253,-17.3,29,0,365,365,1563
1980,16,d) 3,1528,1717,12317,13269,59,3.2,335,18,2063,312,1751,2.4,15.5,3966,1826,2140,13.8,29.9,-1903,-14.4,31,0,244,246,1306
1980,16,l) Left Censored,9465,12059,196778,212589,368,2.9,1260,10.1,28073,4158,23915,2,13.2,59695,10618,49077,5,28.1,-31622,-14.9,26.4,0,780,784,4545
1980,17,a) 0,18933,19117,110407,55487,18923,198,0,0,109841,109841,0,198,198,0,0,0,0,0,109841,198,0,0,,,
1980,17,b) 1,15403,15638,112133,117200,68,0.4,4092,22.9,26702,919,25783,0.8,22.8,36836,17785,19051,15.2,31.4,-10134,-8.6,45.6,0,3261,3264,13817
1980,17,c) 2,14120,14437,101168,108617,542,3.4,3008,19.1,19124,3038,16086,2.8,17.6,34021,15998,18023,14.7,31.3,-14897,-13.7,35.2,0,2375,2399,12194
1980,17,d) 3,14141,16307,157640,165283,680,3.9,2782,16,25614,4696,20918,2.8,15.5,40899,17865,23034,10.8,24.7,-15285,-9.2,31,0,1923,1932,11219
1980,17,l) Left Censored,117311,145583,3702704,3771817,4717,3.1,13695,9.1,404310,96296,308014,2.6,10.7,542536,147203,395333,3.9,14.4,-138226,-3.7,21.4,0,8882,8931,57627
1980,18,a) 0,8707,8771,47229,23705,8687,198.1,0,0,47049,47049,0,198.5,198.5,0,0,0,0,0,47049,198.5,0,0,,,
1980,18,b) 1,7387,7496,46717,48486,38,0.4,2084,24.2,12265,659,11606,1.4,25.3,15802,7753,8049,16,32.6,-3537,-7.3,50.6,0,1696,1696,6559
1980,18,c) 2,6599,6804,48429,52071,273,3.7,1481,19.9,10016,2541,7475,4.9,19.2,17299,7684,9615,14.8,33.2,-7283,-14,38.4,0,1185,1188,6205
1980,18,d) 3,6483,7571,70218,73311,299,3.7,1268,15.7,11335,1916,9419,2.6,15.5,17521,6817,10704,9.3,23.9,-6186,-8.4,31,0,882,891,4265
1980,18,l) Left Censored,52698,68498,1622208,1663666,2228,3.2,6108,8.7,170817,40851,129966,2.5,10.3,253733,59192,194541,3.6,15.3,-82916,-5,20.6,0,3878,3901,22236
1980,19,a) 0,5993,6020,30565,15375,5978,198.6,0,0,30381,30381,0,197.6,197.6,0,0,0,0,0,30381,197.6,0,0,,,
1980,19,b) 1,4791,4937,30934,32368,29,0.5,1337,23.6,7044,398,6646,1.2,21.8,9912,5356,4556,16.5,30.6,-2868,-8.8,43.6,0,1095,1095,4587
1980,19,c) 2,4696,4793,30343,32452,179,3.4,954,18.3,5309,925,4384,2.9,16.4,9526,4196,5330,12.9,29.4,-4217,-13,32.8,0,792,792,3360
1980,19,d) 3,4672,5332,41233,43439,201,3.5,905,15.9,6219,1244,4975,2.9,14.3,10630,4892,5738,11.3,24.5,-4411,-10.2,28.6,0,672,674,3009
1980,19,l) Left Censored,35597,44584,777586,789468,1224,2.7,3982,8.7,86153,16303,69850,2.1,10.9,109916,33624,76292,4.3,13.9,-23763,-3,21.8,0,2755,2766,17400
1980,20,a) 0,5127,5169,27364,13761,5131,198.5,0,0,27207,27207,0,197.7,197.7,0,0,0,0,0,27207,197.7,0,0,,,
1980,20,b) 1,4259,4303,25846,27637,18,0.4,1299,26,6160,183,5977,0.7,22.3,9742,5268,4474,19.1,35.2,-3582,-12.9,44.6,0,1041,1042,4419
1980,20,c) 2,3921,3974,24261,26272,151,3.4,922,21.1,4711,669,4042,2.5,17.9,8733,4878,3855,18.6,33.2,-4022,-15.3,35.8,0,760,760,4125
1980,20,d) 3,3933,4464,36705,37939,188,4,697,14.8,6826,1425,5401,3.8,18,9293,3479,5814,9.2,24.5,-2467,-6.5,36,0,514,515,2323
1980,20,l) Left Censored,29014,36171,640439,644095,1109,3,3421,9.2,78567,14587,63980,2.3,12.2,85878,21900,63978,3.4,13.3,-7311,-1.1,24.4,0,2217,2226,11658
1980,21,a) 0,5646,5716,32857,16513,5658,198,0,0,32688,32688,0,198,198,0,0,0,0,0,32688,198,0,0,,,
1980,21,b) 1,4930,5001,35471,36825,25,0.4,1596,27.3,8428,294,8134,0.8,22.9,11136,6265,4871,17,30.2,-2708,-7.3,45.8,0,1314,1319,5364
1980,21,c) 2,4308,4381,30767,33556,164,3.4,1054,21.7,5128,677,4451,2,15.3,10705,4932,5773,14.7,31.9,-5577,-16.6,30.6,0,886,886,4324
1980,21,d) 3,4220,4770,39170,41246,185,3.6,876,17.1,7032,1339,5693,3.2,17,11183,4937,6246,12,27.1,-4151,-10.1,34,0,631,632,3409
1980,21,l) Left Censored,32689,41306,866635,879127,1330,3.1,3803,8.9,102966,19797,83169,2.3,11.7,127949,30896,97053,3.5,14.6,-24983,-2.9,23.4,0,2525,2535,14306
1980,22,a) 0,8602,8684,54223,27204,8621,198.5,0,0,54038,54038,0,198.6,198.6,0,0,0,0,0,54038,198.6,0,0,,,
1980,22,b) 1,7095,7227,56806,58197,53,0.6,2058,24.7,16415,2428,13987,4.2,28.2,19196,9709,9487,16.7,33,-2781,-4.8,56.4,0,1699,1699,7873
1980,22,c) 2,5640,5707,52905,55490,171,2.7,1285,20.3,10882,935,9947,1.7,19.6,16052,8077,7975,14.6,28.9,-5170,-9.3,39.2,0,1060,1060,5673
1980,22,d) 3,5072,5777,59365,60956,192,3.1,938,15.2,11311,1617,9694,2.7,18.6,14493,5445,9048,8.9,23.8,-3182,-5.2,37.2,0,693,698,3668
1980,22,l) Left Censored,37144,48336,1025107,1029416,1570,3.2,4491,9,151480,25642,125838,2.5,14.7,160097,44369,115728,4.3,15.6,-8617,-0.9,29.4,0,2868,2895,22408
1980,23,a) 0,2181,2195,11419,5732,2173,198,0,0,11375,11375,0,198.4,198.4,0,0,0,0,0,11375,198.4,0,0,,,
1980,23,b) 1,1847,1867,10996,11448,7,0.3,493,23.1,2244,45,2199,0.4,19.6,3147,1549,1598,13.5,27.5,-903,-7.9,39.2,0,372,374,1241
1980,23,c) 2,1757,1781,10250,10831,53,2.7,380,19.4,1950,243,1707,2.2,18,3112,1328,1784,12.3,28.7,-1162,-10.7,36,0,292,292,1135
1980,23,d) 3,1655,1903,15277,16373,86,4.3,302,14.9,2137,412,1725,2.5,13.1,4329,1520,2809,9.3,26.4,-2192,-13.3,26.2,0,209,213,884
1980,23,l) Left Censored,12317,14982,270670,272979,439,2.8,1493,9.6,32290,4711,27579,1.7,11.8,36908,12344,24564,4.5,13.5,-4618,-1.7,23.6,0,974,979,5276
1980,24,a) 0,6904,6982,38393,19315,6908,197.9,0,0,38157,38157,0,197.6,197.6,0,0,0,0,0,38157,197.6,0,0,,,
1980,24,b) 1,5576,5669,39979,39747,32,0.5,1509,23.3,12029,,,,30.3,11564,5536,6028,13.9,29.1,465,1.2,58.2,1,1204,1206,4341
1980,24,c) 2,4828,4942,37930,40256,217,4.1,982,18.4,8018,1780,6238,4.4,19.9,12670,5982,6688,14.9,31.5,-4652,-11.6,39.8,0,794,795,5100
1980,24,d) 3,5043,5796,83084,69664,281,4.6,918,15,38859,,,,55.8,12019,4887,7132,7,17.3,26840,38.5,34.6,1,623,623,3157
1980,24,l) Left Censored,38487,49449,1098313,1095903,1705,3.3,4619,9.1,154895,32447,122448,3,14.1,150074,44195,105879,4,13.7,4821,0.4,27.4,0,2796,2828,19290
1980,25,a) 0,9551,9614,54934,27572,9527,198.2,0,0,54724,54724,0,198.5,198.5,0,0,0,0,0,54724,198.5,0,0,,,
1980,25,b) 1,7990,8112,58994,58078,58,0.6,1833,20.2,18251,1697,16554,2.9,31.4,16419,9281,7138,16,28.3,1832,3.1,56.6,0,1421,1421,7633
1980,25,c) 2,7078,7259,61174,62310,272,3.5,1345,17.2,14503,1693,12810,2.7,23.3,16774,7607,9167,12.2,26.9,-2271,-3.6,46.6,0,1049,1049,6180
1980,25,d) 3,7091,8220,108544,107553,352,4.1,1188,13.7,20562,3552,17010,3.3,19.1,18580,6599,11981,6.1,17.3,1982,1.8,34.6,0,799,802,4116
1980,25,l) Left Censored,66052,80133,1991843,1984399,2236,2.7,6699,8.1,265541,46615,218926,2.3,13.4,250654,77134,173520,3.9,12.6,14887,0.8,25.2,0,4248,4297,30782
1980,26,a) 0,13942,14085,77961,39179,13946,198,0,0,77564,77564,0,198,198,0,0,0,0,0,77564,198,0,0,,,
1980,26,b) 1,11892,12113,108990,109063,87,0.6,3109,22.6,24875,1229,23646,1.1,22.8,25020,12173,12847,11.2,22.9,-145,-0.1,45.6,0,2384,2385,9452
1980,26,c) 2,10757,11011,79174,85988,396,3.3,2328,19.3,14201,2186,12015,2.5,16.5,27829,10847,16982,12.6,32.4,-13628,-15.9,33,0,1814,1814,8603
1980,26,d) 3,10535,12338,111904,120630,510,3.9,2143,16.3,18633,3653,14980,3,15.4,36085,14205,21880,11.8,29.9,-17452,-14.5,30.8,0,1472,1475,8173
1980,26,l) Left Censored,80627,104220,2506724,2616046,3659,3.4,9876,9.2,240395,60549,179846,2.3,9.2,459040,104471,354569,4,17.5,-218645,-8.3,18.4,0,6349,6385,41079
1980,27,a) 0,7835,7897,45651,22878,7860,199.1,0,0,45547,45547,0,199.1,199.1,0,0,0,0,0,45547,199.1,0,0,,,
1980,27,b) 1,6800,6930,51765,53416,40,0.5,1675,21.4,13808,3285,10523,6.1,25.8,17109,8932,8177,16.7,32,-3301,-6.2,51.6,0,1311,1313,7229
1980,27,c) 2,6013,6152,47838,50467,211,3.2,1207,18.1,8839,1625,7214,3.2,17.5,14097,6550,7547,13,27.9,-5258,-10.4,35,0,966,966,5093
1980,27,d) 3,5836,6690,65721,67234,258,3.6,1030,14.5,11636,2172,9464,3.2,17.3,14662,6358,8304,9.5,21.8,-3026,-4.5,34.6,0,712,713,3782
1980,27,l) Left Censored,43803,54977,1287286,1290867,1595,2.8,4631,8.2,164053,30885,133168,2.4,12.7,171216,50548,120668,3.9,13.3,-7163,-0.6,25.4,0,2954,2990,22918
1980,28,a) 0,4598,4644,24108,12117,4602,198.2,0,0,23983,23983,0,197.9,197.9,0,0,0,0,0,23983,197.9,0,0,,,
1980,28,b) 1,3685,3732,23919,25755,18,0.4,1236,28.1,5598,201,5397,0.8,21.7,9270,5720,3550,22.2,36,-3672,-14.3,43.4,0,1027,1027,4787
1980,28,c) 2,3019,3059,22520,23578,111,3.3,727,21.5,4411,529,3882,2.2,18.7,6526,3492,3034,14.8,27.7,-2115,-9,37.4,0,589,589,2611
1980,28,d) 3,3115,3569,30098,31836,159,4.2,610,16,4820,991,3829,3.1,15.1,8296,3406,4890,10.7,26.1,-3476,-11,30.2,0,423,429,2260
1980,28,l) Left Censored,22101,28027,544205,552243,927,3.2,2585,9,65976,13917,52059,2.5,11.9,82051,21922,60129,4,14.9,-16075,-3,23.8,0,1734,1751,10150
1980,29,a) 0,9309,9430,50805,25555,9330,197.9,0,0,50501,50501,0,197.6,197.6,0,0,0,0,0,50501,197.6,0,0,,,
1980,29,b) 1,7813,7921,50904,53982,33,0.4,2299,25.1,12119,526,11593,1,22.5,18275,9447,8828,17.5,33.9,-6156,-11.4,45,0,1874,1876,7732
1980,29,c) 2,6861,6976,48859,52404,256,3.3,1578,20.5,9200,1506,7694,2.9,17.6,16290,7490,8800,14.3,31.1,-7090,-13.5,35.2,0,1282,1284,6447
1980,29,d) 3,6721,7635,67684,70022,298,3.6,1365,16.6,11961,2675,9286,3.8,17.1,16637,7489,9148,10.7,23.8,-4676,-6.7,34.2,0,957,962,4646
1980,29,l) Left Censored,51646,66154,1454484,1474566,2054,3,6305,9.2,170574,34704,135870,2.4,11.6,210738,59757,150981,4.1,14.3,-40164,-2.7,23.2,0,4039,4053,23012
1980,30,a) 0,2443,2448,12325,6185,2423,198,0,0,12281,12281,0,198.6,198.6,0,0,0,0,0,12281,198.6,0,0,,,
1980,30,b) 1,2124,2162,12324,13561,10,0.4,681,26.9,2766,186,2580,1.4,20.4,5239,2660,2579,19.6,38.6,-2473,-18.2,40.8,0,535,535,2103
1980,30,c) 2,1702,1724,11395,12510,54,2.8,418,21.7,2077,248,1829,2,16.6,4307,2066,2241,16.5,34.4,-2230,-17.8,33.2,0,320,320,1669
1980,30,d) 3,1627,1809,11826,13053,65,3.3,325,16.7,1827,329,1498,2.5,14,4281,1621,2660,12.4,32.8,-2454,-18.8,28,0,218,219,939
1980,30,l) Left Censored,9828,11998,170995,178098,339,2.7,1280,10.2,19347,3805,15542,2.1,10.9,33553,8404,25149,4.7,18.8,-14206,-7.9,21.8,0,797,802,4624
1980,31,a) 0,3451,3466,17624,8828,3450,199.1,0,0,17592,17592,0,199.3,199.3,0,0,0,0,0,17592,199.3,0,0,,,
1980,31,b) 1,2882,2912,16310,17767,8,0.2,820,24.5,3076,46,3030,0.3,17.3,5990,3363,2627,18.9,33.7,-2914,-16.4,34.6,0,653,653,2845
1980,31,c) 2,2628,2677,18087,19167,98,3.4,537,18.5,3434,451,2983,2.4,17.9,5593,2960,2633,15.4,29.2,-2159,-11.3,35.8,0,427,427,2633
1980,31,d) 3,2672,2991,21740,22925,129,4,502,15.7,3373,613,2760,2.7,14.7,5742,2531,3211,11,25,-2369,-10.3,29.4,0,346,346,1540
1980,31,l) Left Censored,20767,25307,439364,437980,744,2.8,2294,8.8,58360,10537,47823,2.4,13.3,55592,14431,41161,3.3,12.7,2768,0.6,25.4,0,1549,1558,7798
1980,32,a) 0,2776,2794,19429,9775,2764,197.9,0,0,19309,19309,0,197.5,197.5,0,0,0,0,0,19309,197.5,0,0,,,
1980,32,b) 1,2172,2193,20162,21169,7,0.3,745,28.8,5802,41,5761,0.2,27.4,7815,4459,3356,21.1,36.9,-2013,-9.5,54.8,0,600,600,3614
1980,32,c) 2,1599,1648,15758,18141,67,3.6,455,24.5,2733,392,2341,2.2,15.1,7498,3314,4184,18.3,41.3,-4765,-26.2,30.2,0,361,363,2759
1980,32,d) 3,1387,1594,21060,21604,83,4.9,296,17.4,3997,764,3233,3.5,18.5,5085,1569,3516,7.3,23.5,-1088,-5,37,0,214,214,1223
1980,32,l) Left Censored,7421,9402,262874,258982,510,5.3,981,10.2,46683,12122,34561,4.7,18,38898,13618,25280,5.3,15,7785,3,30,0,619,624,9062
1980,33,a) 0,2061,2067,10000,5040,2036,197,0,0,9921,9921,0,196.8,196.8,0,0,0,0,0,9921,196.8,0,0,,,
1980,33,b) 1,1818,1837,11900,12127,7,0.3,477,22.7,3251,155,3096,1.3,26.8,3704,1910,1794,15.7,30.5,-453,-3.7,53.6,0,370,370,1595
1980,33,c) 2,1666,1685,10867,11529,68,3.7,365,19.8,2135,228,1907,2,18.5,3459,1752,1707,15.2,30,-1324,-11.5,37,0,296,296,1478
1980,33,d) 3,1576,1755,16456,16499,71,3.8,304,16.2,3428,545,2883,3.3,20.8,3514,1463,2051,8.9,21.3,-86,-0.5,41.6,0,211,214,967
1980,33,l) Left Censored,10884,12814,278513,278766,371,2.8,1188,9,36547,7346,29201,2.6,13.1,37053,12419,24634,4.5,13.3,-506,-0.2,26.2,0,795,799,5557
1980,34,a) 0,14407,14491,69530,35018,14327,197.7,0,0,69024,69024,0,197.1,197.1,0,0,0,0,0,69024,197.1,0,0,,,
1980,34,b) 1,11669,11798,71211,71308,61,0.5,3014,22.5,21056,1400,19656,2,29.5,21250,10638,10612,14.9,29.8,-194,-0.3,59,0,2279,2282,8218
1980,34,c) 2,9974,10116,62468,66498,361,3.3,1914,17.5,12803,1572,11231,2.4,19.3,20862,8646,12216,13,31.4,-8059,-12.1,38.6,0,1469,1469,6602
1980,34,d) 3,10455,11323,93783,95914,479,4,1692,14.2,17154,3145,14009,3.3,17.9,21415,7787,13628,8.1,22.3,-4261,-4.4,35.8,0,1208,1209,5565
1980,34,l) Left Censored,85724,102615,2246958,2255963,2963,2.8,8913,8.4,290795,61317,229478,2.7,12.9,308804,91817,216987,4.1,13.7,-18009,-0.8,25.8,0,5917,5954,37167
1980,35,a) 0,3473,3493,20389,10231,3466,198.5,0,0,20316,20316,0,198.6,198.6,0,0,0,0,0,20316,198.6,0,0,,,
1980,35,b) 1,2770,2844,20269,21268,20,0.6,858,25.9,5682,392,5290,1.8,26.7,7680,4015,3665,18.9,36.1,-1998,-9.4,53.4,0,709,709,3496
1980,35,c) 2,2165,2193,15198,16538,66,2.7,520,21.2,3399,441,2958,2.7,20.6,6079,3152,2927,19.1,36.8,-2680,-16.2,41.2,0,410,410,2616
1980,35,d) 3,1988,2234,17624,18923,93,3.8,489,20,3114,456,2658,2.4,16.5,5712,2855,2857,15.1,30.2,-2598,-13.7,33,0,352,353,2146
1980,35,l) Left Censored,12011,15263,256072,261157,589,3.7,1686,10.6,35125,7721,27404,3,13.4,45294,14470,30824,5.5,17.3,-10169,-3.9,26.8,0,1054,1057,6415
1980,36,a) 0,32482,32681,165777,83377,32345,197.9,0,0,164800,164800,0,197.7,197.7,0,0,0,0,0,164800,197.7,0,0,,,
1980,36,b) 1,26694,26957,174816,179063,96,0.3,6780,22.2,46767,2185,44582,1.2,26.1,55260,28528,26732,15.9,30.9,-8493,-4.8,52.2,0,5398,5399,22783
1980,36,c) 2,24101,24469,159802,169135,797,3,4708,17.8,34344,4107,30237,2.4,20.3,53010,23548,29462,13.9,31.3,-18666,-11,40.6,0,3869,3869,19558
1980,36,d) 3,23527,26126,239072,243736,933,3.3,4305,15.5,43655,6929,36726,2.8,17.9,52983,23232,29751,9.5,21.7,-9328,-3.8,35.8,0,3167,3170,14836
1980,36,l) Left Censored,207958,245546,5228334,5242757,6206,2.4,23433,9.2,678230,136369,541861,2.6,12.9,707076,224454,482622,4.3,13.5,-28846,-0.6,25.8,0,16384,16452,101779
1980,37,a) 0,10609,10723,56015,28101,10632,198.3,0,0,55828,55828,0,198.7,198.7,0,0,0,0,0,55828,198.7,0,0,,,
1980,37,b) 1,8689,8840,58906,59347,55,0.5,2802,27.1,16763,1931,14832,3.3,28.2,17644,9310,8334,15.7,29.7,-881,-1.5,56.4,0,2308,2308,7861
1980,37,c) 2,7755,7932,51788,55330,322,3.7,1833,21,10643,2050,8593,3.7,19.2,17727,8688,9039,15.7,32,-7084,-12.8,38.4,0,1493,1497,7138
1980,37,d) 3,7343,8406,78185,79411,360,4,1377,15.4,14592,4441,10151,5.6,18.4,17043,6907,10136,8.7,21.5,-2451,-3.1,36.8,0,965,970,4679
1980,37,l) Left Censored,55488,73618,1755697,1766295,2475,3.3,6437,8.5,197640,36143,161497,2,11.2,218837,61729,157108,3.5,12.4,-21197,-1.2,22.4,0,4122,4151,29545
1980,38,a) 0,1610,1618,8621,4315,1612,199.3,0,0,8613,8613,0,199.6,199.6,0,0,0,0,0,8613,199.6,0,0,,,
1980,38,b) 1,1404,1420,8501,8987,8,0.5,386,23.7,1672,41,1631,0.5,18.6,2644,1328,1316,14.8,29.4,-972,-10.8,37.2,0,299,299,1026
1980,38,c) 2,1152,1162,7336,7498,36,2.8,255,20,1671,93,1578,1.2,22.3,1994,948,1046,12.6,26.6,-323,-4.3,44.6,0,202,202,781
1980,38,d) 3,1177,1259,8810,9361,66,4.9,237,17.6,1539,289,1250,3.1,16.4,2641,1164,1477,12.4,28.2,-1102,-11.8,32.8,0,174,174,877
1980,38,l) Left Censored,8734,10519,149745,149921,336,3.1,918,8.5,19949,4079,15870,2.7,13.3,20300,6424,13876,4.3,13.5,-351,-0.2,26.6,0,603,604,3902
1980,39,a) 0,15977,16200,90478,45452,16056,198.2,0,0,90053,90053,0,198.1,198.1,0,0,0,0,0,90053,198.1,0,0,,,
1980,39,b) 1,13575,13787,98434,99807,73,0.5,3654,23.2,27520,1483,26037,1.5,27.6,30266,13182,17084,13.2,30.3,-2746,-2.7,55.2,0,2893,2895,10562
1980,39,c) 2,11865,12177,86287,91964,485,3.7,2506,18.9,17042,3134,13908,3.4,18.5,28395,13017,15378,14.2,30.9,-11353,-12.4,37,0,1938,1938,10555
1980,39,d) 3,12031,14364,131211,134758,653,4.3,2332,15.3,24682,5376,19306,4,18.3,31775,13590,18185,10.1,23.6,-7093,-5.3,36.6,0,1546,1561,7809
1980,39,l) Left Censored,103384,139570,3371474,3434440,4453,3.1,11999,8.4,361730,80394,281336,2.3,10.5,487662,123406,364256,3.6,14.2,-125932,-3.7,21,0,7361,7434,46398
1980,40,a) 0,7989,8057,45806,23035,7978,198,0,0,45542,45542,0,197.7,197.7,0,0,0,0,0,45542,197.7,0,0,,,
1980,40,b) 1,6176,6284,44123,46001,43,0.6,2009,27.3,11601,487,11114,1.1,25.2,15356,9302,6054,20.2,33.4,-3755,-8.2,50.4,0,1692,1692,7765
1980,40,c) 2,4980,5052,37856,40082,155,2.7,1297,22.9,7467,872,6595,2.2,18.6,11919,5750,6169,14.3,29.7,-4452,-11.1,37.2,0,1074,1075,4836
1980,40,d) 3,4490,5067,45821,47176,187,3.4,882,16.3,8633,1141,7492,2.4,18.3,11342,5254,6088,11.1,24,-2709,-5.7,36.6,0,645,649,3402
1980,40,l) Left Censored,29997,38213,733077,728813,1187,3,3773,9.5,115943,28598,87345,3.9,15.9,107415,29718,77697,4.1,14.7,8528,1.2,29.4,0,2471,2493,14201
1980,41,a) 0,8042,8085,42046,21124,8010,198.1,0,0,41845,41845,0,198.1,198.1,0,0,0,0,0,41845,198.1,0,0,,,
1980,41,b) 1,6000,6066,39317,42084,23,0.3,2255,31,10398,252,10146,0.6,24.7,15932,9311,6621,22.1,37.9,-5534,-13.2,49.4,0,1795,1795,7799
1980,41,c) 2,5192,5279,36578,39295,245,4.1,1438,24.3,8328,1328,7000,3.4,21.2,13761,7027,6734,17.9,35,-5433,-13.8,42.4,0,1135,1135,5525
1980,41,d) 3,4782,5429,51195,52445,261,4.5,1101,18.8,11441,3935,7506,7.5,21.8,13940,6090,7850,11.6,26.6,-2499,-4.8,43.6,0,729,734,3822
1980,41,l) Left Censored,27972,35469,685858,708041,1403,3.8,3807,10.4,91233,20512,70721,2.9,12.9,135599,34293,101306,4.8,19.2,-44366,-6.3,25.8,0,2450,2476,16033
1980,42,a) 0,16892,17038,95675,48032,16906,198.5,0,0,95287,95287,0,198.4,198.4,0,0,0,0,0,95287,198.4,0,0,,,
1980,42,b) 1,14448,14783,99552,99846,71,0.4,3618,21.6,26746,1286,25460,1.3,26.8,27333,12584,14749,12.6,27.4,-587,-0.6,53.6,0,2848,2851,9896
1980,42,c) 2,12918,13192,92622,98831,453,3.2,2606,18.2,17305,2327,14978,2.4,17.5,29722,12739,16983,12.9,30.1,-12417,-12.6,35,0,2086,2086,10723
1980,42,d) 3,13463,15546,144407,148823,687,4.2,2335,14.2,23653,4940,18713,3.3,15.9,32485,13409,19076,9,21.8,-8832,-5.9,31.8,0,1624,1627,8102
1980,42,l) Left Censored,120305,153573,3601174,3627317,4587,2.9,13520,8.5,416220,90092,326128,2.5,11.5,468506,148386,320120,4.1,12.9,-52286,-1.4,23,0,8656,8713,58024
1980,44,a) 0,1760,1763,8463,4257,1751,198.6,0,0,8413,8413,0,197.6,197.6,0,0,0,0,0,8413,197.6,0,0,,,
1980,44,b) 1,1479,1492,9946,10048,7,0.4,376,22.2,2916,,,,29,3119,1371,1748,13.6,31,-203,-2,58,1,299,299,1141
1980,44,c) 2,1301,1311,10925,11425,36,2.5,267,18.7,2054,147,1907,1.3,18,3054,1024,2030,9,26.7,-1000,-8.7,36,0,199,199,767
1980,44,d) 3,1386,1481,12228,12667,47,3,213,13.6,1689,,,,13.3,2567,875,1692,6.9,20.3,-878,-7,26.6,1,151,151,583
1980,44,l) Left Censored,12385,14250,299211,302530,335,2.3,1234,8.4,32828,6299,26529,2.1,10.9,39466,10469,28997,3.5,13,-6638,-2.1,21.8,0,809,810,4915
1980,45,a) 0,5499,5581,30370,15238,5526,198,0,0,30265,30265,0,198.6,198.6,0,0,0,0,0,30265,198.6,0,0,,,
1980,45,b) 1,4262,4351,31206,31816,23,0.5,1377,27.1,7704,698,7006,2.2,24.2,8924,4974,3950,15.6,28,-1220,-3.8,48.4,0,1167,1167,4040
1980,45,c) 2,3955,4020,28370,30067,173,3.9,907,20.6,5744,727,5017,2.4,19.1,9138,4548,4590,15.1,30.4,-3394,-11.3,38.2,0,717,717,3663
1980,45,d) 3,3683,4118,31673,32472,177,4,722,16.4,5869,1062,4807,3.3,18.1,7466,2966,4500,9.1,23,-1597,-4.9,36.2,0,518,518,1906
1980,45,l) Left Censored,27428,35557,849238,857092,1270,3.5,3317,9.1,94564,19713,74851,2.3,11,110272,30294,79978,3.5,12.9,-15708,-1.9,22,0,2104,2121,11448
1980,46,a) 0,1640,1655,7893,3976,1644,198.7,0,0,7834,7834,0,197,197,0,0,0,0,0,7834,197,0,0,,,
1980,46,b) 1,1357,1387,8427,9038,18,1.1,385,24.3,1774,228,1546,2.5,19.6,2996,1450,1546,16,33.1,-1222,-13.5,39.2,0,302,302,1237
1980,46,c) 2,1278,1293,7155,7913,45,3.2,276,19.5,1117,183,934,2.3,14.1,2632,1171,1461,14.8,33.3,-1515,-19.2,28.2,0,228,229,979
1980,46,d) 3,1180,1297,8938,9714,50,3.6,225,16.2,1171,129,1042,1.3,12.1,2722,965,1757,9.9,28,-1551,-15.9,24.2,0,163,163,719
1980,46,l) Left Censored,9193,10908,154406,155477,300,2.7,975,8.7,19245,4655,14590,3,12.4,21387,6868,14519,4.4,13.8,-2142,-1.4,24.8,0,671,674,3839
1980,47,a) 0,8418,8505,47816,23990,8431,198.3,0,0,47653,47653,0,198.6,198.6,0,0,0,0,0,47653,198.6,0,0,,,
1980,47,b) 1,6805,6950,48740,50139,39,0.5,2370,28.9,14577,606,13971,1.2,29.1,17374,10371,7003,20.7,34.7,-2797,-5.6,58.2,0,1934,1934,8092
1980,47,c) 2,5843,5953,42450,46165,232,3.5,1438,21.8,9022,2014,7008,4.4,19.5,16452,7729,8723,16.7,35.6,-7430,-16.1,39,0,1183,1183,6258
1980,47,d) 3,5884,6764,63888,70168,319,4.4,1269,17.5,13857,2292,11565,3.3,19.7,26417,9847,16570,14,37.6,-12560,-17.9,39.4,0,869,872,4813
1980,47,l) Left Censored,41699,54231,1232472,1255370,2088,3.7,5087,9.1,139819,33265,106554,2.6,11.1,185614,49296,136318,3.9,14.8,-45795,-3.7,22.2,0,3250,3262,20655
1980,48,a) 0,19120,19546,116066,58453,19259,197.1,0,0,115227,115227,0,197.1,197.1,0,0,0,0,0,115227,197.1,0,0,,,
1980,48,b) 1,15578,16240,135390,157441,153,0.6,11751,42.3,37155,2200,34955,1.4,23.6,81257,61467,19790,39,51.6,-44102,-28,47.2,0,10118,10126,52608
1980,48,c) 2,17844,18451,150636,166942,589,2.5,6587,28,33285,3974,29311,2.4,19.9,65896,40555,25341,24.3,39.5,-32611,-19.6,39.8,0,5581,5592,35305
1980,48,d) 3,20020,23498,233383,240562,849,3.3,4460,17.6,48133,5909,42224,2.5,20,62490,27984,34506,11.6,26,-14357,-6,40,0,3134,3177,18145
1980,48,l) Left Censored,125145,175184,4007511,3980893,7297,4,18245,10.1,665284,145760,519524,3.7,16.7,612047,195604,416443,4.9,15.4,53237,1.3,30.8,0,11575,11686,86810
1980,49,a) 0,3417,3450,20462,10283,3423,198.4,0,0,20358,20358,0,198,198,0,0,0,0,0,20358,198,0,0,,,
1980,49,b) 1,2735,2795,20310,21657,26,0.8,970,29.3,5301,396,4905,1.8,24.5,7995,4641,3354,21.4,36.9,-2694,-12.4,49,0,782,788,3845
1980,49,c) 2,2263,2299,18762,20375,70,2.7,652,24.9,4420,698,3722,3.4,21.7,7646,3368,4278,16.5,37.5,-3226,-15.8,43.4,0,523,523,2806
1980,49,d) 3,2060,2304,19340,20732,79,3.1,535,21,4149,445,3704,2.1,20,6933,3004,3929,14.5,33.4,-2784,-13.4,40,0,373,373,1908
1980,49,l) Left Censored,12664,16056,342080,343172,608,3.7,1651,9.9,47192,10926,36266,3.2,13.8,49376,16372,33004,4.8,14.4,-2184,-0.6,27.6,0,1000,1009,7049
1980,50,a) 0,1371,1372,6145,3077,1364,198.8,0,0,6136,6136,0,199.4,199.4,0,0,0,0,0,6136,199.4,0,0,,,
1980,50,b) 1,1135,1147,6571,6698,3,0.2,283,21.7,1651,30,1621,0.4,24.6,1905,970,935,14.5,28.4,-254,-3.8,49.2,0,237,237,840
1980,50,c) 2,1096,1110,6566,7130,41,3.4,213,17.7,1115,158,957,2.2,15.6,2243,913,1330,12.8,31.5,-1128,-15.9,31.2,0,183,183,784
1980,50,d) 3,1018,1129,8917,9121,38,3.1,189,15.6,1429,173,1256,1.9,15.7,1836,809,1027,8.9,20.1,-407,-4.4,31.4,0,144,144,563
1980,50,l) Left Censored,6894,7991,141400,140881,206,2.5,712,8.6,18602,2538,16064,1.8,13.2,17563,4531,13032,3.2,12.5,1039,0.7,25,0,492,494,2362
1980,51,a) 0,9601,9653,49259,24720,9571,198.3,0,0,49078,49078,0,198.5,198.5,0,0,0,0,0,49078,198.5,0,0,,,
1980,51,b) 1,7578,7707,55279,54660,53,0.6,2261,25.4,16647,740,15907,1.4,30.5,15408,8194,7214,15,28.2,1239,2.3,56.4,0,1831,1831,6433
1980,51,c) 2,6615,6801,49185,52085,271,3.6,1520,20.3,10441,1526,8915,2.9,20,16241,6924,9317,13.3,31.2,-5800,-11.2,40,0,1252,1252,5922
1980,51,d) 3,6353,7339,70806,73109,330,4.2,1242,15.9,12580,3683,8897,5,17.2,17185,7014,10171,9.6,23.5,-4605,-6.3,34.4,0,888,894,4638
1980,51,l) Left Censored,47795,63657,1366422,1365391,2225,3.4,5799,8.8,171763,37208,134555,2.7,12.6,169702,48398,121304,3.5,12.4,2061,0.2,24.8,0,3602,3627,20658
1980,53,a) 0,10812,10885,54446,27341,10792,198.3,0,0,54211,54211,0,198.3,198.3,0,0,0,0,0,54211,198.3,0,0,,,
1980,53,b) 1,8354,8459,59384,61856,49,0.5,2996,29.7,15965,1000,14965,1.6,25.8,20909,11990,8919,19.4,33.8,-4944,-8,51.6,0,2352,2352,9927
1980,53,c) 2,7308,7457,53009,57143,361,4.3,1952,23.5,11631,1477,10154,2.6,20.4,19899,9196,10703,16.1,34.8,-8268,-14.4,40.8,0,1492,1492,7370
1980,53,d) 3,6896,7899,78487,77123,391,4.6,1580,18.5,22590,5742,16848,7.4,29.3,19864,8912,10952,11.6,25.8,2726,3.5,51.6,0,1044,1049,5260
1980,53,l) Left Censored,40606,52098,1013246,1013660,2068,3.8,5133,9.6,154111,31704,122407,3.1,15.2,154939,44996,109943,4.4,15.3,-828,-0.1,30.4,0,3210,3233,20786
1980,54,a) 0,2894,2915,14665,7386,2866,196.6,0,0,14559,14559,0,197.1,197.1,0,0,0,0,0,14559,197.1,0,0,,,
1980,54,b) 1,2410,2437,15598,15885,9,0.3,794,27.6,4462,56,4406,0.4,28.1,5036,2766,2270,17.4,31.7,-574,-3.6,56.2,0,653,653,2348
1980,54,c) 2,2043,2079,13577,14787,81,3.6,448,19.7,2666,398,2268,2.7,18,5085,2257,2828,15.3,34.4,-2419,-16.4,36,0,350,350,1622
1980,54,d) 3,2145,2392,20174,21266,94,3.7,429,16.7,3959,1090,2869,5.1,18.6,6143,1923,4220,9,28.9,-2184,-10.3,37.2,0,307,307,1213
1980,54,l) Left Censored,17668,21960,422907,447525,700,3.1,1998,8.8,45512,10259,35253,2.3,10.2,94749,17722,77027,4,21.2,-49237,-11,20.4,0,1311,1320,7449
1980,55,a) 0,8123,8177,42966,21573,8111,198.4,0,0,42787,42787,0,198.3,198.3,0,0,0,0,0,42787,198.3,0,0,,,
1980,55,b) 1,6999,7104,46159,47694,32,0.4,1698,21.2,9493,554,8939,1.2,19.9,12563,6299,6264,13.2,26.3,-3070,-6.4,39.8,0,1341,1341,5163
1980,55,c) 2,6737,6908,48771,50885,247,3.3,1430,19,8827,1516,7311,3,17.3,13054,6145,6909,12.1,25.7,-4227,-8.4,34.6,0,1120,1120,4853
1980,55,d) 3,6433,7409,62686,65355,282,3.6,1205,15.3,9115,1651,7464,2.5,13.9,14453,6451,8002,9.9,22.1,-5338,-8.2,27.8,0,821,828,4228
1980,55,l) Left Censored,52102,63629,1417446,1433255,1679,2.6,5211,8,141754,26423,115331,1.8,9.9,173373,47192,126181,3.3,12.1,-31619,-2.2,19.8,0,3467,3492,21129
1980,56,a) 0,1718,1734,9493,4777,1717,198,0,0,9432,9432,0,197.4,197.4,0,0,0,0,0,9432,197.4,0,0,,,
1980,56,b) 1,1384,1407,9776,10108,12,0.7,442,26.9,2905,103,2802,1,28.7,3569,1809,1760,17.9,35.3,-664,-6.6,57.4,0,355,355,1606
1980,56,c) 2,1180,1188,8573,9017,40,3.1,261,19.9,1794,120,1674,1.3,19.9,2682,1216,1466,13.5,29.7,-888,-9.8,39.8,0,210,210,1067
1980,56,d) 3,986,1089,10462,10704,45,3.8,192,16.4,2453,927,1526,8.7,22.9,2936,984,1952,9.2,27.4,-483,-4.5,45.8,0,140,140,737
1980,56,l) Left Censored,5679,6882,109406,108693,270,3.8,713,10,17715,3082,14633,2.8,16.3,16288,5633,10655,5.2,15,1427,1.3,30,0,467,470,3238
1981,01,a) 0,5999,6034,39472,19825,5978,198.1,0,0,39295,39295,0,198.2,198.2,0,0,0,0,0,39295,198.2,0,0,,,
1981,01,b) 1,4785,4850,31196,33277,31,0.5,1727,29.8,8240,248,7992,0.7,24.8,12401,7510,4891,22.6,37.3,-4161,-12.5,49.6,0,1375,1375,6168
1981,01,c) 2,4320,4454,38344,40543,198,4,1139,23,7257,1117,6140,2.8,17.9,11655,6463,5192,15.9,28.7,-4398,-10.8,35.8,0,872,875,5108
1981,01,d) 3,4033,4309,33267,37864,158,3.3,938,19.8,5573,714,4859,1.9,14.7,14767,6261,8506,16.5,39,-9194,-24.3,29.4,0,710,710,4530
1981,01,e) 4,3866,4474,40536,43479,190,3.9,939,19.2,6665,1154,5511,2.7,15.3,12551,6511,6040,15,28.9,-5886,-13.6,30.6,0,555,558,2950
1981,01,l) Left Censored,29549,39381,856357,874519,1417,3.4,4638,11.3,106780,28781,77999,3.3,12.2,143104,51105,91999,5.8,16.4,-36324,-4.2,24.4,0,2544,2563,18286
1981,02,a) 0,1128,1138,7147,3586,1127,198.1,0,0,7123,7123,0,198.6,198.6,0,0,0,0,0,7123,198.6,0,0,,,
1981,02,b) 1,802,811,5786,5780,4,0.4,314,31.8,2073,15,2058,0.3,35.9,2061,1313,748,22.7,35.7,12,0.2,71.4,0,231,231,1050
1981,02,c) 2,788,809,6225,6239,38,4.3,179,20.1,1931,218,1713,3.5,31,1959,994,965,15.9,31.4,-28,-0.4,62,0,125,125,772
1981,02,d) 3,631,643,5008,5218,31,4.4,160,22.5,1334,160,1174,3.1,25.6,1754,791,963,15.2,33.6,-420,-8,51.2,0,102,102,476
1981,02,e) 4,637,753,7637,7707,59,7.4,147,18.3,2267,1014,1253,13.2,29.4,2406,979,1427,12.7,31.2,-139,-1.8,58.8,0,80,80,419
1981,02,l) Left Censored,3118,4129,79910,78352,221,5.1,536,12.5,15680,3294,12386,4.2,20,12564,4771,7793,6.1,16,3116,4,32,0,210,212,1727
1981,04,a) 0,7002,7045,41008,20583,6985,198.3,0,0,40851,40851,0,198.5,198.5,0,0,0,0,0,40851,198.5,0,0,,,
1981,04,b) 1,5511,5585,38879,41493,48,0.7,1973,29.7,10948,707,10241,1.7,26.4,16176,10288,5888,24.8,39,-5228,-12.6,52.8,0,1519,1519,7625
1981,04,c) 2,4530,4650,40390,42314,178,3.4,1321,25.1,10846,1253,9593,3,25.6,14693,7642,7051,18.1,34.7,-3847,-9.1,51.2,0,1001,1003,5645
1981,04,d) 3,3627,3686,30520,33271,117,2.8,923,22.4,5724,1036,4688,3.1,17.2,11226,6297,4929,18.9,33.7,-5502,-16.5,34.4,0,693,693,4467
1981,04,e) 4,3191,3778,40817,43375,177,4.3,858,20.8,6703,1245,5458,2.9,15.5,11819,5515,6304,12.7,27.2,-5116,-11.7,31,0,473,474,2855
1981,04,l) Left Censored,18524,26566,614338,616404,1436,5.2,3124,11.4,89307,23368,65939,3.8,14.5,93438,28096,65342,4.6,15.2,-4131,-0.7,29,0,1555,1568,9667
1981,05,a) 0,4258,4273,26934,13495,4245,198.7,0,0,26878,26878,0,199.2,199.2,0,0,0,0,0,26878,199.2,0,0,,,
1981,05,b) 1,3330,3383,22800,23748,26,0.6,1229,30.3,6131,338,5793,1.4,25.8,8027,4589,3438,19.3,33.8,-1896,-8,51.6,0,938,938,3629
1981,05,c) 2,3249,3328,22239,24220,123,3.3,831,22.4,4452,683,3769,2.8,18.4,8413,4424,3989,18.3,34.7,-3961,-16.3,36.8,0,632,633,3182
1981,05,d) 3,2849,2890,18376,20156,92,2.9,683,21.3,2926,488,2438,2.4,14.5,6485,3010,3475,14.9,32.2,-3559,-17.7,29,0,510,510,2295
1981,05,e) 4,2554,2826,21680,23260,110,3.6,606,19.6,3396,814,2582,3.5,14.6,6556,3290,3266,14.1,28.2,-3160,-13.6,29.2,0,358,359,1772
1981,05,l) Left Censored,18779,23578,464098,478180,828,3.4,2795,11.3,50921,15710,35211,3.3,10.6,79084,22328,56756,4.7,16.5,-28163,-5.9,21.2,0,1576,1588,8523
1981,06,a) 0,59918,60311,403723,202670,59824,198.4,0,0,402107,402107,0,198.4,198.4,0,0,0,0,0,402107,198.4,0,0,,,
1981,06,b) 1,46698,47478,343102,359231,334,0.6,16456,29.2,103194,5636,97558,1.6,28.7,135451,80217,55234,22.3,37.7,-32257,-9,57.4,0,11783,11797,56094
1981,06,c) 2,40463,41599,324649,347336,1819,3.9,10756,23.1,77004,13287,63717,3.8,22.2,122378,66236,56142,19.1,35.2,-45374,-13,44.4,0,7434,7445,46361
1981,06,d) 3,33747,34739,288011,313400,1491,3.9,8154,21.3,63566,10074,53492,3.2,20.3,114344,49522,64822,15.8,36.5,-50778,-16.2,40.6,0,5785,5794,33674
1981,06,e) 4,32995,38397,427694,455572,1974,4.7,8724,20.8,85989,20014,65975,4.4,18.9,141744,59961,81783,13.2,31.1,-55755,-12.2,37.8,0,4375,4413,26523
1981,06,l) Left Censored,194456,266372,6440904,6527033,11529,4.1,33317,12,965519,243212,722307,3.7,14.8,1137776,409389,728387,6.3,17.4,-172257,-2.6,29.6,0,16249,16414,127866
1981,08,a) 0,8991,9058,58504,29766,8920,197,0,0,57477,57477,0,193.1,193.1,0,0,0,0,0,57477,193.1,0,0,,,
1981,08,b) 1,6889,6974,49310,51384,51,0.6,2652,31.6,15242,666,14576,1.3,29.7,19390,11317,8073,22,37.7,-4148,-8,59.4,0,2017,2017,9140
1981,08,c) 2,6040,6181,48566,52240,274,3.9,1784,25.7,11859,2069,9790,4,22.7,19206,11518,7688,22,36.8,-7347,-14.1,45.4,0,1258,1262,8502
1981,08,d) 3,4944,5048,43031,44454,189,3.4,1199,21.5,9586,2168,7418,4.9,21.6,12432,6523,5909,14.7,28,-2846,-6.4,43.2,0,899,899,4989
1981,08,e) 4,4416,5062,51502,53479,272,4.9,1188,21.4,10570,2687,7883,5,19.8,14523,7715,6808,14.4,27.2,-3953,-7.4,39.6,0,687,691,3892
1981,08,l) Left Censored,26505,34922,782474,786560,1778,4.9,4435,12.2,128924,35079,93845,4.5,16.4,137095,49671,87424,6.3,17.4,-8171,-1,32.8,0,2145,2168,19309
1981,09,a) 0,5771,5798,32839,16447,5760,198.7,0,0,32784,32784,0,199.3,199.3,0,0,0,0,0,32784,199.3,0,0,,,
1981,09,b) 1,4518,4585,28609,29321,22,0.4,1272,24.1,7467,287,7180,1,25.5,8890,5559,3331,19,30.3,-1423,-4.8,51,0,846,846,3763
1981,09,c) 2,4043,4095,28751,30145,145,3.2,910,20.1,5476,779,4697,2.6,18.2,8263,4280,3983,14.2,27.4,-2787,-9.2,36.4,0,614,614,2959
1981,09,d) 3,3742,3831,27694,28748,106,2.5,736,17.6,4779,845,3934,2.9,16.6,6887,3149,3738,11,24,-2108,-7.4,33.2,0,517,517,2100
1981,09,e) 4,3977,4456,41945,44338,172,3.6,852,17.7,6762,1575,5187,3.6,15.3,11548,6018,5530,13.6,26,-4786,-10.7,30.6,0,453,453,2405
1981,09,l) Left Censored,34393,41386,1083396,1091398,1161,2.7,4498,10.4,121811,34045,87766,3.1,11.2,137814,48773,89041,4.5,12.6,-16003,-1.4,22.4,0,2308,2314,14460
1981,10,a) 0,978,980,5750,2885,974,198.8,0,0,5731,5731,0,198.6,198.6,0,0,0,0,0,5731,198.6,0,0,,,
1981,10,b) 1,785,797,6005,5992,7,0.8,225,24.4,1570,110,1460,1.8,26.2,1543,852,691,14.2,25.8,27,0.4,51.6,0,147,147,517
1981,10,c) 2,740,757,6159,6031,16,1.9,167,19.9,1683,149,1534,2.5,27.9,1426,784,642,13,23.6,257,4.3,47.2,0,109,109,463
1981,10,d) 3,619,633,4514,4669,29,4.2,145,20.9,918,265,653,5.7,19.7,1227,647,580,13.9,26.3,-309,-6.6,39.4,0,100,100,382
1981,10,e) 4,718,842,8289,8482,28,3.1,147,16.3,1468,358,1110,4.2,17.3,1853,797,1056,9.4,21.8,-385,-4.5,34.6,0,73,73,321
1981,10,l) Left Censored,5866,7240,182237,183518,226,3,804,10.7,20234,5595,14639,3,11,22796,7657,15139,4.2,12.4,-2562,-1.4,22,0,410,413,2834
1981,11,a) 0,1314,1318,16787,8435,1308,198.5,0,0,16705,16705,0,198,198,0,0,0,0,0,16705,198,0,0,,,
1981,11,b) 1,1033,1043,11326,11387,7,0.6,327,26.7,2971,107,2864,0.9,26.1,3092,1559,1533,13.7,27.2,-121,-1.1,52.2,0,233,233,962
1981,11,c) 2,891,907,8098,8534,29,2.9,216,21.5,1682,137,1545,1.6,19.7,2553,1311,1242,15.4,29.9,-871,-10.2,39.4,0,146,146,1005
1981,11,d) 3,845,867,10694,11181,30,3.2,173,18.4,1957,424,1533,3.8,17.5,2930,1482,1448,13.3,26.2,-973,-8.7,35,0,120,120,1054
1981,11,e) 4,920,1050,26432,26896,59,5.2,214,18.9,3282,609,2673,2.3,12.2,4209,2013,2196,7.5,15.6,-927,-3.4,24.4,0,103,103,642
1981,11,l) Left Censored,8112,9845,275631,288510,348,3.4,1268,12.3,42057,7277,34780,2.5,14.6,67816,44312,23504,15.4,23.5,-25759,-8.9,29.2,0,582,587,8882
1981,12,a) 0,28803,28937,171944,86306,28731,198.6,0,0,171277,171277,0,198.5,198.5,0,0,0,0,0,171277,198.5,0,0,,,
1981,12,b) 1,21617,21884,155853,159172,135,0.5,7277,28.2,49177,1980,47197,1.2,30.9,55814,34788,21026,21.9,35.1,-6637,-4.2,61.8,0,5696,5700,26976
1981,12,c) 2,17370,17772,141924,148945,723,3.7,4431,22.4,33197,4560,28637,3.1,22.3,47238,25879,21359,17.4,31.7,-14041,-9.4,44.6,0,3433,3433,19927
1981,12,d) 3,15079,15514,126232,132835,629,3.7,3339,19.7,25455,4363,21092,3.3,19.2,38661,17916,20745,13.5,29.1,-13206,-9.9,38.4,0,2541,2541,13269
1981,12,e) 4,13905,15899,163878,172684,713,4.1,3364,19.5,32005,5931,26074,3.4,18.5,49617,22857,26760,13.2,28.7,-17612,-10.2,37,0,1964,1982,12266
1981,12,l) Left Censored,81470,112413,2316352,2314880,5276,4.5,13029,11.2,382125,98245,283880,4.2,16.5,379180,132679,246501,5.7,16.4,2945,0.1,32.8,0,6979,7045,48215
1981,13,a) 0,10244,10314,68548,34493,10236,198.5,0,0,68111,68111,0,197.5,197.5,0,0,0,0,0,68111,197.5,0,0,,,
1981,13,b) 1,7907,8048,58292,58943,82,0.9,2672,28.2,18930,1379,17551,2.3,32.1,20232,12400,7832,21,34.3,-1302,-2.2,64.2,0,2089,2089,9376
1981,13,c) 2,6883,7063,53091,55852,249,3.2,1777,22.6,12180,1860,10320,3.3,21.8,17702,9737,7965,17.4,31.7,-5522,-9.9,43.6,0,1321,1321,6744
1981,13,d) 3,6157,6335,51059,53209,236,3.4,1449,20.8,12113,2263,9850,4.3,22.8,16412,9425,6987,17.7,30.8,-4299,-8,45.6,0,1040,1040,5750
1981,13,e) 4,6187,7063,68184,75591,336,4.4,1485,19.4,12689,3347,9342,4.4,16.8,27503,18731,8772,24.8,36.4,-14814,-19.6,33.6,0,845,853,3994
1981,13,l) Left Censored,44609,62076,1431058,1442786,2638,4.1,7058,11,199385,54861,144524,3.8,13.8,222841,73066,149775,5.1,15.4,-23456,-1.6,27.6,0,3552,3566,22433
1981,15,a) 0,2353,2366,15964,8002,2348,198.5,0,0,15925,15925,0,199,199,0,0,0,0,0,15925,199,0,0,,,
1981,15,b) 1,1777,1831,14591,14610,33,1.5,610,28.3,4758,1064,3694,7.3,32.6,4796,2710,2086,18.5,32.8,-38,-0.2,65.2,0,464,465,2129
1981,15,c) 2,1496,1540,14420,15044,53,3.1,368,21.5,2899,283,2616,1.9,19.3,4147,2149,1998,14.3,27.6,-1248,-8.3,38.6,0,286,288,1759
1981,15,d) 3,1276,1300,10587,11778,42,2.9,302,21,1562,299,1263,2.5,13.3,3944,2007,1937,17,33.5,-2382,-20.2,26.6,0,216,216,1338
1981,15,e) 4,1235,1535,15206,16230,62,3.7,320,19.2,2603,621,1982,3.8,16,4650,2396,2254,14.8,28.7,-2047,-12.7,32,0,147,152,1123
1981,15,l) Left Censored,8936,11834,237388,239611,462,3.8,1250,10.2,30059,9024,21035,3.8,12.5,34505,11695,22810,4.9,14.4,-4446,-1.9,25,0,587,612,4234
1981,16,a) 0,2099,2107,10910,5471,2096,199,0,0,10878,10878,0,198.8,198.8,0,0,0,0,0,10878,198.8,0,0,,,
1981,16,b) 1,1750,1773,11791,12674,11,0.5,733,33.8,2883,147,2736,1.2,22.7,4649,2702,1947,21.3,36.7,-1766,-14,45.4,0,568,568,2196
1981,16,c) 2,1589,1623,11667,12363,56,3.1,460,25.1,2461,350,2111,2.8,19.9,3853,2087,1766,16.9,31.2,-1392,-11.3,39.8,0,366,366,1707
1981,16,d) 3,1373,1389,10275,11032,38,2.4,357,22.8,1567,103,1464,0.9,14.2,3081,1466,1615,13.3,27.9,-1514,-13.7,28.4,0,261,261,1122
1981,16,e) 4,1265,1428,12084,12148,54,3.4,318,20.3,2848,1296,1552,10.7,23.4,2976,1492,1484,12.3,24.5,-128,-1.1,46.8,0,189,191,963
1981,16,l) Left Censored,8384,10907,199928,196457,412,3.6,1345,11.8,40761,23513,17248,12,20.7,33818,10818,23000,5.5,17.2,6943,3.5,34.4,0,673,691,3992
1981,17,a) 0,17549,17635,117606,59048,17452,197.9,0,0,117117,117117,0,198.3,198.3,0,0,0,0,0,117117,198.3,0,0,,,
1981,17,b) 1,14435,14654,102275,106409,88,0.5,4141,24.5,26688,988,25700,0.9,25.1,34955,20266,14689,19,32.8,-8267,-7.7,50.2,0,2889,2890,13030
1981,17,c) 2,12664,12919,94736,102742,470,3.3,2998,21,19797,4105,15692,4,19.3,35808,21171,14637,20.6,34.9,-16011,-15.6,38.6,0,2122,2126,16311
1981,17,d) 3,11657,11965,88679,93867,393,3,2515,19.2,15775,3205,12570,3.4,16.8,26151,13463,12688,14.3,27.9,-10376,-11.1,33.6,0,1841,1848,9893
1981,17,e) 4,12127,14004,143167,149238,561,3.7,2748,18.2,24030,5494,18536,3.7,16.1,36172,17597,18575,11.8,24.2,-12142,-8.1,32.2,0,1480,1489,7934
1981,17,l) Left Censored,105015,132191,3416888,3514195,4418,3.2,15967,11.6,373431,96413,277018,2.7,10.6,568046,190073,377973,5.4,16.2,-194615,-5.6,21.2,0,8078,8176,61911
1981,18,a) 0,7754,7808,55353,27786,7727,197.9,0,0,55135,55135,0,198.4,198.4,0,0,0,0,0,55135,198.4,0,0,,,
1981,18,b) 1,6470,6553,41094,44040,44,0.6,2043,26.7,10033,678,9355,1.5,22.8,15924,9156,6768,20.8,36.2,-5891,-13.4,45.6,0,1510,1510,6519
1981,18,c) 2,6034,6154,40852,43639,218,3.2,1437,21.1,7964,1688,6276,3.9,18.2,13537,6969,6568,16,31,-5573,-12.8,36.4,0,1075,1078,4935
1981,18,d) 3,5484,5680,43133,45546,193,3.1,1199,19.3,7186,1667,5519,3.7,15.8,12012,6064,5948,13.3,26.4,-4826,-10.6,31.6,0,895,895,4320
1981,18,e) 4,5495,6441,61901,64951,228,3.3,1230,17.6,10016,3651,6365,5.6,15.4,16115,7616,8499,11.7,24.8,-6099,-9.4,30.8,0,664,672,3492
1981,18,l) Left Censored,47346,62653,1498155,1539494,1968,3,7100,10.9,158498,32950,125548,2.1,10.3,241176,77156,164020,5,15.7,-82678,-5.4,20.6,0,3544,3567,22486
1981,19,a) 0,5406,5453,31802,15980,5399,198,0,0,31644,31644,0,198,198,0,0,0,0,0,31644,198,0,0,,,
1981,19,b) 1,4495,4542,26138,28192,24,0.5,1373,26,5711,505,5206,1.8,20.3,9819,5539,4280,19.6,34.8,-4108,-14.5,40.6,0,1027,1027,4201
1981,19,c) 2,3913,4053,26661,28617,132,2.9,960,21.4,4680,1060,3620,3.7,16.4,8591,4512,4079,15.8,30,-3911,-13.6,32.8,0,709,709,3202
1981,19,d) 3,3887,4000,26265,28107,123,2.8,825,18.9,4019,900,3119,3.2,14.3,7702,3473,4229,12.4,27.4,-3683,-13.1,28.6,0,631,631,2639
1981,19,e) 4,3988,4563,36731,38761,145,2.9,863,17.5,5943,1007,4936,2.6,15.3,10003,5257,4746,13.6,25.8,-4060,-10.5,30.6,0,526,530,2624
1981,19,l) Left Censored,32077,40863,709951,733093,1212,2.8,4505,10.6,81741,33179,48562,4.5,11.2,128024,45667,82357,6.2,17.5,-46283,-6.3,22.4,0,2423,2441,13017
1981,20,a) 0,5176,5206,31472,15788,5165,198.4,0,0,31368,31368,0,198.7,198.7,0,0,0,0,0,31368,198.7,0,0,,,
1981,20,b) 1,3767,3820,24801,25971,28,0.6,1278,28.4,7066,376,6690,1.4,27.2,9406,6260,3146,24.1,36.2,-2340,-9,54.4,0,930,931,4521
1981,20,c) 2,3471,3513,23350,24493,139,3.6,870,22.3,5116,974,4142,4,20.9,7401,3753,3648,15.3,30.2,-2285,-9.3,41.8,0,614,614,2511
1981,20,d) 3,3187,3235,21030,22363,101,2.8,722,20.3,4160,584,3576,2.6,18.6,6825,3775,3050,16.9,30.5,-2665,-11.9,37.2,0,545,545,2881
1981,20,e) 4,3344,3836,33943,35127,163,3.9,754,18.2,6350,1654,4696,4.7,18.1,8718,4465,4253,12.7,24.8,-2368,-6.7,36.2,0,459,464,2415
1981,20,l) Left Censored,26181,33072,603095,615700,1114,3.2,3849,11.2,67651,20599,47052,3.3,11,92860,29272,63588,4.8,15.1,-25209,-4.1,22,0,2057,2071,11760
1981,21,a) 0,5332,5356,32843,16523,5302,198,0,0,32640,32640,0,197.5,197.5,0,0,0,0,0,32640,197.5,0,0,,,
1981,21,b) 1,4142,4212,28486,30434,27,0.5,1402,28.2,6906,332,6574,1.1,22.7,10802,6284,4518,20.6,35.5,-3896,-12.8,45.4,0,1029,1029,4616
1981,21,c) 2,3911,3982,32818,34033,142,3.2,1078,24.1,6670,789,5881,2.3,19.6,9100,5092,4008,15,26.7,-2430,-7.1,39.2,0,796,796,3704
1981,21,d) 3,3573,3638,26695,28317,126,3.2,772,19.4,3914,583,3331,2.1,13.8,7157,3577,3580,12.6,25.3,-3243,-11.5,27.6,0,574,574,2555
1981,21,e) 4,3566,4017,33376,35749,188,4.3,810,18.6,5137,1240,3897,3.5,14.4,9883,4918,4965,13.8,27.6,-4746,-13.2,28.8,0,478,484,2611
1981,21,l) Left Censored,29324,37707,779229,799643,1193,3,4151,10.6,90323,22847,67476,2.9,11.3,131151,39475,91676,4.9,16.4,-40828,-5.1,22.6,0,2225,2236,13477
1981,22,a) 0,8422,8451,61118,30681,8394,198.7,0,0,60874,60874,0,198.4,198.4,0,0,0,0,0,60874,198.4,0,0,,,
1981,22,b) 1,6356,6448,57213,56224,40,0.5,2104,27.8,18679,1230,17449,2.2,33.2,16701,10228,6473,18.2,29.7,1978,3.5,59.4,0,1606,1606,8017
1981,22,c) 2,5833,5984,56156,56100,223,3.4,1370,20.8,16237,3471,12766,6.2,28.9,16125,7616,8509,13.6,28.7,112,0.2,57.4,0,1028,1033,5345
1981,22,d) 3,4692,4767,45472,48474,160,3.1,991,19,10630,1781,8849,3.7,21.9,16633,6081,10552,12.5,34.3,-6003,-12.4,43.8,0,726,726,4323
1981,22,e) 4,4366,4981,54003,55888,198,3.7,917,17.1,10877,1655,9222,3,19.5,14646,7292,7354,13,26.2,-3769,-6.7,39,0,547,550,3121
1981,22,l) Left Censored,33641,44707,1008062,1011978,1614,3.5,4872,10.5,147104,32105,114999,3.2,14.5,154935,51031,103904,5,15.3,-7831,-0.8,29,0,2546,2576,18274
1981,23,a) 0,2063,2076,11595,5815,2057,198.2,0,0,11560,11560,0,198.8,198.8,0,0,0,0,0,11560,198.8,0,0,,,
1981,23,b) 1,1634,1656,10065,10782,10,0.5,503,26.1,2444,92,2352,0.9,22.7,3878,2620,1258,24.3,36,-1434,-13.3,45.4,0,344,344,1222
1981,23,c) 2,1544,1567,11104,10996,53,3.1,320,18.7,2522,258,2264,2.3,22.9,2306,1256,1050,11.4,21,216,1.9,42,0,213,213,837
1981,23,d) 3,1447,1474,9288,9610,53,3.3,306,18.9,1795,289,1506,3,18.7,2438,1092,1346,11.4,25.4,-643,-6.7,37.4,0,227,227,841
1981,23,e) 4,1437,1651,14620,14782,70,3.9,305,17.2,2517,512,2005,3.5,17,2841,1285,1556,8.7,19.2,-324,-2.2,34,0,185,185,695
1981,23,l) Left Censored,11003,13574,254944,259522,368,2.6,1569,11,29709,4954,24755,1.9,11.4,38864,14574,24290,5.6,15,-9155,-3.6,22.8,0,880,889,4846
1981,24,a) 0,6568,6604,42876,21511,6543,198.2,0,0,42731,42731,0,198.6,198.6,0,0,0,0,0,42731,198.6,0,0,,,
1981,24,b) 1,5170,5253,38342,38813,25,0.4,1610,26.3,10711,480,10231,1.2,27.6,11652,6987,4665,18,30,-941,-2.4,55.2,0,1080,1080,4571
1981,24,c) 2,4599,4692,36181,37424,164,3.2,1091,21.1,8551,1041,7510,2.8,22.8,11036,5776,5260,15.4,29.5,-2485,-6.7,45.6,0,771,771,3874
1981,24,d) 3,4066,4164,31332,32762,140,3.1,869,19.1,6224,591,5633,1.8,19,9083,4425,4658,13.5,27.7,-2859,-8.7,38,0,614,614,2717
1981,24,e) 4,4304,4950,52363,67324,203,3.8,994,18.5,10926,4476,6450,6.6,16.2,40847,6686,34161,9.9,60.7,-29921,-44.5,32.4,0,552,552,2579
1981,24,l) Left Censored,35033,45825,1059875,1077468,1822,3.8,5233,11,135051,37283,97768,3.5,12.5,170236,61287,108949,5.7,15.8,-35185,-3.3,25,0,2551,2574,18461
1981,25,a) 0,9095,9138,64713,32441,9075,198.6,0,0,64544,64544,0,199,199,0,0,0,0,0,64544,199,0,0,,,
1981,25,b) 1,7404,7477,56199,56098,34,0.4,1922,22.5,15059,609,14450,1.1,26.8,14856,7888,6968,14.1,26.5,203,0.3,53,0,1299,1299,5363
1981,25,c) 2,6743,6898,52316,55547,244,3.3,1352,18,10905,1927,8978,3.5,19.6,17366,7939,9427,14.3,31.3,-6461,-11.7,39.2,0,930,930,5363
1981,25,d) 3,6075,6260,56402,57954,213,3.2,1093,16.2,10285,1468,8817,2.5,17.7,13388,5969,7419,10.3,23.1,-3103,-5.4,35.4,0,806,809,3851
1981,25,e) 4,6280,7274,101987,103930,311,4,1187,15.3,16668,3919,12749,3.8,16,20553,9322,11231,9,19.8,-3885,-3.8,32,0,608,616,4247
1981,25,l) Left Censored,60617,74297,1927479,1954281,2273,2.9,7727,10,249758,52900,196858,2.7,12.8,303363,125180,178183,6.4,15.5,-53605,-2.7,25.6,0,3793,3824,38779
1981,26,a) 0,12828,12897,82074,41366,12797,198.4,0,0,81417,81417,0,196.8,196.8,0,0,0,0,0,81417,196.8,0,0,,,
1981,26,b) 1,10299,10445,68387,72433,75,0.6,3340,27.2,16721,1226,15495,1.7,23.1,24812,14860,9952,20.5,34.3,-8091,-11.2,46.2,0,2218,2226,9444
1981,26,c) 2,9656,9887,100458,102858,353,3.2,2375,21.6,17242,2514,14728,2.4,16.8,22042,10726,11316,10.4,21.4,-4800,-4.6,33.6,0,1612,1613,7162
1981,26,d) 3,8864,9089,67328,72912,316,3.2,2034,20.3,11125,1773,9352,2.4,15.3,22293,11206,11087,15.4,30.6,-11168,-15.3,30.6,0,1407,1407,6629
1981,26,e) 4,8900,10384,97995,103793,390,3.4,2193,19.3,14719,3002,11717,2.9,14.2,26314,12867,13447,12.4,25.4,-11595,-11.2,28.4,0,1179,1201,6071
1981,26,l) Left Censored,72696,95199,2323700,2409518,3128,3.1,11442,11.5,244613,74639,169974,3.1,10.2,416248,135249,280999,5.6,17.3,-171635,-7.1,20.4,0,5584,5633,35954
1981,27,a) 0,7204,7247,52426,26454,7198,198.6,0,0,51944,51944,0,196.4,196.4,0,0,0,0,0,51944,196.4,0,0,,,
1981,27,b) 1,5990,6068,40674,43081,37,0.5,1700,24.3,10356,457,9899,1.1,24,15170,9773,5397,22.7,35.2,-4814,-11.2,48,0,1206,1207,7578
1981,27,c) 2,5625,5766,41852,46532,189,3,1252,19.8,7415,1169,6246,2.5,15.9,16774,7874,8900,16.9,36,-9359,-20.1,31.8,0,872,874,5886
1981,27,d) 3,5082,5236,42555,44716,189,3.3,988,17.4,7318,1486,5832,3.3,16.4,11639,5359,6280,12,26,-4321,-9.6,32.8,0,700,700,4058
1981,27,e) 4,5041,5808,62556,64101,231,3.7,1050,16.8,10968,2687,8281,4.2,17.1,14058,6203,7855,9.7,21.9,-3090,-4.8,34.2,0,558,562,2775
1981,27,l) Left Censored,39838,50640,1214712,1238522,1584,3,5310,10.1,148685,41101,107584,3.3,12,196305,67977,128328,5.5,15.8,-47620,-3.8,24,0,2609,2631,21567
1981,28,a) 0,3991,4003,23102,11693,3972,198.5,0,0,22819,22819,0,195.2,195.2,0,0,0,0,0,22819,195.2,0,0,,,
1981,28,b) 1,3276,3316,21614,22752,13,0.3,1228,30.9,5521,331,5190,1.5,24.3,7796,4836,2960,21.3,34.3,-2275,-10,48.6,0,931,931,3590
1981,28,c) 2,2980,3041,20930,22240,110,3.3,756,22.3,4152,786,3366,3.5,18.7,6772,3427,3345,15.4,30.4,-2620,-11.7,37.4,0,556,556,2469
1981,28,d) 3,2464,2505,18898,20300,102,3.7,620,22.3,2977,822,2155,4,14.7,5781,2785,2996,13.7,28.5,-2804,-13.8,29.4,0,478,478,2139
1981,28,e) 4,2679,3117,25446,26881,127,3.8,552,16.5,4463,1034,3429,3.8,16.6,7333,2923,4410,10.9,27.3,-2870,-10.7,33.2,0,319,322,1563
1981,28,l) Left Censored,19702,25426,487047,498077,733,2.8,2897,10.9,54853,10712,44141,2.2,11,76913,22963,53950,4.6,15.4,-22060,-4.4,22,0,1657,1662,10094
1981,29,a) 0,8895,8947,55233,27830,8851,197.9,0,0,54806,54806,0,196.9,196.9,0,0,0,0,0,54806,196.9,0,0,,,
1981,29,b) 1,6760,6870,43539,46799,41,0.5,2375,29.1,10472,727,9745,1.6,22.4,16991,10433,6558,22.3,36.3,-6519,-13.9,44.8,0,1681,1686,7014
1981,29,c) 2,6247,6367,46490,48516,211,3,1647,23.1,10356,1096,9260,2.3,21.3,14408,8114,6294,16.7,29.7,-4052,-8.4,42.6,0,1186,1188,5899
1981,29,d) 3,5612,5742,42222,45271,195,3.1,1280,20.2,7066,1192,5874,2.6,15.6,13163,6607,6556,14.6,29.1,-6097,-13.5,31.2,0,953,953,4715
1981,29,e) 4,5699,6473,59919,62703,247,3.5,1330,18.9,10084,2671,7413,4.3,16.1,15652,8056,7596,12.8,25,-5568,-8.9,32.2,0,744,748,3722
1981,29,l) Left Censored,46410,60376,1369693,1391690,2053,3.3,6925,11,166510,42347,124163,3,12,210504,70279,140225,5,15.1,-43994,-3.1,24,0,3560,3576,20480
1981,30,a) 0,2198,2209,11649,5865,2186,197.9,0,0,11568,11568,0,197.2,197.2,0,0,0,0,0,11568,197.2,0,0,,,
1981,30,b) 1,1809,1815,11658,11911,6,0.3,582,27.3,3239,35,3204,0.3,27.2,3744,2291,1453,19.2,31.4,-505,-4.2,54.4,0,421,421,1762
1981,30,c) 2,1730,1768,11103,11612,75,3.8,432,22,2387,472,1915,4.1,20.6,3405,1701,1704,14.6,29.3,-1018,-8.7,41.2,0,310,310,1279
1981,30,d) 3,1381,1398,9097,10177,46,3,330,21.3,1460,186,1274,1.8,14.3,3619,1962,1657,19.3,35.6,-2159,-21.3,28.6,0,236,236,1527
1981,30,e) 4,1361,1510,10878,11294,59,3.6,332,20,2188,489,1699,4.3,19.4,3020,1559,1461,13.8,26.7,-832,-7.3,38.8,0,193,193,913
1981,30,l) Left Censored,8633,10722,145122,149623,362,3.2,1231,11,17146,3080,14066,2.1,11.5,26148,9823,16325,6.6,17.5,-9002,-6,23,0,654,654,4010
1981,31,a) 0,3230,3252,21728,10895,3231,198.7,0,0,21667,21667,0,198.9,198.9,0,0,0,0,0,21667,198.9,0,0,,,
1981,31,b) 1,2593,2619,16248,17166,19,0.6,787,25.9,4070,231,3839,1.3,23.7,5906,3160,2746,18.4,34.4,-1836,-10.7,47.4,0,563,563,2161
1981,31,c) 2,2370,2403,13943,15045,63,2.4,529,19.9,2348,290,2058,1.9,15.6,4552,2294,2258,15.2,30.3,-2204,-14.7,31.2,0,398,398,1713
1981,31,d) 3,2185,2231,16851,17220,76,3.1,439,18.1,3279,344,2935,2,19,4016,1974,2042,11.5,23.3,-737,-4.3,38,0,309,309,1360
1981,31,e) 4,2297,2557,19377,20465,94,3.4,485,17.5,2810,399,2411,1.9,13.7,4985,2560,2425,12.5,24.4,-2175,-10.7,27.4,0,270,274,1275
1981,31,l) Left Censored,18171,22521,396271,401801,609,2.6,2545,10.8,48241,10098,38143,2.5,12,59301,21681,37620,5.4,14.8,-11060,-2.8,24,0,1273,1274,7424
1981,32,a) 0,2532,2539,16577,8327,2514,198,0,0,16501,16501,0,198.2,198.2,0,0,0,0,0,16501,198.2,0,0,,,
1981,32,b) 1,1940,1959,18557,19075,14,0.6,781,32.9,5761,197,5564,1,30.2,6796,4138,2658,21.7,35.6,-1035,-5.4,60.4,0,604,604,2953
1981,32,c) 2,1744,1769,17403,18578,77,3.9,469,23.7,3535,694,2841,3.7,19,5884,2867,3017,15.4,31.7,-2349,-12.7,38,0,332,332,2059
1981,32,d) 3,1279,1320,13111,14397,49,3.3,356,24,2573,310,2263,2.2,17.9,5145,2684,2461,18.6,35.7,-2572,-17.8,35.8,0,247,248,2136
1981,32,e) 4,1170,1345,19020,20072,74,5,305,20.8,5429,3390,2039,16.9,27,7533,4448,3085,22.2,37.5,-2104,-10.5,54,0,165,165,993
1981,32,l) Left Censored,6683,8736,247913,254279,502,5.5,1074,11.9,36606,9590,27016,3.8,14.4,49337,14113,35224,5.6,19.4,-12731,-5,28.8,0,513,516,3766
1981,33,a) 0,2012,2019,12556,6307,1998,197.9,0,0,12498,12498,0,198.2,198.2,0,0,0,0,0,12498,198.2,0,0,,,
1981,33,b) 1,1538,1549,9384,9689,8,0.4,476,26.3,2749,158,2591,1.6,28.4,3358,1984,1374,20.5,34.7,-609,-6.3,56.8,0,301,301,1190
1981,33,c) 2,1486,1507,10631,11171,48,2.9,342,20.5,2076,212,1864,1.9,18.6,3155,1550,1605,13.9,28.2,-1079,-9.6,37.2,0,255,255,1052
1981,33,d) 3,1360,1380,10406,10666,48,3.1,316,20.7,2155,320,1835,3,20.2,2675,1351,1324,12.7,25.1,-520,-4.9,40.4,0,222,222,845
1981,33,e) 4,1359,1526,15242,15363,72,4.4,276,16.9,2911,416,2495,2.7,18.9,3152,1829,1323,11.9,20.5,-241,-1.6,37.8,0,166,166,973
1981,33,l) Left Censored,9794,11690,261146,264254,423,3.5,1289,10.6,36098,7973,28125,3,13.7,42313,16440,25873,6.2,16,-6215,-2.3,27.4,0,692,695,4760
1981,34,a) 0,13361,13387,81135,40730,13270,198.3,0,0,80810,80810,0,198.4,198.4,0,0,0,0,0,80810,198.4,0,0,,,
1981,34,b) 1,10866,10942,71195,70200,39,0.3,3250,25.5,23169,2890,20279,4.1,33,21179,12883,8296,18.4,30.2,1990,2.8,60.4,0,2197,2197,8064
1981,34,c) 2,9716,9844,68745,69790,357,3.3,2181,20.2,18884,1848,17036,2.6,27.1,20974,11940,9034,17.1,30.1,-2090,-3,54.2,0,1477,1477,7251
1981,34,d) 3,8503,8647,58740,60295,310,3.3,1677,17.9,11904,1409,10495,2.3,19.7,15014,7068,7946,11.7,24.9,-3110,-5.2,39.4,0,1199,1199,4914
1981,34,e) 4,9017,9728,86308,88599,346,3.3,1869,17.8,15360,2903,12457,3.3,17.3,19941,10651,9290,12,22.5,-4581,-5.2,34.6,0,1043,1046,4765
1981,34,l) Left Censored,78098,94559,2159293,2185229,2927,3,10148,10.3,279993,74638,205355,3.4,12.8,331867,123881,207986,5.7,15.2,-51874,-2.4,25.6,0,5446,5485,33820
1981,35,a) 0,3131,3144,18973,9649,3101,197.3,0,0,18649,18649,0,193.3,193.3,0,0,0,0,0,18649,193.3,0,0,,,
1981,35,b) 1,2514,2538,18384,19254,9,0.3,875,29,4947,109,4838,0.6,25.7,6687,3975,2712,20.6,34.7,-1740,-9,51.4,0,677,677,3055
1981,35,c) 2,2218,2298,17897,19041,79,3.1,594,23.1,3891,521,3370,2.7,20.4,6179,3155,3024,16.6,32.5,-2288,-12.1,40.8,0,451,453,2484
1981,35,d) 3,1778,1811,12958,13994,61,3.1,401,20.1,2460,264,2196,1.9,17.6,4532,2023,2509,14.5,32.4,-2072,-14.8,35.2,0,299,299,1483
1981,35,e) 4,1699,1917,15677,16628,88,4.2,393,18.9,2825,525,2300,3.2,17,4727,2444,2283,14.7,28.4,-1902,-11.4,34,0,234,239,1308
1981,35,l) Left Censored,10678,13827,244063,246884,585,4,1829,12.6,37795,9653,28142,3.9,15.3,43436,16039,27397,6.5,17.6,-5641,-2.3,30.6,0,968,971,7263
1981,36,a) 0,31123,31215,198105,99636,30951,198.3,0,0,196938,196938,0,197.7,197.7,0,0,0,0,0,196938,197.7,0,0,,,
1981,36,b) 1,24681,24890,170994,171468,73,0.3,7137,24.8,52018,1506,50512,0.9,30.3,52965,32591,20374,19,30.9,-947,-0.6,60.6,0,5029,5029,22202
1981,36,c) 2,22136,22404,147692,157082,711,2.9,4935,20,29245,4099,25146,2.6,18.6,48025,26510,21515,16.9,30.6,-18780,-12,37.2,0,3514,3515,17302
1981,36,d) 3,20410,20783,148573,153659,643,2.8,4055,17.9,28991,4970,24021,3.2,18.9,39163,19625,19538,12.8,25.5,-10172,-6.6,37.8,0,3046,3049,14398
1981,36,e) 4,20359,22600,218573,226444,807,3.3,4120,16.9,37160,6842,30318,3,16.4,52901,24037,28864,10.6,23.4,-15741,-7,32.8,0,2438,2455,11708
1981,36,l) Left Censored,188542,224646,4951899,5054552,5760,2.5,25393,10.8,612612,128170,484442,2.5,12.1,817919,300720,517199,5.9,16.2,-205307,-4.1,24.2,0,14427,14531,90231
1981,37,a) 0,10001,10060,63339,31750,9991,198.6,0,0,63179,63179,0,199,199,0,0,0,0,0,63179,199,0,0,,,
1981,37,b) 1,7685,7805,51199,53621,47,0.5,2725,29.4,14225,788,13437,1.5,26.5,19069,12179,6890,22.7,35.6,-4844,-9.1,53,0,2032,2034,8477
1981,37,c) 2,7007,7195,50546,53890,288,3.6,1814,22.6,10152,1504,8648,2.8,18.8,16839,9270,7569,17.2,31.2,-6687,-12.4,37.6,0,1319,1319,6720
1981,37,d) 3,6476,6657,49176,50660,255,3.5,1413,19.4,10268,2405,7863,4.7,20.3,13235,6398,6837,12.6,26.1,-2967,-5.8,40.6,0,1043,1043,4166
1981,37,e) 4,6294,7177,64203,67761,282,3.6,1454,18.7,10803,1870,8933,2.8,15.9,17918,9920,7998,14.6,26.4,-7115,-10.5,31.8,0,799,803,3970
1981,37,l) Left Censored,50353,68299,1686126,1709208,2415,3.4,7282,10.3,189039,46360,142679,2.7,11.1,235204,79633,155571,4.7,13.8,-46165,-2.7,22.2,0,3870,3892,26157
1981,38,a) 0,1521,1526,8977,4497,1518,199,0,0,8961,8961,0,199.3,199.3,0,0,0,0,0,8961,199.3,0,0,,,
1981,38,b) 1,1200,1212,7512,8020,10,0.7,379,26.8,1722,104,1618,1.3,21.5,2738,1411,1327,17.6,34.1,-1016,-12.6,43,0,262,262,1065
1981,38,c) 2,1125,1146,7715,8056,49,3.8,303,23.7,1656,403,1253,5,20.6,2338,1273,1065,15.8,29,-682,-8.4,41.2,0,225,225,994
1981,38,d) 3,971,985,5905,6494,28,2.6,181,17,981,117,864,1.8,15.1,2159,933,1226,14.4,33.2,-1178,-18.1,30.2,0,128,128,705
1981,38,e) 4,1016,1094,7698,8177,52,4.4,195,16.6,1072,231,841,2.8,13.1,2029,850,1179,10.4,24.8,-957,-11.7,26.2,0,130,130,592
1981,38,l) Left Censored,7708,9484,131743,134793,312,3.2,978,9.9,14204,3114,11090,2.3,10.5,20303,6419,13884,4.8,15.1,-6099,-4.6,21,0,507,508,2755
1981,39,a) 0,14780,14874,104383,52402,14745,198.3,0,0,103962,103962,0,198.4,198.4,0,0,0,0,0,103962,198.4,0,0,,,
1981,39,b) 1,11809,12058,81205,85981,100,0.7,3895,27.6,21043,1532,19511,1.8,24.5,30595,17255,13340,20.1,35.6,-9552,-11.1,49,0,2713,2713,11511
1981,39,c) 2,11003,11232,86744,91088,361,2.9,2727,21.8,17170,2051,15119,2.3,18.8,25858,14221,11637,15.6,28.4,-8688,-9.6,37.6,0,1887,1889,9463
1981,39,d) 3,9913,10238,77257,81105,422,3.8,2157,19.3,14395,3422,10973,4.2,17.7,22091,10804,11287,13.3,27.2,-7696,-9.5,35.4,0,1519,1521,7302
1981,39,e) 4,10346,12261,116331,122979,471,3.5,2449,18.4,17348,4095,13253,3.3,14.1,30644,14959,15685,12.2,24.9,-13296,-10.8,28.2,0,1219,1230,6334
1981,39,l) Left Censored,93682,128681,3072772,3181889,4239,3.2,13932,10.4,288267,73251,215016,2.3,9.1,506501,164818,341683,5.2,15.9,-218234,-6.8,18.2,0,6563,6620,42678
1981,40,a) 0,7800,7823,49558,24879,7748,198.1,0,0,49359,49359,0,198.4,198.4,0,0,0,0,0,49359,198.4,0,0,,,
1981,40,b) 1,5843,5923,44894,45112,47,0.7,1989,28.4,14594,814,13780,1.8,32.4,15030,9574,5456,21.2,33.3,-436,-0.9,64.8,0,1605,1605,7701
1981,40,c) 2,4932,5056,44889,43937,195,3.4,1334,23.6,13574,3036,10538,6.9,30.9,11670,6625,5045,15.1,26.6,1904,4.3,53.2,0,1042,1042,5187
1981,40,d) 3,4096,4170,34306,35165,128,2.8,899,19.6,7231,765,6466,2.2,20.6,8948,4619,4329,13.1,25.4,-1717,-4.8,41.2,0,701,701,3673
1981,40,e) 4,3795,4319,41903,42614,191,4.1,847,18.2,8751,1489,7262,3.5,20.5,10172,4693,5479,11,23.9,-1421,-3.4,41,0,533,537,2522
1981,40,l) Left Censored,26800,34818,701048,703146,1277,3.5,4131,11.4,100197,24521,75676,3.5,14.2,104392,39538,64854,5.6,14.8,-4195,-0.6,28.4,0,2217,2228,13481
1981,41,a) 0,7025,7063,40365,20309,7005,198.4,0,0,40112,40112,0,197.5,197.5,0,0,0,0,0,40112,197.5,0,0,,,
1981,41,b) 1,5721,5811,36571,39315,53,0.8,2158,31,9266,703,8563,1.8,23.6,14754,8739,6015,22.2,37.5,-5488,-13.9,47.2,0,1667,1667,6589
1981,41,c) 2,4730,4798,32026,35315,226,4.2,1394,25.7,6062,1081,4981,3.1,17.2,12639,7006,5633,19.8,35.8,-6577,-18.6,34.4,0,1018,1019,5064
1981,41,d) 3,4118,4199,29418,32669,196,4.2,1157,24.5,5824,1316,4508,4,17.8,12326,6780,5546,20.8,37.7,-6502,-19.9,35.6,0,813,814,4558
1981,41,e) 4,3947,4489,44254,47612,225,4.5,1102,22.2,6620,1841,4779,3.9,13.9,13335,6239,7096,13.1,28,-6715,-14.1,27.8,0,617,624,2928
1981,41,l) Left Censored,24871,32167,613803,637780,1305,3.9,4094,12.2,69056,21303,47753,3.3,10.8,117009,39159,77850,6.1,18.3,-47953,-7.5,21.6,0,2031,2044,15430
1981,42,a) 0,15134,15214,109658,54982,15090,198.4,0,0,109353,109353,0,198.9,198.9,0,0,0,0,0,109353,198.9,0,0,,,
1981,42,b) 1,12774,12958,88839,92297,91,0.6,3744,25,22412,2008,20404,2.2,24.3,29327,17203,12124,18.6,31.8,-6915,-7.5,48.6,0,2638,2638,11797
1981,42,c) 2,11886,12207,87009,92727,378,2.8,2726,20.2,15781,2654,13127,2.9,17,27217,14961,12256,16.1,29.4,-11436,-12.4,34,0,1805,1807,10180
1981,42,d) 3,10813,11076,80907,85882,363,3,2218,18.3,13744,2354,11390,2.7,16,23694,12376,11318,14.4,27.6,-9950,-11.6,32,0,1542,1544,8340
1981,42,e) 4,11429,13200,133971,138917,525,3.7,2683,18.7,21675,4813,16862,3.5,15.6,31567,16421,15146,11.8,22.7,-9892,-7.1,31.2,0,1381,1396,7779
1981,42,l) Left Censored,108946,141434,3460289,3520839,4456,3,15289,10.4,393007,109428,283579,3.1,11.2,514106,169967,344139,4.8,14.6,-121099,-3.4,22.4,0,7974,8024,50977
1981,44,a) 0,1631,1636,10771,5420,1622,198.3,0,0,10703,10703,0,197.5,197.5,0,0,0,0,0,10703,197.5,0,0,,,
1981,44,b) 1,1288,1299,8014,8250,9,0.6,422,27.6,2152,154,1998,1.9,26.1,2624,1527,1097,18.5,31.8,-472,-5.7,52.2,0,277,277,868
1981,44,c) 2,1238,1258,9043,9389,47,3.4,249,18.1,2026,300,1726,3.2,21.6,2718,1451,1267,15.5,28.9,-692,-7.3,43.2,0,169,169,874
1981,44,d) 3,1116,1126,9287,9683,40,3.3,208,17.1,1638,195,1443,2,16.9,2430,915,1515,9.4,25.1,-792,-8.2,33.8,0,149,149,684
1981,44,e) 4,1200,1291,12143,12188,57,4.1,236,17,2345,584,1761,4.8,19.2,2434,993,1441,8.1,20,-89,-0.8,38.4,0,156,156,525
1981,44,l) Left Censored,11374,13181,285161,292185,369,2.7,1375,10,30734,7176,23558,2.5,10.5,44781,16228,28553,5.6,15.3,-14047,-4.8,21,0,729,733,5346
1981,45,a) 0,5104,5138,31313,15701,5101,198.6,0,0,31225,31225,0,198.9,198.9,0,0,0,0,0,31225,198.9,0,0,,,
1981,45,b) 1,3892,3977,28025,29219,20,0.4,1516,31.7,7368,951,6417,3.3,25.2,9755,6181,3574,21.2,33.4,-2387,-8.2,50.4,0,1089,1089,4161
1981,45,c) 2,3384,3466,23787,25443,113,2.9,947,24.3,5436,534,4902,2.1,21.4,8748,5182,3566,20.4,34.4,-3312,-13,42.8,0,649,653,3912
1981,45,d) 3,3276,3356,24422,26288,129,3.5,732,19.9,4545,928,3617,3.5,17.3,8276,3957,4319,15.1,31.5,-3731,-14.2,34.6,0,511,511,2648
1981,45,e) 4,3108,3465,27149,28906,147,3.9,779,20.6,5096,1619,3477,5.6,17.6,8610,5044,3566,17.4,29.8,-3514,-12.2,35.2,0,432,434,2571
1981,45,l) Left Censored,24683,32838,814747,826671,1263,3.7,3667,10.8,89116,22354,66762,2.7,10.8,112963,38045,74918,4.6,13.7,-23847,-2.9,21.6,0,1973,1984,12831
1981,46,a) 0,1400,1410,7438,3733,1398,198.3,0,0,7410,,,,198.5,0,0,0,0,0,7410,198.5,0,1,,,
1981,46,b) 1,1199,1212,6799,7309,3,0.2,407,28.4,1424,,,,19.5,2443,1484,959,20.3,33.4,-1019,-13.9,39,1,270,270,1084
1981,46,c) 2,1088,1114,7278,7764,35,2.8,289,23.1,1263,211,1052,2.7,16.3,2234,1275,959,16.4,28.8,-971,-12.5,32.6,0,198,198,801
1981,46,d) 3,1035,1047,6103,6595,30,2.6,246,21.1,1108,184,924,2.8,16.8,2092,1161,931,17.6,31.7,-984,-14.9,33.6,0,179,179,916
1981,46,e) 4,1006,1111,7474,7933,33,2.8,193,16.1,1155,334,821,4.2,14.6,2073,911,1162,11.5,26.1,-918,-11.5,29.2,0,112,112,471
1981,46,l) Left Censored,8253,9908,134057,138230,263,2.6,1015,9.8,12732,3097,9635,2.2,9.2,21078,6663,14415,4.8,15.2,-8346,-6,18.4,0,573,577,3294
1981,47,a) 0,7568,7629,48239,24196,7582,198.8,0,0,48087,48087,0,198.7,198.7,0,0,0,0,0,48087,198.7,0,0,,,
1981,47,b) 1,6022,6101,41374,44492,33,0.5,2233,30.6,11179,456,10723,1,25.1,17415,10487,6928,23.6,39.1,-6236,-14,50.2,0,1792,1802,8377
1981,47,c) 2,5460,5616,43355,45768,248,4,1479,23.6,9518,1424,8094,3.1,20.8,14344,7316,7028,16,31.3,-4826,-10.5,41.6,0,1138,1138,5204
1981,47,d) 3,4834,4958,37091,39125,214,3.9,1092,20.1,6976,1338,5638,3.4,17.8,11044,5613,5431,14.3,28.2,-4068,-10.4,35.6,0,854,854,4301
1981,47,e) 4,4941,5693,57132,60279,231,3.7,1210,19.5,9939,1994,7945,3.3,16.5,16232,7651,8581,12.7,26.9,-6293,-10.4,33,0,718,722,3600
1981,47,l) Left Censored,37362,49668,1172455,1189317,1797,3.5,5605,10.8,140499,34518,105981,2.9,11.8,174222,58628,115594,4.9,14.6,-33723,-2.8,23.6,0,2914,2929,20223
1981,48,a) 0,50689,51040,361238,216990,41882,164.1,0,0,288496,288496,0,133,133,0,0,0,0,0,288496,133,0,0,,,
1981,48,b) 1,14184,14615,113350,114676,150,0.9,4672,27.3,35974,2302,33672,2,31.4,38626,24488,14138,21.4,33.7,-2652,-2.3,62.8,0,3553,3554,18014
1981,48,c) 2,23230,24064,220402,220700,1196,5.9,3289,16.3,38847,14035,24812,6.4,17.6,39443,21825,17618,9.9,17.9,-596,-0.3,35.2,0,2326,2330,14718
1981,48,d) 3,18611,19248,177004,179457,727,3.9,3307,17.6,34003,6508,27495,3.6,18.9,38909,20388,18521,11.4,21.7,-4906,-2.8,37.8,0,2313,2322,14191
1981,48,e) 4,16976,19924,213909,221670,889,4.1,4188,19.3,41895,7457,34438,3.4,18.9,57416,30909,26507,13.9,25.9,-15521,-7,37.8,0,2135,2152,14606
1981,48,l) Left Censored,111382,162136,3948881,3925846,8040,4.8,19471,11.6,657328,181551,475777,4.6,16.7,611259,213127,398132,5.4,15.6,46069,1.1,31.2,0,9483,9552,69351
1981,49,a) 0,3118,3131,19014,9568,3096,197.8,0,0,18892,18892,0,197.4,197.4,0,0,0,0,0,18892,197.4,0,0,,,
1981,49,b) 1,2336,2375,17800,18914,15,0.5,998,34.3,5485,172,5313,0.9,29,7712,4589,3123,24.3,40.8,-2227,-11.8,58,0,761,761,3411
1981,49,c) 2,2204,2266,17370,18606,80,3.2,563,22.3,3931,442,3489,2.4,21.1,6402,3344,3058,18,34.4,-2471,-13.3,42.2,0,438,438,2572
1981,49,d) 3,1831,1873,15666,17121,89,4.3,467,22.5,3094,537,2557,3.1,18.1,6003,2921,3082,17.1,35.1,-2909,-17,36.2,0,322,322,1785
1981,49,e) 4,1711,1909,17509,18340,86,4.1,452,21.5,4140,1998,2142,10.9,22.6,5801,2821,2980,15.4,31.6,-1661,-9,45.2,0,248,248,1454
1981,49,l) Left Censored,11449,15006,329232,334049,861,5.6,1786,11.5,44432,14634,29798,4.4,13.3,54065,19641,34424,5.9,16.2,-9633,-2.9,26.6,0,873,885,7531
1981,50,a) 0,1273,1278,6298,3152,1274,199.4,0,0,6293,6293,0,199.7,199.7,0,0,0,0,0,6293,199.7,0,0,,,
1981,50,b) 1,1011,1014,5535,5811,3,0.3,330,27.6,1212,113,1099,1.9,20.9,1763,966,797,16.6,30.3,-551,-9.4,41.8,0,217,217,651
1981,50,c) 2,885,897,5441,5957,25,2.4,256,25.1,982,85,897,1.4,16.5,2014,1230,784,20.6,33.8,-1032,-17.3,33,0,185,185,996
1981,50,d) 3,920,938,6196,6277,34,3.3,182,17.9,1071,121,950,1.9,17.1,1232,546,686,8.7,19.6,-161,-2.5,34.2,0,136,136,387
1981,50,e) 4,867,972,8395,8595,32,3.1,167,16,1387,215,1172,2.5,16.1,1786,798,988,9.3,20.8,-399,-4.7,32.2,0,89,90,364
1981,50,l) Left Censored,6093,7153,129974,131503,163,2.2,746,10,14112,1872,12240,1.4,10.7,17169,5783,11386,4.4,13.1,-3057,-2.4,21.4,0,430,433,2677
1981,51,a) 0,8906,8962,55615,27891,8887,198.3,0,0,55449,55449,0,198.8,198.8,0,0,0,0,0,55449,198.8,0,0,,,
1981,51,b) 1,7000,7085,47319,48120,51,0.6,2416,28.9,13800,846,12954,1.8,28.7,15402,9999,5403,20.8,32,-1602,-3.3,57.4,0,1739,1739,7107
1981,51,c) 2,6109,6259,50088,52208,239,3.4,1583,22.7,11092,1420,9672,2.7,21.2,15332,8778,6554,16.8,29.4,-4240,-8.2,42.4,0,1123,1124,5526
1981,51,d) 3,5524,5719,44929,46808,202,3.2,1206,19.3,8823,1753,7070,3.7,18.8,12580,5782,6798,12.4,26.9,-3757,-8.1,37.6,0,871,871,4354
1981,51,e) 4,5422,6283,64704,67278,289,4.2,1277,18.8,10887,3359,7528,5,16.2,16035,8488,7547,12.6,23.8,-5148,-7.6,32.4,0,703,707,3507
1981,51,l) Left Censored,43178,59014,1338002,1343944,2397,3.9,6565,10.7,186575,57695,128880,4.3,13.9,198459,77529,120930,5.8,14.8,-11884,-0.9,27.8,0,3321,3364,25955
1981,53,a) 0,9613,9679,55216,27866,9591,198.2,0,0,54701,54701,0,196.3,196.3,0,0,0,0,0,54701,196.3,0,0,,,
1981,53,b) 1,7713,7820,50906,52305,70,0.7,2827,30.2,15303,1044,14259,2,29.3,18100,10997,7103,21,34.6,-2797,-5.3,58.6,0,2043,2044,8087
1981,53,c) 2,6738,6847,48369,52837,305,4,1714,22.4,11015,1625,9390,3.1,20.8,19950,8546,11404,16.2,37.8,-8935,-17,41.6,0,1251,1253,5886
1981,53,d) 3,5959,6105,45000,47458,290,4.3,1488,22,9632,1383,8249,2.9,20.3,14547,7484,7063,15.8,30.7,-4915,-10.4,40.6,0,1045,1045,5022
1981,53,e) 4,5755,6607,63649,69893,321,4.4,1477,20.4,12367,3595,8772,5.1,17.7,24855,9480,15375,13.6,35.6,-12488,-17.9,35.4,0,772,783,4400
1981,53,l) Left Censored,36479,47881,955242,972083,1996,4,5691,11.4,127501,34669,92832,3.6,13.1,161182,52063,109119,5.4,16.6,-33681,-3.5,26.2,0,2775,2795,17664
1981,54,a) 0,2684,2693,16943,8665,2668,198.1,0,0,16556,16556,0,191.1,191.1,0,0,0,0,0,16556,191.1,0,0,,,
1981,54,b) 1,2083,2107,13345,13862,15,0.6,750,29.9,3868,116,3752,0.8,27.9,4902,3156,1746,22.8,35.4,-1034,-7.5,55.8,0,578,578,2236
1981,54,c) 2,1892,1927,13148,14185,69,3.2,531,24.5,2786,600,2186,4.2,19.6,4860,2613,2247,18.4,34.3,-2074,-14.7,39.2,0,390,390,1615
1981,54,d) 3,1698,1739,12187,12748,79,4.2,373,19.7,2352,397,1955,3.1,18.4,3474,1861,1613,14.6,27.3,-1122,-8.9,36.8,0,261,261,1238
1981,54,e) 4,1778,1998,17677,18604,70,3.2,426,19.5,2706,494,2212,2.7,14.5,4560,2139,2421,11.5,24.5,-1854,-10,29,0,280,280,1342
1981,54,l) Left Censored,15873,20151,394155,403780,713,3.4,2288,10.9,42057,11520,30537,2.9,10.4,61308,19455,41853,4.8,15.2,-19251,-4.8,20.8,0,1275,1278,6646
1981,55,a) 0,7502,7548,48175,24172,7483,198.3,0,0,48006,48006,0,198.6,198.6,0,0,0,0,0,48006,198.6,0,0,,,
1981,55,b) 1,6111,6176,39041,41027,28,0.4,1857,25.9,8574,487,8087,1.2,20.9,12546,7494,5052,18.3,30.6,-3972,-9.7,41.8,0,1286,1288,5091
1981,55,c) 2,5836,5983,40776,42486,201,3.1,1241,19,7609,1507,6102,3.5,17.9,11029,5589,5440,13.2,26,-3420,-8.1,35.8,0,857,857,3671
1981,55,d) 3,5733,5916,44345,46101,190,3,1074,16.8,8029,1696,6333,3.7,17.4,11540,5174,6366,11.2,25,-3511,-7.6,34.8,0,774,774,3477
1981,55,e) 4,5577,6405,55319,58831,199,2.9,1135,16.5,7107,1543,5564,2.6,12.1,14130,5789,8341,9.8,24,-7023,-11.9,24.2,0,589,594,2878
1981,55,l) Left Censored,47497,58672,1309143,1350138,1614,2.6,6034,9.9,123761,30898,92863,2.3,9.2,205752,58955,146797,4.4,15.2,-81991,-6,18.4,0,3006,3023,18419
1981,56,a) 0,1716,1725,9728,4896,1710,198.3,0,0,9664,,,,197.4,0,0,0,0,0,9664,197.4,0,1,,,
1981,56,b) 1,1226,1248,9339,9385,9,0.6,460,30.8,3052,,,,32.5,3144,1763,1381,18.8,33.5,-92,-1,65,1,349,349,1380
1981,56,c) 2,1143,1169,9142,9445,50,3.9,277,21.5,2290,194,2096,2.1,24.2,2896,1521,1375,16.1,30.7,-606,-6.5,48.4,0,202,202,1092
1981,56,d) 3,985,995,8234,8319,26,2.4,212,19.4,1965,190,1775,2.3,23.6,2134,988,1146,11.9,25.7,-169,-2.1,47.2,0,159,159,777
1981,56,e) 4,849,943,9585,9814,47,4.6,174,17.2,1738,332,1406,3.4,17.7,2196,841,1355,8.6,22.4,-458,-4.7,35.4,0,93,93,372
1981,56,l) Left Censored,5106,6339,106127,107185,288,4.4,766,11.6,18153,4036,14117,3.8,16.9,20269,6356,13913,5.9,18.9,-2116,-2,33.8,0,426,429,2868
1982,01,a) 0,5769,5905,35201,17820,5858,198.4,0,0,34762,34762,0,195.1,195.1,0,0,0,0,0,34762,195.1,0,0,,,
1982,01,b) 1,4429,4583,39194,39577,92,1.7,1415,26.5,12019,561,11458,1.4,30.4,12784,6757,6027,17.1,32.3,-765,-1.9,60.8,0,1052,1052,5259
1982,01,c) 2,3850,3973,27295,29167,222,5,1013,23,6332,1339,4993,4.6,21.7,10076,5181,4895,17.8,34.5,-3744,-12.8,43.4,0,649,649,3493
1982,01,d) 3,3644,3834,34304,35924,248,6,784,18.9,6340,2208,4132,6.1,17.6,9580,4311,5269,12,26.7,-3240,-9.1,35.2,0,498,498,2896
1982,01,e) 4,3438,3786,29781,31295,207,5.1,648,16,5056,1280,3776,4.1,16.2,8084,3279,4805,10.5,25.8,-3028,-9.6,32.4,0,424,424,2078
1982,01,f) 5,3388,4108,38080,39371,247,5.7,577,13.4,6227,1687,4540,4.3,15.8,8808,3381,5427,8.6,22.4,-2581,-6.6,31.6,0,336,336,1888
1982,01,l) Left Censored,27010,37361,828263,842433,1896,4.9,3468,9,106748,31934,74814,3.8,12.7,135089,39893,95196,4.7,16,-28341,-3.3,25.4,0,1804,1807,11401
1982,02,a) 0,1461,1513,9218,4630,1499,198.1,0,0,9176,9176,0,198.2,198.2,0,0,0,0,0,9176,198.2,0,0,,,
1982,02,b) 1,828,856,6554,6693,20,2,269,27,2555,135,2420,2,38.2,2833,1754,1079,26.2,42.3,-278,-4.1,76.4,0,167,167,1323
1982,02,c) 2,701,717,5511,5608,52,6.8,133,17.5,1619,318,1301,5.7,28.9,1812,816,996,14.6,32.3,-193,-3.4,57.8,0,71,71,475
1982,02,d) 3,675,722,5800,6000,72,9.4,157,20.5,1514,486,1028,8.1,25.2,1913,841,1072,14,31.9,-399,-6.7,50.4,0,91,91,478
1982,02,e) 4,560,595,5055,5122,61,9.8,110,17.7,1401,334,1067,6.5,27.4,1534,663,871,12.9,29.9,-133,-2.5,54.8,0,66,66,480
1982,02,f) 5,568,694,7475,7528,48,6.7,100,13.9,2109,711,1398,9.4,28,2215,777,1438,10.3,29.4,-106,-1.4,56,0,49,49,218
1982,02,l) Left Censored,2977,4105,86884,83315,310,7.5,344,8.3,22334,6127,16207,7.4,26.8,15196,4971,10225,6,18.2,7138,8.6,36.4,0,134,137,2332
1982,04,a) 0,7503,7704,48929,24553,7664,199,0,0,48753,48753,0,198.6,198.6,0,0,0,0,0,48753,198.6,0,0,,,
1982,04,b) 1,5230,5392,37372,39294,139,2.2,1638,26.3,10724,1133,9591,2.9,27.3,14568,7385,7183,18.8,37.1,-3844,-9.8,54.6,0,1126,1126,5240
1982,04,c) 2,4566,4724,33980,35966,370,7.2,1135,22,9054,2900,6154,8.1,25.2,13025,6450,6575,17.9,36.2,-3971,-11,50.4,0,679,679,3772
1982,04,d) 3,3789,4083,33249,36363,372,8.5,914,20.9,8550,3461,5089,9.5,23.5,14778,8465,6313,23.3,40.6,-6228,-17.1,47,0,452,452,2645
1982,04,e) 4,3060,3175,26802,28650,219,6.4,661,19.3,5283,1479,3804,5.2,18.4,8978,4070,4908,14.2,31.3,-3695,-12.9,36.8,0,364,364,2440
1982,04,f) 5,2869,3554,40348,40414,299,8.1,507,13.8,8484,3122,5362,7.7,21,8615,3286,5329,8.1,21.3,-131,-0.3,42,0,258,258,1348
1982,04,l) Left Censored,17290,26072,597144,605241,1951,7.4,2329,8.8,92860,36289,56571,6,15.3,109054,26596,82458,4.4,18,-16194,-2.7,30.6,0,1097,1104,7956
1982,05,a) 0,4262,4335,24127,12108,4305,198.6,0,0,24039,24039,0,198.5,198.5,0,0,0,0,0,24039,198.5,0,0,,,
1982,05,b) 1,3144,3230,22783,24983,74,2,1026,27.3,4766,556,4210,2.2,19.1,9165,4638,4527,18.6,36.7,-4399,-17.6,38.2,0,720,720,3390
1982,05,c) 2,2771,2879,20980,21814,187,6,645,20.6,5545,1311,4234,6,25.4,7212,2868,4344,13.1,33.1,-1667,-7.7,50.8,0,416,416,1819
1982,05,d) 3,2758,2898,19993,21236,176,5.6,538,17.3,4043,1376,2667,6.5,19,6529,2241,4288,10.6,30.7,-2486,-11.7,38,0,342,342,1269
1982,05,e) 4,2464,2527,16153,17197,129,4.8,435,16.1,2822,692,2130,4,16.4,4909,2399,2510,14,28.5,-2087,-12.1,32.8,0,262,262,1792
1982,05,f) 5,2249,2629,21821,22159,239,8.7,413,15,4452,1906,2546,8.6,20.1,5128,2046,3082,9.2,23.1,-676,-3,40.2,0,248,249,1143
1982,05,l) Left Censored,17285,22404,447913,454942,1195,5.2,2108,9.2,54117,13850,40267,3,11.9,68174,18896,49278,4.2,15,-14057,-3.1,23.8,0,1067,1070,7013
1982,06,a) 0,58059,60014,438813,220967,59603,198.6,0,0,435693,435693,0,197.2,197.2,0,0,0,0,0,435693,197.2,0,0,,,
1982,06,b) 1,45812,47451,456823,435478,1130,2.1,12883,23.8,174423,40978,133445,9.4,40.1,131732,68039,63693,15.6,30.2,42691,9.9,60.4,0,8350,8350,43659
1982,06,c) 2,39202,40636,306138,324162,3153,7.2,9076,20.6,78920,24620,54300,7.6,24.3,114967,52755,62212,16.3,35.5,-36047,-11.2,48.6,0,5487,5488,33695
1982,06,d) 3,34968,36887,291156,304893,2932,7.5,6936,17.7,71188,24038,47150,7.9,23.3,98661,44089,54572,14.5,32.4,-27473,-9.1,46.6,0,4215,4215,27643
1982,06,e) 4,29194,30998,286029,288492,2246,6.8,5496,16.7,82492,30739,51753,10.7,28.6,87417,32019,55398,11.1,30.3,-4925,-1.7,57.2,0,3230,3231,19398
1982,06,f) 5,29378,35758,435610,433083,2787,7.5,5058,13.6,105595,49295,56300,11.4,24.4,100541,34260,66281,7.9,23.2,5054,1.2,46.4,0,2636,2647,16710
1982,06,l) Left Censored,179546,256218,6297035,6354769,15678,6,23719,9.1,932203,282594,649609,4.4,14.7,1047672,297040,750632,4.7,16.5,-115469,-1.8,29.4,0,10997,11029,90145
1982,08,a) 0,9407,9649,103759,52045,9607,199.1,0,0,103428,103428,0,198.7,198.7,0,0,0,0,0,103428,198.7,0,0,,,
1982,08,b) 1,6905,7154,63677,61589,158,1.9,1963,24.1,21004,2128,18876,3.5,34.1,16827,8885,7942,14.4,27.3,4177,6.8,54.6,0,1317,1317,6026
1982,08,c) 2,5686,5877,44293,46679,474,7.4,1487,23.2,11776,2992,8784,6.4,25.2,16548,8856,7692,19,35.5,-4772,-10.3,50.4,0,829,829,4780
1982,08,d) 3,5134,5432,44619,46338,530,9.1,1209,20.8,11943,4260,7683,9.2,25.8,15381,7605,7776,16.4,33.2,-3438,-7.4,51.6,0,667,667,4175
1982,08,e) 4,4309,4439,38173,39690,252,5.3,766,16.2,7954,1812,6142,4.6,20,10987,4057,6930,10.2,27.7,-3033,-7.7,40,0,429,430,2358
1982,08,f) 5,3921,4745,51766,51584,421,8.6,699,14.2,11788,3517,8271,6.8,22.9,11423,5083,6340,9.9,22.1,365,0.8,44.2,0,383,383,2828
1982,08,l) Left Censored,24668,33824,780002,781524,2491,7.2,3304,9.6,122930,41560,81370,5.3,15.7,125973,42230,83743,5.4,16.1,-3043,-0.4,31.4,0,1513,1516,12026
1982,09,a) 0,5806,5953,35754,17923,5920,198.9,0,0,35663,35663,0,199,199,0,0,0,0,0,35663,199,0,0,,,
1982,09,b) 1,4702,4839,32605,33175,62,1.2,943,17.6,7931,824,7107,2.5,23.9,9070,4601,4469,13.9,27.3,-1139,-3.4,47.8,0,625,625,3024
1982,09,c) 2,3953,4072,26628,27431,245,5.7,683,15.8,6019,1471,4548,5.4,21.9,7625,3542,4083,12.9,27.8,-1606,-5.9,43.8,0,467,467,2404
1982,09,d) 3,3608,3698,26389,27844,205,5.3,551,14.1,5682,2016,3666,7.2,20.4,8591,4069,4522,14.6,30.9,-2909,-10.5,40.8,0,359,359,3340
1982,09,e) 4,3336,3516,27859,27757,239,6.5,516,14,5978,2106,3872,7.6,21.5,5774,2350,3424,8.5,20.8,204,0.7,41.6,0,345,345,1653
1982,09,f) 5,3645,4216,43552,42970,265,6.1,474,10.9,8858,2026,6832,4.7,20.6,7693,2709,4984,6.3,17.9,1165,2.7,35.8,0,270,270,1339
1982,09,l) Left Censored,32493,39981,1066538,1073852,1981,4.9,3082,7.6,123312,41548,81764,3.9,11.5,137940,33858,104082,3.2,12.8,-14628,-1.3,23,0,1584,1588,10674
1982,10,a) 0,1029,1046,6296,3176,1037,198.3,0,0,6241,6241,0,196.5,196.5,0,0,0,0,0,6241,196.5,0,0,,,
1982,10,b) 1,798,816,5668,5849,20,2.2,165,18.2,1312,205,1107,3.5,22.4,1673,889,784,15.2,28.6,-361,-6.2,44.8,0,117,117,741
1982,10,c) 2,698,717,5269,5519,46,6.1,113,15,1255,224,1031,4.1,22.7,1755,577,1178,10.5,31.8,-500,-9.1,45.4,0,66,66,251
1982,10,d) 3,659,679,5316,5630,43,6,117,16.3,875,190,685,3.4,15.5,1502,514,988,9.1,26.7,-627,-11.2,31,0,81,81,369
1982,10,e) 4,561,593,4379,4433,53,8.7,85,13.9,1017,584,433,13.2,22.9,1124,360,764,8.1,25.4,-107,-2.5,45.8,0,48,48,180
1982,10,f) 5,644,782,7951,8127,50,6.2,94,11.6,1186,361,825,4.4,14.6,1537,612,925,7.5,18.9,-351,-4.3,29.2,0,56,56,242
1982,10,l) Left Censored,5529,6921,181163,181706,334,4.7,607,8.6,18724,5740,12984,3.2,10.3,19809,5803,14006,3.2,10.9,-1085,-0.6,20.6,0,286,290,1395
1982,11,a) 0,1514,1525,9960,4997,1514,198.6,0,0,9927,9927,0,198.7,198.7,0,0,0,0,0,9927,198.7,0,0,,,
1982,11,b) 1,1071,1088,13911,16083,36,3,245,20.4,2244,292,1952,1.8,14,6587,2203,4384,13.7,41,-4343,-27,28,0,156,156,1666
1982,11,c) 2,895,913,7923,8576,60,6.1,172,17.6,1741,550,1191,6.4,20.3,3046,1161,1885,13.5,35.5,-1305,-15.2,40.6,0,104,104,673
1982,11,d) 3,774,795,6944,7402,53,6.2,149,17.5,1180,366,814,4.9,15.9,2095,979,1116,13.2,28.3,-915,-12.4,31.8,0,99,99,603
1982,11,e) 4,739,780,9808,9694,55,6.7,136,16.5,2530,1120,1410,11.6,26.1,2301,849,1452,8.8,23.7,229,2.4,47.4,0,83,83,553
1982,11,f) 5,852,993,27630,27086,90,8.8,141,13.8,4231,805,3426,3,15.6,3143,962,2181,3.6,11.6,1088,4,23.2,0,64,64,479
1982,11,l) Left Censored,7680,9488,258910,263218,595,6.2,895,9.3,38660,19142,19518,7.3,14.7,47275,12595,34680,4.8,18,-8615,-3.3,29.4,0,389,393,4018
1982,12,a) 0,29701,30377,186362,93779,30193,198.8,0,0,185166,185166,0,197.4,197.4,0,0,0,0,0,185166,197.4,0,0,,,
1982,12,b) 1,21659,22220,160164,168304,386,1.5,6550,25.5,43038,3998,39040,2.4,25.6,59318,31508,27810,18.7,35.2,-16280,-9.6,51.2,0,4558,4558,21985
1982,12,c) 2,17870,18400,131595,141095,1157,5.8,4272,21.3,31899,7720,24179,5.5,22.6,50898,23795,27103,16.9,36.1,-18999,-13.5,45.2,0,2724,2724,16686
1982,12,d) 3,14920,15660,125555,133370,1076,6.4,3014,18,27606,8871,18735,6.7,20.7,43236,19251,23985,14.4,32.4,-15630,-11.7,41.4,0,1941,1941,12236
1982,12,e) 4,13066,13922,112098,119294,948,6.4,2415,16.4,22972,7371,15601,6.2,19.3,37363,16749,20614,14,31.3,-14391,-12,38.6,0,1462,1462,11302
1982,12,f) 5,12472,14881,154804,159457,1177,7.6,2067,13.4,31427,11741,19686,7.4,19.7,40732,14269,26463,8.9,25.5,-9305,-5.8,39.4,0,1132,1133,7473
1982,12,l) Left Censored,75842,109504,2270121,2291383,7025,6.3,9526,8.6,340525,105806,234719,4.6,14.9,383050,102213,280837,4.5,16.7,-42525,-1.8,29.8,0,4714,4739,37948
1982,13,a) 0,10569,10871,67698,34021,10828,199.2,0,0,67354,67354,0,198,198,0,0,0,0,0,67354,198,0,0,,,
1982,13,b) 1,7697,7974,61452,64940,173,1.9,2339,25.5,15133,2234,12899,3.4,23.3,22109,11079,11030,17.1,34,-6976,-10.7,46.6,0,1639,1639,8034
1982,13,c) 2,6523,6810,51136,53986,414,5.6,1500,20.2,11845,3206,8639,5.9,21.9,17544,7859,9685,14.6,32.5,-5699,-10.6,43.8,0,946,946,5393
1982,13,d) 3,5880,6171,48756,50558,389,5.9,1181,17.9,10796,3125,7671,6.2,21.4,14399,6414,7985,12.7,28.5,-3603,-7.1,42.8,0,746,746,4278
1982,13,e) 4,5337,5671,45938,48240,436,7.3,999,16.6,10484,5058,5426,10.5,21.7,15087,5683,9404,11.8,31.3,-4603,-9.6,43.4,0,611,611,3383
1982,13,f) 5,5518,6531,65711,66713,468,6.9,922,13.6,12825,3574,9251,5.4,19.2,14828,6125,8703,9.2,22.2,-2003,-3,38.4,0,499,499,2971
1982,13,l) Left Censored,41106,59558,1425672,1428204,3489,5.7,5551,9.1,206135,80099,126036,5.6,14.4,211199,61030,150169,4.3,14.8,-5064,-0.4,28.8,0,2413,2418,18204
1982,15,a) 0,2164,2236,13846,6968,2220,198.6,0,0,13756,13756,0,197.4,197.4,0,0,0,0,0,13756,197.4,0,0,,,
1982,15,b) 1,1794,1854,16172,16438,49,2.3,508,24,4445,1108,3337,6.7,27,4977,2399,2578,14.6,30.3,-532,-3.3,54,0,335,335,1611
1982,15,c) 2,1529,1610,18368,16441,117,6.8,318,18.5,8294,6436,1858,39.1,50.4,4439,1778,2661,10.8,27,3855,23.4,54,0,203,203,1322
1982,15,d) 3,1283,1347,12133,12996,78,5.4,247,17.1,1964,612,1352,4.7,15.1,3689,1357,2332,10.4,28.4,-1725,-13.3,30.2,0,156,156,828
1982,15,e) 4,1107,1175,10574,10454,94,7.6,195,15.8,2537,956,1581,9.1,24.3,2296,1059,1237,10.1,22,241,2.3,44,0,118,118,494
1982,15,f) 5,1091,1456,14774,14936,115,7.7,168,11.2,2477,817,1660,5.5,16.6,2801,1115,1686,7.5,18.8,-324,-2.2,33.2,0,80,80,574
1982,15,l) Left Censored,8306,11416,228286,233023,619,5.3,944,8.1,27061,9982,17079,4.3,11.6,36535,11174,25361,4.8,15.7,-9474,-4.1,23.2,0,463,463,3577
1982,16,a) 0,2116,2169,25245,12643,2155,198.7,0,0,25204,25204,0,199.4,199.4,0,0,0,0,0,25204,199.4,0,0,,,
1982,16,b) 1,1576,1611,9969,10577,34,1.8,489,26.2,2789,513,2276,4.9,26.4,4004,1867,2137,17.7,37.9,-1215,-11.5,52.8,0,317,317,1149
1982,16,c) 2,1439,1472,10265,10989,97,6,358,22.1,2143,861,1282,7.8,19.5,3590,1744,1846,15.9,32.7,-1447,-13.2,39,0,226,226,1177
1982,16,d) 3,1335,1410,10072,10977,95,6.2,294,19.3,2004,733,1271,6.7,18.3,3814,1351,2463,12.3,34.7,-1810,-16.4,36.6,0,179,179,851
1982,16,e) 4,1170,1191,8721,9479,63,4.9,223,17.3,1242,366,876,3.9,13.1,2757,1206,1551,12.7,29.1,-1515,-16,26.2,0,131,131,856
1982,16,f) 5,1088,1264,10617,11302,96,7.2,225,16.8,1644,464,1180,4.1,14.5,3014,1310,1704,11.6,26.7,-1370,-12.2,29,0,119,120,723
1982,16,l) Left Censored,7744,10427,168231,183597,623,5.8,1002,9.4,17792,5357,12435,2.9,9.7,48523,8293,40230,4.5,26.4,-30731,-16.7,19.4,0,437,437,2696
1982,17,a) 0,18156,18600,141692,71402,18475,198.7,0,0,140580,140580,0,196.9,196.9,0,0,0,0,0,140580,196.9,0,0,,,
1982,17,b) 1,13900,14314,115592,118361,314,2,3329,20.8,29432,4655,24777,3.9,24.9,34971,16914,18057,14.3,29.5,-5539,-4.6,49.8,0,2275,2275,11521
1982,17,c) 2,12406,12782,90075,95573,741,5.4,2375,17.4,19732,5491,14241,5.7,20.6,30727,14138,16589,14.8,32.2,-10995,-11.6,41.2,0,1615,1616,9720
1982,17,d) 3,11047,11488,86416,90345,688,5.6,1907,15.6,17761,5127,12634,5.7,19.7,25618,10917,14701,12.1,28.4,-7857,-8.7,39.4,0,1250,1251,6370
1982,17,e) 4,10323,10856,80657,84065,674,5.9,1647,14.4,14457,4712,9745,5.6,17.2,21273,8360,12913,9.9,25.3,-6816,-8.1,34.4,0,1043,1043,5646
1982,17,f) 5,10834,12977,140053,142823,831,6.2,1713,12.7,23500,7178,16322,5,16.5,29039,12221,16818,8.6,20.3,-5539,-3.8,33,0,905,906,4810
1982,17,l) Left Censored,97662,126461,3237176,3324034,6619,5.1,11386,8.8,362142,122227,239915,3.7,10.9,535858,143829,392029,4.3,16.1,-173716,-5.2,21.8,0,5722,5739,41671
1982,18,a) 0,7953,8163,47400,23910,8106,198.6,0,0,46980,46980,0,196.5,196.5,0,0,0,0,0,46980,196.5,0,0,,,
1982,18,b) 1,6019,6238,53251,55405,131,1.9,1616,22.9,11523,1997,9526,3.6,20.8,15831,7797,8034,14.1,28.6,-4308,-7.8,41.6,0,1181,1183,5909
1982,18,c) 2,5545,5703,36400,38720,276,4.5,1007,16.5,7243,2138,5105,5.5,18.7,11883,4849,7034,12.5,30.7,-4640,-12,37.4,0,745,746,3575
1982,18,d) 3,5244,5452,36429,38078,295,5.1,903,15.6,7054,1880,5174,4.9,18.5,10352,4192,6160,11,27.2,-3298,-8.7,37,0,602,605,2957
1982,18,e) 4,4760,5045,41677,42076,323,6,878,16.4,10852,6424,4428,15.3,25.8,11650,4998,6652,11.9,27.7,-798,-1.9,51.6,0,555,558,2984
1982,18,f) 5,4952,6003,61313,62218,353,5.7,757,12.1,9970,2896,7074,4.7,16,11780,3978,7802,6.4,18.9,-1810,-2.9,32,0,449,450,2316
1982,18,l) Left Censored,44319,60453,1428102,1462105,3188,5.2,4973,8.1,143939,41894,102045,2.9,9.8,211945,50323,161622,3.4,14.5,-68006,-4.7,19.6,0,2494,2504,16123
1982,19,a) 0,4997,5085,28493,14325,5054,198.8,0,0,28337,,,,197.8,0,0,0,0,0,28337,197.8,0,1,,,
1982,19,b) 1,4076,4219,30018,32594,94,1.9,1197,24.7,6323,1369,4954,4.2,19.4,11477,5294,6183,16.2,35.2,-5154,-15.8,38.8,0,837,837,3987
1982,19,c) 2,3728,3816,21650,23633,174,4.2,757,18.1,3695,1017,2678,4.3,15.6,7661,3604,4057,15.2,32.4,-3966,-16.8,31.2,0,533,533,2475
1982,19,d) 3,3328,3531,23971,25696,191,5,621,16.4,4304,1679,2625,6.5,16.7,7754,3481,4273,13.5,30.2,-3450,-13.5,33.4,0,422,422,2055
1982,19,e) 4,3299,3496,54086,40124,195,5.2,616,16.4,34873,,,,86.9,6948,2597,4351,6.5,17.3,27925,69.6,34.6,1,369,369,1537
1982,19,f) 5,3538,4211,35922,36430,289,6.6,562,12.8,6615,2009,4606,5.5,18.2,7630,2692,4938,7.4,20.9,-1015,-2.7,36.4,0,311,311,1331
1982,19,l) Left Censored,29384,38575,674308,689435,1815,4.6,3522,8.9,72866,19954,52912,2.9,10.6,103119,27605,75514,4,15,-30253,-4.4,21.2,0,1814,1815,9322
1982,20,a) 0,5140,5253,30881,15490,5223,198.9,0,0,30783,30783,0,198.7,198.7,0,0,0,0,0,30783,198.7,0,0,,,
1982,20,b) 1,3940,4085,29040,30471,106,2.3,1126,24.1,7635,1556,6079,5.1,25.1,10497,6122,4375,20.1,34.4,-2862,-9.3,50.2,0,839,839,4918
1982,20,c) 2,3195,3303,21848,23108,225,6.3,660,18.6,4894,1542,3352,6.7,21.2,7413,3425,3988,14.8,32.1,-2519,-10.9,42.4,0,469,469,2548
1982,20,d) 3,2976,3079,20497,21777,196,5.9,567,17.2,4287,1650,2637,7.6,19.7,6846,3164,3682,14.5,31.4,-2559,-11.7,39.4,0,378,378,2257
1982,20,e) 4,2752,2863,18713,19863,156,5.1,485,15.9,3400,952,2448,4.8,17.1,5700,2408,3292,12.1,28.7,-2300,-11.6,34.2,0,310,310,1582
1982,20,f) 5,2977,3575,32850,33385,266,7.2,480,12.9,6523,2603,3920,7.8,19.5,7593,3794,3799,11.4,22.7,-1070,-3.2,39,0,273,273,1425
1982,20,l) Left Censored,24139,31363,593171,597822,1624,5,2951,9.2,74623,18357,56266,3.1,12.5,83924,24821,59103,4.2,14,-9301,-1.5,25,0,1457,1479,9509
1982,21,a) 0,5855,5965,39425,19838,5928,198.8,0,0,39174,39174,0,197.5,197.5,0,0,0,0,0,39174,197.5,0,0,,,
1982,21,b) 1,4124,4249,30942,32137,98,2,1133,23.5,7765,1067,6698,3.3,24.2,10154,5089,5065,15.8,31.6,-2389,-7.4,48.4,0,834,834,3448
1982,21,c) 2,3477,3582,25238,26662,248,6.4,802,20.6,5478,1846,3632,6.9,20.5,8326,4178,4148,15.7,31.2,-2848,-10.7,41,0,544,544,2784
1982,21,d) 3,3355,3483,29035,30575,237,6.4,661,17.8,5035,1426,3609,4.7,16.5,8114,3472,4642,11.4,26.5,-3079,-10,33,0,415,415,2410
1982,21,e) 4,3101,3206,23938,25078,206,6,580,17,4960,1738,3222,6.9,19.8,7239,3242,3997,12.9,28.9,-2279,-9.1,39.6,0,362,362,2073
1982,21,f) 5,3150,3666,31976,32763,247,6.4,538,14,5861,2101,3760,6.4,17.9,7434,3523,3911,10.8,22.7,-1573,-4.8,35.8,0,310,313,2009
1982,21,l) Left Censored,27036,36007,764113,771586,1840,5,3212,8.7,98965,28777,70188,3.7,12.8,113912,27716,86196,3.6,14.8,-14947,-2,25.6,0,1701,1701,9028
1982,22,a) 0,9241,9493,59640,30140,9442,198.9,0,0,59000,59000,0,195.8,195.8,0,0,0,0,0,59000,195.8,0,0,,,
1982,22,b) 1,6647,6819,61540,61615,133,1.7,1638,21.4,18719,1631,17088,2.6,30.4,18869,8313,10556,13.5,30.6,-150,-0.2,60.8,0,1175,1175,5984
1982,22,c) 2,5489,5665,54156,54582,367,6.1,1061,17.5,14485,2897,11588,5.3,26.5,15337,7010,8327,12.8,28.1,-852,-1.6,53,0,655,660,4470
1982,22,d) 3,5143,5469,52989,54503,391,6.8,900,15.7,12688,4080,8608,7.5,23.3,15715,6224,9491,11.4,28.8,-3027,-5.5,46.6,0,568,568,3965
1982,22,e) 4,4129,4223,46219,45145,227,5.1,686,15.3,13645,2068,11577,4.6,30.2,11496,4571,6925,10.1,25.5,2149,4.7,51,0,422,422,2916
1982,22,f) 5,3941,4717,54077,54333,371,7.6,606,12.5,11780,4171,7609,7.7,21.7,12291,4336,7955,8,22.6,-511,-0.9,43.4,0,329,329,2403
1982,22,l) Left Censored,31168,42930,987843,997428,2331,5.3,3771,8.6,147286,42065,105221,4.2,14.8,166455,52328,114127,5.2,16.7,-19169,-1.9,29.6,0,1773,1785,19212
1982,23,a) 0,1980,2021,11982,6010,2006,198.5,0,0,11944,11944,0,198.7,198.7,0,0,0,0,0,11944,198.7,0,0,,,
1982,23,b) 1,1584,1643,11167,11306,37,2,432,23.1,2876,764,2112,6.8,25.4,3153,1703,1450,15.1,27.9,-277,-2.5,50.8,0,290,290,1322
1982,23,c) 2,1398,1443,9530,9635,90,5.8,253,16.4,2055,498,1557,5.2,21.3,2264,991,1273,10.3,23.5,-209,-2.2,42.6,0,166,166,681
1982,23,d) 3,1319,1350,9474,10141,72,5,256,17.6,1650,335,1315,3.3,16.3,2984,1219,1765,12,29.4,-1334,-13.1,32.6,0,162,162,803
1982,23,e) 4,1280,1354,8919,9206,85,6,198,13.9,1730,506,1224,5.5,18.8,2304,822,1482,8.9,25,-574,-6.2,37.6,0,118,118,585
1982,23,f) 5,1268,1500,14735,14646,83,5.3,208,13.2,2497,374,2123,2.6,17,2319,929,1390,6.3,15.8,178,1.2,31.6,0,119,119,420
1982,23,l) Left Censored,10242,12943,248076,251449,631,4.8,1134,8.6,30891,9510,21381,3.8,12.3,37637,13761,23876,5.5,15,-6746,-2.7,24.6,0,589,596,6118
1982,24,a) 0,6789,6983,46716,23456,6936,198.7,0,0,46521,46521,0,198.3,198.3,0,0,0,0,0,46521,198.3,0,0,,,
1982,24,b) 1,5189,5334,43095,43257,105,1.8,1261,21,10975,1214,9761,2.8,25.4,11299,5533,5766,12.8,26.1,-324,-0.7,50.8,0,857,857,3986
1982,24,c) 2,4446,4571,36091,36879,304,6.2,863,17.6,8628,2709,5919,7.3,23.4,10203,4218,5985,11.4,27.7,-1575,-4.3,46.8,0,573,573,2822
1982,24,d) 3,4076,4236,34406,35192,290,6.5,689,15.4,7486,1926,5560,5.5,21.3,9058,3956,5102,11.2,25.7,-1572,-4.4,42.6,0,426,426,2594
1982,24,e) 4,3618,3850,32049,32190,299,7.4,597,14.8,7008,2945,4063,9.1,21.8,7290,2633,4657,8.2,22.6,-282,-0.8,43.6,0,367,367,1637
1982,24,f) 5,3921,4677,51674,52463,325,6.7,573,11.9,9797,2948,6849,5.6,18.7,11374,4518,6856,8.6,21.7,-1577,-3,37.4,0,298,298,2414
1982,24,l) Left Censored,32794,44357,1034589,1046092,2590,5.7,3720,8.3,136969,46513,90456,4.4,13.1,159975,44095,115880,4.2,15.3,-23006,-2.2,26.2,0,1743,1745,13494
1982,25,a) 0,9656,9924,82346,47529,9872,199,0,0,69634,69634,0,146.5,146.5,0,0,0,0,0,69634,146.5,0,0,,,
1982,25,b) 1,7415,7604,68953,70220,147,1.7,1573,18.7,15783,2022,13761,2.9,22.5,18317,8633,9684,12.3,26.1,-2534,-3.6,45,0,1031,1031,5929
1982,25,c) 2,6580,6728,50020,51627,364,5.1,1010,14.2,11242,2812,8430,5.4,21.8,14455,6488,7967,12.6,28,-3213,-6.2,43.6,0,649,649,4076
1982,25,d) 3,6037,6318,51880,51944,382,5.8,891,13.5,12517,3308,9209,6.4,24.1,12644,5578,7066,10.7,24.3,-127,-0.2,48.2,0,555,555,3657
1982,25,e) 4,5422,5784,54966,55297,356,5.9,793,13.1,11104,3183,7921,5.8,20.1,11766,4539,7227,8.2,21.3,-662,-1.2,40.2,0,477,477,3122
1982,25,f) 5,5687,6896,102677,102875,480,6.8,795,11.2,16709,5069,11640,4.9,16.2,17105,6066,11039,5.9,16.6,-396,-0.4,32.4,0,419,421,3194
1982,25,l) Left Censored,57291,72036,1914466,1920184,3636,5,5479,7.5,227604,65160,162444,3.4,11.9,239040,62371,176669,3.2,12.4,-11436,-0.5,23.8,0,2819,2823,21312
1982,26,a) 0,12686,13052,78015,39342,12973,198.8,0,0,77346,77346,0,196.6,196.6,0,0,0,0,0,77346,196.6,0,0,,,
1982,26,b) 1,10065,10400,78082,80838,235,2,2511,21.5,17352,2277,15075,2.8,21.5,22863,10734,12129,13.3,28.3,-5511,-6.8,43,0,1683,1683,7240
1982,26,c) 2,8634,8938,59248,63662,587,6.1,1903,19.7,12582,3672,8910,5.8,19.8,21409,10897,10512,17.1,33.6,-8827,-13.8,39.6,0,1160,1160,6644
1982,26,d) 3,8410,8810,93881,97114,582,6.2,1522,16.3,12987,4844,8143,5,13.4,19453,8733,10720,9,20,-6466,-6.6,26.8,0,946,946,5373
1982,26,e) 4,7679,8095,60005,63413,563,6.6,1381,16.1,12056,5522,6534,8.7,19,18872,8115,10757,12.8,29.8,-6816,-10.8,38,0,821,822,5303
1982,26,f) 5,7944,9636,94606,96189,631,6.3,1265,12.6,16537,4935,11602,5.1,17.2,19703,7689,12014,8,20.5,-3166,-3.3,34.4,0,690,692,4397
1982,26,l) Left Censored,67232,91222,2171417,2245796,4709,5,8111,8.7,230445,66320,164125,3,10.3,379202,100695,278507,4.5,16.9,-148757,-6.6,20.6,0,3914,3924,26919
1982,27,a) 0,6981,7192,46179,23163,7146,198.7,0,0,46032,46032,0,198.7,198.7,0,0,0,0,0,46032,198.7,0,0,,,
1982,27,b) 1,5678,5849,50163,51523,128,2,1373,20.9,10953,1391,9562,2.7,21.3,13673,6223,7450,12.1,26.5,-2720,-5.2,42.6,0,927,927,4358
1982,27,c) 2,5099,5273,35729,38011,283,5,953,16.8,7417,2210,5207,5.8,19.5,11981,4649,7332,12.2,31.5,-4564,-12,39,0,599,599,3206
1982,27,d) 3,4858,5111,37493,39683,315,5.8,877,16.1,7540,2322,5218,5.9,19,11920,5190,6730,13.1,30,-4380,-11,38,0,562,562,3338
1982,27,e) 4,4407,4674,38254,39873,277,5.6,737,14.9,6649,2222,4427,5.6,16.7,9887,3463,6424,8.7,24.8,-3238,-8.1,33.4,0,466,466,2199
1982,27,f) 5,4570,5462,59066,60403,387,6.9,653,11.6,10888,3305,7583,5.5,18,13561,4410,9151,7.3,22.5,-2673,-4.5,36,0,336,337,2429
1982,27,l) Left Censored,37085,48620,1167287,1190740,2353,4.7,3929,7.9,138061,39033,99028,3.3,11.6,184966,45798,139168,3.8,15.5,-46905,-3.9,23.2,0,1911,1920,12978
1982,28,a) 0,4003,4073,20632,10467,4050,198.9,0,0,20330,20330,0,194.2,194.2,0,0,0,0,0,20330,194.2,0,0,,,
1982,28,b) 1,2995,3077,22835,23464,67,1.9,913,25.7,5463,842,4621,3.6,23.3,6721,3320,3401,14.1,28.6,-1258,-5.3,46.6,0,677,677,2535
1982,28,c) 2,2719,2790,19200,20388,176,5.8,616,20.2,4035,1298,2737,6.4,19.8,6411,3505,2906,17.2,31.4,-2376,-11.6,39.6,0,397,397,2238
1982,28,d) 3,2514,2624,19516,19987,197,7,519,18.4,4751,1543,3208,7.7,23.8,5693,2574,3119,12.9,28.5,-942,-4.7,47.6,0,335,335,1561
1982,28,e) 4,2094,2189,16718,17460,153,6.5,399,17,2899,1309,1590,7.5,16.6,4383,1924,2459,11,25.1,-1484,-8.5,33.2,0,250,250,983
1982,28,f) 5,2347,2805,24081,24748,168,5.7,397,13.4,3898,1263,2635,5.1,15.8,5232,1949,3283,7.9,21.1,-1334,-5.3,31.6,0,216,216,769
1982,28,l) Left Censored,17999,24080,460797,473110,1125,4.5,2162,8.7,46702,15266,31436,3.2,9.9,71328,19792,51536,4.2,15.1,-24626,-5.2,19.8,0,1082,1084,6245
1982,29,a) 0,8546,8753,52719,26562,8689,198.5,0,0,52315,,,,197,0,0,0,0,0,52315,197,0,1,,,
1982,29,b) 1,6811,7085,53487,56321,193,2.4,1915,23.7,12880,2747,10133,4.9,22.9,18547,9982,8565,17.7,32.9,-5667,-10,45.8,0,1362,1362,7136
1982,29,c) 2,5632,5840,38561,40355,381,6,1221,19.3,8899,3243,5656,8,22.1,12487,5973,6514,14.8,30.9,-3588,-8.8,44.2,0,856,857,4382
1982,29,d) 3,5407,5651,41655,43648,410,6.8,991,16.5,8541,2333,6208,5.3,19.6,12526,4956,7570,11.4,28.7,-3985,-9.1,39.2,0,658,658,3443
1982,29,e) 4,4779,5007,71517,56498,349,6.5,950,17.7,42062,,,,74.4,12023,5077,6946,9,21.3,30039,53.1,42.6,1,611,611,3717
1982,29,f) 5,5022,5935,58248,59143,414,6.7,863,13.9,10958,4669,6289,7.9,18.5,12747,5297,7450,9,21.6,-1789,-3.1,37,0,456,456,2229
1982,29,l) Left Censored,42643,57246,1339922,1350927,2870,4.9,5354,9.1,168774,51912,116862,3.8,12.5,190784,55126,135658,4.1,14.1,-22010,-1.6,25,0,2578,2596,16490
1982,30,a) 0,2171,2205,11065,5575,2192,198.8,0,0,10980,10980,0,197,197,0,0,0,0,0,10980,197,0,0,,,
1982,30,b) 1,1658,1696,10918,11150,29,1.5,502,25.7,3295,194,3101,1.7,29.6,3758,1858,1900,16.7,33.7,-463,-4.1,59.2,0,337,337,1357
1982,30,c) 2,1516,1542,10725,11149,96,5.7,322,19.2,2589,895,1694,8,23.2,3437,1550,1887,13.9,30.8,-848,-7.6,46.4,0,209,209,1144
1982,30,d) 3,1454,1536,9945,10488,92,5.5,305,18.4,2104,718,1386,6.8,20.1,3190,1275,1915,12.2,30.4,-1086,-10.3,40.2,0,187,187,843
1982,30,e) 4,1184,1208,7882,8467,62,4.8,222,17.1,1492,475,1017,5.6,17.6,2662,1186,1476,14,31.4,-1170,-13.8,35.2,0,126,126,832
1982,30,f) 5,1186,1361,10761,11014,81,5.6,202,14,1979,619,1360,5.6,18,2484,1017,1467,9.2,22.6,-505,-4.6,36,0,103,103,563
1982,30,l) Left Censored,7890,10080,138224,141108,502,4.8,948,9.1,18682,6260,12422,4.4,13.2,24450,6767,17683,4.8,17.3,-5768,-4.1,26.4,0,471,474,3271
1982,31,a) 0,3109,3188,17898,8989,3164,198.5,0,0,17818,17818,0,198.2,198.2,0,0,0,0,0,17818,198.2,0,0,,,
1982,31,b) 1,2486,2564,15375,18728,57,2,659,22.6,2974,533,2441,2.8,15.9,9679,3261,6418,17.4,51.7,-6705,-35.8,31.8,0,449,449,2192
1982,31,c) 2,2222,2262,13377,14554,129,5.3,408,16.8,2519,719,1800,4.9,17.3,4872,2104,2768,14.5,33.5,-2353,-16.2,34.6,0,295,295,1515
1982,31,d) 3,2057,2120,13589,14152,85,3.7,331,14.6,2408,545,1863,3.9,17,3533,1347,2186,9.5,25,-1125,-8,34,0,224,224,872
1982,31,e) 4,1870,1943,15042,15846,94,4.5,321,15.4,2257,702,1555,4.4,14.2,3865,1422,2443,9,24.4,-1608,-10.2,28.4,0,193,193,939
1982,31,f) 5,2022,2330,18131,18789,154,6.3,326,13.3,3031,1119,1912,6,16.1,4347,1812,2535,9.6,23.1,-1316,-7,32.2,0,193,196,994
1982,31,l) Left Censored,16815,21383,384659,389299,1052,4.8,1845,8.4,44008,13005,31003,3.3,11.3,53288,15011,38277,3.9,13.7,-9280,-2.4,22.6,0,994,994,5670
1982,32,a) 0,2526,2583,21863,11314,2569,198.9,0,0,21098,21098,0,186.5,186.5,0,0,0,0,0,21098,186.5,0,0,,,
1982,32,b) 1,1877,1926,15643,16188,47,2.1,624,27.8,4953,887,4066,5.5,30.6,6042,2908,3134,18,37.3,-1089,-6.7,61.2,0,440,440,2155
1982,32,c) 2,1578,1622,15818,17082,117,6.5,417,23.3,3755,985,2770,5.8,22,6283,2742,3541,16.1,36.8,-2528,-14.8,44,0,240,241,1424
1982,32,d) 3,1527,1590,15991,16596,138,8.2,298,17.7,4365,2629,1736,15.8,26.3,5575,1952,3623,11.8,33.6,-1210,-7.3,52.6,0,170,170,1112
1982,32,e) 4,1121,1169,11578,12127,81,6.5,191,15.4,2260,409,1851,3.4,18.6,3357,1283,2074,10.6,27.7,-1097,-9.1,37.2,0,117,117,928
1982,32,f) 5,1040,1241,15980,17681,93,7.2,189,14.6,3518,776,2742,4.4,19.9,6920,2082,4838,11.8,39.1,-3402,-19.2,39.8,0,89,89,1477
1982,32,l) Left Censored,6266,8533,241429,244167,647,7.5,786,9.1,36664,11739,24925,4.8,15,42139,12537,29602,5.1,17.3,-5475,-2.3,30,0,349,349,3539
1982,33,a) 0,2074,2097,11213,5634,2086,199,0,0,11159,11159,0,198.1,198.1,0,0,0,0,0,11159,198.1,0,0,,,
1982,33,b) 1,1595,1624,12606,12426,28,1.5,377,20.7,3881,205,3676,1.6,31.2,3520,1840,1680,14.8,28.3,361,2.9,56.6,0,251,251,1328
1982,33,c) 2,1320,1350,8899,9111,101,7,264,18.2,2284,635,1649,7,25.1,2708,1376,1332,15.1,29.7,-424,-4.6,50.2,0,187,187,1028
1982,33,d) 3,1316,1357,10517,10487,73,5.1,196,13.7,2340,544,1796,5.2,22.3,2279,890,1389,8.5,21.7,61,0.6,43.4,0,130,130,579
1982,33,e) 4,1210,1263,9329,9833,80,6,182,13.7,1941,459,1482,4.7,19.7,2949,1393,1556,14.2,30,-1008,-10.3,39.4,0,103,103,740
1982,33,f) 5,1219,1436,15169,15127,111,7.5,172,11.6,2493,600,1893,4,16.5,2408,1116,1292,7.4,15.9,85,0.6,31.8,0,99,99,869
1982,33,l) Left Censored,9169,11176,262285,264143,568,5,987,8.6,30264,9234,21030,3.5,11.5,33980,10167,23813,3.8,12.9,-3716,-1.4,23,0,510,511,3815
1982,34,a) 0,14006,14262,81583,41102,14156,198.5,0,0,80962,80962,0,197,197,0,0,0,0,0,80962,197,0,0,,,
1982,34,b) 1,10668,10890,87708,85791,160,1.3,2484,20.4,26920,3307,23613,3.9,31.4,23085,10683,12402,12.5,26.9,3835,4.5,53.8,0,1616,1616,7178
1982,34,c) 2,9597,9762,68072,68534,571,5.5,1575,15.2,17368,3514,13854,5.1,25.3,18291,7209,11082,10.5,26.7,-923,-1.4,50.6,0,1047,1049,5237
1982,34,d) 3,8675,8880,63715,65483,529,5.7,1362,14.6,13275,3564,9711,5.4,20.3,16811,6159,10652,9.4,25.7,-3536,-5.4,40.6,0,839,839,4187
1982,34,e) 4,7630,7929,57782,57908,505,6.1,1129,13.6,13540,4921,8619,8.5,23.4,13791,4914,8877,8.5,23.8,-251,-0.4,46.8,0,682,682,3159
1982,34,f) 5,8180,9022,87298,87276,599,6.4,1211,12.9,18686,5293,13393,6.1,21.4,18642,7990,10652,9.2,21.4,44,0,42.8,0,671,671,4006
1982,34,l) Left Censored,72909,90269,2127027,2142058,4124,4.5,7778,8.4,285950,75121,210829,3.5,13.3,316013,103658,212355,4.8,14.8,-30063,-1.5,26.6,0,3956,3963,26364
1982,35,a) 0,3132,3188,20227,10225,3156,198,0,0,20005,20005,0,195.6,195.6,0,0,0,0,0,20005,195.6,0,0,,,
1982,35,b) 1,2409,2507,18190,18672,75,2.6,674,23.7,5416,884,4532,4.7,29,6380,3322,3058,17.8,34.2,-964,-5.2,58,0,488,488,2512
1982,35,c) 2,2096,2143,16435,17178,131,5.6,470,20.2,4200,1137,3063,6.6,24.4,5685,2940,2745,17.1,33.1,-1485,-8.7,48.8,0,301,301,2146
1982,35,d) 3,1916,2039,15955,16567,138,6.4,365,16.9,3615,879,2736,5.3,21.8,4839,1990,2849,12,29.2,-1224,-7.4,43.6,0,227,227,1167
1982,35,e) 4,1542,1584,12466,12560,78,4.6,262,15.5,3085,702,2383,5.6,24.6,3273,1568,1705,12.5,26.1,-188,-1.5,49.2,0,163,163,1125
1982,35,f) 5,1533,1785,15333,15561,134,7.2,251,13.5,3140,733,2407,4.7,20.2,3596,1544,2052,9.9,23.1,-456,-2.9,40.4,0,143,143,858
1982,35,l) Left Censored,9924,13343,241861,243911,837,6.2,1209,8.9,33853,9502,24351,3.9,13.9,37953,11747,26206,4.8,15.6,-4100,-1.7,27.8,0,565,565,3444
1982,36,a) 0,32562,33106,206178,104115,32878,198.6,0,0,204126,204126,0,196.1,196.1,0,0,0,0,0,204126,196.1,0,0,,,
1982,36,b) 1,24958,25430,197140,198802,333,1.2,5621,19.8,49681,4160,45521,2.1,25,53005,25293,27712,12.7,26.7,-3324,-1.7,50,0,3745,3745,17882
1982,36,c) 2,21537,21927,166783,167907,1156,4.9,3807,16.3,41589,7447,34142,4.4,24.8,43837,21050,22787,12.5,26.1,-2248,-1.3,49.6,0,2566,2566,14545
1982,36,d) 3,19578,20113,139176,143592,1085,5.1,3081,14.5,29843,6794,23049,4.7,20.8,38674,17631,21043,12.3,26.9,-8831,-6.1,41.6,0,2030,2030,12179
1982,36,e) 4,18025,18709,154386,151197,989,5,2773,14,43418,13815,29603,9.1,28.7,37039,14794,22245,9.8,24.5,6379,4.2,49,0,1775,1775,10530
1982,36,f) 5,18374,20974,227119,224851,1359,6.2,2782,12.8,46472,17230,29242,7.7,20.7,41936,16590,25346,7.4,18.7,4536,2,37.4,0,1542,1548,8182
1982,36,l) Left Censored,175114,213152,4880454,4912099,9016,4.1,18817,8.6,604002,173427,430575,3.5,12.3,667292,201266,466026,4.1,13.6,-63290,-1.3,24.6,0,10425,10448,66993
1982,37,a) 0,10376,10607,60435,30302,10543,198.8,0,0,60266,60266,0,198.9,198.9,0,0,0,0,0,60266,198.9,0,0,,,
1982,37,b) 1,7611,7835,61259,63320,151,1.7,2175,24.2,15213,3197,12016,5,24,19334,9885,9449,15.6,30.5,-4121,-6.5,48,0,1615,1615,7097
1982,37,c) 2,6480,6681,45582,48133,320,4.4,1309,18.1,9363,1933,7430,4,19.5,14465,6801,7664,14.1,30.1,-5102,-10.6,39,0,969,969,5132
1982,37,d) 3,6101,6376,45938,48103,403,5.9,1106,16.3,9070,2812,6258,5.8,18.9,13400,5570,7830,11.6,27.9,-4330,-9,37.8,0,732,732,3478
1982,37,e) 4,5710,5974,62445,54937,351,5.6,908,14.4,26349,16162,10187,29.4,48,11333,4197,7136,7.6,20.6,15016,27.4,41.2,0,593,593,2898
1982,37,f) 5,5580,6696,61280,62608,472,6.8,920,13.2,10676,3113,7563,5,17.1,13332,5977,7355,9.5,21.3,-2656,-4.2,34.2,0,533,533,2185
1982,37,l) Left Censored,46802,65651,1640984,1661525,3286,4.9,5393,8.1,173610,53708,119902,3.2,10.4,214693,58564,156129,3.5,12.9,-41083,-2.5,20.8,0,2848,2863,18304
1982,38,a) 0,1512,1534,8077,4046,1526,199,0,0,8062,8062,0,199.3,199.3,0,0,0,0,0,8062,199.3,0,0,,,
1982,38,b) 1,1166,1195,8835,9047,29,2.1,322,23.6,2030,270,1760,3,22.4,2454,1307,1147,14.4,27.1,-424,-4.7,44.8,0,209,209,873
1982,38,c) 2,1037,1064,6825,7136,58,5.1,183,16.1,1320,254,1066,3.6,18.5,1941,797,1144,11.2,27.2,-621,-8.7,37,0,121,121,565
1982,38,d) 3,958,992,7250,7441,53,5,180,16.9,1684,390,1294,5.2,22.6,2065,869,1196,11.7,27.8,-381,-5.2,45.2,0,106,106,611
1982,38,e) 4,846,868,5419,5599,49,5.3,132,14.3,1094,166,928,3,19.5,1454,691,763,12.3,26,-360,-6.5,39,0,79,79,469
1982,38,f) 5,884,983,7179,7435,51,4.9,131,12.6,1359,397,962,5.3,18.3,1870,889,981,12,25.2,-511,-6.9,36.6,0,64,64,517
1982,38,l) Left Censored,7113,9043,130421,130709,443,4.8,765,8.3,15694,4406,11288,3.4,12,16270,4222,12048,3.2,12.4,-576,-0.4,24,0,404,405,2154
1982,39,a) 0,14708,15147,101341,50950,15052,198.7,0,0,100782,100782,0,197.8,197.8,0,0,0,0,0,100782,197.8,0,0,,,
1982,39,b) 1,11549,11927,100305,103622,278,2.1,2923,21.7,22851,4054,18797,3.9,22.1,29485,13830,15655,13.3,28.5,-6634,-6.4,44.2,0,1975,1975,9686
1982,39,c) 2,10107,10540,73127,76440,701,6.2,1997,17.7,16329,4707,11622,6.2,21.4,22955,10636,12319,13.9,30,-6626,-8.6,42.8,0,1365,1365,7127
1982,39,d) 3,9536,9953,74004,77726,645,6.1,1715,16.2,14580,4243,10337,5.5,18.8,22023,10685,11338,13.7,28.3,-7443,-9.5,37.6,0,1090,1090,7551
1982,39,e) 4,8579,9180,71483,74174,619,6.4,1486,15.3,15161,5478,9683,7.4,20.4,20543,8129,12414,11,27.7,-5382,-7.3,40.8,0,882,882,4858
1982,39,f) 5,9346,11634,115315,115947,886,7.4,1389,11.6,23533,8011,15522,6.9,20.3,24797,8123,16674,7,21.4,-1264,-1.1,40.6,0,724,724,3487
1982,39,l) Left Censored,86891,123221,2941467,3007262,6265,5,10660,8.5,323061,98634,224427,3.3,10.7,454650,112894,341756,3.8,15.1,-131589,-4.4,21.4,0,4877,4894,33305
1982,40,a) 0,8999,9196,58661,29475,9150,199,0,0,58372,58372,0,198,198,0,0,0,0,0,58372,198,0,0,,,
1982,40,b) 1,6062,6224,57283,55888,140,2,1618,23,19575,2432,17143,4.4,35,16784,8374,8410,15,30,2791,5,60,0,1173,1173,6076
1982,40,c) 2,4928,5095,41772,43256,292,5.3,1060,19.3,12079,3025,9054,7,27.9,15047,7016,8031,16.2,34.8,-2968,-6.9,55.8,0,677,677,4285
1982,40,d) 3,4287,4517,38208,39701,305,6.4,796,16.6,9628,2877,6751,7.2,24.3,12613,6872,5741,17.3,31.8,-2985,-7.5,48.6,0,501,501,3910
1982,40,e) 4,3576,3664,32102,32674,148,3.8,578,14.8,6470,870,5600,2.7,19.8,7613,3091,4522,9.5,23.3,-1143,-3.5,39.6,0,367,367,2204
1982,40,f) 5,3335,3965,42739,42636,240,5.8,558,13.4,9909,2775,7134,6.5,23.2,9702,4425,5277,10.4,22.8,207,0.4,45.6,0,336,338,2435
1982,40,l) Left Censored,24789,33421,708540,704360,1839,5.4,3003,8.8,107650,27089,80561,3.8,15.3,99289,28110,71179,4,14.1,8361,1.2,28.2,0,1567,1567,10020
1982,41,a) 0,6373,6530,35674,17904,6488,198.7,0,0,35540,35540,0,198.5,198.5,0,0,0,0,0,35540,198.5,0,0,,,
1982,41,b) 1,5138,5292,34003,37415,125,2,1722,27.8,8079,922,7157,2.5,21.6,14903,7637,7266,20.4,39.8,-6824,-18.2,43.2,0,1181,1181,5128
1982,41,c) 2,4409,4541,52972,44313,261,5.1,1370,26.5,30244,10993,19251,24.8,68.3,12926,6697,6229,15.1,29.2,17318,39.1,58.4,0,820,820,4262
1982,41,d) 3,3858,4002,26397,29061,284,6.4,992,22.5,5141,1903,3238,6.5,17.7,10469,4342,6127,14.9,36,-5328,-18.3,35.4,0,604,604,2664
1982,41,e) 4,3432,3595,24367,26503,294,7.5,807,20.7,4939,1849,3090,7,18.6,9211,3635,5576,13.7,34.8,-4272,-16.2,37.2,0,477,477,2164
1982,41,f) 5,3391,3995,41136,42957,331,7.8,748,17.6,7432,2773,4659,6.5,17.3,11074,4722,6352,11,25.8,-3642,-8.5,34.6,0,390,392,2864
1982,41,l) Left Censored,22640,30423,561379,586309,1825,5.8,3292,10.5,61348,21433,39915,3.7,10.5,111207,29089,82118,5,19,-49859,-8.5,21,0,1480,1496,10078
1982,42,a) 0,15863,16301,109307,55227,16197,198.7,0,0,108161,108161,0,195.8,195.8,0,0,0,0,0,108161,195.8,0,0,,,
1982,42,b) 1,12237,12603,106703,108187,266,1.9,2616,18.7,24417,3670,20747,3.4,22.6,27384,13464,13920,12.4,25.3,-2967,-2.7,45.2,0,1803,1803,9409
1982,42,c) 2,11208,11536,82762,84920,663,5.4,1846,15.1,18187,4679,13508,5.5,21.4,22502,10167,12335,12,26.5,-4315,-5.1,42.8,0,1265,1265,6808
1982,42,d) 3,10594,11109,80676,83526,728,6.2,1653,14.2,16411,4583,11828,5.5,19.6,22111,10323,11788,12.4,26.5,-5700,-6.9,39.2,0,1026,1026,6852
1982,42,e) 4,9642,10239,82171,81948,740,6.9,1462,13.7,18889,8495,10394,10.4,23,18442,7625,10817,9.3,22.5,447,0.5,45,0,875,875,5192
1982,42,f) 5,10426,12469,132737,133396,940,7.3,1487,11.6,24198,7780,16418,5.8,18.1,25516,9489,16027,7.1,19.1,-1318,-1,36.2,0,770,778,4157
1982,42,l) Left Censored,100956,135306,3342011,3397935,6668,4.8,11343,8.2,404442,118472,285970,3.5,11.9,516289,134477,381812,4,15.2,-111847,-3.3,23.8,0,5732,5755,39119
1982,44,a) 0,1611,1638,8670,4346,1629,198.9,0,0,8648,8648,0,199,199,0,0,0,0,0,8648,199,0,0,,,
1982,44,b) 1,1269,1284,9501,10138,14,1,332,22.7,1906,137,1769,1.4,18.8,3180,1528,1652,15.1,31.4,-1274,-12.6,37.6,0,234,234,1134
1982,44,c) 2,1149,1174,7521,7739,80,6.5,185,15,1816,686,1130,8.9,23.5,2251,901,1350,11.6,29.1,-435,-5.6,47,0,114,114,535
1982,44,d) 3,1109,1142,8116,8373,61,5.1,161,13.5,1734,508,1226,6.1,20.7,2248,702,1546,8.4,26.8,-514,-6.1,41.4,0,106,106,461
1982,44,e) 4,974,1003,8048,8671,58,5.4,171,16,1354,311,1043,3.6,15.6,2600,1412,1188,16.3,30,-1246,-14.4,31.2,0,110,110,1056
1982,44,f) 5,1101,1210,11713,11926,70,5.6,137,10.9,1974,430,1544,3.6,16.6,2399,747,1652,6.3,20.1,-425,-3.5,33.2,0,79,79,505
1982,44,l) Left Censored,10681,12580,275371,279949,550,4.3,1075,8.3,29775,9592,20183,3.4,10.6,38931,9956,28975,3.6,13.9,-9156,-3.3,21.2,0,562,563,3656
1982,45,a) 0,5363,5472,33152,16693,5439,198.8,0,0,32919,32919,0,197.2,197.2,0,0,0,0,0,32919,197.2,0,0,,,
1982,45,b) 1,3897,4030,31171,31663,87,1.9,1109,24.1,9203,1925,7278,6.1,29.1,10186,5254,4932,16.6,32.2,-983,-3.1,58.2,0,842,842,4254
1982,45,c) 2,3326,3471,24415,26013,279,7.5,721,19.4,5379,1863,3516,7.2,20.7,8575,4259,4316,16.4,33,-3196,-12.3,41.4,0,521,521,3307
1982,45,d) 3,2978,3119,21243,21794,245,7.5,537,16.3,5032,1434,3598,6.6,23.1,6134,2562,3572,11.8,28.1,-1102,-5,46.2,0,382,382,1903
1982,45,e) 4,2860,3043,23736,24560,240,7.5,523,16.3,4678,1755,2923,7.1,19,6325,2400,3925,9.8,25.8,-1647,-6.8,38,0,320,320,1682
1982,45,f) 5,2772,3259,26147,26504,282,8.4,449,13.3,5066,1935,3131,7.3,19.1,5779,2450,3329,9.2,21.8,-713,-2.7,38.2,0,260,260,1291
1982,45,l) Left Censored,22754,31427,765496,774857,1661,5.2,2763,8.6,89974,32506,57468,4.2,11.6,108696,27141,81555,3.5,14,-18722,-2.4,23.2,0,1447,1451,11161
1982,46,a) 0,1310,1333,7431,3744,1321,198.2,0,0,7374,7374,0,197,197,0,0,0,0,0,7374,197,0,0,,,
1982,46,b) 1,1055,1078,6875,7172,13,1,301,24.1,1672,64,1608,0.9,23.3,2265,1292,973,18,31.6,-593,-8.3,46.6,0,202,202,893
1982,46,c) 2,1013,1036,5842,6268,64,5.7,196,17.5,1117,316,801,5,17.8,1969,833,1136,13.3,31.4,-852,-13.6,35.6,0,132,133,616
1982,46,d) 3,925,966,6460,6726,55,5.3,182,17.5,1314,633,681,9.4,19.5,1845,796,1049,11.8,27.4,-531,-7.9,39,0,121,121,466
1982,46,e) 4,886,907,5412,5744,50,5.1,157,16.1,1005,306,699,5.3,17.5,1668,655,1013,11.4,29,-663,-11.5,35,0,91,91,476
1982,46,f) 5,881,1011,6753,7127,78,7.3,141,13.3,1109,449,660,6.3,15.6,1856,578,1278,8.1,26,-747,-10.4,31.2,0,78,78,292
1982,46,l) Left Censored,7608,9333,128501,130599,370,3.8,765,7.9,13791,3937,9854,3,10.6,17986,5081,12905,3.9,13.8,-4195,-3.2,21.2,0,426,426,2356
1982,47,a) 0,7962,8180,51064,25629,8130,198.8,0,0,50870,50870,0,198.5,198.5,0,0,0,0,0,50870,198.5,0,0,,,
1982,47,b) 1,5611,5793,45484,48117,122,1.8,1782,26.5,10402,1209,9193,2.5,21.6,15668,7929,7739,16.5,32.6,-5266,-11,43.2,0,1313,1313,6181
1982,47,c) 2,4927,5069,36182,38311,304,5.5,1201,21.6,7796,2305,5491,6,20.3,12053,5810,6243,15.2,31.5,-4257,-11.2,40.6,0,788,788,3947
1982,47,d) 3,4572,4817,39405,41441,287,5.5,989,19,8547,2485,6062,6,20.6,12619,5782,6837,14,30.5,-4072,-9.9,41.2,0,647,647,3783
1982,47,e) 4,4107,4337,33066,35002,251,5.4,809,17.3,6222,1837,4385,5.2,17.8,10094,4290,5804,12.3,28.8,-3872,-11,35.6,0,516,516,3048
1982,47,f) 5,4354,5254,54783,55658,404,7.4,777,14.2,10289,2999,7290,5.4,18.5,12039,4587,7452,8.2,21.6,-1750,-3.1,37,0,447,448,2306
1982,47,l) Left Censored,34639,47683,1130224,1150477,2818,5.8,4343,8.9,135009,49192,85817,4.3,11.7,175515,43190,132325,3.8,15.3,-40506,-3.6,23.4,0,2107,2113,15026
1982,48,a) 0,39869,41124,269637,135344,40922,199,0,0,268586,268586,0,198.4,198.4,0,0,0,0,0,268586,198.4,0,0,,,
1982,48,b) 1,40677,42081,372271,368482,915,2,9164,19.6,117052,12093,104959,3.3,31.8,109476,53115,56361,14.4,29.7,7576,2.1,59.4,0,6890,6890,40742
1982,48,c) 2,11965,12711,107755,109879,888,6.5,2577,18.9,30722,8818,21904,8,28,34969,17615,17354,16,31.8,-4247,-3.8,56,0,1632,1632,11758
1982,48,d) 3,20357,22014,215161,218167,1517,6.6,3435,14.9,51824,12897,38927,5.9,23.8,57837,22029,35808,10.1,26.5,-6013,-2.7,47.6,0,2291,2291,14885
1982,48,e) 4,16248,17102,163527,167711,949,5.2,2701,14.9,37494,7682,29812,4.6,22.4,45861,20432,25429,12.2,27.3,-8367,-4.9,44.8,0,1614,1614,12992
1982,48,f) 5,15407,19034,221164,217422,1698,8.7,2403,12.3,53653,19174,34479,8.8,24.7,46169,17923,28246,8.2,21.2,7484,3.5,42.4,0,1346,1347,9191
1982,48,l) Left Censored,102997,158380,4030490,3985196,11634,7.3,14328,8.9,698646,253174,445472,6.4,17.5,608059,184520,423539,4.6,15.3,90587,2.2,30.6,0,6502,6518,51601
1982,49,a) 0,3185,3276,19930,10020,3249,198.4,0,0,19820,19820,0,197.8,197.8,0,0,0,0,0,19820,197.8,0,0,,,
1982,49,b) 1,2350,2454,19736,19768,66,2.3,705,25.1,6610,1191,5419,6,33.4,6673,3658,3015,18.5,33.8,-63,-0.4,66.8,0,488,488,2759
1982,49,c) 2,1923,2022,14294,15876,168,7.6,488,22.2,3579,1331,2248,8.4,22.5,6743,3118,3625,19.6,42.5,-3164,-20,45,0,311,311,2142
1982,49,d) 3,1856,1980,15762,16491,137,6.4,400,18.7,4260,1112,3148,6.7,25.8,5717,3049,2668,18.5,34.7,-1457,-8.9,51.6,0,237,237,1704
1982,49,e) 4,1565,1627,13846,14663,89,5.1,309,17.7,2889,737,2152,5,19.7,4522,1897,2625,12.9,30.8,-1633,-11.1,39.4,0,193,193,1310
1982,49,f) 5,1518,1779,17298,17453,158,8.6,258,14,3678,1501,2177,8.6,21.1,3988,1342,2646,7.7,22.8,-310,-1.7,42.2,0,145,145,802
1982,49,l) Left Censored,10589,14435,324299,326405,975,6.6,1363,9.3,43604,13087,30517,4,13.4,47815,13602,34213,4.2,14.6,-4211,-1.2,26.8,0,606,606,4389
1982,50,a) 0,1356,1374,6648,3329,1370,199.4,0,0,6638,6638,0,199.4,199.4,0,0,0,0,0,6638,199.4,0,0,,,
1982,50,b) 1,1028,1043,6325,6328,15,1.3,218,18.8,1671,208,1463,3.3,26.4,1676,827,849,13.1,26.5,-5,-0.1,52.8,0,145,145,539
1982,50,c) 2,864,874,4885,5180,43,4.6,166,17.6,901,146,755,2.8,17.4,1491,711,780,13.7,28.8,-590,-11.4,34.8,0,118,118,494
1982,50,d) 3,799,819,5603,5480,64,7.5,128,15,1469,673,796,12.3,26.8,1223,495,728,9,22.3,246,4.5,44.6,0,78,78,278
1982,50,e) 4,811,833,5521,5786,39,4.4,121,13.7,869,172,697,3,15,1398,540,858,9.3,24.2,-529,-9.2,30,0,65,65,319
1982,50,f) 5,782,899,8524,8598,57,6.1,116,12.4,1473,284,1189,3.3,17.1,1620,552,1068,6.4,18.8,-147,-1.7,34.2,0,68,68,300
1982,50,l) Left Censored,5658,6802,125004,127341,303,4.3,591,8.5,12894,2702,10192,2.1,10.1,17567,5889,11678,4.6,13.8,-4673,-3.7,20.2,0,316,329,2357
1982,51,a) 0,9092,9286,56822,28521,9226,198.7,0,0,56602,56602,0,198.5,198.5,0,0,0,0,0,56602,198.5,0,0,,,
1982,51,b) 1,6863,7107,57495,58461,201,2.5,1885,23.4,16066,3401,12665,5.8,27.5,17997,9343,8654,16,30.8,-1931,-3.3,55,0,1287,1287,7279
1982,51,c) 2,5942,6123,43647,45586,426,6.5,1249,18.9,9542,2625,6917,5.8,20.9,13419,5968,7451,13.1,29.4,-3877,-8.5,41.8,0,847,847,4404
1982,51,d) 3,5404,5696,45937,47921,444,7.4,955,15.9,9191,2657,6534,5.5,19.2,13159,4338,8821,9.1,27.5,-3968,-8.3,38.4,0,628,628,2878
1982,51,e) 4,4795,5091,42233,43847,323,6,829,15.3,8769,2821,5948,6.4,20,11997,4347,7650,9.9,27.4,-3228,-7.4,40,0,502,502,2683
1982,51,f) 5,4815,5879,65750,65724,435,7.1,804,13.2,12375,4514,7861,6.9,18.8,12323,4637,7686,7.1,18.7,52,0.1,37.4,0,455,456,2332
1982,51,l) Left Censored,40022,56825,1314463,1324731,3215,5.5,4838,8.4,184187,47846,136341,3.6,13.9,204724,51436,153288,3.9,15.5,-20537,-1.6,27.8,0,2330,2333,15866
1982,53,a) 0,9783,10029,56033,28350,9949,198.4,0,0,55366,55366,0,195.3,195.3,0,0,0,0,0,55366,195.3,0,0,,,
1982,53,b) 1,7176,7401,54474,56041,173,2,2180,25.4,15665,1693,13972,3,28,18798,8955,9843,16,33.5,-3133,-5.5,56,0,1488,1488,6321
1982,53,c) 2,6459,6666,44308,47055,493,6.8,1473,20.4,11120,3926,7194,8.3,23.6,16614,7816,8798,16.6,35.3,-5494,-11.7,47.2,0,863,863,4646
1982,53,d) 3,5690,5916,40344,43948,430,6.8,1202,18.9,8826,2885,5941,6.6,20.1,16033,6703,9330,15.3,36.5,-7207,-16.4,40.2,0,696,696,4185
1982,53,e) 4,5051,5327,43518,44188,421,7.4,1064,18.6,11452,4175,7277,9.4,25.9,12792,5062,7730,11.5,28.9,-1340,-3,51.8,0,624,624,3279
1982,53,f) 5,5122,6128,59496,61506,499,7.8,893,14,11919,4254,7665,6.9,19.4,15938,5541,10397,9,25.9,-4019,-6.5,38.8,0,466,466,3087
1982,53,l) Left Censored,33911,46204,905052,929207,2876,6.1,4153,8.8,109357,37940,71417,4.1,11.8,157666,38234,119432,4.1,17,-48309,-5.2,23.6,0,1999,2021,13217
1982,54,a) 0,2759,2818,17384,8754,2792,198.2,0,0,17261,17261,0,197.2,197.2,0,0,0,0,0,17261,197.2,0,0,,,
1982,54,b) 1,2030,2070,15870,16463,40,1.7,602,25.2,4072,699,3373,4.2,24.7,5257,2515,2742,15.3,31.9,-1185,-7.2,49.4,0,436,436,1968
1982,54,c) 2,1678,1731,11477,12444,91,4.7,414,21.6,2218,543,1675,4.4,17.8,4151,1642,2509,13.2,33.4,-1933,-15.6,35.6,0,281,281,1200
1982,54,d) 3,1583,1651,11147,12037,119,6.7,347,19.4,2293,719,1574,6,19,4072,1710,2362,14.2,33.8,-1779,-14.8,38,0,232,232,1033
1982,54,e) 4,1399,1483,11434,11873,92,5.7,297,18.3,2471,776,1695,6.5,20.8,3348,1575,1773,13.3,28.2,-877,-7.4,41.6,0,187,187,910
1982,54,f) 5,1542,1774,16765,17207,117,6.2,287,15.2,2803,1013,1790,5.9,16.3,3687,1579,2108,9.2,21.4,-884,-5.1,32.6,0,148,148,623
1982,54,l) Left Censored,14348,18869,379174,385991,960,4.9,1869,9.6,44689,12929,31760,3.3,11.6,58324,18889,39435,4.9,15.1,-13635,-3.5,23.2,0,900,901,6509
1982,55,a) 0,7419,7582,45540,22898,7532,198.7,0,0,45284,45284,0,197.8,197.8,0,0,0,0,0,45284,197.8,0,0,,,
1982,55,b) 1,5975,6145,45299,47104,122,1.8,1381,20.1,9811,2140,7671,4.5,20.8,13420,6327,7093,13.4,28.5,-3609,-7.7,41.6,0,960,960,4213
1982,55,c) 2,5291,5442,36343,37400,337,5.8,925,15.9,7932,2525,5407,6.8,21.2,10045,4063,5982,10.9,26.9,-2113,-5.7,42.4,0,652,652,3150
1982,55,d) 3,5122,5337,37599,38837,307,5.4,831,14.7,7055,2473,4582,6.4,18.2,9530,3405,6125,8.8,24.5,-2475,-6.3,36.4,0,519,519,2071
1982,55,e) 4,4985,5239,41449,42201,309,5.5,844,15.1,8200,2596,5604,6.2,19.4,9704,3775,5929,8.9,23,-1504,-3.6,38.8,0,502,502,2225
1982,55,f) 5,5027,5999,54901,55262,428,6.9,737,11.9,10222,3886,6336,7,18.5,10943,4484,6459,8.1,19.8,-721,-1.3,37,0,391,391,1836
1982,55,l) Left Censored,44357,56416,1273676,1290163,2945,5.1,4523,7.9,136750,43947,92803,3.4,10.6,169724,43036,126688,3.3,13.2,-32974,-2.6,21.2,0,2340,2349,14922
1982,56,a) 0,1735,1762,17625,8818,1754,199.1,0,0,17614,17614,0,199.8,199.8,0,0,0,0,0,17614,199.8,0,0,,,
1982,56,b) 1,1320,1353,9031,9496,28,1.8,390,25.2,2418,231,2187,2.4,25.5,3348,1766,1582,18.6,35.3,-930,-9.8,51,0,266,266,1179
1982,56,c) 2,1014,1050,8661,8945,72,6.3,248,21.6,2588,667,1921,7.5,28.9,3156,1458,1698,16.3,35.3,-568,-6.4,57.8,0,149,149,937
1982,56,d) 3,1004,1058,8395,8710,88,7.9,189,17,1953,581,1372,6.7,22.4,2583,1049,1534,12,29.7,-630,-7.3,44.8,0,114,114,606
1982,56,e) 4,838,852,7222,7696,38,4.1,167,18.1,1155,141,1014,1.8,15,2103,799,1304,10.4,27.3,-948,-12.3,30,0,93,93,463
1982,56,f) 5,752,871,8675,9153,69,7.6,127,14,1894,731,1163,8,20.7,2849,816,2033,8.9,31.1,-955,-10.4,41.4,0,76,76,352
1982,56,l) Left Censored,4735,6141,101213,103429,440,7,560,9,14969,3987,10982,3.9,14.5,19400,5035,14365,4.9,18.8,-4431,-4.3,29,0,283,283,1867
1983,01,a) 0,5908,5959,30548,15431,5838,195.9,0,0,30234,30234,0,195.9,195.9,0,0,0,0,0,30234,195.9,0,0,,,
1983,01,b) 1,4290,4436,32393,33831,23,0.4,1420,27.5,9163,410,8753,1.2,27.1,12039,6956,5083,20.6,35.6,-2876,-8.5,54.2,0,1127,1127,5770
1983,01,c) 2,3713,3858,31329,35173,120,2.8,853,20.2,5513,736,4777,2.1,15.7,13201,6664,6537,18.9,37.5,-7688,-21.8,31.4,0,681,681,3267
1983,01,d) 3,3385,3515,24139,25708,107,2.9,606,16.2,4470,393,4077,1.5,17.4,7608,4006,3602,15.6,29.6,-3138,-12.2,34.8,0,471,471,3494
1983,01,e) 4,3260,3457,33487,33782,122,3.4,534,14.7,6344,1101,5243,3.3,18.8,6933,3338,3595,9.9,20.5,-589,-1.7,37.6,0,395,395,2227
1983,01,f) 5,3127,3481,27415,28731,110,3,481,13.2,4337,592,3745,2.1,15.1,6969,2633,4336,9.2,24.3,-2632,-9.2,30.2,0,343,343,1853
1983,01,g) 6 to 10,3165,3837,37632,38354,126,3.2,437,11,5921,733,5188,1.9,15.4,7364,2517,4847,6.6,19.2,-1443,-3.8,30.8,0,256,258,1464
1983,01,l) Left Censored,25711,36005,781435,797341,1372,3.7,3052,8.3,102336,34205,68131,4.3,12.8,134148,37607,96541,4.7,16.8,-31812,-4,25.6,0,1588,1609,10597
1983,02,a) 0,1786,1803,9076,4613,1761,195.3,0,0,8926,8926,0,193.5,193.5,0,0,0,0,0,8926,193.5,0,0,,,
1983,02,b) 1,1092,1147,8554,8849,14,1.1,367,27.6,2783,68,2715,0.8,31.4,3373,1690,1683,19.1,38.1,-590,-6.7,62.8,0,261,261,1272
1983,02,c) 2,684,720,6578,6559,46,5.9,180,22.9,2060,309,1751,4.7,31.4,2022,1188,834,18.1,30.8,38,0.6,61.6,0,132,132,795
1983,02,d) 3,635,649,5147,5354,29,4.2,111,16.3,1255,142,1113,2.7,23.4,1668,856,812,16,31.2,-413,-7.8,46.8,0,75,75,514
1983,02,e) 4,632,695,5768,5670,48,6.8,90,12.7,1549,281,1268,5,27.3,1352,510,842,9,23.8,197,3.5,47.6,0,60,60,375
1983,02,f) 5,526,567,5264,5198,26,4.5,72,12.4,1453,127,1326,2.4,28,1321,425,896,8.2,25.4,132,2.6,50.8,0,51,51,260
1983,02,g) 6 to 10,544,688,7639,7756,40,5.7,70,10.1,1688,355,1333,4.6,21.8,1922,745,1177,9.6,24.8,-234,-3,43.6,0,31,31,168
1983,02,l) Left Censored,2899,4111,82257,84661,295,7.2,331,8.1,15646,5575,10071,6.6,18.5,20453,5246,15207,6.2,24.2,-4807,-5.7,37,0,147,147,1457
1983,04,a) 0,7100,7217,49627,24968,7097,196.7,0,0,49319,49319,0,197.5,197.5,0,0,0,0,0,49319,197.5,0,0,,,
1983,04,b) 1,5654,5869,41345,44768,60,0.9,1781,26.2,11519,873,10646,2,25.7,18365,9819,8546,21.9,41,-6846,-15.3,51.4,0,1338,1340,7570
1983,04,c) 2,4368,4541,34680,35947,207,4.2,1059,21.4,8544,1634,6910,4.5,23.8,11077,5801,5276,16.1,30.8,-2533,-7,47.6,0,841,841,4877
1983,04,d) 3,3993,4165,31696,32926,177,4,797,18,7016,1215,5801,3.7,21.3,9476,3998,5478,12.1,28.8,-2460,-7.5,42.6,0,629,630,3415
1983,04,e) 4,3485,3777,32575,33014,243,6.2,574,14.6,7604,1758,5846,5.3,23,8481,3423,5058,10.4,25.7,-877,-2.7,46,0,446,448,2689
1983,04,f) 5,2851,2995,25213,26034,156,5.1,373,12.1,4441,847,3594,3.3,17.1,6083,2340,3743,9,23.4,-1642,-6.3,34.2,0,286,287,1917
1983,04,g) 6 to 10,2697,3362,38957,39998,170,4.9,404,11.7,6693,1429,5264,3.6,16.7,8775,2330,6445,5.8,21.9,-2082,-5.2,33.4,0,225,227,1149
1983,04,l) Left Censored,16397,25269,579982,585103,1325,5.2,2204,8.6,90652,23643,67009,4,15.5,100893,26262,74631,4.5,17.2,-10241,-1.7,31,0,978,990,8157
1983,05,a) 0,4230,4280,21634,10897,4198,196.2,0,0,21474,21474,0,197.1,197.1,0,0,0,0,0,21474,197.1,0,0,,,
1983,05,b) 1,3151,3216,21150,22462,10,0.3,1067,28.3,4597,54,4543,0.2,20.5,7221,3898,3323,17.4,32.1,-2624,-11.6,41,0,871,872,3236
1983,05,c) 2,2660,2750,20836,21675,97,3.3,571,19.1,3853,588,3265,2.7,17.8,5530,2869,2661,13.2,25.5,-1677,-7.7,35.6,0,457,457,2445
1983,05,d) 3,2470,2587,19889,20422,110,4,422,15.5,3644,682,2962,3.3,17.8,4710,2136,2574,10.5,23.1,-1066,-5.3,35.6,0,336,336,1778
1983,05,e) 4,2517,2659,18565,19294,87,3.1,371,13.4,3044,476,2568,2.5,15.8,4502,1683,2819,8.7,23.3,-1458,-7.5,31.6,0,275,275,1142
1983,05,f) 5,2265,2330,15578,15967,62,2.6,293,12.1,2493,318,2175,2,15.6,3270,1489,1781,9.3,20.5,-777,-4.9,31.2,0,218,218,1169
1983,05,g) 6 to 10,2128,2524,21873,22123,105,4.1,268,10.4,3404,547,2857,2.5,15.4,3904,1150,2754,5.2,17.6,-500,-2.2,30.8,0,181,181,697
1983,05,l) Left Censored,16502,21525,432407,437655,779,3.5,1822,8.3,51827,13545,38282,3.1,11.8,62323,16095,46228,3.7,14.2,-10496,-2.4,23.6,0,1015,1022,6014
1983,06,a) 0,54193,54833,359330,181367,53762,196.1,0,0,355926,355926,0,196.2,196.2,0,0,0,0,0,355926,196.2,0,0,,,
1983,06,b) 1,43778,45771,334655,384209,313,0.6,13652,25.8,95212,4839,90373,1.3,24.8,194320,62888,131432,16.4,50.6,-99108,-25.8,49.6,0,9857,9876,47370
1983,06,c) 2,38880,40609,354250,405806,1624,3.7,8248,18.8,75119,11124,63995,2.7,18.5,178231,63334,114897,15.6,43.9,-103112,-25.4,37,0,6050,6050,37677
1983,06,d) 3,34318,35790,281707,293658,1345,3.5,6458,16.9,58056,6721,51335,2.3,19.8,81957,36018,45939,12.3,27.9,-23901,-8.1,39.6,0,4636,4641,27796
1983,06,e) 4,31063,32963,273691,282935,1162,3.3,5438,15.6,55733,6287,49446,2.2,19.7,74221,32409,41812,11.5,26.2,-18488,-6.5,39.4,0,3810,3815,22100
1983,06,f) 5,26619,28454,242726,263813,1048,3.5,3947,13.3,46585,7777,38808,2.9,17.7,88759,26648,62111,10.1,33.6,-42174,-15.9,35.4,0,2634,2642,15268
1983,06,g) 6 to 10,27094,33377,386766,410765,1403,4.1,4120,11.9,65321,14941,50380,3.6,15.9,113318,31942,81376,7.8,27.6,-47997,-11.7,31.8,0,2313,2344,18289
1983,06,l) Left Censored,170518,246195,5944369,6098532,10136,4,21575,8.6,808580,192205,616375,3.2,13.3,1116907,310971,805936,5.1,18.3,-308327,-5,26.6,0,10606,10768,81352
1983,08,a) 0,8836,9012,56658,28544,8880,197.1,0,0,56229,56229,0,197,197,0,0,0,0,0,56229,197,0,0,,,
1983,08,b) 1,6931,7189,52436,78115,38,0.5,2419,28.7,14666,1160,13506,1.5,18.8,66024,11632,54392,14.9,84.5,-51358,-65.7,37.6,0,1892,1893,8887
1983,08,c) 2,5668,5905,54457,59164,212,3.3,1430,21.9,9968,1262,8706,2.1,16.8,19381,9292,10089,15.7,32.8,-9413,-16,33.6,0,1081,1082,6861
1983,08,d) 3,5094,5279,40686,43172,303,5.4,938,16.8,8303,1803,6500,4.2,19.2,13275,6023,7252,14,30.7,-4972,-11.5,38.4,0,703,706,4902
1983,08,e) 4,4656,4928,40536,42460,272,5.3,824,15.9,8128,1506,6622,3.5,19.1,11975,4717,7258,11.1,28.2,-3847,-9.1,38.2,0,595,597,3635
1983,08,f) 5,3951,4100,34233,36156,179,4.2,564,13.2,5781,1362,4419,3.8,16,9627,3398,6229,9.4,26.6,-3846,-10.6,32,0,405,405,2303
1983,08,g) 6 to 10,3653,4455,48582,50499,211,4.6,556,12.1,8043,1703,6340,3.4,15.9,11878,3998,7880,7.9,23.5,-3835,-7.6,31.8,0,324,341,2048
1983,08,l) Left Censored,23493,32776,735520,750648,1757,5.3,2962,8.9,100082,28622,71460,3.8,13.3,130338,33474,96864,4.5,17.4,-30256,-4.1,26.6,0,1409,1414,9123
1983,09,a) 0,5702,5738,30680,15533,5623,196,0,0,30294,30294,0,195,195,0,0,0,0,0,30294,195,0,0,,,
1983,09,b) 1,4769,4908,47977,41837,18,0.3,1007,18.5,20925,112,20813,0.3,50,8644,3863,4781,9.2,20.7,12281,29.3,41.4,0,752,753,2710
1983,09,c) 2,4158,4322,32005,32312,153,3.3,660,14.4,6763,1445,5318,4.5,20.9,7377,2986,4391,9.2,22.8,-614,-1.9,41.8,0,497,497,2204
1983,09,d) 3,3564,3686,25233,25936,118,3.1,529,13.7,4375,662,3713,2.6,16.9,5780,2652,3128,10.2,22.3,-1405,-5.4,33.8,0,413,413,2041
1983,09,e) 4,3334,3427,26735,26547,110,3.1,411,11.6,5081,560,4521,2.1,19.1,4704,1819,2885,6.9,17.7,377,1.4,35.4,0,310,310,1539
1983,09,f) 5,3135,3411,30588,31249,89,2.5,349,9.9,6382,2511,3871,8,20.4,7703,2068,5635,6.6,24.7,-1321,-4.3,40.8,0,244,244,1183
1983,09,g) 6 to 10,3419,3982,43857,44211,157,3.8,436,10.6,8269,1579,6690,3.6,18.7,8977,3370,5607,7.6,20.3,-708,-1.6,37.4,0,270,270,1315
1983,09,l) Left Censored,31210,38665,1026145,1044085,1275,3.2,2811,7.2,110006,24530,85476,2.3,10.5,145887,35489,110398,3.4,14,-35881,-3.5,21,0,1562,1568,10384
1983,10,a) 0,1078,1083,5078,2595,1050,193.9,0,0,4967,4967,0,191.4,191.4,0,0,0,0,0,4967,191.4,0,0,,,
1983,10,b) 1,795,807,5796,6019,6,0.6,233,25.2,1537,9,1528,0.1,25.5,1982,1389,593,23.1,32.9,-445,-7.4,51,0,152,152,1138
1983,10,c) 2,710,733,5173,5427,28,3.6,114,14.7,805,103,702,1.9,14.8,1312,737,575,13.6,24.2,-507,-9.4,29.6,0,88,88,539
1983,10,d) 3,634,655,4938,5120,21,3.1,94,13.7,1025,330,695,6.4,20,1389,453,936,8.8,27.1,-364,-7.1,40,0,69,69,379
1983,10,e) 4,605,623,5327,5334,23,3.5,80,12.3,988,115,873,2.2,18.5,1002,379,623,7.1,18.8,-14,-0.3,37,0,61,61,301
1983,10,f) 5,523,555,4052,4216,17,3,65,11.3,628,70,558,1.7,14.9,955,364,591,8.6,22.7,-327,-7.8,29.8,0,41,41,196
1983,10,g) 6 to 10,614,753,8667,8317,35,4.6,79,10.3,1752,243,1509,2.9,21.1,1051,284,767,3.4,12.6,701,8.5,25.2,0,53,54,173
1983,10,l) Left Censored,5336,6732,178210,179698,259,3.8,506,7.4,21188,7424,13764,4.1,11.8,24163,6657,17506,3.7,13.4,-2975,-1.6,23.6,0,246,250,1647
1983,11,a) 0,1471,1481,11505,5797,1455,196.5,0,0,11416,11416,0,196.9,196.9,0,0,0,0,0,11416,196.9,0,0,,,
1983,11,b) 1,1213,1233,9607,9763,8,0.6,288,20.9,2531,49,2482,0.5,25.9,2842,1530,1312,15.7,29.1,-311,-3.2,51.8,0,217,217,1125
1983,11,c) 2,966,981,11690,11904,43,4.2,156,15.1,1545,259,1286,2.2,13,1973,647,1326,5.4,16.6,-428,-3.6,26,0,123,123,595
1983,11,d) 3,815,830,7410,7696,25,2.9,134,15.4,1376,171,1205,2.2,17.9,1948,911,1037,11.8,25.3,-572,-7.4,35.8,0,96,96,609
1983,11,e) 4,724,747,6459,6772,31,4,94,12.1,862,113,749,1.7,12.7,1487,483,1004,7.1,22,-625,-9.3,25.4,0,76,76,427
1983,11,f) 5,695,736,9165,9479,26,3.4,75,9.9,1313,116,1197,1.2,13.9,1940,455,1485,4.8,20.5,-627,-6.6,27.8,0,56,56,359
1983,11,g) 6 to 10,828,982,27523,27552,62,6.3,90,9.1,3415,495,2920,1.8,12.4,3472,647,2825,2.3,12.6,-57,-0.2,24.8,0,44,44,226
1983,11,l) Left Censored,7421,9184,277768,268284,378,4.1,744,8,55229,6461,48768,2.4,20.6,36261,10768,25493,4,13.5,18968,7.1,27,0,351,353,3314
1983,12,a) 0,29200,29500,157191,79434,29004,196.6,0,0,155514,155514,0,195.8,195.8,0,0,0,0,0,155514,195.8,0,0,,,
1983,12,b) 1,21818,22487,167004,177229,122,0.5,7670,29,44836,3148,41688,1.8,25.3,65288,36864,28424,20.8,36.8,-20452,-11.5,50.6,0,5624,5635,26968
1983,12,c) 2,17878,18496,142278,150250,730,3.6,4405,21.7,30678,5045,25633,3.4,20.4,46621,25534,21087,17,31,-15943,-10.6,40.8,0,3198,3198,18796
1983,12,d) 3,14855,15332,112810,122097,510,3,3656,21.7,21138,2471,18667,2,17.3,39711,21046,18665,17.2,32.5,-18573,-15.2,34.6,0,2322,2324,13386
1983,12,e) 4,12501,13175,112652,119168,449,3.1,3034,21.1,21712,3504,18208,2.9,18.2,34744,18948,15796,15.9,29.2,-13032,-11,36.4,0,1755,1756,10648
1983,12,f) 5,11742,12596,103083,107653,440,3.3,1936,14.6,19138,2645,16493,2.5,17.8,28277,12302,15975,11.4,26.3,-9139,-8.5,35.6,0,1273,1273,7722
1983,12,g) 6 to 10,11443,13968,149163,153779,697,4.8,1807,12.5,25081,6150,18931,4,16.3,34313,13541,20772,8.8,22.3,-9232,-6,32.6,0,1058,1073,6194
1983,12,l) Left Censored,71070,105435,2200167,2229450,4875,4.5,9491,8.8,310145,96317,213828,4.3,13.9,368711,104958,263753,4.7,16.5,-58566,-2.6,27.8,0,4589,4641,33513
1983,13,a) 0,10763,10838,56843,28662,10658,196.7,0,0,56362,56362,0,196.6,196.6,0,0,0,0,0,56362,196.6,0,0,,,
1983,13,b) 1,8001,8336,63238,65231,78,0.8,2503,26.1,17486,2123,15363,3.3,26.8,21472,13459,8013,20.6,32.9,-3986,-6.1,53.6,0,1979,1980,10766
1983,13,c) 2,6607,6903,60902,61121,261,3.5,1334,18,13959,1912,12047,3.1,22.8,14397,7292,7105,11.9,23.6,-438,-0.8,45.6,0,1051,1053,5970
1983,13,d) 3,5757,6071,47614,49620,220,3.4,1019,15.8,8927,1312,7615,2.6,18,12938,5462,7476,11,26.1,-4011,-8.1,36,0,785,785,4341
1983,13,e) 4,5320,5593,46997,47905,179,3.1,799,13.6,8927,963,7964,2,18.6,10742,4956,5786,10.3,22.4,-1815,-3.8,37.2,0,600,600,3912
1983,13,f) 5,4974,5340,46838,46780,203,3.7,648,11.8,9128,1323,7805,2.8,19.5,9012,3643,5369,7.8,19.3,116,0.2,38.6,0,493,493,2868
1983,13,g) 6 to 10,5156,6145,64226,65199,276,4.4,708,11.2,11577,3588,7989,5.5,17.8,13522,5405,8117,8.3,20.7,-1945,-2.9,35.6,0,449,451,2791
1983,13,l) Left Censored,39654,58300,1383635,1397080,3017,5.1,4567,7.7,196270,62301,133969,4.5,14,223160,59742,163418,4.3,16,-26890,-2,28,0,2254,2266,15034
1983,15,a) 0,2174,2186,12205,6248,2142,196,0,0,11915,,,,190.7,0,0,0,0,0,11915,190.7,0,1,,,
1983,15,b) 1,1705,1761,11769,12630,2,0.1,458,22.9,2935,,,,23.2,4657,3092,1565,24.5,36.9,-1722,-13.7,46.4,1,338,346,2613
1983,15,c) 2,1551,1601,15803,15880,69,4,308,17.9,3354,730,2624,4.6,21.1,3507,1594,1913,10,22.1,-153,-1,42.2,0,246,246,1364
1983,15,d) 3,1331,1428,11288,14852,63,4.1,259,17,2325,511,1814,3.4,15.7,9452,2091,7361,14.1,63.6,-7127,-47.9,31.4,0,195,195,1518
1983,15,e) 4,1170,1233,11614,11922,34,2.6,159,12.3,1504,167,1337,1.4,12.6,2119,764,1355,6.4,17.8,-615,-5.2,25.2,0,121,121,519
1983,15,f) 5,1039,1095,9762,10230,30,2.6,142,12.5,1264,243,1021,2.4,12.4,2199,811,1388,7.9,21.5,-935,-9.1,24.8,0,96,105,545
1983,15,g) 6 to 10,1022,1366,17657,16644,47,3.3,149,10.6,4811,555,4256,3.3,28.9,2785,973,1812,5.8,16.7,2026,12.2,33.4,0,80,80,471
1983,15,l) Left Censored,7987,11169,220816,224650,406,3.6,784,6.9,25404,7456,17948,3.3,11.3,33072,8623,24449,3.8,14.7,-7668,-3.4,22.6,0,417,421,2943
1983,16,a) 0,2033,2080,12327,6204,2028,195,0,0,12246,12246,0,197.4,197.4,0,0,0,0,0,12246,197.4,0,0,,,
1983,16,b) 1,1572,1624,10828,18027,6,0.3,527,27.8,2712,181,2531,1,15,17109,2348,14761,13,94.9,-14397,-79.9,30,0,416,420,1994
1983,16,c) 2,1318,1351,8858,9549,51,3.4,317,21.4,1530,210,1320,2.2,16,2911,1469,1442,15.4,30.5,-1381,-14.5,32,0,243,243,1039
1983,16,d) 3,1220,1252,8117,8667,40,2.9,266,19.6,1502,147,1355,1.7,17.3,2601,1405,1196,16.2,30,-1099,-12.7,34.6,0,204,204,1041
1983,16,e) 4,1198,1267,9444,9684,38,2.9,181,13.6,1746,343,1403,3.5,18,2226,876,1350,9,23,-480,-5,36,0,141,142,703
1983,16,f) 5,1074,1092,8262,8499,38,3.3,149,13.1,1219,213,1006,2.5,14.3,1692,670,1022,7.9,19.9,-473,-5.6,28.6,0,101,101,468
1983,16,g) 6 to 10,1007,1174,9836,10322,50,4.1,156,12.8,1356,317,1039,3.1,13.1,2328,692,1636,6.7,22.6,-972,-9.5,26.2,0,81,81,347
1983,16,l) Left Censored,7429,10057,162504,164348,356,3.5,817,8,18656,3120,15536,1.9,11.4,22345,7595,14750,4.6,13.6,-3689,-2.2,22.8,0,418,420,2667
1983,17,a) 0,16622,16829,105165,52951,16533,196.5,0,0,104428,104428,0,197.2,197.2,0,0,0,0,0,104428,197.2,0,0,,,
1983,17,b) 1,14059,14654,120303,131673,129,0.8,3948,23.7,28674,3720,24954,2.8,21.8,51414,18360,33054,13.9,39,-22740,-17.2,43.6,0,2643,2656,12338
1983,17,c) 2,11765,12170,102335,108442,369,2.8,2490,18.8,19405,1982,17423,1.8,17.9,31620,15149,16471,14,29.2,-12215,-11.3,35.8,0,1709,1709,9413
1983,17,d) 3,10527,10888,82900,86619,321,2.7,2305,19.5,16434,1573,14861,1.8,19,23871,13121,10750,15.1,27.6,-7437,-8.6,38,0,1378,1386,8375
1983,17,e) 4,9713,10165,78626,82831,294,2.7,1749,16.2,12908,2369,10539,2.9,15.6,21318,9574,11744,11.6,25.7,-8410,-10.1,31.2,0,1080,1083,5568
1983,17,f) 5,9361,9861,77255,78826,285,2.8,1397,13.5,14519,3271,11248,4.1,18.4,17660,7930,9730,10.1,22.4,-3141,-4,36.8,0,907,908,4895
1983,17,g) 6 to 10,10026,12119,136501,139500,471,3.8,1442,11.5,20860,4499,16361,3.2,15,26857,9558,17299,6.9,19.3,-5997,-4.3,30,0,782,792,4239
1983,17,l) Left Censored,89847,118401,3013248,3119502,4305,3.5,12289,10,310116,80437,229679,2.6,9.9,522625,155683,366942,5,16.8,-212509,-6.9,19.8,0,5511,5575,41218
1983,18,a) 0,7265,7345,40583,20297,7336,199.8,0,0,40572,40572,0,199.9,199.9,0,0,0,0,0,40572,199.9,0,0,,,
1983,18,b) 1,5666,5913,42690,45435,23,0.3,2159,30.6,9970,634,9336,1.4,21.9,15459,10012,5447,22,34,-5489,-12.1,43.8,0,1410,1414,6260
1983,18,c) 2,4665,4893,45386,49044,125,2.2,1344,24.2,6883,1127,5756,2.3,14,14198,7296,6902,14.9,28.9,-7315,-14.9,28,0,877,877,4708
1983,18,d) 3,4403,4572,32354,34243,81,1.6,1125,21.9,5707,553,5154,1.6,16.7,9485,5615,3870,16.4,27.7,-3778,-11,33.4,0,671,671,3069
1983,18,e) 4,4377,4586,32263,34077,116,2.3,896,17.8,5122,410,4712,1.2,15,8749,4497,4252,13.2,25.7,-3627,-10.7,30,0,525,525,2778
1983,18,f) 5,4102,4386,35086,38189,128,2.7,708,15,5876,972,4904,2.5,15.4,12081,3902,8179,10.2,31.6,-6205,-16.2,30.8,0,460,460,2427
1983,18,g) 6 to 10,4376,5392,57188,58914,185,3.2,743,13,8579,1367,7212,2.3,14.6,12031,4566,7465,7.8,20.4,-3452,-5.8,29.2,0,385,398,2065
1983,18,l) Left Censored,39864,55589,1328849,1375897,1697,2.9,6122,10.6,136706,29285,107421,2.1,9.9,230802,72906,157896,5.3,16.8,-94096,-6.9,19.8,0,2729,2763,20125
1983,19,a) 0,4803,4874,27060,13682,4742,194.6,0,0,26756,26756,0,195.6,195.6,0,0,0,0,0,26756,195.6,0,0,,,
1983,19,b) 1,3908,4102,25256,27157,20,0.4,1069,23,4578,208,4370,0.8,16.9,8379,4874,3505,17.9,30.9,-3801,-14,33.8,0,850,852,4099
1983,19,c) 2,3540,3694,26539,28334,121,3.1,682,17.3,4041,641,3400,2.3,14.3,7632,3975,3657,14,26.9,-3591,-12.6,28.6,0,542,542,2751
1983,19,d) 3,3365,3460,21563,22594,88,2.4,530,14.6,3087,242,2845,1.1,13.7,5149,2340,2809,10.4,22.8,-2062,-9.1,27.4,0,427,427,1727
1983,19,e) 4,3016,3220,21963,22993,103,3.1,476,14.1,3395,465,2930,2,14.8,5455,2660,2795,11.6,23.7,-2060,-8.9,29.6,0,361,361,1790
1983,19,f) 5,3066,3257,21398,37747,99,2.9,409,12.1,3522,648,2874,1.7,9.3,36220,2306,33914,6.1,96,-32698,-86.7,18.6,0,291,291,1568
1983,19,g) 6 to 10,3304,3979,35037,35196,113,2.8,414,10.1,6714,755,5959,2.1,19.1,7031,3287,3744,9.3,20,-317,-0.9,38.2,0,281,283,1213
1983,19,l) Left Censored,28387,37299,621466,644447,1114,2.9,2809,7.4,68364,21291,47073,3.3,10.6,114325,32300,82025,5,17.7,-45961,-7.1,21.2,0,1544,1550,8297
1983,20,a) 0,5077,5139,25594,12882,5052,196.6,0,0,25424,25424,0,197.4,197.4,0,0,0,0,0,25424,197.4,0,0,,,
1983,20,b) 1,4014,4129,27985,29844,18,0.4,1104,23.5,5660,180,5480,0.6,19,9377,4743,4634,15.9,31.4,-3717,-12.4,38,0,876,877,3688
1983,20,c) 2,3356,3531,24544,26750,131,3.4,698,18.3,4040,591,3449,2.2,15.1,8451,3734,4717,14,31.6,-4411,-16.5,30.2,0,525,525,3084
1983,20,d) 3,2792,2907,19454,20832,87,2.8,541,17.4,3114,596,2518,2.9,14.9,5870,2938,2932,14.1,28.2,-2756,-13.3,29.8,0,421,421,2437
1983,20,e) 4,2693,2798,18721,19460,97,3.3,406,13.8,3436,468,2968,2.4,17.7,4913,2117,2796,10.9,25.2,-1477,-7.5,35.4,0,320,320,1630
1983,20,f) 5,2521,2653,17790,18281,85,3.1,326,11.8,3134,498,2636,2.7,17.1,4116,1545,2571,8.5,22.5,-982,-5.4,34.2,0,254,254,1267
1983,20,g) 6 to 10,2800,3348,31794,32372,118,3.4,397,11.5,5431,923,4508,2.9,16.8,6586,2206,4380,6.8,20.3,-1155,-3.5,33.6,0,249,255,1298
1983,20,l) Left Censored,23151,30257,541666,563599,1101,3.6,2430,7.9,61792,19019,42773,3.4,11,105657,31939,73718,5.7,18.7,-43865,-7.7,22,0,1321,1335,7121
1983,21,a) 0,5730,5777,35228,17745,5683,196.7,0,0,34966,34966,0,197,197,0,0,0,0,0,34966,197,0,0,,,
1983,21,b) 1,4395,4527,34584,37066,34,0.6,1405,26.8,7265,469,6796,1.3,19.6,12229,7545,4684,20.4,33,-4964,-13.4,39.2,0,1134,1136,6428
1983,21,c) 2,3470,3598,28221,29542,116,3,745,19,5545,785,4760,2.7,18.8,8186,4372,3814,14.8,27.7,-2641,-8.9,37.6,0,594,594,3574
1983,21,d) 3,3050,3170,22591,24035,90,2.7,534,15.8,3569,447,3122,1.9,14.8,6456,2934,3522,12.2,26.9,-2887,-12.1,29.6,0,422,422,2350
1983,21,e) 4,2993,3123,26599,27970,101,3.1,498,15.1,3319,453,2866,1.6,11.9,6060,2291,3769,8.2,21.7,-2741,-9.8,23.8,0,376,376,1646
1983,21,f) 5,2802,2907,21446,22711,78,2.6,413,13.5,3251,517,2734,2.3,14.3,5781,2619,3162,11.5,25.5,-2530,-11.2,28.6,0,331,331,2028
1983,21,g) 6 to 10,2988,3488,30502,31521,134,3.7,367,10.3,4518,859,3659,2.7,14.3,6555,2209,4346,7,20.8,-2037,-6.5,28.6,0,233,234,1544
1983,21,l) Left Censored,25779,34584,704794,733137,1103,3.1,2847,8.1,73807,16913,56894,2.3,10.1,130494,30559,99935,4.2,17.8,-56687,-7.7,20.2,0,1523,1530,9178
1983,22,a) 0,8082,8180,46034,23299,8033,196.4,0,0,45471,45471,0,195.2,195.2,0,0,0,0,0,45471,195.2,0,0,,,
1983,22,b) 1,7013,7273,49146,54420,24,0.3,2153,25.7,11779,431,11348,0.8,21.6,22326,11291,11035,20.7,41,-10547,-19.4,43.2,0,1729,1730,8862
1983,22,c) 2,5601,5775,49661,55583,150,2.4,1194,19,8680,1064,7616,1.9,15.6,20523,9261,11262,16.7,36.9,-11843,-21.3,31.2,0,981,981,7863
1983,22,d) 3,4815,5003,44133,49220,154,2.9,841,15.8,6655,961,5694,2,13.5,16828,6207,10621,12.6,34.2,-10173,-20.7,27,0,684,684,4901
1983,22,e) 4,4633,4909,44386,48694,144,2.8,717,13.9,7632,1321,6311,2.7,15.7,16247,7276,8971,14.9,33.4,-8615,-17.7,31.4,0,549,553,4299
1983,22,f) 5,3782,3875,38258,42304,109,2.7,529,13.1,4430,520,3910,1.2,10.5,12522,3790,8732,9,29.6,-8092,-19.1,21,0,407,408,3143
1983,22,g) 6 to 10,3733,4492,48751,51299,186,4,498,10.8,8823,2062,6761,4,17.2,13919,5543,8376,10.8,27.1,-5096,-9.9,34.4,0,303,311,3772
1983,22,l) Left Censored,29836,41362,893812,935376,1666,4,3437,8.1,118094,34270,83824,3.7,12.6,201222,47736,153486,5.1,21.5,-83128,-8.9,25.2,0,1778,1785,13404
1983,23,a) 0,2115,2120,9766,4937,2074,195.7,0,0,9658,9658,0,195.6,195.6,0,0,0,0,0,9658,195.6,0,0,,,
1983,23,b) 1,1588,1633,10688,11308,10,0.5,383,20.9,2336,300,2036,2.7,20.7,3575,2032,1543,18,31.6,-1239,-10.9,41.4,0,267,267,1496
1983,23,c) 2,1363,1422,10349,10796,46,3,266,17.4,1655,168,1487,1.6,15.3,2549,1270,1279,11.8,23.6,-894,-8.3,30.6,0,195,195,769
1983,23,d) 3,1270,1306,8858,9027,44,3.2,172,12.6,1604,139,1465,1.5,17.8,1942,784,1158,8.7,21.5,-338,-3.7,35.6,0,132,132,553
1983,23,e) 4,1199,1229,9403,9462,38,3,165,12.8,1633,182,1451,1.9,17.3,1751,607,1144,6.4,18.5,-118,-1.2,34.6,0,114,114,455
1983,23,f) 5,1204,1272,8345,8595,45,3.4,144,11,1297,145,1152,1.7,15.1,1796,655,1141,7.6,20.9,-499,-5.8,30.2,0,103,103,529
1983,23,g) 6 to 10,1168,1388,14403,14553,54,3.7,171,11.9,2396,559,1837,3.8,16.5,2695,1096,1599,7.5,18.5,-299,-2,33,0,81,81,406
1983,23,l) Left Censored,9765,12439,247236,247826,368,2.9,991,7.8,28050,6760,21290,2.7,11.3,29229,9313,19916,3.8,11.8,-1179,-0.5,22.6,0,583,586,3318
1983,24,a) 0,7112,7196,38914,19651,7058,196.2,0,0,38527,38527,0,196.1,196.1,0,0,0,0,0,38527,196.1,0,0,,,
1983,24,b) 1,5441,5670,47243,47214,59,0.9,1312,20.7,12361,766,11595,1.6,26.2,12302,6927,5375,14.7,26.1,59,0.1,52.2,0,1007,1009,5100
1983,24,c) 2,4609,4776,40774,42000,184,3.6,756,15,7852,920,6932,2.2,18.7,10303,4343,5960,10.3,24.5,-2451,-5.8,37.4,0,598,598,3214
1983,24,d) 3,4075,4196,36174,36170,154,3.5,568,13,7194,1353,5841,3.7,19.9,7185,2774,4411,7.7,19.9,9,0,39.8,0,435,444,2185
1983,24,e) 4,3737,3888,34637,34539,132,3.3,508,12.5,7183,845,6338,2.4,20.8,6986,3336,3650,9.7,20.2,197,0.6,40.4,0,387,387,2827
1983,24,f) 5,3432,3660,31703,31960,145,3.9,395,10.5,6648,1284,5364,4,20.8,7162,2026,5136,6.3,22.4,-514,-1.6,41.6,0,279,282,1500
1983,24,g) 6 to 10,3708,4423,50241,50419,157,3.5,433,9.6,8914,2130,6784,4.2,17.7,9270,2832,6438,5.6,18.4,-356,-0.7,35.4,0,274,275,1461
1983,24,l) Left Censored,31562,43121,1014410,1025680,1658,3.8,3266,7.5,123675,27585,96090,2.7,12.1,146214,43454,102760,4.2,14.3,-22539,-2.2,24.2,0,1670,1682,11952
1983,25,a) 0,9622,9707,58876,29672,9536,196.5,0,0,58408,58408,0,196.8,196.8,0,0,0,0,0,58408,196.8,0,0,,,
1983,25,b) 1,7856,8137,86702,86480,53,0.6,1757,19.4,20283,989,19294,1.1,23.5,19839,9713,10126,11.2,22.9,444,0.6,45.8,0,1293,1294,7217
1983,25,c) 2,6543,6728,65099,65946,208,2.9,1071,15,13301,1457,11844,2.2,20.2,14995,7384,7611,11.2,22.7,-1694,-2.5,40.4,0,804,806,5238
1983,25,d) 3,5977,6122,48855,49332,194,3,860,13.4,9476,1046,8430,2.1,19.2,10429,4646,5783,9.4,21.1,-953,-1.9,38.4,0,645,646,3795
1983,25,e) 4,5565,5855,49821,50492,214,3.5,746,12.3,9905,2000,7905,4,19.6,11247,5205,6042,10.3,22.3,-1342,-2.7,39.2,0,525,526,3921
1983,25,f) 5,5008,5375,53981,54576,151,2.7,624,11.2,10303,2751,7552,5,18.9,11492,5594,5898,10.2,21.1,-1189,-2.2,37.8,0,448,453,3069
1983,25,g) 6 to 10,5378,6565,102417,103519,277,4.1,666,9.9,15365,4796,10569,4.6,14.8,17569,6911,10658,6.7,17,-2204,-2.2,29.6,0,386,389,2583
1983,25,l) Left Censored,54977,69811,1870969,1891895,2142,3,4809,6.8,209772,51939,157833,2.7,11.1,251624,59967,191657,3.2,13.3,-41852,-2.2,22.2,0,2790,2807,20668
1983,26,a) 0,12732,12842,67834,34233,12593,196.1,0,0,67202,67202,0,196.3,196.3,0,0,0,0,0,67202,196.3,0,0,,,
1983,26,b) 1,9945,10283,75333,76115,51,0.4,2675,22.9,20128,837,19291,1.1,26.4,21691,12258,9433,16.1,28.5,-1563,-2.1,52.8,0,1883,1895,8277
1983,26,c) 2,8788,9145,72875,75517,295,3,1545,15.8,12860,1658,11202,2.2,17,18143,8109,10034,10.7,24,-5283,-7,34,0,1159,1159,5515
1983,26,d) 3,7922,8233,59129,59488,462,5.4,1247,14.5,12814,2689,10125,4.5,21.5,13531,6232,7299,10.5,22.7,-717,-1.2,43,0,911,914,4534
1983,26,e) 4,7646,8046,89255,91580,278,3.3,1136,13.5,10520,1802,8718,2,11.5,15170,6098,9072,6.7,16.6,-4650,-5.1,23,0,802,802,4464
1983,26,f) 5,7064,7495,56795,58604,281,3.6,1013,13,10186,2038,8148,3.5,17.4,13803,5731,8072,9.8,23.6,-3617,-6.2,34.8,0,717,717,4092
1983,26,g) 6 to 10,7418,9149,91485,93481,366,3.9,1033,11,13632,3099,10533,3.3,14.6,17623,6662,10961,7.1,18.9,-3991,-4.3,29.2,0,609,624,3470
1983,26,l) Left Censored,64128,87889,2100153,2141342,2958,3.3,7003,7.8,221057,53034,168023,2.5,10.3,303434,77644,225790,3.6,14.2,-82377,-3.9,20.6,0,3641,3669,25395
1983,27,a) 0,7091,7193,44865,22654,7023,195.3,0,0,44423,44423,0,196.1,196.1,0,0,0,0,0,44423,196.1,0,0,,,
1983,27,b) 1,5580,5821,42278,43854,20,0.3,1327,20.3,8879,350,8529,0.8,20.2,12030,6078,5952,13.9,27.4,-3151,-7.2,40.4,0,966,967,4541
1983,27,c) 2,4940,5127,42471,44908,146,2.7,876,16,7132,1032,6100,2.3,15.9,12005,6369,5636,14.2,26.7,-4873,-10.8,31.8,0,668,668,4615
1983,27,d) 3,4545,4720,33662,34552,136,2.7,715,14.4,6844,795,6049,2.3,19.8,8623,4073,4550,11.8,25,-1779,-5.2,39.6,0,512,512,3008
1983,27,e) 4,4422,4672,36034,36740,120,2.5,617,12.6,6336,711,5625,1.9,17.2,7747,3395,4352,9.2,21.1,-1411,-3.9,34.4,0,459,459,2718
1983,27,f) 5,4072,4370,35680,36887,142,3.1,532,11.8,5128,1039,4089,2.8,13.9,7541,2648,4893,7.2,20.4,-2413,-6.5,27.8,0,393,395,2019
1983,27,g) 6 to 10,4344,5228,58855,59295,176,3.3,483,9,9603,1701,7902,2.9,16.2,10482,3448,7034,5.8,17.7,-879,-1.5,32.4,0,266,270,1541
1983,27,l) Left Censored,35595,46998,1108523,1135443,1539,3.2,3500,7.3,125948,32088,93860,2.8,11.1,179788,43308,136480,3.8,15.8,-53840,-4.7,22.2,0,1840,1852,12892
1983,28,a) 0,3931,3962,19552,9879,3857,194.7,0,0,19346,19346,0,195.8,195.8,0,0,0,0,0,19346,195.8,0,0,,,
1983,28,b) 1,3009,3082,17243,18886,13,0.4,957,26.8,3665,146,3519,0.8,19.4,6951,3674,3277,19.5,36.8,-3286,-17.4,38.8,0,781,781,2883
1983,28,c) 2,2523,2609,19859,21106,81,2.9,541,19.1,3496,696,2800,3.3,16.6,5990,2992,2998,14.2,28.4,-2494,-11.8,33.2,0,451,451,2278
1983,28,d) 3,2398,2471,17802,18577,73,2.8,441,16.8,3138,351,2787,1.9,16.9,4688,1797,2891,9.7,25.2,-1550,-8.3,33.8,0,347,347,1431
1983,28,e) 4,2300,2408,18098,18873,76,3,345,13.7,3403,407,2996,2.2,18,4952,1667,3285,8.8,26.2,-1549,-8.2,36,0,274,274,1462
1983,28,f) 5,1966,2070,15380,16089,66,3.1,238,11.2,2123,299,1824,1.9,13.2,3541,1247,2294,7.8,22,-1418,-8.8,26.4,0,171,171,870
1983,28,g) 6 to 10,2205,2642,22665,23481,81,3,324,11.9,3379,644,2735,2.7,14.4,5011,1847,3164,7.9,21.3,-1632,-6.9,28.8,0,209,222,1249
1983,28,l) Left Censored,17245,23232,442239,447131,874,3.7,1878,7.9,55131,17333,37798,3.9,12.3,64915,17143,47772,3.8,14.5,-9784,-2.2,24.6,0,1029,1033,6340
1983,29,a) 0,8840,8923,46645,23505,8729,195.7,0,0,46280,46280,0,196.9,196.9,0,0,0,0,0,46280,196.9,0,0,,,
1983,29,b) 1,6574,6786,45876,49001,33,0.4,1877,24.2,10613,302,10311,0.6,21.7,16862,9022,7840,18.4,34.4,-6249,-12.7,43.4,0,1476,1479,6836
1983,29,c) 2,5837,6125,49073,51112,190,2.9,1149,17.4,9808,1935,7873,3.8,19.2,13886,6279,7607,12.3,27.2,-4078,-8,38.4,0,900,901,4591
1983,29,d) 3,5037,5238,40625,39583,165,3,832,15.1,10823,1050,9773,2.7,27.3,8739,4154,4585,10.5,22.1,2084,5.2,44.2,0,648,650,3429
1983,29,e) 4,4940,5183,37977,39834,171,3.2,728,13.5,6761,1005,5756,2.5,17,10475,4936,5539,12.4,26.3,-3714,-9.3,34,0,533,533,3386
1983,29,f) 5,4447,4657,35159,53184,170,3.5,575,11.9,5687,963,4724,1.8,10.7,41736,2661,39075,5,78.5,-36049,-67.8,21.4,0,437,437,1846
1983,29,g) 6 to 10,4744,5635,55150,56496,229,4,614,10.6,8801,1985,6816,3.5,15.6,11492,3968,7524,7,20.3,-2691,-4.7,31.2,0,381,382,2387
1983,29,l) Left Censored,40978,55265,1279303,1302515,2098,3.7,4621,8.2,159424,47627,111797,3.7,12.2,205848,62990,142858,4.8,15.8,-46424,-3.6,24.4,0,2307,2342,15336
1983,30,a) 0,2163,2212,12874,6496,2152,194.6,0,0,12757,,,,196.4,0,0,0,0,0,12757,196.4,0,1,,,
1983,30,b) 1,1641,1673,9111,10025,2,0.1,504,26,1792,,,,17.9,3620,2094,1526,20.9,36.1,-1828,-18.2,35.8,1,379,382,1589
1983,30,c) 2,1404,1438,9142,9983,52,3.3,295,18.9,1831,208,1623,2.1,18.3,3512,2117,1395,21.2,35.2,-1681,-16.9,36.6,0,236,236,1925
1983,30,d) 3,1315,1346,9140,9939,47,3.3,244,17,1525,364,1161,3.7,15.3,3122,1210,1912,12.2,31.4,-1597,-16.1,30.6,0,177,177,1020
1983,30,e) 4,1345,1418,9129,9366,55,3.7,186,12.6,1824,314,1510,3.4,19.5,2297,1026,1271,11,24.5,-473,-5,39,0,127,127,747
1983,30,f) 5,1102,1128,7263,7539,48,4.1,146,12.5,1127,179,948,2.4,14.9,1679,646,1033,8.6,22.3,-552,-7.4,29.8,0,96,96,417
1983,30,g) 6 to 10,1138,1307,9810,10173,51,3.8,139,10.4,1384,228,1156,2.2,13.6,2109,723,1386,7.1,20.7,-725,-7.1,27.2,0,82,83,374
1983,30,l) Left Censored,7631,9780,129693,133051,328,3.3,796,8,15827,3397,12430,2.6,11.9,22542,5382,17160,4,16.9,-6715,-5,23.8,0,419,430,2661
1983,31,a) 0,3085,3145,23587,11870,3061,194.7,0,0,23434,23434,0,197.4,197.4,0,0,0,0,0,23434,197.4,0,0,,,
1983,31,b) 1,2473,2552,16712,17316,13,0.5,617,21.5,4031,850,3181,4.9,23.3,5239,3143,2096,18.2,30.3,-1208,-7,46.6,0,445,445,2354
1983,31,c) 2,2165,2248,14129,14824,78,3.2,416,17.3,2576,449,2127,3,17.4,3966,2115,1851,14.3,26.8,-1390,-9.4,34.8,0,320,320,1687
1983,31,d) 3,1987,2033,12662,13105,53,2.5,304,14.2,2150,174,1976,1.3,16.4,3035,1322,1713,10.1,23.2,-885,-6.8,32.8,0,235,235,1057
1983,31,e) 4,1877,1951,12979,13282,56,2.8,256,12.6,1973,309,1664,2.3,14.9,2578,1157,1421,8.7,19.4,-605,-4.5,29.8,0,187,187,918
1983,31,f) 5,1776,1850,13223,14183,50,2.6,204,10.8,1480,170,1310,1.2,10.4,3400,1622,1778,11.4,24,-1920,-13.6,20.8,0,145,145,1483
1983,31,g) 6 to 10,1924,2227,17110,17691,75,3.3,242,10.6,2685,526,2159,3,15.2,3847,1656,2191,9.4,21.7,-1162,-6.5,30.4,0,147,152,871
1983,31,l) Left Censored,16218,20656,357401,368226,537,2.6,1539,7.3,37200,6606,30594,1.8,10.1,58850,15220,43630,4.1,16,-21650,-5.9,20.2,0,823,828,4916
1983,32,a) 0,2212,2242,13843,7001,2196,195.9,0,0,13685,13685,0,195.5,195.5,0,0,0,0,0,13685,195.5,0,0,,,
1983,32,b) 1,1796,1849,18188,19790,13,0.6,714,32.2,3755,180,3575,0.9,19,6959,3547,3412,17.9,35.2,-3204,-16.2,38,0,538,542,2908
1983,32,c) 2,1545,1598,13508,14540,57,3.2,379,21.5,2797,266,2531,1.8,19.2,4860,2645,2215,18.2,33.4,-2063,-14.2,38.4,0,302,302,1821
1983,32,d) 3,1341,1386,14498,15168,58,3.9,294,19.6,2749,481,2268,3.2,18.1,4088,1548,2540,10.2,27,-1339,-8.9,36.2,0,223,223,1319
1983,32,e) 4,1361,1424,13520,14706,43,2.9,219,14.6,1818,244,1574,1.7,12.4,4189,2124,2065,14.4,28.5,-2371,-16.1,24.8,0,158,158,1362
1983,32,f) 5,1004,1067,9988,10790,43,3.8,160,14.3,1450,258,1192,2.4,13.4,3054,847,2207,7.8,28.3,-1604,-14.9,26.8,0,128,128,713
1983,32,g) 6 to 10,954,1147,14645,15347,51,4.3,159,13.3,2653,822,1831,5.4,17.3,4056,1196,2860,7.8,26.4,-1403,-9.1,34.6,0,98,98,531
1983,32,l) Left Censored,5957,8184,228378,235112,376,4.5,753,9,28472,10230,18242,4.4,12.1,41939,9935,32004,4.2,17.8,-13467,-5.7,24.2,0,337,338,2749
1983,33,a) 0,2192,2205,12407,6252,2152,195.2,0,0,12310,,,,196.9,0,0,0,0,0,12310,196.9,0,1,,,
1983,33,b) 1,1669,1692,11678,11278,9,0.5,381,20.1,4030,,,,35.7,3229,2155,1074,19.1,28.6,801,7.1,57.2,1,281,281,1416
1983,33,c) 2,1383,1412,12171,12393,44,2.9,259,17.1,2369,292,2077,2.4,19.1,2813,1572,1241,12.7,22.7,-444,-3.6,38.2,0,209,209,1380
1983,33,d) 3,1204,1241,9011,9042,45,3.5,174,13.4,2098,366,1732,4,23.2,2159,867,1292,9.6,23.9,-61,-0.7,46.4,0,131,131,644
1983,33,e) 4,1211,1253,10212,10297,35,2.7,151,11.6,1673,137,1536,1.3,16.2,1843,843,1000,8.2,17.9,-170,-1.7,32.4,0,123,123,695
1983,33,f) 5,1095,1149,8644,8954,35,2.9,151,12.6,1307,161,1146,1.8,14.6,1926,725,1201,8.1,21.5,-619,-6.9,29.2,0,117,117,563
1983,33,g) 6 to 10,1145,1354,14934,15055,57,4.1,153,11,2489,746,1743,5,16.5,2730,1061,1669,7,18.1,-241,-1.6,33,0,83,83,539
1983,33,l) Left Censored,8811,10850,256770,259099,382,3.5,779,7.1,31000,6648,24352,2.6,12,35658,8945,26713,3.5,13.8,-4658,-1.8,24,0,453,455,3431
1983,34,a) 0,13916,13997,69310,34974,13713,195.9,0,0,68672,68672,0,196.4,196.4,0,0,0,0,0,68672,196.4,0,0,,,
1983,34,b) 1,11176,11425,83528,82146,59,0.5,2743,21.4,22606,1202,21404,1.5,27.5,19842,11225,8617,13.7,24.2,2764,3.3,48.4,0,1961,1962,8452
1983,34,c) 2,9386,9630,82699,84827,332,3.2,1592,15.5,18751,1846,16905,2.2,22.1,23007,9822,13185,11.6,27.1,-4256,-5,44.2,0,1199,1199,6714
1983,34,d) 3,8686,8869,66884,67552,302,3.2,1260,13.6,13167,1584,11583,2.3,19.5,14502,6311,8191,9.3,21.5,-1335,-2,39,0,953,953,4411
1983,34,e) 4,8053,8250,62512,62669,257,3,1003,11.7,12073,1862,10211,3,19.3,12387,5015,7372,8,19.8,-314,-0.5,38.6,0,714,718,3859
1983,34,f) 5,7059,7332,56221,57171,231,3,948,12.4,10093,1769,8324,3.1,17.7,11993,5064,6929,8.9,21,-1900,-3.3,35.4,0,665,666,3377
1983,34,g) 6 to 10,7681,8531,82869,85026,302,3.4,924,10.5,13144,2211,10933,2.6,15.5,17458,5335,12123,6.3,20.5,-4314,-5,31,0,604,605,2895
1983,34,l) Left Censored,69810,87091,2104051,2118299,2931,3.3,6693,7.5,287250,77844,209406,3.7,13.6,315746,104021,211725,4.9,14.9,-28496,-1.3,27.2,0,3799,3813,25485
1983,35,a) 0,3209,3273,21068,10600,3211,196.2,0,0,20937,20937,0,197.5,197.5,0,0,0,0,0,20937,197.5,0,0,,,
1983,35,b) 1,2264,2318,17851,18935,17,0.6,827,30.1,4915,674,4241,3.6,26,7082,4152,2930,21.9,37.4,-2167,-11.4,52,0,606,607,3179
1983,35,c) 2,2081,2163,15891,16996,64,2.8,400,17.2,3207,410,2797,2.4,18.9,5416,2559,2857,15.1,31.9,-2209,-13,37.8,0,301,301,1838
1983,35,d) 3,1848,1895,14478,15358,63,3.1,332,16.5,2932,303,2629,2,19.1,4692,1945,2747,12.7,30.6,-1760,-11.5,38.2,0,250,250,1465
1983,35,e) 4,1755,1873,15160,15493,84,4.3,247,12.7,3002,693,2309,4.5,19.4,3667,1334,2333,8.6,23.7,-665,-4.3,38.8,0,180,180,1035
1983,35,f) 5,1419,1469,11291,11912,53,3.5,205,13.4,1966,298,1668,2.5,16.5,3208,1210,1998,10.2,26.9,-1242,-10.4,33,0,151,151,1027
1983,35,g) 6 to 10,1437,1701,14330,14863,73,4.2,197,11.3,2562,505,2057,3.4,17.2,3627,1633,1994,11,24.4,-1065,-7.2,34.4,0,125,126,1056
1983,35,l) Left Censored,9512,12891,223131,229762,509,3.9,1119,8.5,29030,7445,21585,3.2,12.6,42291,11937,30354,5.2,18.4,-13261,-5.8,25.2,0,556,557,3758
1983,36,a) 0,33255,33457,171458,86525,32816,196.2,0,0,169866,169866,0,196.3,196.3,0,0,0,0,0,169866,196.3,0,0,,,
1983,36,b) 1,25817,26360,185186,190697,73,0.2,6466,21.8,45033,1092,43941,0.6,23.6,56054,31168,24886,16.3,29.4,-11021,-5.8,47.2,0,4918,4921,23938
1983,36,c) 2,21883,22354,192197,194104,693,2.9,3810,16,43612,4144,39468,2.1,22.5,47425,23388,24037,12,24.4,-3813,-1.9,45,0,2937,2937,15821
1983,36,d) 3,19383,19766,160873,163839,630,3,3007,14.5,30254,2916,27338,1.8,18.5,36186,14911,21275,9.1,22.1,-5932,-3.6,37,0,2334,2341,12266
1983,36,e) 4,17887,18460,136305,137990,560,2.9,2509,13,28797,3030,25767,2.2,20.9,32167,14411,17756,10.4,23.3,-3370,-2.4,41.8,0,1961,1961,11674
1983,36,f) 5,16673,17373,138651,146969,442,2.4,2108,11.7,21507,2381,19126,1.6,14.6,38142,10310,27832,7,26,-16635,-11.4,29.2,0,1611,1617,8068
1983,36,g) 6 to 10,17150,19808,218489,223115,663,3.3,2117,10.4,33508,5675,27833,2.5,15,42760,12785,29975,5.7,19.2,-9252,-4.2,30,0,1461,1462,7244
1983,36,l) Left Censored,166740,204587,4758651,4823410,5590,2.7,16312,7.8,588805,128850,459955,2.7,12.2,718323,199290,519033,4.1,14.9,-129518,-2.7,24.4,0,10265,10326,65352
1983,37,a) 0,9517,9630,52614,26315,9622,199.8,0,0,52598,52598,0,199.9,199.9,0,0,0,0,0,52598,199.9,0,0,,,
1983,37,b) 1,7255,7494,51813,55408,41,0.5,2936,32.5,12534,733,11801,1.3,22.6,19723,12925,6798,23.3,35.6,-7189,-13,45.2,0,1994,1994,8738
1983,37,c) 2,5918,6130,54743,58086,135,1.9,1681,24.1,9684,1530,8154,2.6,16.7,16369,10418,5951,17.9,28.2,-6685,-11.5,33.4,0,1081,1081,5749
1983,37,d) 3,5173,5379,39833,42491,150,2.5,1334,22.1,7401,1098,6303,2.6,17.4,12716,7403,5313,17.4,29.9,-5315,-12.5,34.8,0,756,756,3942
1983,37,e) 4,5037,5306,42951,44477,123,2.1,1091,18.7,7853,945,6908,2.1,17.7,10904,6036,4868,13.6,24.5,-3051,-6.8,35.4,0,634,634,3742
1983,37,f) 5,4888,5145,42848,52407,131,2.4,864,15.5,7654,935,6719,1.8,14.6,26771,4076,22695,7.8,51.1,-19117,-36.5,29.2,0,478,478,2386
1983,37,g) 6 to 10,4843,5947,59440,60185,227,3.6,889,14.1,9833,2422,7411,4,16.3,11323,4701,6622,7.8,18.8,-1490,-2.5,32.6,0,458,461,2454
1983,37,l) Left Censored,42332,61231,1598782,1612307,1984,3.1,5929,9.3,184707,56453,128254,3.5,11.5,211756,64579,147177,4,13.1,-27049,-1.6,23,0,2644,2684,17560
1983,38,a) 0,1421,1438,8204,4138,1399,194.6,0,0,8132,,,,196.5,0,0,0,0,0,8132,196.5,0,1,,,
1983,38,b) 1,1159,1181,6954,7440,2,0.1,330,24.3,1640,,,,22,2611,1347,1264,18.1,35.1,-971,-13.1,44,1,248,248,992
1983,38,c) 2,1001,1034,7538,8199,38,3.4,210,18.9,1064,200,864,2.4,13,2385,996,1389,12.1,29.1,-1321,-16.1,26,0,163,163,862
1983,38,d) 3,928,953,6046,6424,31,3.1,148,14.7,995,238,757,3.7,15.5,1750,763,987,11.9,27.2,-755,-11.7,31,0,110,110,552
1983,38,e) 4,887,917,6232,6523,39,4.1,130,13.7,955,156,799,2.4,14.6,1537,673,864,10.3,23.6,-582,-9,29.2,0,104,104,609
1983,38,f) 5,774,796,4701,5067,25,3,116,13.9,676,105,571,2.1,13.3,1408,612,796,12.1,27.8,-732,-14.5,26.6,0,91,91,535
1983,38,g) 6 to 10,837,933,6729,6989,23,2.4,98,10.2,968,131,837,1.9,13.9,1488,473,1015,6.8,21.3,-520,-7.4,27.8,0,59,59,252
1983,38,l) Left Censored,6882,8764,123247,126492,255,2.9,664,7.5,12647,2381,10266,1.9,10,19137,6277,12860,5,15.1,-6490,-5.1,20,0,349,352,2546
1983,39,a) 0,14066,14269,75210,38008,13942,195.4,0,0,74405,74405,0,195.8,195.8,0,0,0,0,0,74405,195.8,0,0,,,
1983,39,b) 1,11573,12040,82129,93169,49,0.4,3032,22.3,17082,415,16667,0.4,18.3,39161,13915,25246,14.9,42,-22079,-23.7,36.6,0,2230,2235,10389
1983,39,c) 2,10000,10405,91824,95360,368,3.3,1896,17,15219,2345,12874,2.5,16,22290,10890,11400,11.4,23.4,-7071,-7.4,32,0,1458,1458,7716
1983,39,d) 3,9023,9503,68169,70988,305,3,1467,14.6,12543,1703,10840,2.4,17.7,18181,7717,10464,10.9,25.6,-5638,-7.9,35.4,0,1039,1047,5909
1983,39,e) 4,8702,9115,73524,73903,288,3,1256,13.2,15533,5246,10287,7.1,21,16290,7673,8617,10.4,22,-757,-1,42,0,929,931,6040
1983,39,f) 5,7960,8575,68476,70140,304,3.4,1104,12.4,11955,1599,10356,2.3,17,15282,6113,9169,8.7,21.8,-3327,-4.8,34,0,780,780,4923
1983,39,g) 6 to 10,8776,10980,108494,111944,338,3,1133,10,17571,2677,14894,2.4,15.7,24470,8433,16037,7.5,21.9,-6899,-6.2,31.4,0,631,637,3103
1983,39,l) Left Censored,83224,118739,2811812,2875851,3999,3.3,9434,7.8,301129,79012,222117,2.7,10.5,429207,98405,330802,3.4,14.9,-128078,-4.4,21,0,4629,4689,29812
1983,40,a) 0,7408,7489,39323,19846,7378,197,0,0,38954,38954,0,196.3,196.3,0,0,0,0,0,38954,196.3,0,0,,,
1983,40,b) 1,6375,6581,46017,53235,26,0.3,2528,32.1,9684,323,9361,0.6,18.2,24120,12864,11256,24.2,45.3,-14436,-27.1,36.4,0,2137,2137,11182
1983,40,c) 2,4975,5145,40477,47803,142,2.5,1214,21.4,6620,795,5825,1.7,13.8,21272,9161,12111,19.2,44.5,-14652,-30.7,27.6,0,996,996,7617
1983,40,d) 3,4253,4418,35475,38511,125,2.6,830,17.5,6826,855,5971,2.2,17.7,12898,5134,7764,13.3,33.5,-6072,-15.8,35.4,0,670,670,4055
1983,40,e) 4,3798,3979,30969,34453,121,2.9,692,16.3,4932,803,4129,2.3,14.3,11899,5338,6561,15.5,34.5,-6967,-20.2,28.6,0,499,508,3475
1983,40,f) 5,3246,3335,26710,29285,93,2.7,456,13,3722,391,3331,1.3,12.7,8871,2857,6014,9.8,30.3,-5149,-17.6,25.4,0,354,354,2392
1983,40,g) 6 to 10,3116,3762,37127,40281,147,3.8,415,10.7,5326,1284,4042,3.2,13.2,11633,3983,7650,9.9,28.9,-6307,-15.7,26.4,0,268,274,2220
1983,40,l) Left Censored,23624,32163,654624,675489,1229,3.7,2635,8,92048,30162,61886,4.5,13.6,133777,27922,105855,4.1,19.8,-41729,-6.2,27.2,0,1448,1455,10063
1983,41,a) 0,5997,6125,35653,17966,5993,195.7,0,0,35375,35375,0,196.9,196.9,0,0,0,0,0,35375,196.9,0,0,,,
1983,41,b) 1,4704,4839,31260,33053,22,0.4,1631,28.7,7569,333,7236,1,22.9,11155,6610,4545,20,33.7,-3586,-10.8,45.8,0,1188,1202,5036
1983,41,c) 2,4269,4426,30964,32419,121,2.5,1012,20.8,6471,950,5521,2.9,20,9381,4706,4675,14.5,28.9,-2910,-8.9,40,0,777,777,3793
1983,41,d) 3,3907,4047,25778,39622,189,4.4,735,17.1,4706,738,3968,1.9,11.9,32393,4076,28317,10.3,81.8,-27687,-69.9,23.8,0,531,531,3456
1983,41,e) 4,3390,3531,24170,25265,148,3.9,653,17.3,4238,541,3697,2.1,16.8,6428,3048,3380,12.1,25.4,-2190,-8.6,33.6,0,497,497,2458
1983,41,f) 5,3093,3254,22314,23345,141,4.1,541,15.8,3806,528,3278,2.3,16.3,5868,2179,3689,9.3,25.1,-2062,-8.8,32.6,0,375,375,1641
1983,41,g) 6 to 10,3117,3697,37804,39233,196,5.1,540,14,7069,1873,5196,4.8,18,9926,3301,6625,8.4,25.3,-2857,-7.3,36,0,318,319,1914
1983,41,l) Left Censored,21602,29266,533899,545779,1238,4.1,2581,8.6,63708,13482,50226,2.5,11.7,87468,23510,63958,4.3,16,-23760,-4.3,23.4,0,1276,1290,8126
1983,42,a) 0,15954,16114,93781,47310,15775,195.8,0,0,92943,92943,0,196.5,196.5,0,0,0,0,0,92943,196.5,0,0,,,
1983,42,b) 1,12783,13253,106213,108132,90,0.6,2940,19.9,25208,1887,23321,1.7,23.3,29045,15203,13842,14.1,26.9,-3837,-3.6,46.6,0,2178,2182,10282
1983,42,c) 2,10814,11187,99484,103085,300,2.5,1734,14.6,16453,1858,14595,1.8,16,23654,10319,13335,10,22.9,-7201,-6.9,32,0,1294,1295,7660
1983,42,d) 3,10134,10473,77879,80196,279,2.5,1424,13,13373,1252,12121,1.6,16.7,18006,7404,10602,9.2,22.5,-4633,-5.8,33.4,0,1101,1101,5811
1983,42,e) 4,9691,10200,77610,78920,327,3.1,1347,12.7,13386,1838,11548,2.3,17,16005,6374,9631,8.1,20.3,-2619,-3.3,34,0,957,957,4654
1983,42,f) 5,8977,9588,78577,80603,286,2.9,1090,11,13748,2714,11034,3.4,17.1,17800,5897,11903,7.3,22.1,-4052,-5,34.2,0,764,764,3710
1983,42,g) 6 to 10,9842,11845,127896,131098,438,3.6,1227,10.1,19113,4992,14121,3.8,14.6,25517,8971,16546,6.8,19.5,-6404,-4.9,29.2,0,676,683,4124
1983,42,l) Left Censored,97018,130794,3119097,3229226,4228,3.2,10255,7.7,341321,92199,249122,2.9,10.6,561579,136566,425013,4.2,17.4,-220258,-6.8,21.2,0,5367,5417,37569
1983,44,a) 0,1660,1672,7894,3984,1636,195.7,0,0,7821,,,,196.3,0,0,0,0,0,7821,196.3,0,1,,,
1983,44,b) 1,1292,1319,9058,8851,1,0.1,304,20.6,2672,,,,30.2,2258,1045,1213,11.8,25.5,414,4.7,51,1,232,232,795
1983,44,c) 2,1118,1134,8827,9187,34,2.8,179,14.8,1741,146,1595,1.6,19,2461,1440,1021,15.7,26.8,-720,-7.8,38,0,135,135,963
1983,44,d) 3,1022,1046,7157,7326,33,3,156,14.1,1242,126,1116,1.7,17,1579,771,808,10.5,21.6,-337,-4.6,34,0,122,122,571
1983,44,e) 4,1022,1053,7947,8029,32,2.9,128,11.7,1250,211,1039,2.6,15.6,1414,563,851,7,17.6,-164,-2,31.2,0,97,97,469
1983,44,f) 5,888,925,7834,7931,44,4.6,132,13.7,1434,164,1270,2.1,18.1,1628,649,979,8.2,20.5,-194,-2.4,36.2,0,96,96,478
1983,44,g) 6 to 10,1054,1152,12253,12088,33,2.8,114,9.6,2434,186,2248,1.5,20.1,2104,705,1399,5.8,17.4,330,2.7,34.8,0,63,65,265
1983,44,l) Left Censored,10245,12077,271168,273254,315,2.6,904,7.3,28089,5542,22547,2,10.3,32261,8693,23568,3.2,11.8,-4172,-1.5,20.6,0,549,549,3244
1983,45,a) 0,4729,4798,25562,12785,4793,199.8,0,0,25555,25555,0,199.9,199.9,0,0,0,0,0,25555,199.9,0,0,,,
1983,45,b) 1,3824,3942,29805,31745,26,0.6,1445,30.7,7727,702,7025,2.2,24.3,11607,6670,4937,21,36.6,-3880,-12.3,48.6,0,999,1000,4196
1983,45,c) 2,3076,3206,26518,28102,84,2.3,822,22.8,4887,462,4425,1.6,17.4,8055,4522,3533,16.1,28.7,-3168,-11.3,34.8,0,548,548,2912
1983,45,d) 3,2675,2827,21635,22854,75,2.4,666,21.1,3877,309,3568,1.4,17,6314,3278,3036,14.3,27.6,-2437,-10.6,34,0,392,392,1910
1983,45,e) 4,2451,2595,19044,20012,85,3,534,18.8,3849,935,2914,4.7,19.2,5784,3078,2706,15.4,28.9,-1935,-9.7,38.4,0,308,308,1711
1983,45,f) 5,2432,2621,21460,22487,82,2.9,465,16.4,3474,598,2876,2.7,15.4,5528,2323,3205,10.3,24.6,-2054,-9.2,30.8,0,289,289,1404
1983,45,g) 6 to 10,2394,2887,23548,24744,113,3.7,439,14.3,4119,769,3350,3.1,16.6,6511,3318,3193,13.4,26.3,-2392,-9.7,33.2,0,259,267,1982
1983,45,l) Left Censored,20644,29325,728926,743569,1032,3.4,2878,9.5,81019,23963,57056,3.2,10.9,110305,29225,81080,3.9,14.8,-29286,-3.9,21.8,0,1445,1450,10027
1983,46,a) 0,1369,1384,6858,3453,1349,194.9,0,0,6810,,,,197.2,0,0,0,0,0,6810,197.2,0,1,,,
1983,46,b) 1,1015,1041,6718,7272,2,0.2,286,24.1,1053,,,,14.5,2161,1208,953,16.6,29.7,-1108,-15.2,29,1,209,209,921
1983,46,c) 2,899,921,6667,6748,23,2.3,185,18.6,1259,126,1133,1.9,18.7,1420,739,681,11,21,-161,-2.3,37.4,0,143,143,591
1983,46,d) 3,908,931,5297,5582,26,2.7,153,15.7,794,107,687,1.9,14.2,1363,718,645,12.9,24.4,-569,-10.2,28.4,0,111,111,531
1983,46,e) 4,831,874,6013,6259,28,3,144,15.7,940,152,788,2.4,15,1432,797,635,12.7,22.9,-492,-7.9,30,0,103,103,633
1983,46,f) 5,831,854,5227,5229,32,3.6,106,12.1,1012,201,811,3.8,19.4,1015,487,528,9.3,19.4,-3,0,38.8,0,79,79,388
1983,46,g) 6 to 10,833,965,6564,6656,35,3.5,107,10.8,1158,260,898,3.9,17.4,1341,544,797,8.2,20.1,-183,-2.7,34.8,0,62,62,358
1983,46,l) Left Censored,7338,8986,122199,124930,224,2.4,706,7.7,12260,2881,9379,2.3,9.8,17721,4564,13157,3.7,14.2,-5461,-4.4,19.6,0,369,373,1871
1983,47,a) 0,8011,8069,45699,23012,7918,196.3,0,0,45374,45374,0,197.2,197.2,0,0,0,0,0,45374,197.2,0,0,,,
1983,47,b) 1,5880,6106,49256,52053,46,0.6,2027,28.4,11416,729,10687,1.4,21.9,17009,10419,6590,20,32.7,-5593,-10.8,43.8,0,1670,1673,8754
1983,47,c) 2,4699,4888,40323,42258,149,2.8,1060,19.9,7654,799,6855,1.9,18.1,11523,5438,6085,12.9,27.3,-3869,-9.2,36.2,0,857,857,4440
1983,47,d) 3,4375,4542,33757,35207,161,3.4,775,16.1,5674,935,4739,2.7,16.1,8574,3959,4615,11.2,24.4,-2900,-8.3,32.2,0,617,621,3416
1983,47,e) 4,4064,4286,40655,39906,134,3,692,15.3,10194,771,9423,1.9,25.5,8696,3781,4915,9.5,21.8,1498,3.7,43.6,0,497,497,2840
1983,47,f) 5,3808,4043,33024,33112,122,2.9,500,11.9,6590,797,5793,2.4,19.9,6765,2390,4375,7.2,20.4,-175,-0.5,39.8,0,374,376,1840
1983,47,g) 6 to 10,4068,4931,51862,53327,199,3.9,594,11.7,8827,1827,7000,3.4,16.6,11756,4433,7323,8.3,22,-2929,-5.4,33.2,0,358,366,2698
1983,47,l) Left Censored,33098,46107,1107707,1111522,1959,4.2,3829,8.2,150249,47943,102306,4.3,13.5,157879,38677,119202,3.5,14.2,-7630,-0.7,27,0,1955,1969,12881
1983,48,a) 0,36423,36811,218341,110132,36182,196.6,0,0,216419,216419,0,196.5,196.5,0,0,0,0,0,216419,196.5,0,0,,,
1983,48,b) 1,29497,30715,225146,247110,159,0.4,10063,28,59403,1982,57421,0.8,24,103330,55309,48021,22.4,41.8,-43927,-17.8,48,0,8043,8049,44370
1983,48,c) 2,34346,35798,304297,336544,1098,2.8,7228,18.6,60864,9049,51815,2.7,18.1,125359,50445,74914,15,37.2,-64495,-19.1,36.2,0,5874,5877,41037
1983,48,d) 3,10587,11349,99911,105015,410,3.4,1870,15.5,20969,3333,17636,3.2,20,31177,12784,18393,12.2,29.7,-10208,-9.7,40,0,1434,1441,9695
1983,48,e) 4,18350,19927,191614,201944,676,3.2,2907,13.9,37160,5599,31561,2.8,18.4,57821,20614,37207,10.2,28.6,-20661,-10.2,36.8,0,2180,2182,15619
1983,48,f) 5,14938,15838,144289,154680,611,3.7,2132,12.9,24441,4162,20279,2.7,15.8,45223,14518,30705,9.4,29.2,-20782,-13.4,31.6,0,1643,1650,11053
1983,48,g) 6 to 10,14301,17939,201682,212087,829,4.5,2213,12,38740,9559,29181,4.5,18.3,59550,17972,41578,8.5,28.1,-20810,-9.8,36.6,0,1332,1353,9633
1983,48,l) Left Censored,98307,154139,3755043,3868109,8442,5.4,13670,8.7,566822,194777,372045,5,14.7,792954,187803,605151,4.9,20.5,-226132,-5.8,29.4,0,6446,6642,52266
1983,49,a) 0,2838,2900,21951,11099,2812,193.9,0,0,21704,21704,0,195.5,195.5,0,0,0,0,0,21704,195.5,0,0,,,
1983,49,b) 1,2355,2450,17807,18825,23,0.8,817,28.5,5375,590,4785,3.1,28.6,7410,4636,2774,24.6,39.4,-2035,-10.8,57.2,0,609,609,3079
1983,49,c) 2,1940,2046,17463,18811,60,2.7,480,21.3,3700,394,3306,2.1,19.7,6395,3354,3041,17.8,34,-2695,-14.3,39.4,0,366,366,2529
1983,49,d) 3,1664,1758,12432,13422,53,2.8,339,18,2448,295,2153,2.2,18.2,4427,2240,2187,16.7,33,-1979,-14.8,36.4,0,241,241,1585
1983,49,e) 4,1651,1768,13795,14738,60,3.2,284,15.2,2535,250,2285,1.7,17.2,4421,1735,2686,11.8,30,-1886,-12.8,34.4,0,193,194,1286
1983,49,f) 5,1446,1506,13328,13610,60,3.8,208,13.3,2928,297,2631,2.2,21.5,3491,1511,1980,11.1,25.7,-563,-4.2,43,0,153,154,988
1983,49,g) 6 to 10,1421,1658,16635,16922,61,3.5,208,12.1,2666,359,2307,2.1,15.8,3239,1101,2138,6.5,19.1,-573,-3.3,31.6,0,113,113,631
1983,49,l) Left Censored,10145,14012,304668,312616,610,4.3,1166,8.2,36115,10318,25797,3.3,11.6,52011,11015,40996,3.5,16.6,-15896,-5,23.2,0,559,564,3869
1983,50,a) 0,1320,1325,5389,2715,1295,195.5,0,0,5348,,,,197,0,0,0,0,0,5348,197,0,1,,,
1983,50,b) 1,1082,1102,6256,6445,4,0.3,259,20.9,1597,,,,24.8,1974,901,1073,14,30.6,-377,-5.8,49.6,1,199,199,621
1983,50,c) 2,898,912,5729,6024,27,2.8,158,16.2,948,202,746,3.4,15.7,1538,760,778,12.6,25.5,-590,-9.8,31.4,0,113,113,409
1983,50,d) 3,757,768,4816,4852,20,2.4,135,16.5,913,78,835,1.6,18.8,985,490,495,10.1,20.3,-72,-1.5,37.6,0,101,101,387
1983,50,e) 4,708,725,4842,5221,18,2.3,113,14.7,708,123,585,2.4,13.6,1465,516,949,9.9,28.1,-757,-14.5,27.2,0,82,82,370
1983,50,f) 5,736,760,5359,5445,20,2.5,101,12.7,735,112,623,2.1,13.5,906,352,554,6.5,16.6,-171,-3.1,27,0,72,72,252
1983,50,g) 6 to 10,745,872,8394,8481,33,3.7,72,8.1,1448,200,1248,2.4,17.1,1622,428,1194,5,19.1,-174,-2,34.2,0,47,48,328
1983,50,l) Left Censored,5442,6560,120734,122973,168,2.5,487,7.3,10547,2342,8205,1.9,8.6,15025,2823,12202,2.3,12.2,-4478,-3.6,17.2,0,288,289,1482
1983,51,a) 0,9097,9172,46121,23222,9014,196.6,0,0,45798,45798,0,197.2,197.2,0,0,0,0,0,45798,197.2,0,0,,,
1983,51,b) 1,7126,7349,55492,56264,55,0.7,1894,22.8,14130,1160,12970,2.1,25.1,15673,9017,6656,16,27.9,-1543,-2.8,50.2,0,1503,1511,7247
1983,51,c) 2,5985,6271,54813,56571,251,3.8,1119,16.7,11105,1948,9157,3.4,19.6,14621,6524,8097,11.5,25.8,-3516,-6.2,39.2,0,901,901,4887
1983,51,d) 3,5383,5561,41650,42354,194,3.3,792,13.6,8278,1106,7172,2.6,19.5,9686,4217,5469,10,22.9,-1408,-3.4,39,0,620,620,3163
1983,51,e) 4,4967,5263,45539,45700,187,3.4,658,12,8269,1238,7031,2.7,18.1,8591,3245,5346,7.1,18.8,-322,-0.7,36.2,0,489,490,2520
1983,51,f) 5,4462,4783,42386,42193,162,3.3,580,11.8,8607,1351,7256,3.2,20.4,8221,2817,5404,6.7,19.5,386,0.9,39,0,429,429,2147
1983,51,g) 6 to 10,4549,5641,65638,65291,234,4.1,545,9.5,11367,2311,9056,3.5,17.4,10673,3654,7019,5.6,16.3,694,1.1,32.6,0,354,360,2211
1983,51,l) Left Censored,38498,55244,1268066,1290913,2147,3.8,4300,7.7,151893,36095,115798,2.8,11.8,197586,46908,150678,3.6,15.3,-45693,-3.5,23.6,0,2146,2181,14551
1983,53,a) 0,9873,10002,55287,27975,9782,195.6,0,0,54624,54624,0,195.3,195.3,0,0,0,0,0,54624,195.3,0,0,,,
1983,53,b) 1,7445,7669,54336,55773,38,0.4,2284,25.8,14691,805,13886,1.4,26.3,17564,10315,7249,18.5,31.5,-2873,-5.2,52.6,0,1650,1674,8145
1983,53,c) 2,6171,6394,46825,49799,274,4,1299,18.9,9509,1168,8341,2.3,19.1,15456,6824,8632,13.7,31,-5947,-11.9,38.2,0,960,960,4777
1983,53,d) 3,5778,5994,40709,42838,253,4,1013,16,8297,1397,6900,3.3,19.4,12555,5519,7036,12.9,29.3,-4258,-9.9,38.8,0,760,760,4035
1983,53,e) 4,5135,5360,35808,38228,220,3.9,885,15.7,6556,877,5679,2.3,17.1,11396,4891,6505,12.8,29.8,-4840,-12.7,34.2,0,648,659,3821
1983,53,f) 5,4730,5004,37978,40886,194,3.8,646,12.5,6006,818,5188,2,14.7,11822,3222,8600,7.9,28.9,-5816,-14.2,29.4,0,436,437,2132
1983,53,g) 6 to 10,4798,5751,55842,57356,255,4.3,707,11.9,9536,2074,7462,3.6,16.6,12564,3979,8585,6.9,21.9,-3028,-5.3,33.2,0,381,382,1852
1983,53,l) Left Censored,32362,44629,893288,897288,1742,3.8,3709,8.2,131332,50543,80789,5.6,14.6,139331,32199,107132,3.6,15.5,-7999,-0.9,29.2,0,1892,1912,12170
1983,54,a) 0,2401,2436,13025,6612,2358,193.6,0,0,12827,12827,0,194,194,0,0,0,0,0,12827,194,0,0,,,
1983,54,b) 1,2042,2097,16051,17477,12,0.5,686,27.9,3014,123,2891,0.7,17.2,5866,3322,2544,19,33.6,-2852,-16.4,34.4,0,551,551,2542
1983,54,c) 2,1718,1756,13721,14746,57,3,368,19.3,2178,272,1906,1.8,14.8,4228,1903,2325,12.9,28.7,-2050,-13.9,29.6,0,295,295,1566
1983,54,d) 3,1472,1540,10276,11016,52,3.2,286,17.4,1308,171,1137,1.6,11.9,2788,1189,1599,10.8,25.3,-1480,-13.4,23.8,0,221,221,909
1983,54,e) 4,1440,1507,9693,10462,49,3.1,232,14.7,1479,357,1122,3.4,14.1,3017,1330,1687,12.7,28.8,-1538,-14.7,28.2,0,164,164,1027
1983,54,f) 5,1299,1404,10326,10799,73,5.1,189,13.1,1695,305,1390,2.8,15.7,2640,1020,1620,9.4,24.4,-945,-8.7,31.4,0,139,139,804
1983,54,g) 6 to 10,1449,1686,15087,16081,58,3.3,204,11.8,1923,364,1559,2.3,12,3911,1064,2847,6.6,24.3,-1988,-12.3,24,0,127,127,600
1983,54,l) Left Censored,13929,18353,334335,356371,726,3.9,1551,8.3,31142,11110,20032,3.1,8.7,75215,15794,59421,4.4,21.1,-44073,-12.4,17.4,0,819,823,5176
1983,55,a) 0,7222,7314,39165,19806,7150,195.5,0,0,38719,38719,0,195.5,195.5,0,0,0,0,0,38719,195.5,0,0,,,
1983,55,b) 1,5943,6137,41085,43478,41,0.6,1433,20.9,8178,931,7247,2.1,18.8,12964,7010,5954,16.1,29.8,-4786,-11,37.6,0,1062,1063,5184
1983,55,c) 2,5210,5387,41496,43266,137,2.4,894,15.5,6929,904,6025,2.1,16,10469,5098,5371,11.8,24.2,-3540,-8.2,32,0,657,658,3582
1983,55,d) 3,4787,4935,33751,35171,168,3.2,716,13.8,5536,893,4643,2.5,15.7,8376,4258,4118,12.1,23.8,-2840,-8.1,31.4,0,524,524,3373
1983,55,e) 4,4683,4915,35853,36696,158,3.1,624,12.2,6009,1168,4841,3.2,16.4,7694,3051,4643,8.3,21,-1685,-4.6,32.8,0,441,441,2319
1983,55,f) 5,4673,4936,38142,39890,140,2.8,542,10.7,5834,999,4835,2.5,14.6,9330,2820,6510,7.1,23.4,-3496,-8.8,29.2,0,389,390,2151
1983,55,g) 6 to 10,4765,5719,51009,52970,205,3.5,578,9.9,6784,1703,5081,3.2,12.8,10706,3136,7570,5.9,20.2,-3922,-7.4,25.6,0,338,342,1609
1983,55,l) Left Censored,42949,54918,1211304,1243303,1618,2.9,3779,6.8,120178,26639,93539,2.1,9.7,184175,38701,145474,3.1,14.8,-63997,-5.1,19.4,0,2028,2043,13223
1983,56,a) 0,1473,1506,9054,4621,1463,194.3,0,0,8867,8867,0,191.9,191.9,0,0,0,0,0,8867,191.9,0,0,,,
1983,56,b) 1,1218,1243,7521,12515,9,0.6,507,33.8,1641,141,1500,1.1,13.1,11629,2303,9326,18.4,92.9,-9988,-79.8,26.2,0,393,393,1883
1983,56,c) 2,1075,1111,6634,7809,38,3.1,264,21.5,888,100,788,1.3,11.4,3237,1305,1932,16.7,41.5,-2349,-30.1,22.8,0,201,201,1102
1983,56,d) 3,847,884,5768,7189,28,2.9,188,19.5,755,100,655,1.4,10.5,3597,1368,2229,19,50,-2842,-39.5,21,0,141,142,1196
1983,56,e) 4,864,921,6674,7576,31,3.1,180,18.2,890,120,770,1.6,11.7,2694,1034,1660,13.6,35.6,-1804,-23.9,23.4,0,142,142,837
1983,56,f) 5,749,764,5831,6540,25,3.1,128,15.9,827,236,591,3.6,12.6,2244,733,1511,11.2,34.3,-1417,-21.7,25.2,0,98,98,509
1983,56,g) 6 to 10,697,810,8082,8716,23,2.7,103,12.2,1073,132,941,1.5,12.3,2340,700,1640,8,26.8,-1267,-14.5,24.6,0,59,59,360
1983,56,l) Left Censored,4544,5878,84665,91500,238,4,547,9.1,10516,3293,7223,3.6,11.5,24186,4717,19469,5.2,26.4,-13670,-14.9,23,0,275,275,1867
1984,01,a) 0,7745,7782,40539,20319,7747,199.1,0,0,40440,40440,0,199,199,0,0,0,0,0,40440,199,0,0,,,
1984,01,b) 1,4446,4530,31376,31450,32,0.6,1421,27.1,9056,473,8583,1.5,28.8,9203,5741,3462,18.3,29.3,-147,-0.5,57.6,0,1110,1111,4739
1984,01,c) 2,3576,3722,30542,31553,153,3.8,842,20.6,7192,917,6275,2.9,22.8,9213,6151,3062,19.5,29.2,-2021,-6.4,45.6,0,669,670,5323
1984,01,d) 3,3272,3415,31441,31310,125,3.4,570,15.7,6449,562,5887,1.8,20.6,6186,2859,3327,9.1,19.8,263,0.8,39.6,0,447,447,2334
1984,01,e) 4,3053,3176,25188,24617,142,4.2,476,14.2,5648,534,5114,2.2,22.9,4506,2103,2403,8.5,18.3,1142,4.6,36.6,0,354,354,1512
1984,01,f) 5,2931,3134,33683,33627,139,4.2,469,14.2,5817,925,4892,2.8,17.3,5705,2361,3344,7,17,112,0.3,34,0,334,335,1798
1984,01,g) 6 to 10,5870,6910,67719,66954,314,4.4,764,10.7,12649,1798,10851,2.7,18.9,11119,4509,6610,6.7,16.6,1530,2.3,33.2,0,484,485,2565
1984,01,l) Left Censored,24245,34564,818161,800500,1380,3.9,2866,8.1,126956,29233,97723,3.7,15.9,91633,32299,59334,4,11.4,35323,4.5,22.8,0,1490,1508,10173
1984,02,a) 0,1954,1966,9713,4873,1950,198.4,0,0,9681,9681,0,198.7,198.7,0,0,0,0,0,9681,198.7,0,0,,,
1984,02,b) 1,1322,1348,8883,8992,11,0.7,451,28.6,3047,88,2959,1,33.9,3265,1967,1298,21.9,36.3,-218,-2.4,67.8,0,319,319,1554
1984,02,c) 2,891,941,7433,7859,35,3.4,230,22.1,1898,150,1748,1.9,24.2,2749,1407,1342,17.9,35,-851,-10.8,48.4,0,165,165,1024
1984,02,d) 3,614,649,6231,6415,40,5.8,105,15.3,1652,417,1235,6.5,25.8,2019,686,1333,10.7,31.5,-367,-5.7,51.6,0,78,78,382
1984,02,e) 4,583,601,5372,5226,32,5.1,76,12.2,1546,274,1272,5.2,29.6,1254,441,813,8.4,24,292,5.6,48,0,54,54,342
1984,02,f) 5,574,633,5246,5462,31,4.7,94,14.2,1081,138,943,2.5,19.8,1512,805,707,14.7,27.7,-431,-7.9,39.6,0,54,54,525
1984,02,g) 6 to 10,996,1182,12337,12629,64,5.3,141,11.6,2176,381,1795,3,17.2,2760,978,1782,7.7,21.9,-584,-4.7,34.4,0,71,71,522
1984,02,l) Left Censored,2787,4042,85755,84408,293,7.2,362,8.9,16365,5504,10861,6.5,19.4,13672,4044,9628,4.8,16.2,2693,3.2,32.4,0,160,161,1412
1984,04,a) 0,8599,8689,48708,24420,8639,198.8,0,0,48576,48576,0,198.9,198.9,0,0,0,0,0,48576,198.9,0,0,,,
1984,04,b) 1,5488,5652,51776,50648,73,1.1,1565,24.3,18796,2721,16075,5.4,37.1,16539,6843,9696,13.5,32.7,2257,4.4,65.4,0,1158,1158,5271
1984,04,c) 2,4740,4966,44608,43216,223,4.1,1099,20.3,13259,1609,11650,3.7,30.7,10475,5646,4829,13.1,24.2,2784,6.5,48.4,0,836,841,4458
1984,04,d) 3,3799,3972,34537,34213,150,3.5,720,16.9,8452,666,7786,1.9,24.7,7804,3968,3836,11.6,22.8,648,1.9,45.6,0,519,521,2924
1984,04,e) 4,3568,3748,33442,32541,163,4.1,583,14.7,8643,838,7805,2.6,26.6,6840,3151,3689,9.7,21,1803,5.6,42,0,434,436,2543
1984,04,f) 5,3137,3422,35670,33986,154,4.3,504,14,10107,2727,7380,8,29.7,6739,3137,3602,9.2,19.8,3368,9.9,39.6,0,354,354,2085
1984,04,g) 6 to 10,5115,5900,70148,67308,268,4.4,736,12,16721,1647,15074,2.4,24.8,11040,4308,6732,6.4,16.4,5681,8.4,32.8,0,442,446,2601
1984,04,l) Left Censored,15546,24615,616824,600233,1311,5.3,2030,8.1,106323,29808,76515,5,17.7,73141,23395,49746,3.9,12.2,33182,5.5,24.4,0,887,896,7344
1984,05,a) 0,5362,5391,25721,12886,5364,199,0,0,25671,25671,0,199.2,199.2,0,0,0,0,0,25671,199.2,0,0,,,
1984,05,b) 1,3180,3236,20989,20886,25,0.7,1025,27.3,6365,291,6074,1.4,30.5,6159,4079,2080,19.5,29.5,206,1,59,0,791,791,3153
1984,05,c) 2,2617,2676,20409,20729,92,3.1,609,20.7,4236,390,3846,1.9,20.4,4876,2651,2225,12.8,23.5,-640,-3.1,40.8,0,478,479,2178
1984,05,d) 3,2308,2395,20585,20723,78,3,424,16.5,3921,307,3614,1.5,18.9,4196,1854,2342,8.9,20.2,-275,-1.3,37.8,0,319,319,1518
1984,05,e) 4,2213,2334,20112,20056,83,3.4,339,13.8,4219,577,3642,2.9,21,4106,1700,2406,8.5,20.5,113,0.5,41,0,246,246,1419
1984,05,f) 5,2302,2436,19071,18746,93,3.7,318,12.5,3829,432,3397,2.3,20.4,3178,1483,1695,7.9,17,651,3.4,34,0,231,233,1169
1984,05,g) 6 to 10,4088,4581,40382,39108,184,3.9,487,10.3,7989,1586,6403,4.1,20.4,5440,2457,2983,6.3,13.9,2549,6.5,27.8,0,326,327,1507
1984,05,l) Left Censored,15556,20673,446781,438753,845,4,1742,8.3,63533,13388,50145,3.1,14.5,47477,16599,30878,3.8,10.8,16056,3.7,21.6,0,969,984,5989
1984,06,a) 0,60585,61144,363145,182409,60821,198.9,0,0,361472,361472,0,198.2,198.2,0,0,0,0,0,361472,198.2,0,0,,,
1984,06,b) 1,41721,42595,371473,364898,275,0.6,12041,24.7,112043,5099,106944,1.4,30.7,98892,57337,41555,15.7,27.1,13151,3.6,54.2,0,8629,8630,44658
1984,06,c) 2,37506,39391,336157,335968,1765,4.1,7819,18.4,93340,11036,82304,3.3,27.8,92962,52229,40733,15.5,27.7,378,0.1,55.4,0,5541,5564,40629
1984,06,d) 3,34690,36411,382707,367138,1717,4.5,5853,15.2,100393,15523,84870,4.2,27.3,69254,33716,35538,9.2,18.9,31139,8.4,37.8,0,4114,4119,24452
1984,06,e) 4,31135,32559,299112,290223,1578,4.6,4851,14.2,73720,8278,65442,2.9,25.4,55942,27276,28666,9.4,19.3,17778,6.1,38.6,0,3313,3330,19427
1984,06,f) 5,28444,30310,272202,268419,1519,4.8,4225,13.4,63883,8458,55425,3.2,23.8,56316,27209,29107,10.1,21,7567,2.8,42,0,2870,2878,18224
1984,06,g) 6 to 10,50208,58334,670526,650066,3073,5.1,6648,11.1,146037,24784,121253,3.8,22.5,105117,40993,64124,6.3,16.2,40920,6.3,32.4,0,3940,3969,22995
1984,06,l) Left Censored,160384,237042,6141429,6041930,10775,4.5,20087,8.3,991524,249307,742217,4.1,16.4,792526,240134,552392,4,13.1,198998,3.3,26.2,0,9891,9972,62447
1984,08,a) 0,10267,10335,57532,28868,10285,199,0,0,57328,57328,0,198.6,198.6,0,0,0,0,0,57328,198.6,0,0,,,
1984,08,b) 1,6644,6872,58181,57411,77,1,2182,27.4,20744,4566,16178,8,36.1,19203,9355,9848,16.3,33.4,1541,2.7,66.8,0,1662,1662,7446
1984,08,c) 2,5780,6031,48304,50338,243,3.7,1357,20.5,12308,1772,10536,3.5,24.5,16375,7914,8461,15.7,32.5,-4067,-8,49,0,1043,1045,6072
1984,08,d) 3,4977,5211,53698,54267,225,4,931,16.7,10603,1248,9355,2.3,19.5,11741,5185,6556,9.6,21.6,-1138,-2.1,39,0,709,709,3719
1984,08,e) 4,4518,4700,40924,40859,185,3.7,794,15.9,9231,1136,8095,2.8,22.6,9101,4343,4758,10.6,22.3,130,0.3,44.6,0,612,613,3311
1984,08,f) 5,4171,4439,39327,39944,198,4.2,701,15,7913,976,6937,2.4,19.8,9147,4083,5064,10.2,22.9,-1234,-3.1,39.6,0,487,489,2961
1984,08,g) 6 to 10,6965,7893,84391,83031,360,4.4,997,12.2,18797,2496,16301,3,22.6,16076,5805,10271,7,19.4,2721,3.2,38.8,0,658,661,3682
1984,08,l) Left Censored,22218,31774,746280,741246,1674,5.2,2772,8.6,108721,32403,76318,4.4,14.7,98654,30454,68200,4.1,13.3,10067,1.4,26.6,0,1303,1317,8658
1984,09,a) 0,6530,6563,35526,17814,6532,199.1,0,0,35425,35425,0,198.9,198.9,0,0,0,0,0,35425,198.9,0,0,,,
1984,09,b) 1,4664,4709,32198,31486,19,0.4,1009,19.3,10095,233,9862,0.7,32.1,8670,5334,3336,16.9,27.5,1425,4.6,55,0,758,758,4445
1984,09,c) 2,4143,4279,47377,47222,120,2.6,721,15.7,8437,648,7789,1.4,17.9,8126,3585,4541,7.6,17.2,311,0.7,34.4,0,547,548,2937
1984,09,d) 3,3759,3932,33930,32981,125,3,524,12.7,7478,852,6626,2.6,22.7,5579,2329,3250,7.1,16.9,1899,5.8,33.8,0,399,399,1671
1984,09,e) 4,3250,3368,25946,25562,94,2.7,429,12.1,5001,427,4574,1.7,19.6,4232,1895,2337,7.4,16.6,769,3,33.2,0,316,316,1347
1984,09,f) 5,3089,3186,26899,26698,98,3,353,10.7,5306,484,4822,1.8,19.9,4903,1751,3152,6.6,18.4,403,1.5,36.8,0,252,252,1226
1984,09,g) 6 to 10,6137,6963,75771,75499,252,3.5,712,9.9,13964,1962,12002,2.6,18.5,13420,4128,9292,5.5,17.8,544,0.7,35.6,0,465,467,2245
1984,09,l) Left Censored,29733,37362,1046096,1035708,1332,3.5,2610,6.9,138075,34163,103912,3.3,13.3,117298,35116,82182,3.4,11.3,20777,2,22.6,0,1449,1457,11044
1984,10,a) 0,1255,1261,6628,3324,1252,198.6,0,0,6609,6609,0,198.8,198.8,0,0,0,0,0,6609,198.8,0,0,,,
1984,10,b) 1,852,861,5621,5449,6,0.6,220,22.6,1666,32,1634,0.6,30.6,1321,789,532,14.5,24.2,345,6.4,48.4,0,159,159,576
1984,10,c) 2,697,708,5735,5666,38,5,132,17.5,1391,330,1061,5.8,24.5,1253,633,620,11.2,22.1,138,2.4,44.2,0,94,94,466
1984,10,d) 3,624,650,5492,5333,19,2.7,99,14.3,1135,279,856,5.2,21.3,816,322,494,6,15.3,319,6,30.6,0,72,72,227
1984,10,e) 4,559,579,4603,4772,17,2.8,94,15.2,946,65,881,1.4,19.8,1284,729,555,15.3,26.9,-338,-7.1,39.6,0,62,62,413
1984,10,f) 5,543,562,5512,5405,15,2.5,75,12.7,1156,83,1073,1.5,21.4,941,375,566,6.9,17.4,215,4,34.8,0,59,59,321
1984,10,g) 6 to 10,1052,1213,13498,13137,37,2.9,133,10.6,2664,193,2471,1.5,20.3,1942,557,1385,4.2,14.8,722,5.5,29.6,0,82,83,286
1984,10,l) Left Censored,5031,6436,183774,180724,242,3.7,544,8.3,25067,6122,18945,3.4,13.9,18966,6234,12732,3.4,10.5,6101,3.4,21,0,251,253,1468
1984,11,a) 0,1322,1332,8422,4216,1331,199.8,0,0,8412,8412,0,199.5,199.5,0,0,0,0,0,8412,199.5,0,0,,,
1984,11,b) 1,1110,1118,9432,10387,11,0.8,340,26.2,2568,,,,24.7,4477,1667,2810,16,43.1,-1909,-18.4,49.4,1,204,204,1129
1984,11,c) 2,951,968,8840,9181,36,3.3,285,25.9,2513,215,2298,2.3,27.4,3194,2023,1171,22,34.8,-681,-7.4,54.8,0,174,174,800
1984,11,d) 3,802,819,11664,11550,25,2.8,170,18.9,1824,155,1669,1.3,15.8,1596,854,742,7.4,13.8,228,2,27.6,0,103,103,536
1984,11,e) 4,669,682,6905,7145,21,2.8,159,21.1,1454,127,1327,1.8,20.3,1933,1172,761,16.4,27.1,-479,-6.8,40.6,0,97,97,900
1984,11,f) 5,622,646,7013,6610,23,3.3,122,17.6,2078,,,,31.4,1272,756,516,11.4,19.2,806,12.2,38.4,1,74,74,418
1984,11,g) 6 to 10,1382,1559,39546,38129,55,3.4,210,12.8,6752,1130,5622,3,17.7,3917,1315,2602,3.4,10.3,2835,7.4,20.6,0,126,126,653
1984,11,l) Left Censored,6935,8789,255198,266275,371,4.1,785,8.7,30808,8404,22404,3.2,11.6,52962,10219,42743,3.8,19.9,-22154,-8.3,23.2,0,395,395,2419
1984,12,a) 0,33262,33452,188441,94427,33304,199.1,0,0,188028,188028,0,199.1,199.1,0,0,0,0,0,188028,199.1,0,0,,,
1984,12,b) 1,22277,22677,163565,160185,157,0.6,6727,25.8,55583,2109,53474,1.3,34.7,48823,28491,20332,17.8,30.5,6760,4.2,61,0,5198,5199,22818
1984,12,c) 2,18593,19242,164827,165124,1065,5.1,4199,20.1,42433,6506,35927,3.9,25.7,43028,22533,20495,13.6,26.1,-595,-0.4,51.4,0,3244,3267,17893
1984,12,d) 3,15915,16556,152125,147870,908,5.2,2852,16.3,38547,6980,31567,4.7,26.1,30037,15338,14699,10.4,20.3,8510,5.8,40.6,0,2187,2189,11951
1984,12,e) 4,13771,14252,119255,116102,1163,7.9,2294,15.5,31792,7904,23888,6.8,27.4,25486,13222,12264,11.4,22,6306,5.4,44,0,1738,1740,10324
1984,12,f) 5,11955,12614,120406,116434,1121,8.7,1707,13.2,31108,8477,22631,7.3,26.7,23164,10170,12994,8.7,19.9,7944,6.8,39.8,0,1240,1244,7359
1984,12,g) 6 to 10,21642,25065,256213,252275,1378,5.3,2918,11.3,54521,11144,43377,4.4,21.6,46644,17980,28664,7.1,18.5,7877,3.1,37,0,1882,1887,10687
1984,12,l) Left Censored,67567,103251,2329024,2268400,5742,5.5,8012,7.7,397608,125574,272034,5.5,17.5,276361,89763,186598,4,12.2,121247,5.3,24.4,0,4075,4143,27428
1984,13,a) 0,13059,13165,73138,36642,13112,199.2,0,0,72993,72993,0,199.2,199.2,0,0,0,0,0,72993,199.2,0,0,,,
1984,13,b) 1,8299,8403,60871,58562,60,0.6,2415,25.1,20942,1197,19745,2,35.8,16324,10633,5691,18.2,27.9,4618,7.9,55.8,0,1810,1810,8203
1984,13,c) 2,6769,7108,64617,63960,247,3.2,1445,18.7,15734,1833,13901,2.9,24.6,14420,8334,6086,13,22.5,1314,2.1,45,0,1097,1098,6251
1984,13,d) 3,5837,6105,59035,58862,237,3.7,1002,15.4,14091,2335,11756,4,23.9,13745,7226,6519,12.3,23.4,346,0.5,46.8,0,730,734,5148
1984,13,e) 4,5196,5527,50613,49137,257,4.4,814,14,11385,1210,10175,2.5,23.2,8433,4294,4139,8.7,17.2,2952,6,34.4,0,578,579,3155
1984,13,f) 5,4854,5143,49357,48199,242,4.5,728,13.5,11991,2322,9669,4.8,24.9,9674,4472,5202,9.3,20.1,2317,4.8,40.2,0,493,502,2714
1984,13,g) 6 to 10,9428,10838,119030,116026,472,4.2,1202,10.8,25144,3473,21671,3,21.7,19135,7671,11464,6.6,16.5,6009,5.2,33,0,732,732,4612
1984,13,l) Left Censored,37534,56586,1457050,1420692,2525,4.4,4348,7.6,217641,56780,160861,4,15.3,144924,48582,96342,3.4,10.2,72717,5.1,20.4,0,2087,2101,15091
1984,15,a) 0,1803,1819,9480,4755,1808,198.8,0,0,9451,9451,0,198.8,198.8,0,0,0,0,0,9451,198.8,0,0,,,
1984,15,b) 1,1661,1689,11594,11817,20,1,491,25.4,2847,141,2706,1.2,24.1,3293,1898,1395,16.1,27.9,-446,-3.8,48.2,0,350,350,1442
1984,15,c) 2,1444,1480,10823,11259,51,3.2,318,19.6,2422,365,2057,3.2,21.5,3293,2047,1246,18.2,29.2,-871,-7.7,43,0,235,241,1525
1984,15,d) 3,1368,1442,16105,16270,52,3.4,225,14.7,2435,322,2113,2,15,2765,1106,1659,6.8,17,-330,-2,30,0,161,161,925
1984,15,e) 4,1179,1269,11316,11228,51,3.8,211,15.6,2279,327,1952,2.9,20.3,2102,1046,1056,9.3,18.7,177,1.6,37.4,0,144,144,705
1984,15,f) 5,1069,1145,11440,11571,49,4.1,146,12.3,1959,480,1479,4.1,16.9,2221,746,1475,6.4,19.2,-262,-2.3,33.8,0,98,99,566
1984,15,g) 6 to 10,1880,2274,23977,25883,97,4.1,297,12.5,3401,524,2877,2,13.1,7213,2172,5041,8.4,27.9,-3812,-14.8,26.2,0,169,170,1068
1984,15,l) Left Censored,7565,10710,216074,218015,398,3.6,835,7.6,24359,6490,17869,3,11.2,28241,8567,19674,3.9,13,-3882,-1.8,22.4,0,392,416,2605
1984,16,a) 0,2176,2190,11112,5574,2176,198.7,0,0,11077,11077,0,198.7,198.7,0,0,0,0,0,11077,198.7,0,0,,,
1984,16,b) 1,1555,1606,13744,13084,11,0.6,468,25.4,5113,226,4887,1.7,39.1,3792,2003,1789,15.3,29,1321,10.1,58,0,356,356,1646
1984,16,c) 2,1330,1381,9779,10257,54,3.6,284,18.9,1953,302,1651,2.9,19,2908,1521,1387,14.8,28.4,-955,-9.4,38,0,213,213,1249
1984,16,d) 3,1155,1197,9008,8961,53,4.2,206,16.2,2000,245,1755,2.7,22.3,1905,837,1068,9.3,21.3,95,1,42.6,0,160,160,682
1984,16,e) 4,1086,1120,8574,8353,56,4.7,188,15.8,1983,281,1702,3.4,23.7,1540,739,801,8.8,18.4,443,5.3,36.8,0,138,138,555
1984,16,f) 5,1091,1157,12871,11148,53,4.4,163,13.4,5615,172,5443,1.5,50.4,2168,1225,943,11,19.4,3447,31,38.8,0,109,109,558
1984,16,g) 6 to 10,1975,2172,19143,18666,113,5.1,214,9.6,3465,490,2975,2.6,18.6,2511,1014,1497,5.4,13.5,954,5.1,27,0,148,148,752
1984,16,l) Left Censored,6994,9658,163894,163198,354,3.6,769,7.8,20959,5197,15762,3.2,12.8,19567,6220,13347,3.8,12,1392,0.8,24,0,438,441,2680
1984,17,a) 0,19410,19589,112146,56196,19483,198.9,0,0,111900,111900,0,199.1,199.1,0,0,0,0,0,111900,199.1,0,0,,,
1984,17,b) 1,13286,13503,113034,111014,74,0.5,3230,21.3,35350,2039,33311,1.8,31.8,31310,15228,16082,13.7,28.2,4040,3.6,56.4,0,2243,2246,10673
1984,17,c) 2,12463,12915,120772,119579,639,4.7,2204,16.1,25957,3711,22246,3.1,21.7,23570,10849,12721,9.1,19.7,2387,2,39.4,0,1571,1576,7624
1984,17,d) 3,10671,11068,108718,105505,545,4.7,1637,14.1,24795,4683,20112,4.4,23.5,18369,8074,10295,7.7,17.4,6426,6.1,34.8,0,1172,1172,5443
1984,17,e) 4,9894,10242,86339,84221,740,7,1391,13.2,19129,4432,14697,5.3,22.7,14893,7241,7652,8.6,17.7,4236,5,35.4,0,1000,1002,5240
1984,17,f) 5,9108,9558,80344,79358,582,5.9,1189,12.1,16314,3672,12642,4.6,20.6,14341,6381,7960,8,18.1,1973,2.5,36.2,0,862,863,4934
1984,17,g) 6 to 10,18226,20817,214389,214060,994,4.6,2241,10.5,38065,7899,30166,3.7,17.8,37407,13241,24166,6.2,17.5,658,0.3,35,0,1324,1335,7257
1984,17,l) Left Censored,87696,116967,3139006,3081690,4719,4,7583,6.4,438707,99514,339193,3.2,14.2,324076,103371,220705,3.4,10.5,114631,3.7,21,0,2116,2144,11557
1984,18,a) 0,9794,9900,57005,29179,9664,195.2,0,0,55652,55652,0,190.7,190.7,0,0,0,0,0,55652,190.7,0,0,,,
1984,18,b) 1,6524,6630,47141,44578,32,0.5,758,10.8,13343,992,12351,2.2,29.9,8217,2888,5329,6.5,18.4,5126,11.5,36.8,0,34,34,134
1984,18,c) 2,5153,5396,45538,44109,164,2.9,668,11.8,11063,1662,9401,3.8,25.1,8204,3397,4807,7.7,18.6,2859,6.5,37.2,0,33,34,358
1984,18,d) 3,4400,4642,47636,46838,116,2.4,464,9.7,8516,764,7752,1.6,18.2,6919,3013,3906,6.4,14.8,1597,3.4,29.6,0,16,16,134
1984,18,e) 4,4328,4512,34799,33947,80,1.8,307,6.8,6470,634,5836,1.9,19.1,4766,1414,3352,4.2,14,1704,5.1,28,0,11,11,127
1984,18,f) 5,4288,4524,35217,34119,132,2.9,365,8,7182,932,6250,2.7,21,4985,1902,3083,5.6,14.6,2197,6.4,29.2,0,10,10,117
1984,18,g) 6 to 10,8201,9512,96240,94254,306,3.2,848,8.8,16993,2551,14442,2.7,18,13021,4228,8793,4.5,13.8,3972,4.2,27.6,0,16,24,184
1984,18,l) Left Censored,39344,55301,1383552,1357494,1725,3.1,2986,5.4,197574,47676,149898,3.5,14.6,145459,50781,94678,3.7,10.7,52115,3.9,21.4,0,34,48,779
1984,19,a) 0,5824,5849,28011,14050,5822,199.1,0,0,27923,27923,0,198.7,198.7,0,0,0,0,0,27923,198.7,0,0,,,
1984,19,b) 1,3701,3860,25932,26495,100,2.3,1081,24.7,8176,3090,5086,11.7,30.9,9302,4243,5059,16,35.1,-1126,-4.2,61.8,0,832,832,3460
1984,19,c) 2,3270,3363,23019,23776,99,2.7,709,19.3,4197,605,3592,2.5,17.7,5710,3078,2632,12.9,24,-1513,-6.3,35.4,0,543,545,2399
1984,19,d) 3,3120,3277,26560,26799,101,2.9,519,14.9,4128,767,3361,2.9,15.4,4605,2366,2239,8.8,17.2,-477,-1.8,30.8,0,390,390,1539
1984,19,e) 4,3011,3094,20108,20799,82,2.5,451,13.7,3899,312,3587,1.5,18.7,5281,1941,3340,9.3,25.4,-1382,-6.7,37.4,0,326,326,1371
1984,19,f) 5,2754,2943,20241,20468,122,4,389,12.7,3342,611,2731,3,16.3,3795,1802,1993,8.8,18.5,-453,-2.2,32.6,0,273,273,1324
1984,19,g) 6 to 10,5836,6731,53617,55011,286,4.1,802,11.5,7839,1569,6270,2.9,14.2,10626,4253,6373,7.7,19.3,-2787,-5.1,28.4,0,537,539,2532
1984,19,l) Left Censored,26733,35788,629172,625795,1073,2.9,2692,7.4,77522,16806,60716,2.7,12.4,70767,19856,50911,3.2,11.3,6755,1.1,22.6,0,1527,1535,7429
1984,20,a) 0,6105,6142,32481,16265,6122,199.3,0,0,32432,32432,0,199.4,199.4,0,0,0,0,0,32432,199.4,0,0,,,
1984,20,b) 1,3809,3887,24985,25349,27,0.6,1243,27.5,7501,492,7009,1.9,29.6,8229,5254,2975,20.7,32.5,-728,-2.9,59.2,0,891,891,3853
1984,20,c) 2,3250,3371,26423,27323,110,2.9,846,22.6,5390,857,4533,3.1,19.7,7189,3942,3247,14.4,26.3,-1799,-6.6,39.4,0,557,558,2489
1984,20,d) 3,2868,3019,26167,25306,118,3.6,623,19,7274,599,6675,2.4,28.7,5551,3069,2482,12.1,21.9,1723,6.8,43.8,0,393,393,1755
1984,20,e) 4,2476,2588,18494,18900,116,4.2,448,16.3,3483,680,2803,3.6,18.4,4294,2279,2015,12.1,22.7,-811,-4.3,36.8,0,278,280,1508
1984,20,f) 5,2365,2465,18225,18496,82,3.1,428,16.3,3408,508,2900,2.7,18.4,3950,2081,1869,11.3,21.4,-542,-3,36.8,0,243,243,1080
1984,20,g) 6 to 10,4710,5409,46625,48079,207,3.6,831,14.6,8417,1497,6920,3.1,17.5,11325,5068,6257,10.5,23.6,-2908,-6.1,35,0,519,519,2916
1984,20,l) Left Censored,21425,28691,583393,562778,1068,3.6,2686,9.1,105500,16539,88961,2.9,18.7,64270,23834,40436,4.2,11.4,41230,7.3,22.8,0,1274,1281,9007
1984,21,a) 0,6720,6763,33988,17026,6734,199.1,0,0,33924,33924,0,199.2,199.2,0,0,0,0,0,33924,199.2,0,0,,,
1984,21,b) 1,4375,4441,33924,34757,24,0.5,1313,25.7,7962,560,7402,1.6,22.9,9627,5752,3875,16.5,27.7,-1665,-4.8,45.8,0,1040,1040,4688
1984,21,c) 2,3674,3811,30810,32642,134,3.2,820,19.7,6642,953,5689,2.9,20.3,10306,6526,3780,20,31.6,-3664,-11.3,40.6,0,654,655,5706
1984,21,d) 3,3029,3159,26896,27364,110,3.3,549,16.2,5339,719,4620,2.6,19.5,6275,3315,2960,12.1,22.9,-936,-3.4,39,0,436,436,2776
1984,21,e) 4,2677,2803,21617,22143,99,3.3,477,16,4101,445,3656,2,18.5,5152,2652,2500,12,23.3,-1051,-4.8,37,0,344,344,1860
1984,21,f) 5,2672,2794,26102,26477,92,3.1,419,14.2,3951,449,3502,1.7,14.9,4701,2160,2541,8.2,17.8,-750,-2.9,29.8,0,304,304,1320
1984,21,g) 6 to 10,5303,5922,54561,54522,262,4.3,754,12.2,9194,1632,7562,3,16.9,9115,3815,5300,7,16.7,79,0.2,33.4,0,494,496,2128
1984,21,l) Left Censored,24230,33140,719038,711092,1261,3.7,2687,7.9,93521,23197,70324,3.3,13.2,77629,24215,53414,3.4,10.9,15892,2.3,21.8,0,1453,1459,8715
1984,22,a) 0,8706,8754,49856,25076,8700,198.8,0,0,49561,49561,0,197.6,197.6,0,0,0,0,0,49561,197.6,0,0,,,
1984,22,b) 1,6125,6247,47517,46696,49,0.7,1911,26.5,15738,585,15153,1.3,33.7,14096,7812,6284,16.7,30.2,1642,3.5,60.4,0,1467,1467,6017
1984,22,c) 2,5778,6034,46340,47658,225,3.4,1416,21.3,11224,1218,10006,2.6,23.6,13859,7906,5953,16.6,29.1,-2635,-5.5,47.2,0,1070,1075,6336
1984,22,d) 3,4792,4961,46263,47700,160,3,960,17.9,9480,1358,8122,2.8,19.9,12353,5476,6877,11.5,25.9,-2873,-6,39.8,0,740,741,4160
1984,22,e) 4,4225,4410,41392,42794,141,3,747,15.9,7667,755,6912,1.8,17.9,10470,4437,6033,10.4,24.5,-2803,-6.6,35.8,0,561,562,3303
1984,22,f) 5,4124,4412,41360,43011,160,3.4,667,14.3,7085,1281,5804,3,16.5,10387,3740,6647,8.7,24.1,-3302,-7.6,33,0,495,495,2733
1984,22,g) 6 to 10,6845,7653,83828,85173,277,3.5,974,12.2,13570,2732,10838,3.2,15.9,16260,6655,9605,7.8,19.1,-2690,-3.2,31.8,0,652,653,3923
1984,22,l) Left Censored,28155,40073,878405,887928,1840,4.5,3243,8,115458,31935,83523,3.6,13,134503,37848,96655,4.3,15.1,-19045,-2.1,26,0,1618,1636,10388
1984,23,a) 0,2561,2577,11643,5835,2563,198.9,0,0,11617,11617,0,199.1,199.1,0,0,0,0,0,11617,199.1,0,0,,,
1984,23,b) 1,1713,1724,10206,10029,5,0.3,383,19.9,2741,,,,27.3,2387,1204,1183,12,23.8,354,3.5,47.6,1,274,274,900
1984,23,c) 2,1379,1427,10706,10688,37,2.4,236,15.4,2076,127,1949,1.2,19.4,2039,1011,1028,9.5,19.1,37,0.3,38.2,0,188,188,892
1984,23,d) 3,1225,1275,10407,10386,44,3.3,196,14.5,1964,218,1746,2.1,18.9,1921,953,968,9.2,18.5,43,0.4,37,0,146,146,604
1984,23,e) 4,1180,1210,9130,8996,44,3.5,149,11.8,1896,144,1752,1.6,21.1,1627,1011,616,11.2,18.1,269,3,36.2,0,106,107,754
1984,23,f) 5,1117,1148,9410,9433,48,4,124,10.4,1471,,,,15.6,1516,656,860,7,16.1,-45,-0.5,31.2,1,82,82,500
1984,23,g) 6 to 10,2233,2519,23639,23272,115,4.4,261,10.1,3873,572,3301,2.5,16.6,3138,1089,2049,4.7,13.5,735,3.1,27,0,174,174,578
1984,23,l) Left Censored,9216,11977,252569,249361,468,3.8,874,7.2,30898,6587,24311,2.6,12.4,24483,7178,17305,2.9,9.8,6415,2.6,19.6,0,474,481,2422
1984,24,a) 0,7070,7117,47855,23945,7102,199.6,0,0,47820,47820,0,199.7,199.7,0,0,0,0,0,47820,199.7,0,0,,,
1984,24,b) 1,5322,5414,40187,39295,25,0.4,1708,27.1,13277,508,12769,1.3,33.8,11493,7944,3549,20.2,29.2,1784,4.6,58.4,0,1056,1058,4863
1984,24,c) 2,4405,4627,44329,45324,128,2.5,1109,21.6,9725,964,8761,2.1,21.5,11714,7317,4397,16.1,25.8,-1989,-4.3,43,0,650,653,4977
1984,24,d) 3,3840,3999,40139,40484,101,2.3,845,19.2,8683,1216,7467,3,21.4,9373,5338,4035,13.2,23.2,-690,-1.8,42.8,0,497,497,3448
1984,24,e) 4,3438,3559,35044,35567,113,2.9,728,18.7,6522,442,6080,1.2,18.3,7567,3898,3669,11,21.3,-1045,-3,36.6,0,434,435,2289
1984,24,f) 5,3392,3541,35774,35213,115,3.1,463,12.5,7142,536,6606,1.5,20.3,6020,2406,3614,6.8,17.1,1122,3.2,34.2,0,326,326,1687
1984,24,g) 6 to 10,6575,7537,83695,82950,321,4.1,875,11.2,15147,2270,12877,2.7,18.3,13656,4847,8809,5.8,16.5,1491,1.8,33,0,513,517,2689
1984,24,l) Left Censored,29657,41569,1053666,1032471,1716,4.1,3328,7.9,153647,44507,109140,4.3,14.9,111257,39232,72025,3.8,10.8,42390,4.1,21.6,0,1719,1728,10990
1984,25,a) 0,11226,11301,71356,35745,11249,199.1,0,0,71222,71222,0,199.3,199.3,0,0,0,0,0,71222,199.3,0,0,,,
1984,25,b) 1,7929,8047,65854,63261,55,0.6,1657,18.7,19292,1520,17772,2.4,30.5,14106,8105,6001,12.8,22.3,5186,8.2,44.6,0,1177,1177,5658
1984,25,c) 2,6929,7206,84231,84293,244,3.2,1136,14.8,15682,1419,14263,1.7,18.6,15805,5744,10061,6.8,18.8,-123,-0.2,37.2,0,837,841,4189
1984,25,d) 3,5999,6190,69392,67062,219,3.4,759,11.7,15411,1491,13920,2.2,23,10751,4203,6548,6.3,16,4660,7,32,0,566,566,2936
1984,25,e) 4,5462,5601,50542,49972,185,3.1,751,12.8,10926,1047,9879,2.1,21.9,9786,4355,5431,8.7,19.6,1140,2.3,39.2,0,523,523,2588
1984,25,f) 5,5185,5464,50817,50322,196,3.5,580,10.2,9754,1143,8611,2.3,19.4,8764,3247,5517,6.5,17.4,990,2,34.8,0,396,398,2268
1984,25,g) 6 to 10,9773,11332,162037,159970,445,3.8,1096,9.4,25198,4156,21042,2.6,15.8,21064,7526,13538,4.7,13.2,4134,2.6,26.4,0,682,685,4005
1984,25,l) Left Censored,52224,67445,1959235,1920274,2167,3.2,4663,6.8,276131,57133,218998,3,14.4,198209,58748,139461,3.1,10.3,77922,4.1,20.6,0,2702,2708,20009
1984,26,a) 0,15433,15549,83695,41975,15461,198.9,0,0,83440,83440,0,198.8,198.8,0,0,0,0,0,83440,198.8,0,0,,,
1984,26,b) 1,10344,10482,73345,70472,57,0.5,2314,19.8,21101,1231,19870,1.7,29.9,15354,8255,7099,11.7,21.8,5747,8.1,43.6,0,1642,1642,6349
1984,26,c) 2,8612,8963,73149,74208,391,4.1,1663,17.3,17453,2412,15041,3.3,23.5,19571,9759,9812,13.2,26.4,-2118,-2.9,47,0,1238,1244,7814
1984,26,d) 3,7864,8184,75674,73720,297,3.4,1234,14.3,16038,1808,14230,2.5,21.8,12129,6243,5886,8.5,16.5,3909,5.3,33,0,878,886,4428
1984,26,e) 4,7263,7588,61341,60467,313,4,1009,12.7,12669,1635,11034,2.7,21,10920,4909,6011,8.1,18.1,1749,2.9,36.2,0,739,743,3259
1984,26,f) 5,7049,7437,64677,62492,306,4,931,12,14190,1446,12744,2.3,22.7,9819,4881,4938,7.8,15.7,4371,7,31.4,0,678,679,3800
1984,26,g) 6 to 10,13517,15681,156073,152494,701,4.3,1740,10.8,30410,5552,24858,3.6,19.9,23251,9604,13647,6.3,15.2,7159,4.7,30.4,0,1067,1070,5682
1984,26,l) Left Censored,60866,84737,2201849,2146246,3038,3.5,6455,7.5,318117,61472,256645,2.9,14.8,206911,82975,123936,3.9,9.6,111206,5.2,19.2,0,3415,3449,19947
1984,27,a) 0,8724,8822,49103,24593,8775,198.9,0,0,49021,49021,0,199.3,199.3,0,0,0,0,0,49021,199.3,0,0,,,
1984,27,b) 1,5689,5932,47137,46089,152,2.3,1364,20.8,15198,3701,11497,8,33,13101,7638,5463,16.6,28.4,2097,4.6,56.8,0,1006,1006,6244
1984,27,c) 2,4797,5002,42426,42117,169,3.1,924,17.1,9443,1117,8326,2.7,22.4,8825,4371,4454,10.4,21,618,1.4,42,0,707,713,3422
1984,27,d) 3,4415,4603,44619,43918,146,3,670,13.8,8792,1147,7645,2.6,20,7390,3719,3671,8.5,16.8,1402,3.2,33.6,0,494,494,2507
1984,27,e) 4,4168,4328,35151,34209,165,3.6,577,12.7,7665,730,6935,2.1,22.4,5781,2724,3057,8,16.9,1884,5.5,33.8,0,418,425,2202
1984,27,f) 5,4026,4264,37105,36471,141,3.2,560,12.5,7555,495,7060,1.4,20.7,6286,2903,3383,8,17.2,1269,3.5,34.4,0,401,412,2030
1984,27,g) 6 to 10,7801,8965,96384,95508,333,3.6,976,10.5,17845,2463,15382,2.6,18.7,16092,5267,10825,5.5,16.8,1753,1.9,33.6,0,608,624,3119
1984,27,l) Left Censored,33844,45293,1158557,1133940,1602,3.5,3404,7.4,171264,39970,131294,3.5,15.1,122031,43459,78572,3.8,10.8,49233,4.3,21.6,0,1746,1755,12700
1984,28,a) 0,4887,4904,24790,12443,4871,198.7,0,0,24695,24695,0,198.5,198.5,0,0,0,0,0,24695,198.5,0,0,,,
1984,28,b) 1,2954,2996,18518,18980,15,0.4,948,27.2,4944,113,4831,0.6,26,5868,3273,2595,17.2,30.9,-924,-4.9,52,0,741,741,2715
1984,28,c) 2,2476,2537,17490,17656,80,2.8,607,21.6,4106,580,3526,3.3,23.3,4438,2625,1813,14.9,25.1,-332,-1.8,46.6,0,485,485,2085
1984,28,d) 3,2228,2317,20872,20921,82,3.3,381,15.4,4555,775,3780,3.7,21.8,4653,2857,1796,13.7,22.2,-98,-0.4,43.6,0,280,280,1240
1984,28,e) 4,2153,2228,18283,18027,90,3.8,349,14.8,3558,325,3233,1.8,19.7,3045,1412,1633,7.8,16.9,513,2.8,33.8,0,257,257,1019
1984,28,f) 5,2086,2199,18356,18265,99,4.3,315,13.7,3566,421,3145,2.3,19.5,3383,1306,2077,7.2,18.5,183,1,37,0,224,224,1003
1984,28,g) 6 to 10,3872,4422,38556,38461,194,4.2,503,11,6440,894,5546,2.3,16.7,6249,2746,3503,7.1,16.2,191,0.5,32.4,0,321,321,1824
1984,28,l) Left Censored,16245,22303,456667,448117,801,3.5,1764,7.8,63316,13461,49855,3,14.1,46216,15972,30244,3.6,10.3,17100,3.8,20.6,0,951,962,5070
1984,29,a) 0,10023,10091,53536,26849,10047,199.1,0,0,53375,53375,0,198.8,198.8,0,0,0,0,0,53375,198.8,0,0,,,
1984,29,b) 1,6552,6670,49016,48580,64,0.8,2235,28.7,16576,3991,12585,8.2,34.1,15703,10389,5314,21.4,32.3,873,1.8,64.6,0,1572,1572,6904
1984,29,c) 2,5348,5580,45124,45417,199,3.2,1379,22.3,11054,1482,9572,3.3,24.3,11640,7266,4374,16,25.6,-586,-1.3,48.6,0,947,953,4976
1984,29,d) 3,5024,5331,48293,48738,177,3.1,980,17.1,8888,1128,7760,2.3,18.2,9777,5244,4533,10.8,20.1,-889,-1.9,36.4,0,691,691,3629
1984,29,e) 4,4543,4722,36498,36564,163,3.3,710,14.2,7212,1261,5951,3.4,19.7,7344,3243,4101,8.9,20.1,-132,-0.4,39.4,0,522,524,2326
1984,29,f) 5,4489,4729,37454,37565,183,3.7,645,13,7513,744,6769,2,20,7735,3421,4314,9.1,20.6,-222,-0.6,40,0,468,468,2624
1984,29,g) 6 to 10,8413,9527,91117,90690,388,3.9,1178,11.9,16642,2905,13737,3.2,18.4,15788,6894,8894,7.6,17.4,854,1,34.8,0,763,766,3909
1984,29,l) Left Censored,38657,53125,1336870,1318523,2006,3.7,4386,8.1,191312,46639,144673,3.5,14.5,154617,46237,108380,3.5,11.7,36695,2.8,23.4,0,2288,2306,17836
1984,30,a) 0,2519,2529,10541,5291,2509,198.4,0,0,10501,10501,0,198.5,198.5,0,0,0,0,0,10501,198.5,0,0,,,
1984,30,b) 1,1638,1709,11347,12134,27,1.4,519,26.4,3249,,,,26.8,4822,1959,2863,16.1,39.7,-1573,-12.9,53.6,1,390,390,1554
1984,30,c) 2,1373,1400,8425,8748,51,3.3,313,20.4,1699,278,1421,3.2,19.4,2344,1258,1086,14.4,26.8,-645,-7.4,38.8,0,229,229,943
1984,30,d) 3,1253,1285,8474,8840,50,3.7,201,14.7,1492,177,1315,2,16.9,2224,1032,1192,11.7,25.2,-732,-8.3,33.8,0,150,150,750
1984,30,e) 4,1221,1252,8897,9040,71,5.5,178,13.7,1619,271,1348,3,17.9,1904,742,1162,8.2,21.1,-285,-3.2,35.8,0,130,130,540
1984,30,f) 5,1223,1299,9037,9056,51,3.8,164,12.1,1654,,,,18.3,1692,631,1061,7,18.7,-38,-0.4,36.6,1,116,116,475
1984,30,g) 6 to 10,2096,2290,17043,17075,135,5.7,280,11.9,3105,646,2459,3.8,18.2,3168,1312,1856,7.7,18.6,-63,-0.4,36.4,0,162,163,706
1984,30,l) Left Censored,7230,9379,127547,128483,321,3.4,722,7.5,14819,2453,12366,1.9,11.5,16690,4773,11917,3.7,13,-1871,-1.5,23,0,375,377,2021
1984,31,a) 0,3193,3205,15996,8018,3186,198.8,0,0,15957,15957,0,199,199,0,0,0,0,0,15957,199,0,0,,,
1984,31,b) 1,2349,2445,19100,21317,41,1.5,719,25.7,6351,,,,29.8,10784,2735,8049,12.8,50.6,-4433,-20.8,59.6,1,466,466,2009
1984,31,c) 2,2057,2135,15127,15840,68,2.9,463,19.8,2480,375,2105,2.4,15.7,3906,1997,1909,12.6,24.7,-1426,-9,31.4,0,324,326,1414
1984,31,d) 3,1844,1926,13280,13637,71,3.4,386,18.5,2468,295,2173,2.2,18.1,3181,1794,1387,13.2,23.3,-713,-5.2,36.2,0,242,242,1271
1984,31,e) 4,1715,1750,11414,12242,54,2.9,341,18,2035,156,1879,1.3,16.6,3691,2641,1050,21.6,30.2,-1656,-13.6,33.2,0,195,195,1455
1984,31,f) 5,1615,1661,10945,11378,58,3.2,332,18.5,1648,,,,14.5,2513,1536,977,13.5,22.1,-865,-7.6,29,1,189,189,760
1984,31,g) 6 to 10,3377,3765,29241,29827,155,4,495,12.6,4732,627,4105,2.1,15.9,5904,2635,3269,8.8,19.8,-1172,-3.9,31.8,0,296,297,1450
1984,31,l) Left Censored,15130,19654,363494,364216,609,3,1632,8.1,41650,8977,32673,2.5,11.4,43093,13844,29249,3.8,11.8,-1443,-0.4,22.8,0,826,835,4483
1984,32,a) 0,2723,2737,16268,8153,2721,198.8,0,0,16230,16230,0,199.1,199.1,0,0,0,0,0,16230,199.1,0,0,,,
1984,32,b) 1,1655,1686,14268,13978,9,0.5,537,27.3,5105,353,4752,2.5,36.5,4524,2747,1777,19.7,32.4,581,4.1,64.8,0,407,407,2211
1984,32,c) 2,1500,1548,18501,18076,80,4.7,367,21.6,5061,354,4707,2,28,4210,2296,1914,12.7,23.3,851,4.7,46.6,0,274,274,1270
1984,32,d) 3,1324,1380,13588,13467,53,3.6,268,18,3044,190,2854,1.4,22.6,2801,1301,1500,9.7,20.8,243,1.8,41.6,0,190,190,1036
1984,32,e) 4,1222,1261,14141,13713,59,4.5,191,14.4,3649,403,3246,2.9,26.6,2793,1172,1621,8.5,20.4,856,6.2,40.8,0,134,134,874
1984,32,f) 5,1211,1274,13952,13707,53,3.9,204,15.1,2723,281,2442,2.1,19.9,2232,1115,1117,8.1,16.3,491,3.6,32.6,0,143,143,912
1984,32,g) 6 to 10,1846,2103,25568,24710,105,4.9,230,10.7,5622,687,4935,2.8,22.8,3906,1406,2500,5.7,15.8,1716,7,31.6,0,136,136,769
1984,32,l) Left Censored,5691,8016,245302,238023,448,5.5,616,7.6,41919,10387,31532,4.4,17.6,27361,10022,17339,4.2,11.5,14558,6.1,23,0,297,297,2053
1984,33,a) 0,2761,2776,14794,7418,2761,198.9,0,0,14752,14752,0,198.9,198.9,0,0,0,0,0,14752,198.9,0,0,,,
1984,33,b) 1,1766,1779,13591,13204,12,0.6,423,21.2,4651,137,4514,1,35.2,3876,2062,1814,15.6,29.4,775,5.8,58.8,0,303,303,1471
1984,33,c) 2,1470,1494,12146,12072,53,3.3,241,15.1,2916,385,2531,3.2,24.2,2768,1574,1194,13,22.9,148,1.3,45.8,0,184,184,972
1984,33,d) 3,1221,1250,12980,12544,45,3.4,204,15.3,2936,311,2625,2.5,23.4,2064,1132,932,9,16.5,872,6.9,33,0,159,159,951
1984,33,e) 4,1105,1140,9665,9182,36,3,141,11.8,2457,218,2239,2.4,26.8,1490,635,855,6.9,16.2,967,10.6,32.4,0,99,99,422
1984,33,f) 5,1129,1168,11913,11043,42,3.5,127,10.5,3190,202,2988,1.8,28.9,1450,754,696,6.8,13.1,1740,15.8,26.2,0,94,94,584
1984,33,g) 6 to 10,2107,2404,24581,24107,132,5.4,235,9.6,4924,898,4026,3.7,20.4,3976,1400,2576,5.8,16.5,948,3.9,33,0,151,151,738
1984,33,l) Left Censored,8381,10492,271270,260652,394,3.7,776,7.3,44397,12846,31551,4.9,17,23160,8760,14400,3.4,8.9,21237,8.1,17.8,0,436,441,2755
1984,34,a) 0,15358,15434,81776,40986,15344,198.8,0,0,81580,81580,0,199,199,0,0,0,0,0,81580,199,0,0,,,
1984,34,b) 1,11268,11350,78215,74934,36,0.3,2570,20.3,24354,396,23958,0.5,32.5,17792,8966,8826,12,23.7,6562,8.8,47.4,0,1778,1778,6516
1984,34,c) 2,9749,9994,84662,84037,361,3.4,1734,16.2,19324,2069,17255,2.5,23,18073,8517,9556,10.1,21.5,1251,1.5,43,0,1266,1267,6172
1984,34,d) 3,8467,8707,77766,79246,299,3.3,1210,13.2,16613,2045,14568,2.6,21,19572,10416,9156,13.1,24.7,-2959,-3.7,42,0,853,853,8394
1984,34,e) 4,7926,8105,70402,68494,276,3.2,1076,12.7,15170,2651,12519,3.9,22.1,11353,4871,6482,7.1,16.6,3817,5.5,33.2,0,739,739,3393
1984,34,f) 5,7358,7553,59703,60940,248,3.1,962,12.2,12143,1116,11027,1.8,19.9,14617,8846,5771,14.5,24,-2474,-4.1,39.8,0,664,666,3787
1984,34,g) 6 to 10,13768,14958,147468,144181,583,3.8,1561,10.1,29418,4046,25372,2.8,20.4,22843,8690,14153,6,15.8,6575,4.6,31.6,0,1021,1021,4775
1984,34,l) Left Censored,65925,83669,2157064,2127389,2860,3.4,6421,7.5,311454,85566,225888,4,14.6,252105,75037,177068,3.5,11.9,59349,2.7,23.8,0,3683,3702,21073
1984,35,a) 0,3451,3467,17677,8854,3452,199.1,0,0,17647,17647,0,199.3,199.3,0,0,0,0,0,17647,199.3,0,0,,,
1984,35,b) 1,2407,2482,19834,20398,16,0.6,776,27,5518,340,5178,1.7,27.1,6645,3284,3361,16.1,32.6,-1127,-5.5,54.2,0,595,595,2665
1984,35,c) 2,1821,1872,15643,16714,80,3.8,502,24,3468,448,3020,2.7,20.7,5609,2736,2873,16.4,33.6,-2141,-12.9,41.4,0,391,395,2131
1984,35,d) 3,1791,1870,15014,15438,55,2.7,336,16.7,3048,268,2780,1.7,19.7,3896,1830,2066,11.9,25.2,-848,-5.5,39.4,0,254,254,1350
1984,35,e) 4,1690,1746,14373,14425,94,5.2,247,13.5,3155,577,2578,4,21.9,3258,1363,1895,9.4,22.6,-103,-0.7,43.8,0,182,183,1088
1984,35,f) 5,1549,1652,14682,14933,57,3.2,282,16,3057,337,2720,2.3,20.5,3559,1510,2049,10.1,23.8,-502,-3.3,41,0,180,180,977
1984,35,g) 6 to 10,2657,2980,25451,25587,150,4.9,347,11.3,4803,825,3978,3.2,18.8,5075,1704,3371,6.7,19.8,-272,-1,37.6,0,220,220,1041
1984,35,l) Left Censored,8974,12372,230099,227428,568,4.5,1077,8.5,35508,12033,23475,5.3,15.6,30166,8632,21534,3.8,13.3,5342,2.3,26.6,0,539,539,3073
1984,36,a) 0,36030,36226,184649,92560,36079,199.2,0,0,184179,184179,0,199,199,0,0,0,0,0,184179,199,0,0,,,
1984,36,b) 1,26659,26943,186285,178594,114,0.4,6436,21.3,59898,2464,57434,1.4,33.5,44515,25448,19067,14.2,24.9,15383,8.6,49.8,0,4646,4647,20619
1984,36,c) 2,22200,22732,180016,182122,719,2.9,4223,17.2,38861,4769,34092,2.6,21.3,43072,22519,20553,12.4,23.7,-4211,-2.4,42.6,0,3196,3199,18066
1984,36,d) 3,19397,19896,181091,186620,604,2.9,3080,14.6,31416,3427,27989,1.8,16.8,42474,15005,27469,8,22.8,-11058,-6,33.6,0,2374,2377,12109
1984,36,e) 4,17369,17741,161014,160768,522,2.8,2587,13.8,28515,2198,26317,1.4,17.7,28022,13883,14139,8.6,17.4,493,0.3,34.8,0,1952,1952,11059
1984,36,f) 5,16167,16691,133957,136128,447,2.5,2262,12.9,25422,2998,22424,2.2,18.7,29763,10542,19221,7.7,21.9,-4341,-3.2,37.4,0,1613,1613,7407
1984,36,g) 6 to 10,30999,34492,357492,357687,1179,3.3,3976,11.1,58743,8928,49815,2.5,16.4,59133,23468,35665,6.6,16.5,-390,-0.1,32.8,0,2740,2749,14691
1984,36,l) Left Censored,156224,194146,4822953,4802748,5281,2.6,15800,7.9,631619,162178,469441,3.4,13.2,591211,175978,415233,3.7,12.3,40408,0.9,24.6,0,9736,9765,77958
1984,37,a) 0,14520,14632,71238,36072,14317,195.7,0,0,70332,70332,0,195,195,0,0,0,0,0,70332,195,0,0,,,
1984,37,b) 1,8369,8513,56941,57026,39,0.4,1178,13,15755,594,15161,1,27.6,15927,4371,11556,7.7,27.9,-172,-0.3,55.2,0,60,60,324
1984,37,c) 2,6555,6809,56171,54040,251,3.5,926,13,14025,1985,12040,3.7,26,9762,4705,5057,8.7,18.1,4263,7.9,36.2,0,54,55,350
1984,37,d) 3,5732,5963,59460,57782,168,2.8,489,8.1,11246,875,10371,1.5,19.5,7889,2870,5019,5,13.7,3357,5.8,27.4,0,25,25,174
1984,37,e) 4,5140,5339,44558,42450,138,2.6,361,6.7,9904,1494,8410,3.5,23.3,5688,2187,3501,5.2,13.4,4216,9.9,26.8,0,15,16,88
1984,37,f) 5,5050,5334,47801,45621,155,2.9,331,6.2,10097,1392,8705,3.1,22.1,5736,1678,4058,3.7,12.6,4361,9.5,25.2,0,21,21,149
1984,37,g) 6 to 10,9796,11173,108396,106029,352,3.2,678,6.1,19207,2685,16522,2.5,18.1,14473,3546,10927,3.3,13.7,4734,4.4,27.4,0,16,18,197
1984,37,l) Left Censored,42271,61709,1690198,1638718,2155,3.5,2653,4.3,237283,48094,189189,2.9,14.5,134322,36256,98066,2.2,8.2,102961,6.3,16.4,0,39,44,467
1984,38,a) 0,1592,1601,7815,3917,1589,198.5,0,0,7796,7796,0,199,199,0,0,0,0,0,7796,199,0,0,,,
1984,38,b) 1,1101,1160,8050,8358,44,3.4,315,24.2,2301,824,1477,9.9,27.5,2916,1324,1592,15.8,34.9,-615,-7.4,55,0,210,210,883
1984,38,c) 2,977,998,6076,6294,39,3.6,209,19.3,1176,297,879,4.7,18.7,1612,753,859,12,25.6,-436,-6.9,37.4,0,152,152,541
1984,38,d) 3,844,875,7158,7330,27,2.8,182,19.1,1262,156,1106,2.1,17.2,1605,894,711,12.2,21.9,-343,-4.7,34.4,0,120,120,621
1984,38,e) 4,808,836,5578,5823,20,2.2,144,16.1,883,61,822,1,15.2,1372,681,691,11.7,23.6,-489,-8.4,30.4,0,88,88,417
1984,38,f) 5,803,832,5904,6070,30,3.4,118,13.5,966,119,847,2,15.9,1298,517,781,8.5,21.4,-332,-5.5,31.8,0,71,71,273
1984,38,g) 6 to 10,1483,1606,11209,11363,57,3.4,194,11.6,1602,320,1282,2.8,14.1,1909,780,1129,6.9,16.8,-307,-2.7,28.2,0,111,112,455
1984,38,l) Left Censored,6497,8397,122504,122959,266,3.1,658,7.7,13618,2619,10999,2.1,11.1,14528,4947,9581,4,11.8,-910,-0.7,22.2,0,302,304,1866
1984,39,a) 0,17085,17212,97137,48807,17102,198.7,0,0,96661,96661,0,198,198,0,0,0,0,0,96661,198,0,0,,,
1984,39,b) 1,11251,11494,82837,80871,88,0.7,2768,21.5,24625,2176,22449,2.7,30.4,20693,11473,9220,14.2,25.6,3932,4.8,51.2,0,2024,2031,8538
1984,39,c) 2,9971,10408,77635,78390,404,3.6,1947,17.4,17201,2591,14610,3.3,21.9,18710,9660,9050,12.3,23.9,-1509,-2,43.8,0,1462,1468,6928
1984,39,d) 3,8962,9393,96710,94535,338,3.4,1359,13.7,18437,2258,16179,2.4,19.5,14086,6262,7824,6.6,14.9,4351,4.6,29.8,0,977,977,4334
1984,39,e) 4,8195,8686,67805,67147,345,3.8,1162,12.8,13195,1618,11577,2.4,19.7,11878,4912,6966,7.3,17.7,1317,2,35.4,0,808,808,3421
1984,39,f) 5,7933,8358,74938,74234,310,3.5,1104,12.6,13574,1387,12187,1.9,18.3,12165,5470,6695,7.4,16.4,1409,1.9,32.8,0,787,787,3710
1984,39,g) 6 to 10,15676,18537,177537,177036,845,4.4,1932,10.1,31005,5570,25435,3.1,17.5,30002,10982,19020,6.2,16.9,1003,0.6,33.8,0,1138,1150,6210
1984,39,l) Left Censored,78962,114368,2894988,2854619,3960,3.4,8535,7.3,380197,81063,299134,2.8,13.3,299459,86691,212768,3,10.5,80738,2.8,21,0,4211,4278,23828
1984,40,a) 0,8281,8333,41635,20876,8283,198.8,0,0,41519,41519,0,198.9,198.9,0,0,0,0,0,41519,198.9,0,0,,,
1984,40,b) 1,5498,5599,35372,37328,43,0.7,1882,28.7,9139,573,8566,1.5,24.5,13050,7742,5308,20.7,35,-3911,-10.5,49,0,1464,1464,6338
1984,40,c) 2,5123,5320,40900,43452,192,3.2,1418,23.8,8069,1372,6697,3.2,18.6,13173,7371,5802,17,30.3,-5104,-11.7,37.2,0,1129,1129,5882
1984,40,d) 3,4147,4320,35786,37904,156,3.3,956,20.2,6361,925,5436,2.4,16.8,10596,5093,5503,13.4,28,-4235,-11.2,33.6,0,768,770,4196
1984,40,e) 4,3712,3869,30606,32918,105,2.5,656,15.8,5378,675,4703,2.1,16.3,10001,4359,5642,13.2,30.4,-4623,-14.1,32.6,0,503,503,3301
1984,40,f) 5,3376,3542,27822,29215,124,3.3,557,14.8,4498,774,3724,2.6,15.4,7284,3114,4170,10.7,24.9,-2786,-9.5,30.8,0,411,411,2336
1984,40,g) 6 to 10,5758,6510,60337,62206,225,3.3,825,12.1,9460,1842,7618,3,15.2,13198,5178,8020,8.3,21.2,-3738,-6,30.4,0,579,581,3395
1984,40,l) Left Censored,22196,30992,643820,650647,1342,4.3,2481,7.9,88357,25567,62790,3.9,13.6,102011,28592,73419,4.4,15.7,-13654,-2.1,27.2,0,1356,1361,7742
1984,41,a) 0,7243,7271,35958,18035,7219,198.6,0,0,35846,35846,0,198.8,198.8,0,0,0,0,0,35846,198.8,0,0,,,
1984,41,b) 1,4556,4713,34045,35098,35,0.6,1400,25.8,9634,599,9035,1.7,27.4,11740,5131,6609,14.6,33.4,-2106,-6,54.8,0,1082,1082,4254
1984,41,c) 2,4053,4183,32089,31615,200,4.4,830,18.4,8518,1544,6974,4.9,26.9,7569,4224,3345,13.4,23.9,949,3,47.8,0,643,643,3085
1984,41,d) 3,3763,3922,31164,31059,171,4.1,682,16.3,6464,1196,5268,3.9,20.8,6254,3219,3035,10.4,20.1,210,0.7,40.2,0,512,512,2439
1984,41,e) 4,3536,3667,26163,25878,174,4.5,558,14.5,5682,631,5051,2.4,22,5112,2460,2652,9.5,19.8,570,2.2,39.6,0,397,397,1852
1984,41,f) 5,3100,3255,25235,24788,179,5.3,467,13.8,5596,720,4876,2.9,22.6,4701,1910,2791,7.7,19,895,3.6,38,0,327,330,1485
1984,41,g) 6 to 10,5744,6476,60891,60396,335,5,824,12.3,11468,1569,9899,2.6,19,10477,3586,6891,5.9,17.3,991,1.7,34.6,0,524,524,2497
1984,41,l) Left Censored,20488,28281,543714,538563,1283,4.5,2299,8,76241,14746,61495,2.7,14.2,65938,20490,45448,3.8,12.2,10303,2,24.4,0,1237,1245,6818
1984,42,a) 0,18787,18928,107368,53830,18837,199,0,0,107077,107077,0,198.9,198.9,0,0,0,0,0,107077,198.9,0,0,,,
1984,42,b) 1,12771,12986,99177,97242,92,0.6,3059,21,28031,1587,26444,1.6,28.8,24160,12599,11561,13,24.8,3871,4,49.6,0,2148,2150,9205
1984,42,c) 2,11022,11465,106934,105540,335,2.7,2039,16.5,25665,7579,18086,7.2,24.3,22876,12936,9940,12.3,21.7,2789,2.6,43.4,0,1392,1398,8796
1984,42,d) 3,9627,10023,97244,98490,329,3.1,1486,14,18553,2401,16152,2.4,18.8,21044,11995,9049,12.2,21.4,-2491,-2.6,37.6,0,1066,1067,10230
1984,42,e) 4,9180,9528,78317,77863,291,2.9,1288,12.9,14158,1512,12646,1.9,18.2,13249,6327,6922,8.1,17,909,1.2,34,0,902,903,4671
1984,42,f) 5,8857,9363,78711,78445,330,3.4,1187,12.1,14521,2262,12259,2.9,18.5,13988,5888,8100,7.5,17.8,533,0.7,35.6,0,802,802,4003
1984,42,g) 6 to 10,17461,20163,211839,209708,845,4.1,2211,10.6,35316,5998,29318,2.9,16.8,31053,12207,18846,5.8,14.8,4263,2,29.6,0,1325,1331,5914
1984,42,l) Left Censored,91235,125142,3176798,3146358,4222,3.3,9942,7.8,417713,91633,326080,2.9,13.3,356832,113534,243298,3.6,11.3,60881,2,22.6,0,5282,5335,33452
1984,44,a) 0,2038,2043,10113,5076,2029,198.6,0,0,10075,10075,0,198.5,198.5,0,0,0,0,0,10075,198.5,0,0,,,
1984,44,b) 1,1350,1362,9380,8835,4,0.3,311,20.4,2889,,,,32.7,1799,903,896,10.2,20.4,1090,12.3,40.8,1,235,236,580
1984,44,c) 2,1125,1156,9591,9326,35,2.8,188,15.2,2231,191,2040,2,23.9,1701,918,783,9.8,18.2,530,5.7,36.4,0,138,138,692
1984,44,d) 3,1003,1020,9003,8908,34,3.2,147,13.6,1773,170,1603,1.9,19.9,1583,653,930,7.3,17.8,190,2.1,35.6,0,124,124,561
1984,44,e) 4,934,957,7218,7118,37,3.7,133,13.3,1444,186,1258,2.6,20.3,1244,475,769,6.7,17.5,200,2.8,35,0,96,96,389
1984,44,f) 5,931,964,8746,8380,33,3.3,118,11.7,2069,,,,24.7,1336,609,727,7.3,15.9,733,8.8,31.8,1,89,89,528
1984,44,g) 6 to 10,1786,1914,20154,20106,59,3,218,10.9,3564,612,2952,3,17.7,3468,1051,2417,5.2,17.2,96,0.5,34.4,0,141,142,583
1984,44,l) Left Censored,9645,11467,278520,275156,280,2.4,870,7.4,35531,7680,27851,2.8,12.9,28803,9071,19732,3.3,10.5,6728,2.4,21,0,500,502,3057
1984,45,a) 0,6903,6955,37911,19171,6810,195.8,0,0,37481,37481,0,195.5,195.5,0,0,0,0,0,37481,195.5,0,0,,,
1984,45,b) 1,4247,4326,33546,31288,19,0.4,506,11.1,10231,,,,32.7,5715,2191,3524,7,18.3,4516,14.4,36.6,1,29,29,
1984,45,c) 2,3440,3577,30991,30416,121,3.2,501,13.3,7395,902,6493,3,24.3,6245,3157,3088,10.4,20.5,1150,3.8,41,0,20,21,236
1984,45,d) 3,2888,3029,28139,27477,94,3,338,10.8,5990,827,5163,3,21.8,4666,1849,2817,6.7,17,1324,4.8,34,0,10,10,113
1984,45,e) 4,2668,2793,24340,23025,107,3.8,203,7.3,5548,782,4766,3.4,24.1,2918,1161,1757,5,12.7,2630,11.4,25.4,1,2,2,
1984,45,f) 5,2456,2603,20960,20102,76,2.9,160,6.2,4089,,,,20.3,2373,601,1772,3,11.8,1716,8.5,23.6,1,9,10,47
1984,45,g) 6 to 10,4797,5464,46992,46555,224,4.1,453,8.3,8842,1417,7425,3,19,7968,3062,4906,6.6,17.1,874,1.9,34.2,0,15,15,126
1984,45,l) Left Censored,20365,29344,755799,741532,1159,3.9,1673,5.7,99627,24581,75046,3.3,13.4,71092,21197,49895,2.9,9.6,28535,3.8,19.2,0,42,43,500
1984,46,a) 0,1642,1646,7713,3874,1632,198.3,0,0,7678,7678,0,198.2,198.2,0,0,0,0,0,7678,198.2,0,0,,,
1984,46,b) 1,1014,1068,6800,6854,42,3.4,343,28,2008,373,1635,5.4,29.3,2115,1084,1031,15.8,30.9,-107,-1.6,58.6,0,240,240,850
1984,46,c) 2,870,889,5333,5724,35,3.6,177,18.4,736,79,657,1.4,12.9,1517,791,726,13.8,26.5,-781,-13.6,25.8,0,116,116,517
1984,46,d) 3,806,825,6020,5794,29,3.3,124,14.2,1414,133,1281,2.3,24.4,962,538,424,9.3,16.6,452,7.8,33.2,0,78,78,351
1984,46,e) 4,782,798,4900,5065,39,4.5,166,19.2,1001,266,735,5.3,19.8,1331,897,434,17.7,26.3,-330,-6.5,39.6,0,94,94,390
1984,46,f) 5,725,765,5635,5732,29,3.5,141,17.2,974,92,882,1.6,17,1167,637,530,11.1,20.4,-193,-3.4,34,0,78,78,299
1984,46,g) 6 to 10,1523,1672,11108,11488,61,3.5,226,12.9,1601,249,1352,2.2,13.9,2361,1106,1255,9.6,20.6,-760,-6.7,27.8,0,128,129,543
1984,46,l) Left Censored,6915,8598,127642,125827,290,3.3,688,7.8,16659,2893,13766,2.3,13.2,13029,4582,8447,3.6,10.4,3630,2.8,20.8,0,333,334,1901
1984,47,a) 0,10121,10168,56362,28245,10121,199.1,0,0,56234,56234,0,199.1,199.1,0,0,0,0,0,56234,199.1,0,0,,,
1984,47,b) 1,6035,6125,45911,46661,37,0.5,1918,27,13019,693,12326,1.5,27.9,14518,8923,5595,19.1,31.1,-1499,-3.2,55.8,0,1505,1505,7093
1984,47,c) 2,4847,5059,45895,46334,180,3.2,1180,21.2,10534,1809,8725,3.9,22.7,11412,6000,5412,12.9,24.6,-878,-1.9,45.4,0,904,916,4448
1984,47,d) 3,4049,4241,40874,40625,165,3.6,817,17.9,8716,1127,7589,2.8,21.5,8217,4618,3599,11.4,20.2,499,1.3,40.4,0,639,641,3552
1984,47,e) 4,3866,4030,33760,33670,131,3.1,648,15.1,6724,561,6163,1.7,20,6543,3199,3344,9.5,19.4,181,0.6,38.8,0,479,483,2375
1984,47,f) 5,3696,3921,37445,38864,149,3.6,517,12.6,7648,1252,6396,3.2,19.7,10485,2975,7510,7.7,27,-2837,-7.3,39.4,0,394,395,2368
1984,47,g) 6 to 10,7315,8401,90927,88345,384,4.4,989,11.4,17932,2614,15318,3,20.3,12768,5310,7458,6,14.5,5164,5.8,29,0,625,628,3113
1984,47,l) Left Censored,31132,44333,1138495,1125282,1901,4.2,3686,8.2,160116,38280,121836,3.4,14.2,133689,41878,91811,3.7,11.9,26427,2.3,23.8,0,1890,1902,12182
1984,48,a) 0,39410,39882,242719,121765,39674,199,0,0,241908,241908,0,198.7,198.7,0,0,0,0,0,241908,198.7,0,0,,,
1984,48,b) 1,27509,28032,225210,223534,208,0.6,8634,26.6,73302,3973,69329,1.8,32.8,69950,42130,27820,18.8,31.3,3352,1.5,62.6,0,6621,6621,33559
1984,48,c) 2,23906,25102,215690,219926,950,3.4,6374,22.8,56154,6409,49745,2.9,25.5,64625,36521,28104,16.6,29.4,-8471,-3.9,51,0,4853,4864,28044
1984,48,d) 3,29422,30873,296543,302996,927,2.8,5783,17.3,63685,6702,56983,2.2,21,76590,37738,38852,12.5,25.3,-12905,-4.3,42,0,4550,4560,30465
1984,48,e) 4,9317,10043,96258,97765,320,3,1656,15.5,20578,3441,17137,3.5,21,23591,10968,12623,11.2,24.1,-3013,-3.1,42,0,1174,1186,8123
1984,48,f) 5,16394,17905,185099,187009,612,3.2,2629,13.9,37228,4200,33028,2.2,19.9,41048,18893,22155,10.1,21.9,-3820,-2,39.8,0,1900,1906,12676
1984,48,g) 6 to 10,26659,31237,341278,343952,1440,4.4,4066,12.5,70171,15330,54841,4.5,20.4,75519,26876,48643,7.8,22,-5348,-1.6,40.8,0,2573,2593,14933
1984,48,l) Left Censored,91515,148793,3785534,3769687,8057,5.3,13517,8.9,604120,218015,386105,5.8,16,572426,166893,405533,4.4,15.2,31694,0.8,30.4,0,6229,6294,44349
1984,49,a) 0,3287,3333,21011,10615,3306,198.4,0,0,20792,20792,0,195.9,195.9,0,0,0,0,0,20792,195.9,0,0,,,
1984,49,b) 1,2143,2216,19627,20768,27,1.1,682,26.6,5409,714,4695,3.4,26,7691,3533,4158,17,37,-2282,-11,52,0,497,497,2383
1984,49,c) 2,1959,2053,16823,17296,90,4,470,20.9,4335,960,3375,5.6,25.1,5280,2455,2825,14.2,30.5,-945,-5.4,50.2,0,360,360,1991
1984,49,d) 3,1676,1776,17272,17485,54,2.8,327,17.1,3709,329,3380,1.9,21.2,4135,2118,2017,12.1,23.6,-426,-2.4,42.4,0,240,240,1485
1984,49,e) 4,1487,1574,12960,12686,73,4.4,265,15.9,3084,550,2534,4.3,24.3,2535,1396,1139,11,20,549,4.3,40,0,187,187,1059
1984,49,f) 5,1530,1643,13947,13894,93,5.4,229,13.4,2985,421,2564,3,21.5,2878,1182,1696,8.5,20.7,107,0.8,41.4,0,153,153,803
1984,49,g) 6 to 10,2695,2997,29812,29832,153,5,321,10.4,5670,1088,4582,3.6,19,5710,2293,3417,7.7,19.1,-40,-0.1,38,0,178,178,1337
1984,49,l) Left Censored,9626,13560,317653,311039,627,4.6,1070,7.8,45895,8936,36959,2.9,14.8,32666,10561,22105,3.4,10.5,13229,4.3,21,0,530,531,3137
1984,50,a) 0,1638,1647,7933,3986,1632,198.2,0,0,7895,7895,0,198.1,198.1,0,0,0,0,0,7895,198.1,0,0,,,
1984,50,b) 1,1082,1091,5395,5383,8,0.7,234,19.4,1461,38,1423,0.7,27.1,1436,855,581,15.9,26.7,25,0.4,53.4,0,159,159,717
1984,50,c) 2,933,956,6374,6281,27,2.6,160,15.6,1511,77,1434,1.2,24.1,1325,646,679,10.3,21.1,186,3,42.2,0,120,120,506
1984,50,d) 3,806,822,5896,5807,27,3.1,111,12.8,1212,83,1129,1.4,20.9,1033,529,504,9.1,17.8,179,3.1,35.6,0,90,90,395
1984,50,e) 4,691,702,4754,4632,25,3.4,100,13.6,994,64,930,1.4,21.5,750,377,373,8.1,16.2,244,5.3,32.4,0,72,72,253
1984,50,f) 5,647,664,4998,4926,23,3.3,87,12.5,995,92,903,1.9,20.2,851,395,456,8,17.3,144,2.9,34.6,0,62,62,298
1984,50,g) 6 to 10,1356,1504,14090,13905,54,3.4,182,11.6,2252,279,1973,2,16.2,1881,904,977,6.5,13.5,371,2.7,27,0,120,120,441
1984,50,l) Left Censored,5147,6294,123526,122027,211,3.3,453,7.1,14071,2845,11226,2.3,11.5,11072,3718,7354,3,9.1,2999,2.4,18.2,0,276,278,1680
1984,51,a) 0,10054,10112,52582,26292,10110,200,0,0,52580,52580,0,200,200,0,0,0,0,0,52580,200,0,0,,,
1984,51,b) 1,6493,6585,46078,46358,34,0.4,2477,31.4,14241,911,13330,2,30.7,14801,10640,4161,23,31.9,-560,-1.2,61.4,0,1500,1500,6288
1984,51,c) 2,5653,5858,52466,53850,168,2.5,1578,23.9,11876,1459,10417,2.7,22.1,14644,8902,5742,16.5,27.2,-2768,-5.1,44.2,0,976,976,5670
1984,51,d) 3,4965,5218,55033,54951,154,2.7,1157,20.1,11569,1469,10100,2.7,21.1,11405,7015,4390,12.8,20.8,164,0.3,41.6,0,714,715,3292
1984,51,e) 4,4537,4701,41054,41249,160,3.1,1008,19.6,8295,740,7555,1.8,20.1,8684,5661,3023,13.7,21.1,-389,-1,40.2,0,534,534,2982
1984,51,f) 5,4209,4498,44536,44976,157,3.2,856,17.6,8177,999,7178,2.2,18.2,9056,4518,4538,10,20.1,-879,-1.9,36.4,0,432,433,1984
1984,51,g) 6 to 10,7934,9357,108902,108067,427,4.3,1400,14.2,21240,3920,17320,3.6,19.7,19570,8256,11314,7.6,18.1,1670,1.6,36.2,0,688,706,4201
1984,51,l) Left Censored,34878,52088,1302447,1278428,2339,4.4,5132,9.6,186326,48070,138256,3.8,14.6,138287,52637,85650,4.1,10.8,48039,3.8,21.6,0,2208,2211,17356
1984,53,a) 0,11661,11718,58575,29385,11642,198.7,0,0,58380,58380,0,198.7,198.7,0,0,0,0,0,58380,198.7,0,0,,,
1984,53,b) 1,7641,7795,51961,54155,42,0.5,2162,24.3,15191,918,14273,1.7,28.1,19579,9644,9935,17.8,36.2,-4388,-8.1,56.2,0,1586,1586,7177
1984,53,c) 2,6354,6577,51704,52379,292,4.1,1338,18.8,12084,1621,10463,3.1,23.1,13434,7294,6140,13.9,25.6,-1350,-2.5,46.2,0,1009,1009,5560
1984,53,d) 3,5502,5732,47877,47858,262,4.3,934,15.4,10191,1004,9187,2.1,21.3,10152,4546,5606,9.5,21.2,39,0.1,42.4,0,684,684,3569
1984,53,e) 4,5218,5426,42039,41366,228,4,827,14.5,9681,1862,7819,4.5,23.4,8334,4169,4165,10.1,20.1,1347,3.3,40.2,0,578,578,3015
1984,53,f) 5,4709,4925,36113,35947,252,4.9,700,13.6,7671,910,6761,2.5,21.3,7338,3316,4022,9.2,20.4,333,0.9,40.8,0,508,510,2519
1984,53,g) 6 to 10,8945,10202,94460,94372,576,5.5,1173,11.2,17923,2676,15247,2.8,19,17747,6383,11364,6.8,18.8,176,0.2,37.6,0,761,762,3919
1984,53,l) Left Censored,30688,43158,905199,897429,1875,4.3,3367,7.7,132654,32934,99720,3.7,14.8,117113,32581,84532,3.6,13,15541,1.8,26,0,1785,1790,10033
1984,54,a) 0,2700,2712,12624,6313,2711,199.9,0,0,12623,12623,0,200,200,0,0,0,0,0,12623,200,0,0,,,
1984,54,b) 1,1659,1686,11202,12177,4,0.2,717,34.8,3198,32,3166,0.3,26.3,5148,3608,1540,29.6,42.3,-1950,-16,52.6,0,452,452,2220
1984,54,c) 2,1598,1636,15151,15547,44,2.4,475,25.5,2935,270,2665,1.7,18.9,3726,2369,1357,15.2,24,-791,-5.1,37.8,0,289,289,1245
1984,54,d) 3,1390,1425,11980,12849,38,2.4,348,21.8,2230,191,2039,1.5,17.4,3968,1574,2394,12.2,30.9,-1738,-13.5,34.8,0,210,210,829
1984,54,e) 4,1210,1286,9608,9923,60,4.2,298,21.1,1497,259,1238,2.6,15.1,2127,1194,933,12,21.4,-630,-6.3,30.2,0,160,160,698
1984,54,f) 5,1219,1282,9346,9450,58,4.2,266,19.1,1774,310,1464,3.3,18.8,1981,1041,940,11,21,-207,-2.2,37.6,0,160,160,635
1984,54,g) 6 to 10,2387,2770,24917,25476,135,4.6,444,15.1,4184,880,3304,3.5,16.4,5301,2453,2848,9.6,20.8,-1117,-4.4,32.8,0,219,219,1310
1984,54,l) Left Censored,12520,16913,329538,330272,648,3.7,1972,11.2,41113,11045,30068,3.3,12.4,42580,17876,24704,5.4,12.9,-1467,-0.5,24.8,0,774,779,4622
1984,55,a) 0,9002,9047,47305,23749,9000,199,0,0,47112,47112,0,198.4,198.4,0,0,0,0,0,47112,198.4,0,0,,,
1984,55,b) 1,5724,5833,40861,39927,44,0.7,1463,22.3,11720,780,10940,2,29.4,9851,5760,4091,14.4,24.7,1869,4.7,49.4,0,1045,1045,3958
1984,55,c) 2,5159,5347,41495,41226,200,3.5,935,16.3,9197,1735,7462,4.2,22.3,8659,4581,4078,11.1,21,538,1.3,42,0,691,692,3429
1984,55,d) 3,4664,4833,41781,42094,174,3.4,727,14.2,7321,917,6404,2.2,17.4,7946,4158,3788,9.9,18.9,-625,-1.5,34.8,0,504,506,2118
1984,55,e) 4,4364,4502,34118,33910,180,3.8,637,13.5,6316,826,5490,2.4,18.6,5899,2700,3199,8,17.4,417,1.2,34.8,0,443,443,1898
1984,55,f) 5,4279,4504,33910,34701,164,3.5,579,12.3,5524,941,4583,2.7,15.9,7105,3109,3996,9,20.5,-1581,-4.6,31.8,0,392,393,2391
1984,55,g) 6 to 10,8765,9925,92884,90861,354,3.4,1065,10.4,17005,2158,14847,2.4,18.7,12958,5464,7494,6,14.3,4047,4.4,28.6,0,626,635,3192
1984,55,l) Left Censored,40706,52940,1253578,1232290,1767,3.3,3804,7.1,168067,34849,133218,2.8,13.6,125491,38613,86878,3.1,10.2,42576,3.4,20.4,0,2103,2110,11503
1984,56,a) 0,1436,1437,6465,3237,1432,199.3,0,0,6456,6456,0,199.4,199.4,0,0,0,0,0,6456,199.4,0,0,,,
1984,56,b) 1,1105,1147,7464,8283,13,1,363,27.3,2127,,,,25.7,3765,1555,2210,18.8,45.5,-1638,-19.8,51.4,1,265,265,
1984,56,c) 2,977,1013,6813,7088,54,4.8,276,24.5,1539,204,1335,2.9,21.7,2089,1062,1027,15,29.5,-550,-7.8,43.4,0,209,210,893
1984,56,d) 3,926,956,5795,6205,34,3.3,188,18.2,960,85,875,1.4,15.5,1780,741,1039,11.9,28.7,-820,-13.2,31,0,129,130,490
1984,56,e) 4,736,773,5102,5435,26,3.1,139,16.7,796,102,694,1.9,14.6,1461,589,872,10.8,26.9,-665,-12.3,29.2,1,98,98,
1984,56,f) 5,753,804,5947,6269,29,3.4,142,16.5,985,,,,15.7,1628,672,956,10.7,26,-643,-10.3,31.4,1,90,91,444
1984,56,g) 6 to 10,1323,1456,13063,13480,71,4.7,191,12.6,2117,682,1435,5.1,15.7,2951,1004,1947,7.4,21.9,-834,-6.2,31.4,0,117,117,560
1984,56,l) Left Censored,4262,5611,83904,84621,262,4.6,541,9.4,13147,5279,7868,6.2,15.5,14580,4923,9657,5.8,17.2,-1433,-1.7,31,0,237,237,1502
1985,01,a) 0,7128,7219,41798,20981,7184,199,0,0,41635,41635,0,198.4,198.4,0,0,0,0,0,41635,198.4,0,0,,,
1985,01,b) 1,6133,6208,49299,48955,50,0.7,1537,21.9,12514,1037,11477,2.1,25.6,11826,6457,5369,13.2,24.2,688,1.4,48.4,0,1140,1140,4955
1985,01,c) 2,3661,3751,28763,29015,175,4.2,909,22,7678,972,6706,3.3,26.5,8181,4348,3833,15,28.2,-503,-1.7,53,0,709,712,3526
1985,01,d) 3,3109,3280,32212,31511,137,3.9,591,16.9,8429,1293,7136,4.1,26.7,7027,3681,3346,11.7,22.3,1402,4.4,44.6,0,455,458,2606
1985,01,e) 4,2943,3094,34888,34165,104,3.2,448,13.8,8069,539,7530,1.6,23.6,6623,3257,3366,9.5,19.4,1446,4.2,38.8,0,329,330,2271
1985,01,f) 5,2778,2907,23931,24624,123,4,406,13.3,4504,555,3949,2.3,18.3,5890,2315,3575,9.4,23.9,-1386,-5.6,36.6,0,300,301,1679
1985,01,g) 6 to 10,8134,9438,101155,101227,461,4.7,1059,10.9,16886,3763,13123,3.7,16.7,17029,6491,10538,6.4,16.8,-143,-0.1,33.4,0,736,740,4596
1985,01,l) Left Censored,23018,33366,819980,822729,1386,4.1,2909,8.5,99753,21212,78541,2.6,12.1,105252,35905,69347,4.4,12.8,-5499,-0.7,24.2,0,1489,1507,12758
1985,02,a) 0,1834,1851,9773,4914,1838,198.6,0,0,9718,,,,197.8,0,0,0,0,0,9718,197.8,0,1,,,
1985,02,b) 1,1419,1429,8791,9268,5,0.3,526,30.9,3011,,,,32.5,3965,2326,1639,25.1,42.8,-954,-10.3,65,1,398,398,1644
1985,02,c) 2,1031,1062,7370,8163,58,4.8,327,27.2,1749,291,1458,3.6,21.4,3334,1625,1709,19.9,40.8,-1585,-19.4,42.8,0,240,240,1095
1985,02,d) 3,756,808,7242,7265,35,4,162,18.5,2092,177,1915,2.4,28.8,2137,1002,1135,13.8,29.4,-45,-0.6,57.6,0,116,118,776
1985,02,e) 4,550,588,6082,6174,28,4.5,90,14.5,1331,110,1221,1.8,21.6,1514,475,1039,7.7,24.5,-183,-2.9,43.2,0,58,58,281
1985,02,f) 5,534,549,5010,5240,26,4.5,80,13.9,888,130,758,2.5,16.9,1347,487,860,9.3,25.7,-459,-8.8,33.8,0,57,58,375
1985,02,g) 6 to 10,1422,1684,17956,17732,98,5.6,232,13.3,4105,532,3573,3,23.2,3656,1516,2140,8.5,20.6,449,2.6,41.2,0,148,149,850
1985,02,l) Left Censored,2643,3952,91429,90698,262,6.5,386,9.6,18034,5665,12369,6.2,19.9,16572,6708,9864,7.4,18.3,1462,1.6,36.6,0,158,159,1135
1985,04,a) 0,8995,9066,61592,30902,9006,198.7,0,0,61380,61380,0,198.6,198.6,0,0,0,0,0,61380,198.6,0,0,,,
1985,04,b) 1,6590,6716,54820,52279,56,0.7,1915,24.8,20639,1485,19154,2.8,39.5,15557,9459,6098,18.1,29.8,5082,9.7,59.6,0,1436,1437,7604
1985,04,c) 2,4609,4826,52140,52236,255,4.9,1037,19.8,13993,3023,10970,5.8,26.8,14185,7215,6970,13.8,27.2,-192,-0.4,53.6,0,829,829,6074
1985,04,d) 3,4141,4378,44289,44457,203,4.3,796,17.1,11301,999,10302,2.2,25.4,11636,5726,5910,12.9,26.2,-335,-0.8,50.8,0,598,600,4206
1985,04,e) 4,3369,3557,37153,35855,166,4.4,568,15.1,9928,1381,8547,3.9,27.7,7332,3522,3810,9.8,20.4,2596,7.3,40.8,0,405,407,2728
1985,04,f) 5,3246,3427,34655,34069,147,4.1,477,13.3,8743,756,7987,2.2,25.7,7571,3117,4454,9.1,22.2,1172,3.5,44.4,0,348,352,2351
1985,04,g) 6 to 10,7532,8593,114185,110037,450,5,1184,13.2,28658,4485,24173,4.1,26,20361,9542,10819,8.7,18.5,8297,7.5,37,0,724,740,5586
1985,04,l) Left Censored,14809,24049,649150,637411,1363,5.6,2000,8.2,106363,23248,83115,3.6,16.7,82887,30899,51988,4.8,13,23476,3.7,26,0,875,883,8573
1985,05,a) 0,4794,4834,24410,12225,4815,199.2,0,0,24371,24371,0,199.4,199.4,0,0,0,0,0,24371,199.4,0,0,,,
1985,05,b) 1,4133,4174,25532,25886,24,0.5,1174,24.5,7407,418,6989,1.6,28.6,8114,4883,3231,18.9,31.3,-707,-2.7,57.2,0,920,920,3916
1985,05,c) 2,2608,2666,18538,19553,98,3.3,627,21.3,4005,705,3300,3.6,20.5,6035,3144,2891,16.1,30.9,-2030,-10.4,41,0,510,510,2619
1985,05,d) 3,2281,2339,18503,19532,86,3.4,434,17.3,3533,329,3204,1.7,18.1,5590,3228,2362,16.5,28.6,-2057,-10.5,36.2,0,338,338,2075
1985,05,e) 4,2060,2132,19550,20037,97,4.3,359,15.9,3260,342,2918,1.7,16.3,4234,2044,2190,10.2,21.1,-974,-4.8,32.6,0,251,252,1504
1985,05,f) 5,2008,2136,19843,20214,84,3.8,295,13.2,3366,496,2870,2.5,16.7,4108,1556,2552,7.7,20.3,-742,-3.6,33.4,0,224,224,1130
1985,05,g) 6 to 10,5887,6562,59178,59305,270,4,733,10.8,10295,2065,8230,3.5,17.4,10548,4162,6386,7,17.8,-253,-0.4,34.8,0,535,538,2901
1985,05,l) Left Censored,15057,20129,471976,473689,674,3.3,1667,8.1,56497,12636,43861,2.7,11.9,59924,23047,36877,4.9,12.7,-3427,-0.8,23.8,0,912,943,7111
1985,06,a) 0,63193,63814,383922,193058,63324,198.5,0,0,381729,381729,0,197.7,197.7,0,0,0,0,0,381729,197.7,0,0,,,
1985,06,b) 1,48632,49435,402488,392165,301,0.5,11450,20.7,131348,6288,125060,1.6,33.5,110701,55435,55266,14.1,28.2,20647,5.3,56.4,0,7807,7808,39632
1985,06,c) 2,35632,37077,396722,400268,1914,4.8,7294,18.3,104855,19823,85032,5,26.2,111946,48279,63667,12.1,28,-7091,-1.8,52.4,0,5507,5514,36135
1985,06,d) 3,33132,35010,335259,335814,1585,4.3,5996,16.1,82328,13269,69059,4,24.5,83437,39152,44285,11.7,24.8,-1109,-0.3,49,0,4279,4306,28820
1985,06,e) 4,31406,33212,381650,383089,1445,4.1,4782,13.7,76472,11615,64857,3,20,79350,33248,46102,8.7,20.7,-2878,-0.7,40,0,3297,3312,21092
1985,06,f) 5,28479,29863,286190,292253,1323,4.2,4108,13.2,57658,7587,50071,2.6,19.7,69784,31834,37950,10.9,23.9,-12126,-4.2,39.4,0,2861,2880,22854
1985,06,g) 6 to 10,72423,82297,911909,924647,3846,4.5,10407,12.2,166217,27826,138391,3,18,191693,81050,110643,8.8,20.7,-25476,-2.7,36,0,6341,6385,47791
1985,06,l) Left Censored,150405,225991,6161327,6160000,9914,4.3,20982,9.1,923189,241615,681574,3.9,15,920536,330413,590123,5.4,14.9,2653,0.1,29.8,0,9719,9871,86229
1985,08,a) 0,10129,10220,59091,29726,10176,199.1,0,0,58730,58730,0,197.6,197.6,0,0,0,0,0,58730,197.6,0,0,,,
1985,08,b) 1,7775,7887,57367,58322,57,0.6,2427,26.6,17339,1410,15929,2.4,29.7,19249,10953,8296,18.8,33,-1910,-3.3,59.4,0,1874,1875,8945
1985,08,c) 2,5369,5640,61983,63533,255,4.1,1455,23.2,14655,3799,10856,6,23.1,17755,8982,8773,14.1,27.9,-3100,-4.8,46.2,0,1164,1166,7005
1985,08,d) 3,4894,5113,41868,44909,230,4.1,1138,20.4,8490,1767,6723,3.9,18.9,14571,8416,6155,18.7,32.4,-6081,-13.5,37.8,0,853,860,6229
1985,08,e) 4,4349,4587,49268,51446,173,3.5,813,16.6,7665,1316,6349,2.6,14.9,12020,4624,7396,9,23.4,-4355,-8.5,29.8,0,593,596,3129
1985,08,f) 5,4030,4203,37524,39030,167,3.8,645,14.5,6338,495,5843,1.3,16.2,9350,3641,5709,9.3,24,-3012,-7.8,32.4,0,480,482,2729
1985,08,g) 6 to 10,10012,11241,112374,117008,532,4.5,1615,13.7,19854,3622,16232,3.1,17,29121,13107,16014,11.2,24.9,-9267,-7.9,34,0,1074,1080,7963
1985,08,l) Left Censored,20856,30550,742703,742269,1636,5.2,2978,9.5,103524,28170,75354,3.8,13.9,102656,35903,66753,4.8,13.8,868,0.1,27.6,0,1427,1431,12116
1985,09,a) 0,6975,7014,36700,18450,6970,198.7,0,0,36501,36501,0,197.8,197.8,0,0,0,0,0,36501,197.8,0,0,,,
1985,09,b) 1,5474,5528,42637,40424,27,0.4,1019,16.8,12787,564,12223,1.4,31.6,8360,4145,4215,10.3,20.7,4427,10.9,41.4,0,712,712,3160
1985,09,c) 2,3996,4047,27859,29199,140,3.2,750,17.2,5945,852,5093,2.9,20.4,8625,5085,3540,17.4,29.5,-2680,-9.1,40.8,0,582,582,4253
1985,09,d) 3,3697,3838,46275,46825,119,2.9,557,13.7,7124,430,6694,0.9,15.2,8223,3782,4441,8.1,17.6,-1099,-2.4,30.4,0,433,434,3009
1985,09,e) 4,3396,3573,34439,34664,118,3.1,481,12.8,6502,1200,5302,3.5,18.8,6951,3051,3900,8.8,20.1,-449,-1.3,37.6,0,364,365,2247
1985,09,f) 5,2940,3064,26094,26012,95,3,401,12.5,4399,307,4092,1.2,16.9,4235,1746,2489,6.7,16.3,164,0.6,32.6,0,292,292,1188
1985,09,g) 6 to 10,8517,9306,102481,99942,318,3.3,1028,10.6,20484,2061,18423,2.1,20.5,15406,6873,8533,6.9,15.4,5078,5.1,30.8,0,718,720,3963
1985,09,l) Left Censored,28248,36132,1069604,1065857,1220,3.3,2723,7.4,126112,23595,102517,2.2,11.8,118617,40120,78497,3.8,11.1,7495,0.7,22.2,0,1529,1538,11467
1985,10,a) 0,1300,1305,6941,3509,1297,198.8,0,0,6865,6865,0,195.6,195.6,0,0,0,0,0,6865,195.6,0,0,,,
1985,10,b) 1,1033,1044,7285,7111,13,1.1,219,19,1911,126,1785,1.8,26.9,1563,884,679,12.4,22,348,4.9,44,0,146,146,606
1985,10,c) 2,725,739,5634,5611,36,4.5,151,18.9,1401,234,1167,4.2,25,1355,759,596,13.5,24.1,46,0.9,48.2,0,99,100,435
1985,10,d) 3,616,628,5613,5693,27,4,109,16.3,1148,133,1015,2.3,20.2,1307,726,581,12.8,23,-159,-2.8,40.4,0,80,80,565
1985,10,e) 4,581,610,5239,5340,26,4.1,70,11.1,830,62,768,1.2,15.5,1032,576,456,10.8,19.3,-202,-3.8,31,0,45,45,291
1985,10,f) 5,508,530,5281,4945,19,3.4,70,12.6,1535,138,1397,2.8,31,862,402,460,8.1,17.4,673,13.6,34.8,0,56,56,343
1985,10,g) 6 to 10,1463,1649,20724,19844,62,3.6,184,10.8,4386,663,3723,3.3,22.1,2625,873,1752,4.4,13.2,1761,8.9,26.4,0,117,117,549
1985,10,l) Left Censored,4797,6228,188674,187433,264,4.2,476,7.5,24648,5070,19578,2.7,13.2,22167,6973,15194,3.7,11.8,2481,1.4,23.6,0,225,226,1840
1985,11,a) 0,1343,1348,11591,5813,1342,199.1,0,0,11557,11557,0,198.8,198.8,0,0,0,0,0,11557,198.8,0,0,,,
1985,11,b) 1,1210,1222,11695,10757,7,0.5,130,10.1,3521,160,3361,1.5,32.7,1644,573,1071,5.3,15.3,1877,17.4,30.6,1,8,8,
1985,11,c) 2,1025,1039,8422,8904,62,5.7,143,13.3,2248,906,1342,10.2,25.2,3212,916,2296,10.3,36.1,-964,-10.9,50.4,0,14,14,44
1985,11,d) 3,889,908,8022,8457,45,4.8,118,12.6,1684,437,1247,5.2,19.9,2554,590,1964,7,30.2,-870,-10.3,39.8,0,14,19,122
1985,11,e) 4,776,799,10162,10561,33,4.1,63,7.8,1408,309,1099,2.9,13.3,2206,924,1282,8.7,20.9,-798,-7.6,26.6,1,10,10,
1985,11,f) 5,648,663,7391,7161,22,3.3,48,7.1,1509,188,1321,2.6,21.1,1048,355,693,5,14.6,461,6.5,29.2,0,17,17,68
1985,11,g) 6 to 10,1844,2059,46227,46531,104,4.9,243,11.4,5301,709,4592,1.5,11.4,5909,2166,3743,4.7,12.7,-608,-1.3,22.8,0,133,137,961
1985,11,l) Left Censored,6540,8432,259630,257046,346,4,727,8.4,38687,9168,29519,3.6,15.1,33518,15708,17810,6.1,13,5169,2.1,26,0,227,229,4507
1985,12,a) 0,34768,35120,196244,98386,34949,199,0,0,195716,195716,0,198.9,198.9,0,0,0,0,0,195716,198.9,0,0,,,
1985,12,b) 1,25530,25834,203786,201775,133,0.4,7396,24.9,66237,3380,62857,1.7,32.8,62215,34769,27446,17.2,30.8,4022,2,61.6,0,5581,5581,26969
1985,12,c) 2,18327,18750,159686,161376,848,4.1,4563,22,46052,5132,40920,3.2,28.5,49431,25986,23445,16.1,30.6,-3379,-2.1,57,0,3620,3627,20711
1985,12,d) 3,16152,16771,153590,158934,681,3.8,3119,17.3,31781,3695,28086,2.3,20,42469,18566,23903,11.7,26.7,-10688,-6.7,40,0,2379,2389,13912
1985,12,e) 4,14049,14724,147583,149638,585,3.7,2404,15.4,30220,4775,25445,3.2,20.2,34330,15500,18830,10.4,22.9,-4110,-2.7,40.4,0,1831,1837,11700
1985,12,f) 5,12432,12928,114409,117165,520,3.8,1893,13.9,21859,3002,18857,2.6,18.7,27371,10616,16755,9.1,23.4,-5512,-4.7,37.4,0,1415,1417,7859
1985,12,g) 6 to 10,30739,34878,366775,371788,1529,4.2,4394,12.1,66697,11007,55690,3,17.9,76723,33362,43361,9,20.6,-10026,-2.7,35.8,0,2946,2964,21133
1985,12,l) Left Censored,63204,100409,2354822,2343346,5736,5.6,8619,8.5,359191,113129,246062,4.8,15.3,336238,114611,221627,4.9,14.3,22953,1,28.6,0,4255,4295,37604
1985,13,a) 0,13714,13816,82181,41268,13749,199,0,0,81826,81826,0,198.3,198.3,0,0,0,0,0,81826,198.3,0,0,,,
1985,13,b) 1,10456,10613,86598,82966,79,0.7,2492,20.9,27908,3851,24057,4.6,33.6,20644,11817,8827,14.2,24.9,7264,8.7,49.8,0,1825,1825,8895
1985,13,c) 2,7072,7208,58892,59464,333,4.3,1463,18.8,14534,1813,12721,3,24.4,15678,8060,7618,13.6,26.4,-1144,-2,48.8,0,1124,1124,6063
1985,13,d) 3,6002,6360,64534,64766,258,3.8,1025,15.2,13579,1671,11908,2.6,21,14042,6534,7508,10.1,21.7,-463,-0.7,42,0,762,767,4917
1985,13,e) 4,5271,5558,59649,58759,244,4.2,775,13.3,12439,1841,10598,3.1,21.2,10659,4808,5851,8.2,18.1,1780,3.1,36.2,0,539,539,3182
1985,13,f) 5,4745,5093,57165,54032,247,4.6,708,13.3,16711,1954,14757,3.6,30.9,10444,5238,5206,9.7,19.3,6267,11.6,38.6,0,476,485,3336
1985,13,g) 6 to 10,13271,15023,166764,167069,748,4.8,1724,11.1,31612,5764,25848,3.5,18.9,32222,13989,18233,8.4,19.3,-610,-0.4,37.8,0,1075,1094,7182
1985,13,l) Left Censored,35774,55112,1522956,1500739,2646,4.7,4381,7.8,220389,51527,168862,3.4,14.7,175955,59026,116929,3.9,11.7,44434,3,23.4,0,2066,2082,15226
1985,15,a) 0,2151,2168,12901,6463,2159,199.2,0,0,12877,12877,0,199.2,199.2,0,0,0,0,0,12877,199.2,0,0,,,
1985,15,b) 1,1484,1503,10899,10586,8,0.5,308,18.5,3074,252,2822,2.4,29,2448,1203,1245,11.4,23.1,626,5.9,46.2,0,204,204,843
1985,15,c) 2,1443,1473,11234,11305,81,5.1,281,17.8,2347,369,1978,3.3,20.8,2489,1160,1329,10.3,22,-142,-1.2,41.6,0,219,219,933
1985,15,d) 3,1258,1299,10210,10533,53,3.8,225,16.2,1814,236,1578,2.2,17.2,2459,977,1482,9.3,23.3,-645,-6.1,34.4,0,166,166,734
1985,15,e) 4,1252,1315,14075,13821,59,4.3,165,12.1,2743,478,2265,3.5,19.8,2235,805,1430,5.8,16.2,508,3.6,32.4,0,126,126,561
1985,15,f) 5,1061,1156,10761,11039,44,3.6,165,13.6,2089,265,1824,2.4,18.9,2644,1147,1497,10.4,24,-555,-5.1,37.8,0,124,125,734
1985,15,g) 6 to 10,2692,3128,32699,33091,134,4.1,411,12.6,5200,1109,4091,3.4,15.7,5984,3048,2936,9.2,18.1,-784,-2.4,31.4,0,234,241,1518
1985,15,l) Left Censored,7123,10337,218322,219201,389,3.7,769,7.3,25384,6672,18712,3,11.6,27142,8828,18314,4,12.4,-1758,-0.8,23.2,0,391,395,2382
1985,16,a) 0,2119,2133,10939,5502,2122,199,0,0,10874,10874,0,197.6,197.6,0,0,0,0,0,10874,197.6,0,0,,,
1985,16,b) 1,1757,1780,10812,10932,8,0.4,383,19.3,3063,48,3015,0.4,28,3302,1570,1732,14.4,30.2,-239,-2.2,56,0,273,273,1205
1985,16,c) 2,1247,1313,10398,12057,64,4.4,336,23,2037,525,1512,4.4,16.9,5354,1611,3743,13.4,44.4,-3317,-27.5,33.8,0,253,254,1289
1985,16,d) 3,1101,1159,9048,9368,36,2.8,255,20.1,1873,131,1742,1.4,20,2513,1236,1277,13.2,26.8,-640,-6.8,40,0,195,195,1015
1985,16,e) 4,997,1037,8105,8621,37,3.3,196,17.5,1430,97,1333,1.1,16.6,2462,1423,1039,16.5,28.6,-1032,-12,33.2,0,131,132,816
1985,16,f) 5,981,1024,7983,8286,46,4.3,149,13.9,1396,352,1044,4.2,16.8,2001,1070,931,12.9,24.1,-605,-7.3,33.6,0,113,113,794
1985,16,g) 6 to 10,2802,3063,27188,29388,119,3.7,377,11.8,3966,437,3529,1.5,13.5,8365,2283,6082,7.8,28.5,-4399,-15,27,0,258,259,1574
1985,16,l) Left Censored,6728,9388,165978,166943,346,3.6,781,8.1,19145,3685,15460,2.2,11.5,21077,6150,14927,3.7,12.6,-1932,-1.1,23,0,408,414,2337
1985,17,a) 0,19243,19385,119561,59919,19275,198.9,0,0,119284,119284,0,199.1,199.1,0,0,0,0,0,119284,199.1,0,0,,,
1985,17,b) 1,15969,16244,133384,131359,109,0.6,3322,18.5,35212,3643,31569,2.8,26.8,31164,14300,16864,10.9,23.7,4048,3.1,47.4,0,2415,2415,10678
1985,17,c) 2,11444,11682,104770,106602,480,3.8,2196,17.4,21232,3040,18192,2.9,19.9,24895,12284,12611,11.5,23.4,-3663,-3.5,39.8,0,1664,1667,9222
1985,17,d) 3,11032,11458,116028,118385,393,3.2,1832,15,20544,2128,18416,1.8,17.4,25257,11526,13731,9.7,21.3,-4713,-3.9,34.8,0,1388,1391,8329
1985,17,e) 4,9605,9994,104811,106908,355,3.4,1422,13.5,18276,2427,15849,2.3,17.1,22470,11441,11029,10.7,21,-4194,-3.9,34.2,0,1036,1038,8450
1985,17,f) 5,8969,9330,84019,84936,366,3.7,1284,13.1,14715,2403,12312,2.8,17.3,16548,6719,9829,7.9,19.5,-1833,-2.2,34.6,0,934,939,4934
1985,17,g) 6 to 10,25172,28173,287638,290861,1037,3.5,3291,11.3,50234,8011,42223,2.8,17.3,56680,25759,30921,8.9,19.5,-6446,-2.2,34.6,0,2136,2158,16091
1985,17,l) Left Censored,83244,112651,3148038,3168016,4104,3.6,9786,8.5,376872,96848,280024,3.1,11.9,416828,139327,277501,4.4,13.2,-39956,-1.3,23.8,0,5143,5192,40502
1985,18,a) 0,9557,9698,53421,26829,9627,198.5,0,0,53184,53184,0,198.2,198.2,0,0,0,0,0,53184,198.2,0,0,,,
1985,18,b) 1,7948,8112,61668,61123,73,0.8,1779,19.7,16410,1876,14534,3.1,26.8,15319,8327,6992,13.6,25.1,1091,1.7,50.2,0,1342,1342,6282
1985,18,c) 2,5474,5596,44849,45863,175,2.9,1162,19,9598,1535,8063,3.3,20.9,11626,5426,6200,11.8,25.3,-2028,-4.4,41.8,0,892,892,4148
1985,18,d) 3,4516,4768,43071,44061,154,3,798,15.7,8533,1229,7304,2.8,19.4,10512,5364,5148,12.2,23.9,-1979,-4.5,38.8,0,588,590,3957
1985,18,e) 4,4047,4265,46812,46595,165,3.7,523,11.8,8066,1009,7057,2.2,17.3,7631,3374,4257,7.2,16.4,435,0.9,32.8,0,390,391,2366
1985,18,f) 5,3967,4166,36421,35769,130,3,508,11.7,7241,1388,5853,3.9,20.2,5937,2563,3374,7.2,16.6,1304,3.6,33.2,0,379,379,1933
1985,18,g) 6 to 10,11585,13162,132376,131994,585,4.3,1539,11.3,22797,4655,18142,3.5,17.3,22033,9810,12223,7.4,16.7,764,0.6,33.4,0,956,960,6253
1985,18,l) Left Censored,37443,53251,1399459,1405887,1914,3.5,4456,8.2,157012,44003,113009,3.1,11.2,169867,55533,114334,4,12.1,-12855,-0.9,22.4,0,2248,2273,18443
1985,19,a) 0,4913,4957,24992,12611,4930,198.9,0,0,24762,24762,0,196.4,196.4,0,0,0,0,0,24762,196.4,0,0,,,
1985,19,b) 1,4639,4681,25694,26790,23,0.4,1122,21.3,5692,203,5489,0.8,21.2,7884,4442,3442,16.6,29.4,-2192,-8.2,42.4,0,828,828,3434
1985,19,c) 2,3051,3233,23616,24781,108,3,713,20.1,4150,613,3537,2.5,16.7,6479,3750,2729,15.1,26.1,-2329,-9.4,33.4,0,554,554,2985
1985,19,d) 3,2810,2896,20645,21683,88,2.8,535,17.1,3502,577,2925,2.7,16.2,5577,2616,2961,12.1,25.7,-2075,-9.5,32.4,0,415,416,1913
1985,19,e) 4,2760,2913,25348,25998,101,3.3,459,14.8,3630,561,3069,2.2,14,4929,2248,2681,8.6,19,-1299,-5,28,0,345,348,1594
1985,19,f) 5,2652,2735,19162,19628,86,3,437,15,3908,363,3545,1.8,19.9,4840,2355,2485,12,24.7,-932,-4.8,39.8,0,323,323,1768
1985,19,g) 6 to 10,7751,8870,69872,72026,298,3.2,1109,12,10812,1606,9206,2.2,15,15119,8104,7015,11.3,21,-4307,-6,30,0,746,748,3647
1985,19,l) Left Censored,25199,34041,641172,644949,993,2.8,3048,8.7,66488,13876,52612,2.2,10.3,74042,25265,48777,3.9,11.5,-7554,-1.2,20.6,0,1717,1730,10029
1985,20,a) 0,5516,5582,30080,15088,5555,199,0,0,29984,29984,0,198.7,198.7,0,0,0,0,0,29984,198.7,0,0,,,
1985,20,b) 1,4863,4912,32819,32683,29,0.5,1179,21.3,9119,490,8629,1.5,27.9,8847,5402,3445,16.5,27.1,272,0.8,54.2,0,923,923,4574
1985,20,c) 2,3239,3335,21764,23319,198,5.5,719,19.9,5078,1179,3899,5.1,21.8,8187,4760,3427,20.4,35.1,-3109,-13.3,43.6,0,558,560,3737
1985,20,d) 3,2916,3037,24735,25552,176,5.5,500,15.6,4432,776,3656,3,17.3,6065,3253,2812,12.7,23.7,-1633,-6.4,34.6,0,384,384,2358
1985,20,e) 4,2635,2788,23465,24946,155,5.3,384,13.2,4617,793,3824,3.2,18.5,7579,2221,5358,8.9,30.4,-2962,-11.9,37,0,280,280,1493
1985,20,f) 5,2285,2390,17539,17959,145,5.8,335,13.5,3101,681,2420,3.8,17.3,3940,2115,1825,11.8,21.9,-839,-4.6,34.6,0,251,255,1694
1985,20,g) 6 to 10,6625,7471,63835,64321,442,5.8,864,11.3,10733,2719,8014,4.2,16.7,11704,5178,6526,8.1,18.2,-971,-1.5,33.4,0,602,605,3255
1985,20,l) Left Censored,20710,27856,574724,587303,1235,4.4,2290,8.1,69127,18917,50210,3.2,11.8,94285,47429,46856,8.1,16.1,-25158,-4.3,23.6,0,1118,1127,8628
1985,21,a) 0,6010,6066,36426,18285,6035,199,0,0,36282,36282,0,198.4,198.4,0,0,0,0,0,36282,198.4,0,0,,,
1985,21,b) 1,5475,5547,36393,36376,36,0.6,1204,19.5,10209,952,9257,2.6,28.1,10174,6107,4067,16.8,28,35,0.1,56,0,926,926,3789
1985,21,c) 2,3611,3683,32826,33239,133,3.3,845,20.8,7068,703,6365,2.1,21.3,7893,4717,3176,14.2,23.7,-825,-2.4,42.6,0,678,679,3582
1985,21,d) 3,3228,3348,29713,29848,120,3.4,573,16,6021,828,5193,2.8,20.2,6290,2916,3374,9.8,21.1,-269,-0.9,40.4,0,444,455,2162
1985,21,e) 4,2728,2856,33544,33853,87,2.9,413,13.7,5078,355,4723,1,15,5695,2610,3085,7.7,16.8,-617,-1.8,30,0,317,318,1878
1985,21,f) 5,2434,2563,20718,21145,116,4.3,355,13.2,3135,609,2526,2.9,14.8,3988,1628,2360,7.7,18.9,-853,-4.1,29.6,0,284,285,1303
1985,21,g) 6 to 10,7334,8079,84371,82499,333,4,994,11.8,16260,3007,13253,3.6,19.7,12516,5093,7423,6.2,15.2,3744,4.5,30.4,0,706,711,3592
1985,21,l) Left Censored,23365,32204,763555,762577,1178,3.6,2656,8.1,85356,18022,67334,2.4,11.2,83399,29968,53431,3.9,10.9,1957,0.3,21.8,0,1432,1442,10045
1985,22,a) 0,8306,8386,50478,25298,8343,199,0,0,50360,50360,0,199.1,199.1,0,0,0,0,0,50360,199.1,0,0,,,
1985,22,b) 1,6895,6981,58432,58132,34,0.4,1717,21.8,15233,490,14743,0.8,26.2,14633,7488,7145,12.9,25.2,600,1,50.4,0,1331,1331,5646
1985,22,c) 2,5035,5166,41344,44152,215,3.8,1237,21.7,8636,1092,7544,2.5,19.6,14251,6995,7256,15.8,32.3,-5615,-12.7,39.2,0,992,994,5226
1985,22,d) 3,4968,5218,43635,45201,214,3.8,1035,18.4,8559,1021,7538,2.3,18.9,11690,5378,6312,11.9,25.9,-3131,-7,37.8,0,804,806,4021
1985,22,e) 4,4224,4390,47122,47896,160,3.4,743,15.9,8890,1156,7734,2.4,18.6,10437,4650,5787,9.7,21.8,-1547,-3.2,37.2,0,564,566,3172
1985,22,f) 5,3783,3961,37132,38871,146,3.5,602,14.4,6271,762,5509,2,16.1,9749,4404,5345,11.3,25.1,-3478,-9,32.2,0,427,434,3215
1985,22,g) 6 to 10,9920,11067,121866,123308,448,3.9,1432,12.4,21975,5877,16098,4.8,17.8,24858,9362,15496,7.6,20.2,-2883,-2.4,35.6,0,986,995,5362
1985,22,l) Left Censored,26412,38295,846413,862392,1640,4.2,3491,8.9,103684,28247,75437,3.3,12,135642,43607,92035,5.1,15.7,-31958,-3.7,24,0,1724,1739,14467
1985,23,a) 0,2767,2783,12522,6289,2761,198.4,0,0,12466,12466,0,198.2,198.2,0,0,0,0,0,12466,198.2,0,0,,,
1985,23,b) 1,2130,2156,13206,12800,13,0.5,405,17.1,3543,210,3333,1.6,27.7,2730,1161,1569,9.1,21.3,813,6.4,42.6,0,273,273,877
1985,23,c) 2,1485,1499,10285,10235,50,3.1,260,16.1,2397,280,2117,2.7,23.4,2297,1003,1294,9.8,22.4,100,1,44.8,0,193,193,787
1985,23,d) 3,1225,1271,10107,10400,44,3.3,196,14.5,1739,228,1511,2.2,16.7,2324,1135,1189,10.9,22.3,-585,-5.6,33.4,0,144,145,992
1985,23,e) 4,1115,1166,10344,10377,40,3.3,143,11.7,1582,98,1484,0.9,15.2,1647,697,950,6.7,15.9,-65,-0.7,30.4,0,103,103,592
1985,23,f) 5,1079,1110,9088,9124,35,3,136,11.7,1674,122,1552,1.3,18.3,1745,706,1039,7.7,19.1,-71,-0.8,36.6,0,92,92,487
1985,23,g) 6 to 10,3116,3440,33049,32793,154,4.3,392,11,5573,711,4862,2.2,17,5061,2068,2993,6.3,15.4,512,1.6,30.8,0,264,264,1096
1985,23,l) Left Censored,8879,11606,249063,252983,389,3.3,948,8,28489,7926,20563,3.1,11.3,36330,15938,20392,6.3,14.4,-7841,-3.1,22.6,0,500,503,4451
1985,24,a) 0,8699,8854,56259,28361,8768,198.1,0,0,55797,55797,0,196.7,196.7,0,0,0,0,0,55797,196.7,0,0,,,
1985,24,b) 1,6498,6584,60329,55174,44,0.6,626,9.1,20096,813,19283,1.5,36.4,9785,2654,7131,4.8,17.7,10311,18.7,35.4,0,48,48,295
1985,24,c) 2,4891,5012,43583,42096,222,4.3,638,12.2,11667,1893,9774,4.5,27.7,8692,3729,4963,8.9,20.6,2975,7.1,41.2,0,31,31,170
1985,24,d) 3,4153,4366,46033,45153,168,3.7,475,10.6,10373,1264,9109,2.8,23,8612,3344,5268,7.4,19.1,1761,3.9,38.2,0,46,63,773
1985,24,e) 4,3670,3838,43287,45158,149,3.8,358,9.1,9625,1457,8168,3.2,21.3,13367,2702,10665,6,29.6,-3742,-8.3,42.6,0,39,40,319
1985,24,f) 5,3344,3478,40257,38447,123,3.5,262,7.4,9488,1421,8067,3.7,24.7,5868,1673,4195,4.4,15.3,3620,9.4,30.6,0,79,79,719
1985,24,g) 6 to 10,9279,10445,120975,119832,418,3.9,1064,9.9,23683,2918,20765,2.4,19.8,21397,9466,11931,7.9,17.9,2286,1.9,35.8,0,667,671,5737
1985,24,l) Left Censored,27953,40024,1073097,1058739,1674,4.1,3187,7.8,156763,43016,113747,4.1,14.8,128046,47169,80877,4.5,12.1,28717,2.7,24.2,0,1446,1455,14226
1985,25,a) 0,12384,12486,78969,39586,12421,199,0,0,78767,78767,0,199,199,0,0,0,0,0,78767,199,0,0,,,
1985,25,b) 1,9483,9582,98254,88736,55,0.5,1711,16.4,37021,1419,35602,1.6,41.7,17984,9604,8380,10.8,20.3,19037,21.4,40.6,0,1211,1211,7929
1985,25,c) 2,6945,7075,64675,64933,272,3.6,1174,15.6,14765,1490,13275,2.3,22.7,15281,7390,7891,11.4,23.5,-516,-0.8,45.4,0,887,887,5963
1985,25,d) 3,6199,6475,82759,83311,208,3,919,13.5,13302,1763,11539,2.1,16,14406,5992,8414,7.2,17.3,-1104,-1.3,32,0,666,666,3970
1985,25,e) 4,5481,5691,72910,71374,176,3,693,11.7,15753,1134,14619,1.6,22.1,12681,5175,7506,7.3,17.8,3072,4.3,35.6,0,499,499,2552
1985,25,f) 5,4995,5155,50347,50087,188,3.5,625,11.6,9723,1150,8573,2.3,19.4,9202,3977,5225,7.9,18.4,521,1,36.8,0,476,477,2877
1985,25,g) 6 to 10,13851,15750,215304,213881,597,3.7,1671,10.3,33328,4149,29179,1.9,15.6,30481,13917,16564,6.5,14.3,2847,1.3,28.6,0,1087,1096,8061
1985,25,l) Left Censored,49293,64750,1946190,1951165,2047,3.1,4823,7.3,238286,44529,193757,2.3,12.2,248236,83405,164831,4.3,12.7,-9950,-0.5,24.4,0,2705,2724,29797
1985,26,a) 0,15551,15757,91221,45743,15666,198.8,0,0,90956,90956,0,198.8,198.8,0,0,0,0,0,90956,198.8,0,0,,,
1985,26,b) 1,12744,12945,98778,94737,100,0.7,2585,18.1,29874,3583,26291,3.8,31.5,21791,10369,11422,10.9,23,8083,8.5,46,0,1897,1897,7639
1985,26,c) 2,8944,9121,74032,73206,363,3.7,1622,16.6,16945,1876,15069,2.6,23.1,15293,7481,7812,10.2,20.9,1652,2.2,41.8,0,1283,1283,5925
1985,26,d) 3,7691,8037,71709,72389,302,3.6,1222,14.4,14458,1506,12952,2.1,20,15818,7247,8571,10,21.9,-1360,-1.9,40,0,931,939,5591
1985,26,e) 4,7203,7548,77133,76683,307,3.9,945,12,15289,2567,12722,3.3,19.9,14389,6464,7925,8.4,18.8,900,1.1,37.6,0,709,715,3951
1985,26,f) 5,6672,7008,60371,60581,273,3.7,886,12.1,11134,1314,9820,2.2,18.4,11554,5073,6481,8.4,19.1,-420,-0.7,36.8,0,645,650,3875
1985,26,g) 6 to 10,19166,21802,224438,222418,965,4.3,2382,10.6,39258,7143,32115,3.2,17.7,35217,16070,19147,7.2,15.8,4041,1.9,31.6,0,1548,1554,9900
1985,26,l) Left Censored,57269,81180,2219869,2207383,2967,3.6,6594,7.9,304754,96287,208467,4.4,13.8,279782,119794,159988,5.4,12.7,24972,1.1,25.4,0,3568,3601,27574
1985,27,a) 0,8534,8640,53455,26788,8595,199,0,0,53334,53334,0,199.1,199.1,0,0,0,0,0,53334,199.1,0,0,,,
1985,27,b) 1,7116,7255,56839,56005,50,0.6,1557,19.3,15225,1964,13261,3.5,27.2,13556,7362,6194,13.1,24.2,1669,3,48.4,0,1141,1141,5754
1985,27,c) 2,4827,5107,47653,48097,162,2.9,988,17.8,10439,1638,8801,3.4,21.7,11326,6154,5172,12.8,23.5,-887,-1.8,43.4,0,740,740,4607
1985,27,d) 3,4117,4309,40768,41443,133,2.9,813,17.5,8243,568,7675,1.4,19.9,9593,5041,4552,12.2,23.1,-1350,-3.2,39.8,0,619,621,3753
1985,27,e) 4,3956,4137,44865,44605,135,3.1,590,13.5,8672,1129,7543,2.5,19.4,8152,3529,4623,7.9,18.3,520,1.1,36.6,0,441,444,2544
1985,27,f) 5,3743,3916,34827,35001,137,3.3,553,13.4,6360,1071,5289,3.1,18.2,6707,3100,3607,8.9,19.2,-347,-1,36.4,0,396,397,2418
1985,27,g) 6 to 10,10795,12259,129617,131779,520,4.1,1510,11.8,21752,3431,18321,2.6,16.5,26076,13294,12782,10.1,19.8,-4324,-3.3,33,0,1026,1032,8847
1985,27,l) Left Censored,32136,43549,1177907,1174843,1526,3.4,3524,7.9,152886,42435,110451,3.6,13,146758,58363,88395,5,12.5,6128,0.5,25,0,1834,1854,26025
1985,28,a) 0,4415,4450,23562,11816,4417,198.5,0,0,23492,23492,0,198.8,198.8,0,0,0,0,0,23492,198.8,0,0,,,
1985,28,b) 1,3782,3814,24036,24750,14,0.3,1055,24.2,5728,290,5438,1.2,23.1,7156,4044,3112,16.3,28.9,-1428,-5.8,46.2,0,799,799,3086
1985,28,c) 2,2423,2469,17527,17955,102,3.7,594,21.8,4553,444,4109,2.5,25.4,5408,2547,2861,14.2,30.1,-855,-4.7,50.8,0,462,463,1999
1985,28,d) 3,2101,2168,15531,16459,74,3.1,425,18.1,2363,265,2098,1.6,14.4,4218,2053,2165,12.5,25.6,-1855,-11.2,28.8,0,345,345,1802
1985,28,e) 4,1995,2085,22249,21915,75,3.4,297,13.5,4274,696,3578,3.2,19.5,3605,1526,2079,7,16.4,669,3.1,32.8,0,218,218,1042
1985,28,f) 5,1912,1981,16911,17549,76,3.6,327,15.5,2749,327,2422,1.9,15.7,4024,1850,2174,10.5,22.9,-1275,-7.2,31.4,0,234,234,1456
1985,28,g) 6 to 10,5454,6155,54339,55546,296,4.6,767,12,8809,1866,6943,3.4,15.9,11223,4300,6923,7.7,20.2,-2414,-4.3,31.8,0,506,508,2418
1985,28,l) Left Censored,15503,21643,484359,486433,799,3.6,1682,7.6,55886,12803,43083,2.6,11.5,60033,20759,39274,4.3,12.3,-4147,-0.8,23,0,895,909,6926
1985,29,a) 0,10228,10323,56377,28286,10259,198.8,0,0,56183,56183,0,198.6,198.6,0,0,0,0,0,56183,198.6,0,0,,,
1985,29,b) 1,8079,8196,59212,59006,51,0.6,1865,20.4,15956,1372,14584,2.3,27,15544,7911,7633,13.4,26.3,412,0.7,52.6,0,1370,1370,6071
1985,29,c) 2,5600,5750,48084,48647,321,5.2,1203,19.4,11581,2700,8881,5.6,23.8,12707,7180,5527,14.8,26.1,-1126,-2.3,47.6,0,959,959,5766
1985,29,d) 3,4814,5064,42942,43935,262,4.9,770,14.5,8086,1524,6562,3.5,18.4,10072,4712,5360,10.7,22.9,-1986,-4.5,36.8,0,595,597,3686
1985,29,e) 4,4562,4874,46695,47370,225,4.4,686,13.5,8220,1274,6946,2.7,17.4,9569,4809,4760,10.2,20.2,-1349,-2.8,34.8,0,515,516,2751
1985,29,f) 5,4088,4272,36502,36743,163,3.6,625,13.9,7256,1123,6133,3.1,19.7,7738,3565,4173,9.7,21.1,-482,-1.4,39.4,0,457,458,2547
1985,29,g) 6 to 10,11825,13244,128688,129078,606,4.4,1660,12.1,22083,4111,17972,3.2,17.1,22862,10421,12441,8.1,17.7,-779,-0.6,34.2,0,1144,1150,6868
1985,29,l) Left Censored,36834,51281,1348506,1353253,1966,3.7,4246,8.1,161934,42495,119439,3.1,12,171429,70514,100915,5.2,12.7,-9495,-0.7,24,0,2244,2270,17947
1985,30,a) 0,2337,2344,10649,5343,2326,198.5,0,0,10613,10613,0,198.6,198.6,0,0,0,0,0,10613,198.6,0,0,,,
1985,30,b) 1,1885,1905,9565,10053,5,0.2,600,27,2410,33,2377,0.3,24,3385,1788,1597,17.8,33.7,-975,-9.7,48,0,434,434,1356
1985,30,c) 2,1360,1444,10033,10602,61,3.9,311,19.7,1958,357,1601,3.4,18.5,3095,1575,1520,14.9,29.2,-1137,-10.7,37,0,243,243,1312
1985,30,d) 3,1159,1182,7231,7758,45,3.5,254,19.7,1235,121,1114,1.6,15.9,2289,1285,1004,16.6,29.5,-1054,-13.6,31.8,0,186,186,980
1985,30,e) 4,1109,1140,8386,8539,30,2.5,179,14.8,1613,150,1463,1.8,18.9,1919,916,1003,10.7,22.5,-306,-3.6,37.8,0,138,139,735
1985,30,f) 5,1093,1127,8241,8474,42,3.5,163,13.7,1314,192,1122,2.3,15.5,1780,721,1059,8.5,21,-466,-5.5,31,0,119,119,574
1985,30,g) 6 to 10,3046,3315,23811,24853,140,4.1,421,12.2,3462,458,3004,1.8,13.9,5545,2518,3027,10.1,22.3,-2083,-8.4,27.8,0,279,281,1253
1985,30,l) Left Censored,7080,9147,139651,142760,281,3,817,8.7,12778,1958,10820,1.4,9,18997,7277,11720,5.1,13.3,-6219,-4.3,18,0,418,418,2174
1985,31,a) 0,3282,3303,18466,9292,3276,198.4,0,0,18349,18349,0,197.5,197.5,0,0,0,0,0,18349,197.5,0,0,,,
1985,31,b) 1,2663,2694,16307,16387,12,0.4,491,16.6,3972,165,3807,1,24.2,4132,2063,2069,12.6,25.2,-160,-1,48.4,0,352,352,1332
1985,31,c) 2,2034,2145,18331,18918,121,5.2,428,18.6,3517,935,2582,4.9,18.6,4690,2687,2003,14.2,24.8,-1173,-6.2,37.2,0,331,331,1899
1985,31,d) 3,1815,1886,14142,14585,81,4,331,16.5,2493,435,2058,3,17.1,3379,1921,1458,13.2,23.2,-886,-6.1,34.2,0,252,253,1323
1985,31,e) 4,1689,1771,12236,12547,95,5.2,246,13.3,1899,304,1595,2.4,15.1,2521,1068,1453,8.5,20.1,-622,-5,30.2,0,196,196,835
1985,31,f) 5,1601,1636,11815,11581,122,7.2,240,14.2,3009,1606,1403,13.9,26,2541,1442,1099,12.5,21.9,468,4.1,43.8,0,178,180,804
1985,31,g) 6 to 10,4697,5143,39826,40069,301,5.7,585,11.1,6096,1286,4810,3.2,15.2,6582,2650,3932,6.6,16.4,-486,-1.2,30.4,0,417,420,1904
1985,31,l) Left Censored,15039,19500,379814,380499,731,3.7,1575,7.9,44924,13442,31482,3.5,11.8,46293,19745,26548,5.2,12.2,-1369,-0.4,23.6,0,874,879,8498
1985,32,a) 0,2508,2523,17369,8709,2511,199,0,0,17320,,,,198.9,0,0,0,0,0,17320,198.9,0,1,,,
1985,32,b) 1,1986,2011,18418,17568,11,0.5,714,30.1,6848,,,,39,5148,3067,2081,17.5,29.3,1700,9.7,58.6,1,565,565,2510
1985,32,c) 2,1337,1398,14487,15074,77,5,361,23.3,3862,423,3439,2.8,25.6,5035,2131,2904,14.1,33.4,-1173,-7.8,51.2,0,286,286,1835
1985,32,d) 3,1307,1364,15693,16233,72,4.9,266,18.2,3021,327,2694,2,18.6,4101,2135,1966,13.2,25.3,-1080,-6.7,37.2,0,189,190,1247
1985,32,e) 4,1194,1251,11949,12766,68,5.2,199,15.1,2230,400,1830,3.1,17.5,3863,2252,1611,17.6,30.3,-1633,-12.8,35,0,142,142,1864
1985,32,f) 5,1090,1133,12854,13691,51,4.2,191,15.9,1910,240,1670,1.8,14,3584,1182,2402,8.6,26.2,-1674,-12.2,28,0,125,125,602
1985,32,g) 6 to 10,2798,3116,39939,39831,148,4.6,427,13.1,7765,1743,6022,4.4,19.5,7548,3612,3936,9.1,19,217,0.5,38,0,276,276,1532
1985,32,l) Left Censored,5383,7680,245875,245490,409,5.2,707,9,29931,6642,23289,2.7,12.2,29160,13795,15365,5.6,11.9,771,0.3,23.8,0,308,312,3777
1985,33,a) 0,3202,3215,16859,8450,3197,198.9,0,0,16818,16818,0,199,199,0,0,0,0,0,16818,199,0,0,,,
1985,33,b) 1,2325,2354,18283,16878,21,0.8,427,16.6,5835,395,5440,2.3,34.6,3024,1523,1501,9,17.9,2811,16.7,35.8,0,304,304,1116
1985,33,c) 2,1518,1544,12077,12164,61,3.7,273,16.5,2752,510,2242,4.2,22.6,2926,1295,1631,10.6,24.1,-174,-1.5,45.2,0,218,218,942
1985,33,d) 3,1315,1347,12724,12500,47,3.3,197,13.9,2976,477,2499,3.8,23.8,2528,1499,1029,12,20.2,448,3.6,40.4,0,151,151,1025
1985,33,e) 4,1093,1115,11668,12288,30,2.5,169,14.3,2365,765,1600,6.2,19.2,3605,1019,2586,8.3,29.3,-1240,-10.1,38.4,0,118,118,721
1985,33,f) 5,1023,1060,10057,9868,39,3.5,123,11.2,2111,185,1926,1.9,21.4,1733,732,1001,7.4,17.6,378,3.8,35.2,0,92,92,525
1985,33,g) 6 to 10,2999,3361,35966,36190,144,4.2,373,10.8,7232,1136,6096,3.1,20,7680,3700,3980,10.2,21.2,-448,-1.2,40,0,251,252,1489
1985,33,l) Left Censored,8112,10281,293601,292073,396,3.8,848,8.1,38945,7700,31245,2.6,13.3,35888,13276,22612,4.5,12.3,3057,1,24.6,0,462,465,5292
1985,34,a) 0,16690,16798,84325,42423,16660,198.4,0,0,83804,83804,0,197.5,197.5,0,0,0,0,0,83804,197.5,0,0,,,
1985,34,b) 1,12619,12762,104541,96170,79,0.6,2662,18.8,38248,8494,29754,8.8,39.8,21505,11241,10264,11.7,22.4,16743,17.4,44.8,0,1852,1852,7794
1985,34,c) 2,9807,9914,78501,78034,376,3.5,1723,16.2,21015,2134,18881,2.7,26.9,20081,9879,10202,12.7,25.7,934,1.2,51.4,0,1287,1287,6533
1985,34,d) 3,8767,9008,80667,82683,323,3.4,1312,13.8,15822,2608,13214,3.2,19.1,19854,8514,11340,10.3,24,-4032,-4.9,38.2,0,979,985,6190
1985,34,e) 4,7733,7978,75967,76782,286,3.4,1003,12,13434,2061,11373,2.7,17.5,15064,5937,9127,7.7,19.6,-1630,-2.1,35,0,710,710,4296
1985,34,f) 5,7276,7450,66511,66880,268,3.4,926,11.9,12060,1015,11045,1.5,18,12797,5456,7341,8.2,19.1,-737,-1.1,36,0,695,695,4153
1985,34,g) 6 to 10,19739,21149,207727,207791,855,3.9,2273,10.4,38759,8482,30277,4.1,18.7,38887,16551,22336,8,18.7,-128,0,37.4,0,1521,1527,10009
1985,34,l) Left Censored,62495,80642,2207890,2198257,2969,3.6,6368,7.7,302984,62798,240186,2.9,13.8,283718,97253,186465,4.4,12.9,19266,0.9,25.8,0,3672,3701,28482
1985,35,a) 0,3318,3334,18610,9359,3310,198.6,0,0,18502,18502,0,197.7,197.7,0,0,0,0,0,18502,197.7,0,0,,,
1985,35,b) 1,2633,2676,16952,17253,24,0.8,769,25,4962,390,4572,2.3,28.8,5563,3100,2463,18,32.2,-601,-3.4,57.6,0,580,580,2375
1985,35,c) 2,1981,2062,17731,18874,90,4,483,21.3,3585,468,3117,2.5,19,5870,3165,2705,16.8,31.1,-2285,-12.1,38,0,389,389,2649
1985,35,d) 3,1569,1621,14019,14833,69,4,321,18.4,3077,427,2650,2.9,20.7,4704,2632,2072,17.7,31.7,-1627,-11,41.4,0,240,240,1665
1985,35,e) 4,1572,1648,14557,14733,58,3.3,276,15.7,2822,321,2501,2.2,19.2,3173,1488,1685,10.1,21.5,-351,-2.3,38.4,0,193,194,1101
1985,35,f) 5,1497,1549,13398,13798,56,3.4,246,14.9,2445,354,2091,2.6,17.7,3245,1717,1528,12.4,23.5,-800,-5.8,35.4,0,183,185,1168
1985,35,g) 6 to 10,3838,4263,38329,39110,195,4.4,563,12.7,7094,1075,6019,2.7,18.1,8656,3611,5045,9.2,22.1,-1562,-4,36.2,0,346,346,2096
1985,35,l) Left Censored,8560,11924,247329,245736,570,4.7,1059,8.7,36861,8851,28010,3.6,15,33675,13757,19918,5.6,13.7,3186,1.3,27.4,0,459,465,3261
1985,36,a) 0,38170,38314,194156,97796,38076,198.8,0,0,192721,192721,0,197.1,197.1,0,0,0,0,0,192721,197.1,0,0,,,
1985,36,b) 1,29560,29917,210355,204293,149,0.4,6247,18.9,61242,3586,57656,1.8,30,49117,25558,23559,12.5,24,12125,6,48,0,4535,4535,18707
1985,36,c) 2,22913,23241,172505,178813,929,3.7,4425,17.6,39145,4693,34452,2.6,21.9,51760,21811,29949,12.2,28.9,-12615,-7,43.8,0,3401,3402,16221
1985,36,d) 3,19697,20248,172499,175686,702,3.3,3159,14.7,33780,3972,29808,2.3,19.2,40154,21370,18784,12.2,22.9,-6374,-3.7,38.4,0,2439,2441,15024
1985,36,e) 4,17488,18011,178278,178596,560,3,2468,13,31977,3513,28464,2,17.9,32613,13903,18710,7.8,18.3,-636,-0.4,35.8,0,1901,1905,9737
1985,36,f) 5,15759,16143,157819,158878,527,3.1,2125,12.5,27585,2556,25029,1.6,17.4,29702,13975,15727,8.8,18.7,-2117,-1.3,34.8,0,1577,1578,9865
1985,36,g) 6 to 10,43444,47548,494908,493044,1632,3.3,5315,10.8,80464,9884,70580,2,16.3,76736,32523,44213,6.6,15.6,3728,0.7,31.2,0,3797,3816,20257
1985,36,l) Left Censored,146409,184673,4827683,4831761,5160,2.7,15471,8.2,575221,122072,453149,2.5,11.9,583378,204642,378736,4.2,12.1,-8157,-0.2,23.8,0,9519,9601,71842
1985,37,a) 0,13692,13832,73716,37015,13740,198.7,0,0,73402,73402,0,198.3,198.3,0,0,0,0,0,73402,198.3,0,0,,,
1985,37,b) 1,11934,12127,80986,78933,99,0.7,2500,18.7,23010,2236,20774,2.8,29.2,18903,9029,9874,11.4,23.9,4107,5.3,47.8,0,1842,1846,6691
1985,37,c) 2,7033,7194,56566,56651,220,2.8,1457,18.6,14044,1440,12604,2.5,24.8,14215,7511,6704,13.3,25.1,-171,-0.3,49.6,0,1121,1121,5856
1985,37,d) 3,5747,5995,53884,54837,177,2.8,990,15.5,10613,1279,9334,2.3,19.4,12518,6265,6253,11.4,22.8,-1905,-3.4,38.8,0,717,717,3775
1985,37,e) 4,5210,5467,60711,61535,184,3.2,739,12.9,8400,1291,7109,2.1,13.7,10047,3928,6119,6.4,16.3,-1647,-2.6,27.4,0,539,539,2577
1985,37,f) 5,4736,4928,45223,45379,176,3.4,643,12.5,8451,926,7525,2,18.6,8763,3941,4822,8.7,19.3,-312,-0.7,37.2,0,444,449,2427
1985,37,g) 6 to 10,13785,15486,152401,153698,623,3.9,1716,10.7,26646,5217,21429,3.4,17.3,29240,12705,16535,8.3,19,-2594,-1.7,34.6,0,1091,1096,7868
1985,37,l) Left Censored,39998,59642,1723235,1720181,2205,3.6,4446,7.3,202303,46799,155504,2.7,11.8,196197,57527,138670,3.3,11.4,6106,0.4,22.8,0,2231,2246,16834
1985,38,a) 0,1476,1491,7222,3626,1484,199.1,0,0,7192,7192,0,198.3,198.3,0,0,0,0,0,7192,198.3,0,0,,,
1985,38,b) 1,1277,1292,6603,7199,5,0.3,303,20.9,1552,73,1479,1,21.6,2743,1487,1256,20.7,38.1,-1191,-16.5,43.2,0,222,222,1063
1985,38,c) 2,928,1007,7963,8053,44,4,215,19.6,1764,216,1548,2.7,21.9,1944,1023,921,12.7,24.1,-180,-2.2,43.8,0,162,162,822
1985,38,d) 3,864,887,5630,5855,39,4.1,153,16.2,1025,109,916,1.9,17.5,1474,725,749,12.4,25.2,-449,-7.7,35,0,115,115,531
1985,38,e) 4,765,793,6399,6634,37,4.4,119,14.3,913,138,775,2.1,13.8,1382,518,864,7.8,20.8,-469,-7,27.6,0,82,82,411
1985,38,f) 5,754,783,6611,6089,50,6.2,103,12.7,2157,428,1729,7,35.4,1112,522,590,8.6,18.3,1045,17.1,36.6,0,77,77,462
1985,38,g) 6 to 10,2102,2254,16253,16637,99,4.2,276,11.8,2313,547,1766,3.3,13.9,3081,1156,1925,6.9,18.5,-768,-4.6,27.8,0,173,174,686
1985,38,l) Left Censored,6495,8351,133393,133989,299,3.5,615,7.2,12950,2930,10020,2.2,9.7,14142,4319,9823,3.2,10.6,-1192,-0.9,19.4,0,315,316,1594
1985,39,a) 0,16686,16867,99833,50265,16786,199,0,0,99137,99137,0,197.2,197.2,0,0,0,0,0,99137,197.2,0,0,,,
1985,39,b) 1,14054,14293,114307,109586,90,0.6,2890,18.3,34368,2331,32037,2.1,31.4,24925,12726,12199,11.6,22.7,9443,8.7,45.4,0,2206,2206,10340
1985,39,c) 2,9725,10017,78346,79836,416,3.9,1811,16.9,17414,2668,14746,3.3,21.8,20394,10758,9636,13.5,25.5,-2980,-3.7,43.6,0,1423,1423,8849
1985,39,d) 3,8791,9223,76198,76888,349,3.6,1543,15.7,15533,1949,13584,2.5,20.2,16913,9120,7793,11.9,22,-1380,-1.8,40.4,0,1179,1190,7109
1985,39,e) 4,8215,8695,95658,96724,327,3.6,1031,11.4,15555,1622,13933,1.7,16.1,17686,7319,10367,7.6,18.3,-2131,-2.2,32.2,0,772,774,5577
1985,39,f) 5,7543,8041,67771,68582,344,4.1,1030,12.3,11907,1513,10394,2.2,17.4,13529,5755,7774,8.4,19.7,-1622,-2.3,34.8,0,752,756,4121
1985,39,g) 6 to 10,21876,25222,257938,255701,1014,3.9,2732,10.5,47292,9752,37540,3.8,18.5,42818,22003,20815,8.6,16.7,4474,1.8,33.4,0,1797,1808,10284
1985,39,l) Left Censored,74304,109088,2894264,2879657,3870,3.5,8988,8.1,358026,57687,300339,2,12.4,328811,124612,204199,4.3,11.4,29215,1,22.8,0,4264,4339,39402
1985,40,a) 0,7481,7548,39644,19933,7503,198.8,0,0,39423,39423,0,197.8,197.8,0,0,0,0,0,39423,197.8,0,0,,,
1985,40,b) 1,6292,6352,39262,40767,30,0.4,1922,26.2,10483,850,9633,2.1,25.7,13493,7904,5589,19.4,33.1,-3010,-7.4,51.4,0,1512,1512,6275
1985,40,c) 2,4338,4444,29799,32334,201,4,1291,25.8,6783,878,5905,2.7,21,11853,6888,4965,21.3,36.7,-5070,-15.7,42,0,1025,1026,5347
1985,40,d) 3,4334,4502,36489,38678,163,3.3,990,20.2,6350,759,5591,2,16.4,10727,5165,5562,13.4,27.7,-4377,-11.3,32.8,0,757,758,3863
1985,40,e) 4,3582,3755,32801,34219,136,3.4,695,17.2,5332,706,4626,2.1,15.6,8168,3422,4746,10,23.9,-2836,-8.3,31.2,0,551,552,2660
1985,40,f) 5,3274,3436,27176,28897,137,3.8,584,16,4594,743,3851,2.6,15.9,8035,3595,4440,12.4,27.8,-3441,-11.9,31.8,0,453,454,2530
1985,40,g) 6 to 10,8144,9079,83334,86181,331,3.5,1323,13.8,13174,3001,10173,3.5,15.3,18868,9037,9831,10.5,21.9,-5694,-6.6,30.6,0,918,929,6168
1985,40,l) Left Censored,21209,30068,666501,675116,1247,4.1,2644,8.6,73979,19251,54728,2.9,11,91209,26981,64228,4,13.5,-17230,-2.5,22,0,1396,1399,8403
1985,41,a) 0,7017,7064,36862,18484,7021,198.8,0,0,36756,36756,0,198.9,198.9,0,0,0,0,0,36756,198.9,0,0,,,
1985,41,b) 1,5458,5520,36988,37240,26,0.4,1703,26.6,10036,519,9517,1.4,26.9,10539,6320,4219,17,28.3,-503,-1.4,53.8,0,1265,1265,5057
1985,41,c) 2,3690,3917,35780,35009,192,4.5,956,22.2,10152,3364,6788,9.6,29,8609,4644,3965,13.3,24.6,1543,4.4,49.2,0,763,763,3745
1985,41,d) 3,3482,3627,31116,31878,131,3.3,700,17.9,6534,990,5544,3.1,20.5,8057,4215,3842,13.2,25.3,-1523,-4.8,41,0,563,565,3314
1985,41,e) 4,3333,3501,29842,30490,153,4.1,575,15.5,6005,761,5244,2.5,19.7,7301,3924,3377,12.9,23.9,-1296,-4.2,39.4,0,425,426,2763
1985,41,f) 5,3189,3303,23475,24630,153,4.4,504,14.5,3813,598,3215,2.4,15.5,6122,2650,3472,10.8,24.9,-2309,-9.4,31,0,388,389,2210
1985,41,g) 6 to 10,8073,8965,83111,84835,417,4.5,1234,13.2,14129,2338,11791,2.8,16.7,17576,6748,10828,8,20.7,-3447,-4,33.4,0,791,798,4025
1985,41,l) Left Censored,19493,27044,556730,559985,1035,3.7,2547,9.2,70753,14803,55950,2.6,12.6,77262,28204,49058,5,13.8,-6509,-1.2,25.2,0,1262,1292,9553
1985,42,a) 0,18877,19145,119971,60420,19031,198.8,0,0,119103,119103,0,197.1,197.1,0,0,0,0,0,119103,197.1,0,0,,,
1985,42,b) 1,15534,15957,135799,131397,177,1,3111,17.7,38610,3912,34698,3,29.4,29805,13633,16172,10.4,22.7,8805,6.7,45.4,0,2090,2090,8736
1985,42,c) 2,11090,11343,93604,95738,487,4,2011,16.5,20386,3709,16677,3.9,21.3,24654,12034,12620,12.6,25.8,-4268,-4.5,42.6,0,1508,1508,8797
1985,42,d) 3,9897,10363,100976,103967,405,3.7,1525,14,19166,3061,16105,2.9,18.4,25148,14921,10227,14.4,24.2,-5982,-5.8,36.8,0,1139,1148,12665
1985,42,e) 4,8821,9234,99458,99223,342,3.6,1150,11.9,16578,2136,14442,2.2,16.7,16108,6899,9209,7,16.2,470,0.5,32.4,0,800,808,4906
1985,42,f) 5,8455,8807,77416,78052,345,3.8,1080,11.8,13697,1527,12170,2,17.5,14969,7532,7437,9.6,19.2,-1272,-1.7,35,0,780,782,5509
1985,42,g) 6 to 10,24407,27612,294203,292827,1139,4,3126,10.9,50482,8820,41662,3,17.2,47730,21536,26194,7.4,16.3,2752,0.9,32.6,0,1989,1997,13283
1985,42,l) Left Censored,85684,119081,3095824,3130686,4081,3.3,10222,8.4,337119,74610,262509,2.4,10.8,406842,153828,253014,4.9,13,-69723,-2.2,21.6,0,5315,5389,60519
1985,44,a) 0,2141,2147,11229,5619,2141,199.4,0,0,11220,11220,0,199.7,199.7,0,0,0,0,0,11220,199.7,0,0,,,
1985,44,b) 1,1657,1666,13373,12591,14,0.8,371,20,4086,272,3814,2.2,32.5,2521,1333,1188,10.6,20,1565,12.5,40,0,276,276,1009
1985,44,c) 2,1171,1185,8886,9174,41,3.2,207,16.3,1945,432,1513,4.7,21.2,2520,1347,1173,14.7,27.5,-575,-6.3,42.4,0,150,150,1150
1985,44,d) 3,1004,1039,9957,9772,31,2.8,150,13.7,2203,334,1869,3.4,22.5,1833,895,938,9.2,18.8,370,3.7,37.6,0,119,119,767
1985,44,e) 4,914,931,9392,9220,20,2.1,112,11.5,1650,84,1566,0.9,17.9,1306,595,711,6.5,14.2,344,3.7,28.4,0,81,81,496
1985,44,f) 5,846,868,7026,7141,29,3.2,122,13.4,1212,61,1151,0.9,17,1441,761,680,10.7,20.2,-229,-3.2,34,0,82,82,533
1985,44,g) 6 to 10,2528,2699,29108,29162,95,3.4,287,10.3,4745,343,4402,1.2,16.3,4852,2161,2691,7.4,16.6,-107,-0.3,32.6,0,198,199,1421
1985,44,l) Left Censored,9123,10977,271284,274011,317,2.8,846,7.5,27628,4369,23259,1.6,10.1,33081,9718,23363,3.5,12.1,-5453,-2,20.2,0,530,530,5038
1985,45,a) 0,6834,6907,39017,19604,6852,198.4,0,0,38826,38826,0,198.1,198.1,0,0,0,0,0,38826,198.1,0,0,,,
1985,45,b) 1,5532,5627,41382,41268,42,0.7,1295,20.6,10970,694,10276,1.7,26.6,10742,5240,5502,12.7,26,228,0.6,52,0,985,985,4200
1985,45,c) 2,3543,3638,29957,31360,113,2.8,770,19.3,6288,820,5468,2.6,20.1,9093,4103,4990,13.1,29,-2805,-8.9,40.2,0,619,619,3451
1985,45,d) 3,3023,3170,30231,30533,116,3.4,523,15.5,6211,796,5415,2.6,20.3,6814,3310,3504,10.8,22.3,-603,-2,40.6,0,403,405,2744
1985,45,e) 4,2617,2774,28217,28524,89,3.1,372,12.8,5264,775,4489,2.7,18.5,5877,2719,3158,9.5,20.6,-613,-2.1,37,0,263,263,2178
1985,45,f) 5,2467,2609,24509,24458,106,3.9,311,11.5,4985,725,4260,3,20.4,4883,1901,2982,7.8,20,102,0.4,40,0,233,233,1260
1985,45,g) 6 to 10,6763,7599,76122,72116,313,4,827,10.6,20732,2680,18052,3.7,28.7,12719,5411,7308,7.5,17.6,8013,11.1,35.2,0,547,551,3475
1985,45,l) Left Censored,19443,28595,762433,764967,1227,4.2,2171,7.5,89295,22648,66647,3,11.7,94362,30118,64244,3.9,12.3,-5067,-0.6,23.4,0,1083,1090,9445
1985,46,a) 0,1584,1597,7816,3923,1582,198.1,0,0,7787,7787,0,198.5,198.5,0,0,0,0,0,7787,198.5,0,0,,,
1985,46,b) 1,1325,1336,7185,7423,10,0.7,296,19.8,1708,137,1571,1.8,23,2184,920,1264,12.4,29.4,-476,-6.4,46,0,190,190,634
1985,46,c) 2,861,944,6604,6871,39,3.8,177,17.4,1034,144,890,2.1,15,1568,797,771,11.6,22.8,-534,-7.8,30,0,141,141,690
1985,46,d) 3,757,776,4848,5042,30,3.6,142,17.1,869,149,720,3,17.2,1257,730,527,14.5,24.9,-388,-7.7,34.4,0,95,96,454
1985,46,e) 4,741,761,6642,6314,25,3.2,88,11.1,1554,111,1443,1.8,24.6,898,383,515,6.1,14.2,656,10.4,28.4,0,67,67,348
1985,46,f) 5,723,737,4685,4777,65,8.5,127,16.5,958,410,548,8.6,20.1,1141,643,498,13.5,23.9,-183,-3.8,40.2,0,83,85,496
1985,46,g) 6 to 10,2082,2272,16006,16411,115,4.9,273,11.6,2398,440,1958,2.7,14.6,3207,1339,1868,8.2,19.5,-809,-4.9,29.2,0,190,192,939
1985,46,l) Left Censored,6788,8434,138946,138839,317,3.7,636,7.4,15550,4884,10666,3.5,11.2,15335,4519,10816,3.3,11,215,0.2,22,0,337,338,1848
1985,47,a) 0,9244,9350,54488,27306,9299,198.9,0,0,54365,54365,0,199.1,199.1,0,0,0,0,0,54365,199.1,0,0,,,
1985,47,b) 1,8155,8235,61798,61071,44,0.5,1879,20.4,17581,1532,16049,2.5,28.8,16127,8502,7625,13.9,26.4,1454,2.4,52.8,0,1430,1430,6243
1985,47,c) 2,5055,5166,43090,44434,253,4.5,1163,20.6,9486,1561,7925,3.5,21.3,12174,5927,6247,13.3,27.4,-2688,-6.1,42.6,0,909,909,4815
1985,47,d) 3,4215,4403,44429,44844,141,3,775,16.4,8495,1129,7366,2.5,18.9,9325,4519,4806,10.1,20.8,-830,-1.9,37.8,0,594,602,2980
1985,47,e) 4,3662,3868,43782,43372,147,3.6,537,13.2,8829,1187,7642,2.7,20.4,8009,3699,4310,8.5,18.5,820,1.9,37,0,406,407,2827
1985,47,f) 5,3477,3651,32614,33020,139,3.6,525,13.7,5447,755,4692,2.3,16.5,6259,2819,3440,8.5,19,-812,-2.5,33,0,417,417,2164
1985,47,g) 6 to 10,10145,11503,127162,128063,494,4.1,1363,11.4,21917,3512,18405,2.7,17.1,23718,9791,13927,7.6,18.5,-1801,-1.4,34.2,0,904,910,6250
1985,47,l) Left Censored,29644,42968,1163858,1159535,1873,4.3,3650,8.3,140896,32737,108159,2.8,12.2,132249,46162,86087,4,11.4,8647,0.8,22.8,0,1839,1876,11437
1985,48,a) 0,39775,40337,244027,122768,40114,198.9,0,0,242519,242519,0,197.5,197.5,0,0,0,0,0,242519,197.5,0,0,,,
1985,48,b) 1,31855,32631,271205,268600,229,0.6,7309,20.1,89312,6009,83303,2.2,33.3,84102,38735,45367,14.4,31.3,5210,2,62.6,0,5346,5350,29364
1985,48,c) 2,22847,23441,208587,216819,1020,4,5386,20.9,50714,6320,44394,2.9,23.4,67177,32063,35114,14.8,31,-16463,-7.6,46.8,0,4175,4184,25173
1985,48,d) 3,20505,21569,198577,207200,907,3.9,4438,19,43324,6979,36345,3.4,20.9,60569,32197,28372,15.5,29.2,-17245,-8.3,41.8,0,3311,3346,23186
1985,48,e) 4,25869,27328,281739,291114,937,3.2,4481,15.4,54545,8025,46520,2.8,18.7,73294,35305,37989,12.1,25.2,-18749,-6.5,37.4,0,3386,3395,20950
1985,48,f) 5,8346,9079,89679,92678,390,4.1,1361,14.2,17105,3541,13564,3.8,18.5,23102,10320,12782,11.1,24.9,-5997,-6.4,37,0,945,956,6705
1985,48,g) 6 to 10,39056,45322,510432,519481,2126,4.5,5968,12.6,101142,24647,76495,4.7,19.5,119240,47257,71983,9.1,23,-18098,-3.5,39,0,3890,3952,28605
1985,48,l) Left Censored,85688,143413,3764723,3765354,7508,5.1,12870,8.8,542035,172966,369069,4.6,14.4,543298,176194,367104,4.7,14.4,-1263,0,28.8,0,5803,5854,46360
1985,49,a) 0,3306,3335,20108,10093,3312,198.6,0,0,20031,20031,0,198.5,198.5,0,0,0,0,0,20031,198.5,0,0,,,
1985,49,b) 1,2444,2496,22172,21764,16,0.5,809,27.7,6840,500,6340,2.3,31.4,6024,3582,2442,16.5,27.7,816,3.7,55.4,0,608,608,2899
1985,49,c) 2,1748,1836,18767,19301,93,4.6,454,22.4,3858,645,3213,3.3,20,4925,2337,2588,12.1,25.5,-1067,-5.5,40,0,343,343,1835
1985,49,d) 3,1638,1726,14815,15745,72,3.8,400,21.2,2784,280,2504,1.8,17.7,4643,2360,2283,15,29.5,-1859,-11.8,35.4,0,302,305,1703
1985,49,e) 4,1473,1571,17942,17794,76,4.5,286,17.1,3883,313,3570,1.8,21.8,3586,2065,1521,11.6,20.2,297,1.6,40.4,0,197,198,1273
1985,49,f) 5,1331,1423,12292,12645,68,4.5,221,14.7,2249,382,1867,3,17.8,2954,1575,1379,12.5,23.4,-705,-5.6,35.6,0,163,163,1312
1985,49,g) 6 to 10,3831,4226,43465,43705,204,4.6,618,14,8106,939,7167,2.1,18.5,8585,4163,4422,9.5,19.6,-479,-1.1,37,0,384,384,2342
1985,49,l) Left Censored,9108,13024,319708,318920,583,4.4,1166,8.8,40419,9659,30760,3,12.7,38843,11846,26997,3.7,12.2,1576,0.5,24.4,0,576,583,4760
1985,50,a) 0,1743,1752,8352,4212,1735,198.1,0,0,8281,8281,0,196.6,196.6,0,0,0,0,0,8281,196.6,0,0,,,
1985,50,b) 1,1371,1387,7772,7905,10,0.7,248,16.4,1941,83,1858,1,24.6,2206,1298,908,16.4,27.9,-265,-3.3,49.2,0,160,160,592
1985,50,c) 2,946,956,5272,5321,40,3.9,160,15.6,1181,139,1042,2.6,22.2,1279,616,663,11.6,24,-98,-1.8,44.4,0,128,128,524
1985,50,d) 3,828,848,6012,6183,22,2.4,129,14.3,1052,82,970,1.3,17,1393,656,737,10.6,22.5,-341,-5.5,34,0,93,93,484
1985,50,e) 4,720,738,5469,5690,18,2.3,107,13.7,832,126,706,2.2,14.6,1273,553,720,9.7,22.4,-441,-7.8,29.2,0,75,75,327
1985,50,f) 5,632,643,4544,4646,23,3.4,80,11.9,690,88,602,1.9,14.9,894,400,494,8.6,19.2,-204,-4.3,29.8,0,52,52,283
1985,50,g) 6 to 10,1838,2018,18449,18995,96,4.6,256,12.2,2535,473,2062,2.5,13.3,3626,1842,1784,9.7,19.1,-1091,-5.8,26.6,0,191,191,919
1985,50,l) Left Censored,5118,6247,133139,133284,177,2.8,483,7.6,13718,1901,11817,1.4,10.3,14008,5281,8727,4,10.5,-290,-0.2,20.6,0,275,276,1430
1985,51,a) 0,12070,12190,67449,34026,12026,197.3,0,0,66846,66846,0,196.5,196.5,0,0,0,0,0,66846,196.5,0,0,,,
1985,51,b) 1,9429,9558,69233,63575,52,0.5,673,6.8,21707,706,21001,1.1,34.1,10391,2921,7470,4.6,16.3,11316,17.8,32.6,1,36,36,
1985,51,c) 2,6076,6203,49708,48194,287,4.5,682,10.7,12766,2480,10286,5.1,26.5,9737,3361,6376,7,20.2,3029,6.3,40.4,0,18,18,133
1985,51,d) 3,5316,5551,55629,54215,221,3.9,583,10.2,11731,1482,10249,2.7,21.6,8902,3262,5640,6,16.4,2829,5.2,32.8,0,25,45,541
1985,51,e) 4,4735,5012,54216,54953,156,3,431,8.4,8953,785,8168,1.4,16.3,10426,5241,5185,9.5,19,-1473,-2.7,32.6,1,19,20,
1985,51,f) 5,4461,4650,43764,42714,137,2.9,274,5.9,8322,728,7594,1.7,19.5,6222,1631,4591,3.8,14.6,2100,4.9,29.2,0,21,24,150
1985,51,g) 6 to 10,11895,13689,157118,155358,558,4.1,957,7,27780,5611,22169,3.6,17.9,24260,9223,15037,5.9,15.6,3520,2.3,31.2,0,53,57,940
1985,51,l) Left Censored,34366,52005,1352549,1342797,2146,4.1,2746,5.3,173804,50569,123235,3.8,12.9,154300,46032,108268,3.4,11.5,19504,1.4,23,0,125,141,3397
1985,53,a) 0,10897,10998,54799,27551,10899,198.2,0,0,54496,54496,0,197.8,197.8,0,0,0,0,0,54496,197.8,0,0,,,
1985,53,b) 1,9102,9239,61005,60973,44,0.4,2423,23.1,17388,835,16553,1.4,28.5,17324,9288,8036,15.2,28.4,64,0.1,56.8,0,1740,1740,7305
1985,53,c) 2,6309,6579,58937,58282,359,5,1538,21.4,16776,6627,10149,11.4,28.8,15466,8111,7355,13.9,26.5,1310,2.3,53,0,1185,1185,6162
1985,53,d) 3,5493,5721,46649,49262,245,4,1104,17.9,9066,1016,8050,2.1,18.4,14291,8419,5872,17.1,29,-5225,-10.6,36.8,0,841,845,5563
1985,53,e) 4,4895,5151,43787,45662,209,3.8,806,14.8,7650,1011,6639,2.2,16.8,11400,4799,6601,10.5,25,-3750,-8.2,33.6,0,577,577,2822
1985,53,f) 5,4691,4900,40132,41056,184,3.6,712,13.8,7556,1582,5974,3.9,18.4,9404,3683,5721,9,22.9,-1848,-4.5,36.8,0,528,528,2756
1985,53,g) 6 to 10,12515,13963,137263,134485,626,4.3,1853,12.7,31669,12414,19255,9.2,23.5,26113,10646,15467,7.9,19.4,5556,4.1,38.8,0,1115,1125,6417
1985,53,l) Left Censored,28996,41327,908909,914228,1758,4.2,3751,8.9,112738,22386,90352,2.4,12.3,123376,39783,83593,4.4,13.5,-10638,-1.2,24.6,0,1847,1885,13770
1985,54,a) 0,2961,2995,17562,8850,2943,196.5,0,0,17424,17424,0,196.9,196.9,0,0,0,0,0,17424,196.9,0,0,,,
1985,54,b) 1,2478,2498,14550,14355,8,0.3,238,9.1,3232,188,3044,1.3,22.5,2842,914,1928,6.4,19.8,390,2.7,39.6,0,23,23,63
1985,54,c) 2,1500,1539,11239,11228,68,4.2,218,13.5,2677,785,1892,7,23.8,2654,1132,1522,10.1,23.6,23,0.2,47.2,0,13,13,78
1985,54,d) 3,1490,1533,14861,15032,52,3.3,170,10.7,2333,581,1752,3.9,15.5,2674,899,1775,6,17.8,-341,-2.3,31,0,18,18,159
1985,54,e) 4,1320,1352,12123,12534,41,3,145,10.4,1654,219,1435,1.7,13.2,2476,1116,1360,8.9,19.8,-822,-6.6,26.4,0,7,8,316
1985,54,f) 5,1187,1273,9295,9498,56,4.4,96,7.5,1294,221,1073,2.3,13.6,1700,554,1146,5.8,17.9,-406,-4.3,27.2,0,9,9,56
1985,54,g) 6 to 10,3491,3937,33721,34228,142,3.6,353,8.8,5125,862,4263,2.5,15,6139,1961,4178,5.7,17.9,-1014,-2.9,30,0,17,20,199
1985,54,l) Left Censored,12486,16812,330601,334011,575,3.4,1019,6,32392,8856,23536,2.7,9.7,39211,10307,28904,3.1,11.7,-6819,-2,19.4,0,45,48,422
1985,55,a) 0,8631,8718,47250,23688,8672,198.9,0,0,47124,47124,0,198.9,198.9,0,0,0,0,0,47124,198.9,0,0,,,
1985,55,b) 1,7341,7416,52833,52129,42,0.5,1543,18.7,13162,1152,12010,2.2,25.2,11753,6183,5570,11.9,22.5,1409,2.7,45,0,1187,1187,4825
1985,55,c) 2,4940,5069,40084,40299,208,3.8,905,16.6,8618,1374,7244,3.4,21.4,9048,4474,4574,11.1,22.5,-430,-1.1,42.8,0,740,741,3912
1985,55,d) 3,4538,4729,39368,40260,167,3.3,756,15,6292,926,5366,2.3,15.6,8076,4029,4047,10,20.1,-1784,-4.5,31.2,0,604,605,3197
1985,55,e) 4,4255,4425,40909,41297,166,3.6,555,12,6446,1112,5334,2.7,15.6,7222,2994,4228,7.2,17.5,-776,-1.9,31.2,0,427,428,2250
1985,55,f) 5,4005,4147,35620,35019,162,3.7,501,11.6,6958,1561,5397,4.5,19.9,5756,2609,3147,7.5,16.4,1202,3.5,32.8,0,377,377,1845
1985,55,g) 6 to 10,12191,13613,124205,125783,584,4.2,1428,10.2,19264,2810,16454,2.2,15.3,22419,8343,14076,6.6,17.8,-3155,-2.5,30.6,0,948,949,5138
1985,55,l) Left Censored,38534,50648,1228662,1235329,1582,3.1,3845,7.4,127664,26050,101614,2.1,10.3,140998,53579,87419,4.3,11.4,-13334,-1.1,20.6,0,2133,2179,19393
1985,56,a) 0,1358,1361,6727,3377,1349,198.2,0,0,6701,,,,198.4,0,0,0,0,0,6701,198.4,0,1,,,
1985,56,b) 1,1096,1098,6343,6567,2,0.2,330,26,1557,,,,23.7,2004,1180,824,18,30.5,-447,-6.8,47.4,1,246,246,919
1985,56,c) 2,890,940,6859,7234,57,5.4,253,24.2,1385,297,1088,4.1,19.1,2134,1147,987,15.9,29.5,-749,-10.4,38.2,0,195,195,939
1985,56,d) 3,868,914,6070,6468,51,5.3,151,15.6,1166,219,947,3.4,18,1961,869,1092,13.4,30.3,-795,-12.3,36,0,116,116,690
1985,56,e) 4,841,868,5595,5698,48,5.3,138,15.1,970,218,752,3.8,17,1175,527,648,9.2,20.6,-205,-3.6,34,0,96,97,398
1985,56,f) 5,663,704,4598,4864,31,4.2,100,13.5,715,82,633,1.7,14.7,1246,613,633,12.6,25.6,-531,-10.9,29.4,0,76,76,453
1985,56,g) 6 to 10,1841,2030,17574,18322,82,3.8,309,14.4,2596,258,2338,1.4,14.2,4092,1826,2266,10,22.3,-1496,-8.1,28.4,0,196,197,1270
1985,56,l) Left Censored,4053,5354,82415,83789,243,4.4,529,9.6,11047,3123,7924,3.7,13.2,13794,4519,9275,5.4,16.5,-2747,-3.3,26.4,0,247,247,1531
1986,01,a) 0,7510,7574,45390,22978,7551,199.4,0,0,44825,44825,0,195.1,195.1,0,0,0,0,0,44825,195.1,0,0,,,
1986,01,b) 1,5547,5648,43489,42411,116,1.8,1611,25,14276,2964,11312,7,33.7,12119,7515,4604,17.7,28.6,2157,5.1,57.2,0,1192,1208,6074
1986,01,c) 2,5248,5345,44968,46997,230,4,1034,17.9,9137,1398,7739,3,19.4,13195,6348,6847,13.5,28.1,-4058,-8.7,38.8,0,798,799,4443
1986,01,d) 3,3193,3296,26726,27636,171,4.9,594,16.9,6551,1527,5024,5.5,23.7,8371,3311,5060,12,30.3,-1820,-6.6,47.4,0,441,441,2487
1986,01,e) 4,2755,2929,30989,31709,126,4.1,446,14.4,5667,717,4950,2.3,17.9,7106,2391,4715,7.5,22.4,-1439,-4.5,35.8,0,346,346,1767
1986,01,f) 5,2672,2817,38589,36770,101,3.4,371,12.6,8848,668,8180,1.8,24.1,5209,2207,3002,6,14.2,3639,9.9,28.4,0,272,272,1396
1986,01,g) 6 to 10,10084,11641,129584,129176,590,4.9,1306,10.9,24522,4902,19620,3.8,19,23706,8662,15044,6.7,18.4,816,0.6,36.8,0,892,896,5356
1986,01,l) Left Censored,21629,32206,825131,819766,1527,4.7,2556,7.8,112599,29523,83076,3.6,13.7,101869,30725,71144,3.7,12.4,10730,1.3,24.8,0,1361,1364,12057
1986,02,a) 0,1726,1742,9372,4699,1735,199.2,0,0,9347,9347,0,198.9,198.9,0,0,0,0,0,9347,198.9,0,0,,,
1986,02,b) 1,1277,1295,9095,9458,24,1.5,546,34.7,3072,686,2386,7.3,32.5,3798,2185,1613,23.1,40.2,-726,-7.7,65,0,396,396,1440
1986,02,c) 2,1089,1097,7566,8170,41,3.2,359,28.4,2010,191,1819,2.3,24.6,3218,1725,1493,21.1,39.4,-1208,-14.8,49.2,0,268,268,1379
1986,02,d) 3,831,869,6279,6776,56,5.8,232,24.1,1695,443,1252,6.5,25,2688,1116,1572,16.5,39.7,-993,-14.7,50,0,172,172,803
1986,02,e) 4,649,698,5442,6346,26,3.5,128,17,960,122,838,1.9,15.1,2767,1315,1452,20.7,43.6,-1807,-28.5,30.2,0,97,97,1111
1986,02,f) 5,483,525,5008,5530,21,3.8,82,14.7,862,142,720,2.6,15.6,1906,465,1441,8.4,34.5,-1044,-18.9,31.2,0,60,60,298
1986,02,g) 6 to 10,1797,2065,22938,24556,112,5.2,265,12.3,3335,778,2557,3.2,13.6,6571,1606,4965,6.5,26.8,-3236,-13.2,27.2,0,177,177,1162
1986,02,l) Left Censored,2480,3765,82065,84580,264,6.8,447,11.6,12827,3904,8923,4.6,15.2,17857,5638,12219,6.7,21.1,-5030,-5.9,30.4,0,144,144,1040
1986,04,a) 0,9179,9272,57928,29029,9246,199.4,0,0,57799,57799,0,199.1,199.1,0,0,0,0,0,57799,199.1,0,0,,,
1986,04,b) 1,6814,6904,62187,61974,97,1.2,2126,26.6,20506,2366,18140,3.8,33.1,20080,11146,8934,18,32.4,426,0.7,64.8,0,1599,1599,8982
1986,04,c) 2,5496,5665,52385,53555,313,5.1,1309,21.1,14860,3323,11537,6.2,27.7,17200,8815,8385,16.5,32.1,-2340,-4.4,55.4,0,985,985,6397
1986,04,d) 3,3922,4217,50563,51423,226,5,799,17.7,13377,4403,8974,8.6,26,15096,6540,8556,12.7,29.4,-1719,-3.4,52,0,606,606,4960
1986,04,e) 4,3673,3942,43378,43866,203,4.9,625,15,10347,2040,8307,4.7,23.6,11322,5847,5475,13.3,25.8,-975,-2.2,47.2,0,455,458,4304
1986,04,f) 5,3025,3235,35694,36776,165,4.8,509,15,7242,1227,6015,3.3,19.7,9405,3385,6020,9.2,25.6,-2163,-5.9,39.4,0,358,359,2317
1986,04,g) 6 to 10,9885,11207,142266,145602,580,5,1362,11.7,28100,6624,21476,4.5,19.3,34771,9739,25032,6.7,23.9,-6671,-4.6,38.6,0,917,919,6390
1986,04,l) Left Censored,14025,23542,658295,652607,1456,6.1,1902,8,108656,37713,70943,5.8,16.6,97281,29875,67406,4.6,14.9,11375,1.7,29.8,0,868,869,8317
1986,05,a) 0,4711,4737,25182,12603,4725,199.5,0,0,25158,25158,0,199.6,199.6,0,0,0,0,0,25158,199.6,0,0,,,
1986,05,b) 1,3618,3678,26338,25321,77,1.8,1167,27.4,9672,3348,6324,13.2,38.2,7638,4344,3294,17.2,30.2,2034,8,60.4,0,888,888,3518
1986,05,c) 2,3458,3509,21495,23434,119,3.1,740,19.2,4398,611,3787,2.6,18.8,8275,3610,4665,15.4,35.3,-3877,-16.5,37.6,0,561,564,2969
1986,05,d) 3,2257,2322,17492,18027,98,3.9,429,17.2,3305,426,2879,2.4,18.3,4375,2269,2106,12.6,24.3,-1070,-6,36.6,0,342,342,1781
1986,05,e) 4,2017,2072,17588,18195,69,3.1,328,14.9,3095,204,2891,1.1,17,4308,1930,2378,10.6,23.7,-1213,-6.7,34,0,263,263,1572
1986,05,f) 5,1842,1912,17450,18600,59,2.9,273,13.5,2728,237,2491,1.3,14.7,5028,3121,1907,16.8,27,-2300,-12.3,29.4,0,218,218,1101
1986,05,g) 6 to 10,7308,8117,77675,78627,337,4,943,11.2,12829,3240,9589,4.1,16.3,14733,5573,9160,7.1,18.7,-1904,-2.4,32.6,0,665,670,4085
1986,05,l) Left Censored,14136,19180,483915,477027,688,3.5,1525,7.8,69354,17378,51976,3.6,14.5,55579,17012,38567,3.6,11.7,13775,2.8,23.4,0,839,849,5419
1986,06,a) 0,66597,67366,413313,207394,67115,199.3,0,0,411839,411839,0,198.6,198.6,0,0,0,0,0,411839,198.6,0,0,,,
1986,06,b) 1,49813,50679,404507,396216,1189,2.1,13372,23.4,140383,27743,112640,7,35.4,123801,66529,57272,16.8,31.2,16582,4.2,62.4,0,9287,9289,49918
1986,06,c) 2,41500,42495,385213,392442,2130,4.6,8514,18.5,99766,16456,83310,4.2,25.4,114224,57821,56403,14.7,29.1,-14458,-3.7,50.8,0,6178,6179,42993
1986,06,d) 3,30917,32476,379225,388097,1490,4.3,5842,16.8,79615,12602,67013,3.2,20.5,97358,45512,51846,11.7,25.1,-17743,-4.6,41,0,4281,4284,33015
1986,06,e) 4,29633,31559,313344,323925,1367,4.1,4676,14.1,64091,11732,52359,3.6,19.8,85253,37980,47273,11.7,26.3,-21162,-6.5,39.6,0,3185,3188,24104
1986,06,f) 5,28562,30474,383869,392342,1337,4.2,4017,12.6,71772,11079,60693,2.8,18.3,88718,31259,57459,8,22.6,-16946,-4.3,36.6,0,2679,2682,21263
1986,06,g) 6 to 10,92951,104623,1182814,1195326,5128,4.7,12562,11.6,221218,45220,175998,3.8,18.5,246241,85307,160934,7.1,20.6,-25023,-2.1,37,0,8025,8045,51295
1986,06,l) Left Censored,141390,218510,6143207,6129586,12267,5.5,19278,8.7,932942,294126,638816,4.8,15.2,905700,285830,619870,4.7,14.8,27242,0.4,29.6,0,9150,9217,76256
1986,08,a) 0,9703,9774,59171,29623,9741,199.3,0,0,59097,59097,0,199.5,199.5,0,0,0,0,0,59097,199.5,0,0,,,
1986,08,b) 1,7624,7731,57339,57693,142,1.6,2497,27.8,19792,4695,15097,8.1,34.3,20499,12302,8197,21.3,35.5,-707,-1.2,68.6,0,1872,1872,10023
1986,08,c) 2,6387,6521,49977,53314,304,4.2,1597,22.2,12387,1560,10827,2.9,23.2,19060,10734,8326,20.1,35.8,-6673,-12.6,46.4,0,1247,1248,8699
1986,08,d) 3,4555,4950,58810,60471,300,5.7,977,18.4,12403,4030,8373,6.7,20.5,15725,5586,10139,9.2,26,-3322,-5.5,41,0,757,757,4522
1986,08,e) 4,4183,4394,37924,40049,153,3.2,849,17.9,6387,786,5601,2,15.9,10636,4923,5713,12.3,26.6,-4249,-10.7,31.8,0,641,643,3810
1986,08,f) 5,3819,4066,43412,46036,186,4.3,701,16.2,7721,1575,6146,3.4,16.8,12969,7247,5722,15.7,28.2,-5248,-11.4,33.6,0,512,512,6067
1986,08,g) 6 to 10,12665,14082,135400,142337,669,4.5,2033,13.8,21215,4622,16593,3.2,14.9,35089,13300,21789,9.3,24.7,-13874,-9.8,29.8,0,1345,1348,8938
1986,08,l) Left Censored,19523,29457,744249,743930,1887,6.3,2837,9.5,113001,39209,73792,5.3,15.2,112364,39795,72569,5.3,15.1,637,0.1,30.2,0,1269,1283,9846
1986,09,a) 0,7596,7637,43805,21927,7626,199.7,0,0,43756,43756,0,199.6,199.6,0,0,0,0,0,43756,199.6,0,0,,,
1986,09,b) 1,5825,5885,44131,40606,140,2.2,1208,18.7,16995,4869,12126,12,41.9,9944,5371,4573,13.2,24.5,7051,17.4,49,0,832,832,3695
1986,09,c) 2,4835,4903,39750,40576,185,3.5,774,14.8,8314,1022,7292,2.5,20.5,9965,4131,5834,10.2,24.6,-1651,-4.1,41,0,560,560,2904
1986,09,d) 3,3554,3613,32345,31708,138,3.6,536,14,7374,2305,5069,7.3,23.3,6099,2690,3409,8.5,19.2,1275,4.1,38.4,0,383,383,1933
1986,09,e) 4,3323,3450,39027,42676,103,2.8,472,13,5152,831,4321,1.9,12.1,12449,4023,8426,9.4,29.2,-7297,-17.1,24.2,0,326,326,3097
1986,09,f) 5,3115,3304,32012,32453,111,3.2,382,11.1,4921,601,4320,1.9,15.2,5802,2582,3220,8,17.9,-881,-2.7,30.4,0,270,270,1769
1986,09,g) 6 to 10,10679,11606,130276,129334,441,3.7,1192,9.9,22699,3122,19577,2.4,17.6,20815,7991,12824,6.2,16.1,1884,1.5,32.2,0,830,832,4535
1986,09,l) Left Censored,26738,34736,1062866,1065507,1233,3.5,2545,7.2,117770,34806,82964,3.3,11.1,123052,37300,85752,3.5,11.5,-5282,-0.4,22.2,0,1439,1443,16465
1986,10,a) 0,1421,1438,25393,12702,1434,199.4,0,0,25383,25383,0,199.8,199.8,0,0,0,0,0,25383,199.8,0,0,,,
1986,10,b) 1,1057,1065,7585,7243,34,2.9,259,21.8,2588,608,1980,8.4,35.7,1904,1078,826,14.9,26.3,684,9.4,52.6,0,162,162,786
1986,10,c) 2,916,928,7505,7369,39,4,146,14.8,1698,230,1468,3.1,23,1425,791,634,10.7,19.3,273,3.7,38.6,0,106,106,595
1986,10,d) 3,660,676,5722,5637,43,6.1,99,14,1372,359,1013,6.4,24.3,1202,476,726,8.4,21.3,170,3,42.6,0,81,81,390
1986,10,e) 4,557,568,5795,5730,17,2.8,76,12.7,1115,130,985,2.3,19.5,984,350,634,6.1,17.2,131,2.3,34.4,0,44,44,235
1986,10,f) 5,550,578,5267,5261,32,5.4,67,11.3,799,120,679,2.3,15.2,786,392,394,7.5,14.9,13,0.3,29.8,0,45,45,303
1986,10,g) 6 to 10,1864,2078,25456,25699,95,4.5,190,8.9,5049,1117,3932,4.3,19.6,5535,1424,4111,5.5,21.5,-486,-1.9,39.2,0,121,121,861
1986,10,l) Left Censored,4599,6087,187984,187781,322,5.2,451,7.3,25691,6457,19234,3.4,13.7,25284,7818,17466,4.2,13.5,407,0.2,27,0,234,235,1277
1986,11,a) 0,1410,1415,9803,4917,1402,198.2,0,0,9772,9772,0,198.7,198.7,0,0,0,0,0,9772,198.7,0,0,,,
1986,11,b) 1,1131,1137,14662,13056,36,2.9,229,18.5,5803,2581,3222,19.8,44.4,2591,945,1646,7.2,19.8,3212,24.6,39.6,0,154,154,564
1986,11,c) 2,1048,1058,11362,11356,46,4,196,17.3,2353,252,2101,2.2,20.7,2340,1013,1327,8.9,20.6,13,0.1,41.2,0,140,140,753
1986,11,d) 3,929,945,8316,8346,38,3.8,130,13.1,1943,315,1628,3.8,23.3,2002,1036,966,12.4,24,-59,-0.7,46.6,0,94,94,606
1986,11,e) 4,799,819,8134,8077,40,4.6,125,14.5,1791,516,1275,6.4,22.2,1677,982,695,12.2,20.8,114,1.4,41.6,0,76,77,539
1986,11,f) 5,714,734,10391,10281,27,3.5,90,11.8,1957,359,1598,3.5,19,1736,723,1013,7,16.9,221,2.1,33.8,0,70,70,481
1986,11,g) 6 to 10,2328,2560,53735,53293,108,4.1,251,9.5,8157,903,7254,1.7,15.3,7272,3841,3431,7.2,13.6,885,1.7,27.2,0,154,154,1473
1986,11,l) Left Censored,6270,8262,270147,272547,451,5.4,622,7.4,34124,13015,21109,4.8,12.5,38923,9034,29889,3.3,14.3,-4799,-1.8,25,0,292,294,2879
1986,12,a) 0,36472,36809,212560,106498,36731,199.6,0,0,212124,212124,0,199.2,199.2,0,0,0,0,0,212124,199.2,0,0,,,
1986,12,b) 1,26618,27091,205100,201803,445,1.4,8077,26,70288,10882,59406,5.4,34.8,63694,37111,26583,18.4,31.6,6594,3.2,63.2,0,6062,6062,28621
1986,12,c) 2,21315,21695,184094,190904,1010,4.3,4918,20.7,45331,6407,38924,3.4,23.7,58950,31166,27784,16.3,30.9,-13619,-7.2,47.4,0,3886,3886,24681
1986,12,d) 3,15739,16212,141298,151438,700,4,3125,17.9,30605,4490,26115,3,20.2,50884,20841,30043,13.8,33.6,-20279,-13.4,40.4,0,2451,2451,16972
1986,12,e) 4,14310,15012,151713,154165,598,3.8,2344,14.7,30481,4670,25811,3,19.8,35384,14059,21325,9.1,23,-4903,-3.2,39.6,0,1781,1781,10713
1986,12,f) 5,12613,13300,138008,141540,559,4,1945,13.9,25409,4159,21250,2.9,18,32473,13049,19424,9.2,22.9,-7064,-4.9,36,0,1436,1438,9106
1986,12,g) 6 to 10,39381,44219,470536,476460,2025,4.4,5534,12,89197,20257,68940,4.3,18.7,101045,36764,64281,7.7,21.2,-11848,-2.5,37.4,0,3771,3776,22606
1986,12,l) Left Censored,59422,97554,2380004,2364696,5523,5.6,8169,8.3,361777,115899,245878,4.9,15.3,331160,106828,224332,4.5,14,30617,1.3,28,0,3891,3916,34352
1986,13,a) 0,14306,14449,87722,43899,14415,199.5,0,0,87646,87646,0,199.7,199.7,0,0,0,0,0,87646,199.7,0,0,,,
1986,13,b) 1,10700,10846,87179,85958,203,1.6,2995,24.3,27777,4591,23186,5.3,32.3,25334,14680,10654,17.1,29.5,2443,2.8,59,0,2200,2200,10578
1986,13,c) 2,8951,9154,80562,81992,400,4.1,1736,17.6,19269,3687,15582,4.5,23.5,22128,11054,11074,13.5,27,-2859,-3.5,47,0,1280,1280,7768
1986,13,d) 3,6123,6313,56567,57733,313,4.6,1153,17.1,12674,1973,10701,3.4,22,15006,7686,7320,13.3,26,-2332,-4,44,0,867,867,5790
1986,13,e) 4,5352,5706,62086,62919,226,3.7,843,14,12120,1363,10757,2.2,19.3,13786,6626,7160,10.5,21.9,-1666,-2.6,38.6,0,624,625,4798
1986,13,f) 5,4775,5083,58784,58989,214,4,670,12.6,10894,2115,8779,3.6,18.5,11303,3855,7448,6.5,19.2,-409,-0.7,37,0,484,484,2673
1986,13,g) 6 to 10,16742,18943,221297,223552,995,5.1,2118,10.8,43718,10806,32912,4.8,19.6,48228,21919,26309,9.8,21.6,-4510,-2,39.2,0,1353,1355,9297
1986,13,l) Left Censored,33800,53710,1553680,1537485,2953,5.4,4250,7.8,218196,58053,160143,3.8,14.2,185806,60282,125524,3.9,12.1,32390,2.1,24.2,0,1950,1953,15354
1986,15,a) 0,2090,2121,13055,6531,2116,199.5,0,0,13048,13048,0,199.8,199.8,0,0,0,0,0,13048,199.8,0,0,,,
1986,15,b) 1,1747,1780,14945,14470,70,3.5,425,21.5,4469,1401,3068,9.7,30.9,3519,2079,1440,14.4,24.3,950,6.6,48.6,0,296,296,1432
1986,15,c) 2,1276,1296,10313,10562,59,4.2,248,17.7,2207,366,1841,3.5,20.9,2705,1319,1386,12.5,25.6,-498,-4.7,41.8,0,207,207,1098
1986,15,d) 3,1244,1271,9863,10555,47,3.4,241,17.6,1783,193,1590,1.8,16.9,3167,1273,1894,12.1,30,-1384,-13.1,33.8,0,166,166,908
1986,15,e) 4,1144,1200,9958,10059,69,5.5,158,12.7,1918,326,1592,3.2,19.1,2120,729,1391,7.2,21.1,-202,-2,38.2,0,109,109,537
1986,15,f) 5,1125,1197,12474,12978,40,3.2,164,13.1,1649,186,1463,1.4,12.7,2656,1380,1276,10.6,20.5,-1007,-7.8,25.4,0,112,112,610
1986,15,g) 6 to 10,3548,4096,47836,46359,184,4.4,371,8.8,10223,1276,8947,2.8,22.1,7268,2014,5254,4.3,15.7,2955,6.4,31.4,0,254,254,1244
1986,15,l) Left Censored,6784,10042,223128,219700,436,4.3,704,6.9,31335,9494,21841,4.3,14.3,24479,7213,17266,3.3,11.1,6856,3.2,22.2,0,356,356,1969
1986,16,a) 0,2118,2130,11312,5671,2118,198.9,0,0,11283,11283,0,199,199,0,0,0,0,0,11283,199,0,0,,,
1986,16,b) 1,1759,1780,10801,10834,38,1.9,352,18,2889,470,2419,4.3,26.7,2955,1490,1465,13.8,27.3,-66,-0.6,53.4,0,216,216,1075
1986,16,c) 2,1470,1491,10002,10361,54,3.3,325,19.8,2242,336,1906,3.2,21.6,2960,1599,1361,15.4,28.6,-718,-7,43.2,0,235,235,1151
1986,16,d) 3,1079,1158,9822,10028,67,5.4,208,16.9,2063,598,1465,6,20.6,2474,934,1540,9.3,24.7,-411,-4.1,41.2,0,164,164,785
1986,16,e) 4,957,1019,8155,8545,43,3.9,185,17,1426,112,1314,1.3,16.7,2205,1087,1118,12.7,25.8,-779,-9.1,33.4,0,147,147,957
1986,16,f) 5,893,934,7313,7775,33,3.3,140,14.2,1100,128,972,1.6,14.1,2024,901,1123,11.6,26,-924,-11.9,28.2,0,99,99,598
1986,16,g) 6 to 10,3511,3826,34830,35122,185,4.7,457,11.5,5859,1039,4820,3,16.7,6443,2421,4022,6.9,18.3,-584,-1.6,33.4,0,296,299,1693
1986,16,l) Left Censored,6264,8881,163289,164407,318,3.5,751,8.2,18671,3529,15142,2.1,11.4,20908,4976,15932,3,12.7,-2237,-1.3,22.8,0,398,400,2079
1986,17,a) 0,19659,19847,115996,58336,19792,199.4,0,0,115320,115320,0,197.7,197.7,0,0,0,0,0,115320,197.7,0,0,,,
1986,17,b) 1,16319,16524,136473,126789,441,2.5,3101,17.3,50311,19035,31276,15,39.7,30943,15114,15829,11.9,24.4,19368,15.3,48.8,0,2115,2118,11043
1986,17,c) 2,14069,14376,127763,128428,523,3.4,2257,14.8,28522,4241,24281,3.3,22.2,29853,13696,16157,10.7,23.2,-1331,-1,44.4,0,1685,1685,11071
1986,17,d) 3,10183,10502,106118,106041,408,3.7,1553,14,20464,3351,17113,3.2,19.3,20309,9195,11114,8.7,19.2,155,0.1,38.4,0,1175,1175,6494
1986,17,e) 4,9899,10338,110855,112963,331,3,1400,12.8,18710,2653,16057,2.3,16.6,22925,8962,13963,7.9,20.3,-4215,-3.7,33.2,0,1048,1049,6477
1986,17,f) 5,8732,9143,107570,108454,299,3.1,1174,12.2,17832,3002,14830,2.8,16.4,19600,8264,11336,7.6,18.1,-1768,-1.7,32.8,0,852,852,5954
1986,17,g) 6 to 10,31809,35158,367263,371184,1318,3.6,3746,10.3,56860,10031,46829,2.7,15.3,64702,26051,38651,7,17.4,-7842,-2.1,30.6,0,2454,2454,16843
1986,17,l) Left Censored,78159,107885,3140006,3139892,4571,4.1,8974,8.1,392823,113590,279233,3.6,12.5,392595,130682,261913,4.2,12.5,228,0,25,0,4802,4836,41021
1986,18,a) 0,9628,9709,57641,28851,9685,199.5,0,0,57580,57580,0,199.6,199.6,0,0,0,0,0,57580,199.6,0,0,,,
1986,18,b) 1,7779,7940,61655,57585,208,2.4,1861,21.1,22120,7387,14733,12.8,38.4,13979,7852,6127,13.6,24.3,8141,14.1,48.6,0,1374,1374,6026
1986,18,c) 2,6925,7119,60698,60648,278,3.7,1185,15.6,14738,4472,10266,7.4,24.3,14638,7145,7493,11.8,24.1,100,0.2,48.2,0,900,900,5393
1986,18,d) 3,4796,4922,45069,45035,197,3.7,824,15.7,9459,1887,7572,4.2,21,9390,4790,4600,10.6,20.9,69,0.1,41.8,0,612,612,3336
1986,18,e) 4,4059,4331,40781,42035,168,3.7,590,13,6615,1292,5323,3.1,15.7,9122,4119,5003,9.8,21.7,-2507,-6,31.4,0,442,442,3094
1986,18,f) 5,3641,3883,45668,45714,134,3.3,512,12.6,7806,2097,5709,4.6,17.1,7898,3133,4765,6.9,17.3,-92,-0.2,34.2,0,373,373,2333
1986,18,g) 6 to 10,14597,16490,171180,171891,722,4.3,1617,9.5,28233,5490,22743,3.2,16.4,29654,10718,18936,6.2,17.3,-1421,-0.9,32.8,0,1123,1124,6902
1986,18,l) Left Censored,35428,51357,1393450,1392376,2110,4,3819,7.3,158819,42376,116443,3,11.4,156671,48097,108574,3.5,11.3,2148,0.1,22.6,0,2031,2061,18347
1986,19,a) 0,4801,4833,30169,15164,4822,199.5,0,0,30010,30010,0,197.9,197.9,0,0,0,0,0,30010,197.9,0,0,,,
1986,19,b) 1,3944,4014,28006,26326,134,3,1013,22.6,10396,4556,5840,17.3,39.5,7036,3787,3249,14.4,26.7,3360,12.8,53.4,0,762,762,2984
1986,19,c) 2,4035,4084,23997,24843,170,3.9,736,16.8,4902,824,4078,3.3,19.7,6594,3393,3201,13.7,26.5,-1692,-6.8,39.4,0,573,573,2836
1986,19,d) 3,2660,2857,21194,22491,120,3.9,480,15.8,3425,1147,2278,5.1,15.2,6018,2483,3535,11,26.8,-2593,-11.6,30.4,0,370,370,2010
1986,19,e) 4,2476,2561,19054,20040,78,2.9,401,14.7,2676,386,2290,1.9,13.4,4648,1986,2662,9.9,23.2,-1972,-9.8,26.8,0,317,317,1683
1986,19,f) 5,2489,2645,23571,24149,70,2.5,337,12.1,2968,362,2606,1.5,12.3,4124,1367,2757,5.7,17.1,-1156,-4.8,24.6,0,246,246,991
1986,19,g) 6 to 10,9485,10712,82899,86386,410,3.7,1301,11.6,11681,2317,9364,2.7,13.5,18654,8303,10351,9.6,21.6,-6973,-8.1,27,0,890,890,4628
1986,19,l) Left Censored,23627,32293,636852,637846,1062,3.2,2694,8.1,72462,16658,55804,2.6,11.4,74450,23536,50914,3.7,11.7,-1988,-0.3,22.8,0,1468,1468,9065
1986,20,a) 0,5315,5365,31020,15525,5351,199.5,0,0,30990,30990,0,199.6,199.6,0,0,0,0,0,30990,199.6,0,0,,,
1986,20,b) 1,4334,4398,29769,30223,120,2.4,1236,24.8,10078,4208,5870,13.9,33.3,10986,5745,5241,19,36.3,-908,-3,66.6,0,903,903,4354
1986,20,c) 2,4064,4126,29676,31169,131,2.9,843,18.7,5423,812,4611,2.6,17.4,8409,4162,4247,13.4,27,-2986,-9.6,34.8,0,666,666,3470
1986,20,d) 3,2781,2880,18687,20217,132,4.2,572,18.4,3842,1085,2757,5.4,19,6902,3480,3422,17.2,34.1,-3060,-15.1,38,0,451,451,2317
1986,20,e) 4,2519,2652,22851,23633,76,2.7,459,16.1,3654,333,3321,1.4,15.5,5217,2318,2899,9.8,22.1,-1563,-6.6,31,0,359,359,1475
1986,20,f) 5,2368,2517,23636,23716,103,3.9,370,13.9,4288,1190,3098,5,18.1,4447,1778,2669,7.5,18.8,-159,-0.7,36.2,0,263,274,1406
1986,20,g) 6 to 10,8096,9145,80747,81524,408,4.3,1174,12.3,13774,3587,10187,4.4,16.9,15328,5714,9614,7,18.8,-1554,-1.9,33.8,0,861,865,4066
1986,20,l) Left Censored,19404,26484,568189,570098,997,3.7,2212,8.2,68427,17139,51288,3,12,72244,24902,47342,4.4,12.7,-3817,-0.7,24,0,1224,1235,7618
1986,21,a) 0,6249,6311,41768,20918,6297,199.6,0,0,41701,41701,0,199.4,199.4,0,0,0,0,0,41701,199.4,0,0,,,
1986,21,b) 1,5042,5109,40432,38578,100,1.8,992,17.8,12502,3547,8955,9.2,32.4,8793,4397,4396,11.4,22.8,3709,9.6,45.6,0,704,704,3451
1986,21,c) 2,4797,4893,39286,39389,166,3.2,799,15.3,9570,1580,7990,4,24.3,9775,4372,5403,11.1,24.8,-205,-0.5,48.6,0,641,642,3707
1986,21,d) 3,3088,3165,39349,40866,109,3.2,599,17.5,5119,778,4341,1.9,12.5,8153,2986,5167,7.3,20,-3034,-7.5,25,0,486,486,2404
1986,21,e) 4,2864,2975,28863,29180,95,3,454,14.4,5426,878,4548,3,18.6,6059,3209,2850,11,20.8,-633,-2.2,37.2,0,354,360,2423
1986,21,f) 5,2464,2584,33538,34074,81,3,335,12.3,4946,623,4323,1.8,14.5,6018,2527,3491,7.4,17.7,-1072,-3.2,29,0,275,275,1438
1986,21,g) 6 to 10,8990,9882,105117,105668,378,3.7,1211,11.7,16806,2513,14293,2.4,15.9,17907,7262,10645,6.9,16.9,-1101,-1,31.8,0,877,880,5321
1986,21,l) Left Censored,21861,30857,750910,748806,1268,4,2449,7.8,84741,20063,64678,2.7,11.3,80532,24694,55838,3.3,10.8,4209,0.5,21.6,0,1380,1384,9159
1986,22,a) 0,7924,7966,47658,23848,7951,199.6,0,0,47621,47621,0,199.7,199.7,0,0,0,0,0,47621,199.7,0,0,,,
1986,22,b) 1,6269,6374,48384,50057,132,1.8,2052,27.8,14425,3107,11318,6.2,28.8,17771,10661,7110,21.3,35.5,-3346,-6.7,57.6,0,1626,1627,8546
1986,22,c) 2,5726,5837,49560,52950,203,3.2,1289,20.1,8886,1655,7231,3.1,16.8,15665,7924,7741,15,29.6,-6779,-12.8,33.6,0,1024,1024,6325
1986,22,d) 3,4268,4401,37812,39320,171,3.6,885,18.5,7219,1366,5853,3.5,18.4,10234,4717,5517,12,26,-3015,-7.6,36.8,0,711,711,3866
1986,22,e) 4,4300,4566,39065,41654,150,3.1,787,16.1,6480,1097,5383,2.6,15.6,11657,3995,7662,9.6,28,-5177,-12.4,31.2,0,615,615,3081
1986,22,f) 5,3696,3873,40539,43749,136,3.3,631,15.3,5918,843,5075,1.9,13.5,12338,4033,8305,9.2,28.2,-6420,-14.7,27,0,468,470,3056
1986,22,g) 6 to 10,12310,13629,151126,156189,537,3.7,1898,13.2,24013,5430,18583,3.5,15.4,34138,12100,22038,7.7,21.9,-10125,-6.5,30.8,0,1364,1370,8346
1986,22,l) Left Censored,24580,36591,807868,825315,1780,4.8,3349,9,107243,35811,71432,4.3,13,142137,40180,101957,4.9,17.2,-34894,-4.2,26,0,1720,1725,12544
1986,23,a) 0,3146,3157,14045,7028,3151,199.6,0,0,14035,14035,0,199.7,199.7,0,0,0,0,0,14035,199.7,0,0,,,
1986,23,b) 1,2290,2307,13551,12981,33,1.3,474,18.6,4283,526,3757,4.1,33,3142,1613,1529,12.4,24.2,1141,8.8,48.4,0,327,327,1181
1986,23,c) 2,1862,1893,12935,13073,67,3.3,313,15.5,2492,265,2227,2,19.1,2768,1343,1425,10.3,21.2,-276,-2.1,38.2,0,219,219,969
1986,23,d) 3,1314,1334,10076,10209,46,3.2,206,14.5,2347,386,1961,3.8,23,2612,1028,1584,10.1,25.6,-265,-2.6,46,0,157,157,804
1986,23,e) 4,1099,1144,9996,10042,29,2.4,148,12.3,1456,97,1359,1,14.5,1548,611,937,6.1,15.4,-92,-0.9,29,0,110,110,531
1986,23,f) 5,1014,1067,10832,10906,40,3.6,136,12.2,1758,329,1429,3,16.1,1905,750,1155,6.9,17.5,-147,-1.4,32.2,0,99,99,533
1986,23,g) 6 to 10,3938,4309,41685,42008,209,4.7,467,10.5,6580,1368,5212,3.3,15.7,7225,2793,4432,6.6,17.2,-645,-1.5,31.4,0,294,294,1485
1986,23,l) Left Censored,8354,11097,251469,250020,440,3.9,896,7.9,32151,8173,23978,3.3,12.9,29252,11040,18212,4.4,11.7,2899,1.2,23.4,0,503,520,4129
1986,24,a) 0,9639,9730,63741,31955,9683,199,0,0,63573,63573,0,198.9,198.9,0,0,0,0,0,63573,198.9,0,0,,,
1986,24,b) 1,7216,7412,63254,59699,189,2.3,1553,19.1,22798,4296,18502,7.2,38.2,15688,7768,7920,13,26.3,7110,11.9,52.6,0,1068,1068,5564
1986,24,c) 2,5744,5846,54024,56790,208,3.4,901,14.5,13381,1668,11713,2.9,23.6,18912,7490,11422,13.2,33.3,-5531,-9.7,47.2,0,622,622,4616
1986,24,d) 3,4342,4503,42482,42943,181,3.8,676,14.2,9036,1445,7591,3.4,21,9958,4874,5084,11.3,23.2,-922,-2.2,42,0,491,491,3395
1986,24,e) 4,3731,3954,45237,45614,132,3.2,531,12.8,8640,1031,7609,2.3,18.9,9394,3597,5797,7.9,20.6,-754,-1.7,37.8,0,365,365,2608
1986,24,f) 5,3382,3560,41154,42079,136,3.7,413,11.2,7606,1273,6333,3,18.1,9456,3880,5576,9.2,22.5,-1850,-4.4,36.2,0,300,302,2778
1986,24,g) 6 to 10,11792,13142,161153,161187,572,4.2,1330,9.8,31139,5332,25807,3.3,19.3,31207,10430,20777,6.5,19.4,-68,-0.1,38.6,0,880,886,6699
1986,24,l) Left Censored,26633,39000,1094560,1082925,2016,5.1,2997,7.6,160539,49202,111337,4.5,14.8,137268,45740,91528,4.2,12.7,23271,2.1,25.4,0,1471,1586,13162
1986,25,a) 0,13348,13463,99809,49959,13433,199.6,0,0,99701,99701,0,199.6,199.6,0,0,0,0,0,99701,199.6,0,0,,,
1986,25,b) 1,10387,10548,96531,89179,246,2.1,2026,17.6,35410,9215,26195,10.3,39.7,20706,10553,10153,11.8,23.2,14704,16.5,46.4,0,1368,1368,7739
1986,25,c) 2,8332,8458,80654,87266,306,3.4,1330,14.8,18061,2115,15946,2.4,20.7,31284,21474,9810,24.6,35.8,-13223,-15.1,41.4,0,964,964,7825
1986,25,d) 3,6159,6309,63010,63017,225,3.4,946,14.2,13579,1703,11876,2.7,21.5,13593,6181,7412,9.8,21.6,-14,-0.1,43,0,661,661,4383
1986,25,e) 4,5622,5904,80733,81317,209,3.4,742,12,12920,1160,11760,1.4,15.9,14087,6214,7873,7.6,17.3,-1167,-1.4,31.8,0,527,527,4671
1986,25,f) 5,5028,5264,71122,72099,187,3.4,608,11.1,13101,1493,11608,2.1,18.2,15055,6212,8843,8.6,20.9,-1954,-2.7,36.4,0,441,441,5185
1986,25,g) 6 to 10,17498,19684,263221,264743,829,4.1,2046,10.1,41729,6447,35282,2.4,15.8,44773,18013,26760,6.8,16.9,-3044,-1.1,31.6,0,1368,1382,12359
1986,25,l) Left Censored,46386,62013,1923136,1933567,2332,3.7,4939,7.8,241345,59849,181496,3.1,12.5,262207,73744,188463,3.8,13.6,-20862,-1.1,25,0,2756,2765,25221
1986,26,a) 0,15752,15920,96100,48142,15868,199.3,0,0,95917,95917,0,199.2,199.2,0,0,0,0,0,95917,199.2,0,0,,,
1986,26,b) 1,12772,13052,107030,98978,383,2.7,2907,20.2,39648,11620,28028,11.7,40.1,23543,14496,9047,14.6,23.8,16105,16.3,47.6,0,2070,2070,9963
1986,26,c) 2,11006,11261,100616,99633,412,3.4,1985,16.4,24403,5066,19337,5.1,24.5,22437,10870,11567,10.9,22.5,1966,2,45,0,1494,1494,8839
1986,26,d) 3,7829,8041,74029,73804,296,3.5,1307,15.2,15675,2106,13569,2.9,21.2,15224,7699,7525,10.4,20.6,451,0.6,41.2,0,1015,1015,6061
1986,26,e) 4,6816,7174,71031,71501,244,3.2,1068,14,14365,1488,12877,2.1,20.1,15304,7934,7370,11.1,21.4,-939,-1.3,40.2,0,827,827,6223
1986,26,f) 5,6526,6891,75770,76530,230,3.2,872,12.1,12471,1872,10599,2.4,16.3,13991,5994,7997,7.8,18.3,-1520,-2,32.6,0,630,630,4602
1986,26,g) 6 to 10,23906,27047,293606,290215,1170,4.2,2937,10.5,52800,10613,42187,3.7,18.2,46018,17995,28023,6.2,15.9,6782,2.3,31.8,0,1948,1952,11222
1986,26,l) Left Censored,53845,78064,2271642,2244203,3160,4,6126,7.7,295322,75035,220287,3.3,13.2,240443,75299,165144,3.4,10.7,54879,2.5,21.4,0,3298,3316,24834
1986,27,a) 0,8381,8471,51950,26155,8445,199.4,0,0,51591,51591,0,197.3,197.3,0,0,0,0,0,51591,197.3,0,0,,,
1986,27,b) 1,6899,7069,59402,56554,205,2.6,1684,21.4,20716,7312,13404,12.9,36.6,15019,8379,6640,14.8,26.6,5697,10,53.2,0,1175,1175,6045
1986,27,c) 2,6043,6211,53731,55021,210,3.1,1194,17.7,12914,2179,10735,4,23.5,15494,9436,6058,17.1,28.2,-2580,-4.7,47,0,889,889,7643
1986,27,d) 3,4147,4445,44453,45804,173,3.6,805,16.9,7988,1215,6773,2.7,17.4,10689,4810,5879,10.5,23.3,-2701,-5.9,34.8,0,629,630,3275
1986,27,e) 4,3680,3877,39142,40107,124,3,561,13.7,6627,817,5810,2,16.5,8557,3641,4916,9.1,21.3,-1930,-4.8,33,0,413,415,2371
1986,27,f) 5,3599,3797,40985,42863,140,3.5,475,12,6512,1171,5341,2.7,15.2,10268,3906,6362,9.1,24,-3756,-8.8,30.4,0,329,329,2582
1986,27,g) 6 to 10,13381,15055,160497,162130,608,3.9,1730,11.1,27742,5007,22735,3.1,17.1,31008,11629,19379,7.2,19.1,-3266,-2,34.2,0,1124,1143,7716
1986,27,l) Left Censored,30313,41748,1171209,1173854,1701,4,3355,7.9,149782,34070,115712,2.9,12.8,155071,49812,105259,4.2,13.2,-5289,-0.4,25.6,0,1635,1640,17978
1986,28,a) 0,4425,4452,22753,11508,4437,199.3,0,0,22490,22490,0,195.4,195.4,0,0,0,0,0,22490,195.4,0,0,,,
1986,28,b) 1,3487,3524,25047,24243,78,2,942,23.6,9319,2703,6616,11.1,38.4,7711,4899,2812,20.2,31.8,1608,6.6,63.6,0,692,692,3185
1986,28,c) 2,3260,3293,22950,23444,137,3.9,616,17.3,5347,966,4381,4.1,22.8,6334,3035,3299,12.9,27,-987,-4.2,45.6,0,447,448,2288
1986,28,d) 3,2115,2161,15131,16302,101,4.4,391,16.9,3041,503,2538,3.1,18.7,5382,2037,3345,12.5,33,-2341,-14.3,37.4,0,288,288,1522
1986,28,e) 4,1864,1931,16031,15824,60,2.9,293,14.3,3479,738,2741,4.7,22,3065,1341,1724,8.5,19.4,414,2.6,38.8,0,224,225,1051
1986,28,f) 5,1772,1856,21114,21645,64,3.3,276,14,3212,434,2778,2,14.8,4274,2014,2260,9.3,19.7,-1062,-4.9,29.6,0,194,194,1365
1986,28,g) 6 to 10,6798,7586,73187,73741,294,3.7,845,10.7,11568,2134,9434,2.9,15.7,12676,4706,7970,6.4,17.2,-1108,-1.5,31.4,0,567,567,3034
1986,28,l) Left Censored,14604,20834,490894,485761,912,4.3,1634,7.7,70885,16321,54564,3.4,14.6,60618,18624,41994,3.8,12.5,10267,2.1,25,0,862,873,7368
1986,29,a) 0,10571,10668,60937,30567,10635,199.4,0,0,60741,60741,0,198.7,198.7,0,0,0,0,0,60741,198.7,0,0,,,
1986,29,b) 1,9013,9146,69486,64516,210,2.2,1368,14,23905,5773,18132,8.9,37.1,13965,6280,7685,9.7,21.6,9940,15.5,43.2,0,520,520,2663
1986,29,c) 2,7063,7228,57886,58409,277,3.6,1186,15.4,13737,2805,10932,4.8,23.5,14782,7648,7134,13.1,25.3,-1045,-1.8,47,0,884,884,5830
1986,29,d) 3,4933,5110,47036,47600,211,3.9,832,15.3,8958,1648,7310,3.5,18.8,10085,4933,5152,10.4,21.2,-1127,-2.4,37.6,0,619,624,3696
1986,29,e) 4,4266,4537,42263,42659,164,3.4,680,14.2,8093,1032,7061,2.4,19,8885,4121,4764,9.7,20.8,-792,-1.8,38,0,505,514,3173
1986,29,f) 5,4122,4483,47009,46121,166,3.5,568,12.1,9399,2768,6631,6,20.4,7623,3061,4562,6.6,16.5,1776,3.9,33,0,393,398,2065
1986,29,g) 6 to 10,14753,16467,164456,165418,738,4.3,1838,10.8,30114,6584,23530,4,18.2,32037,12056,19981,7.3,19.4,-1923,-1.2,36.4,0,1233,1243,8572
1986,29,l) Left Censored,34768,49408,1346883,1345160,2208,4.4,3858,7.7,173777,50159,123618,3.7,12.9,170330,55437,114893,4.1,12.7,3447,0.2,25.4,0,1910,1921,16372
1986,30,a) 0,2220,2228,10355,5185,2222,199.5,0,0,10341,10341,0,199.4,199.4,0,0,0,0,0,10341,199.4,0,0,,,
1986,30,b) 1,1785,1798,10275,10397,36,1.7,531,25.6,2967,700,2267,6.7,28.5,3210,1791,1419,17.2,30.9,-243,-2.4,57,0,399,399,1445
1986,30,c) 2,1537,1562,8008,8757,78,4.5,404,23.3,1676,263,1413,3,19.1,3174,1816,1358,20.7,36.2,-1498,-17.1,38.2,0,310,310,1529
1986,30,d) 3,1169,1271,8943,9475,58,4.3,221,16.3,1530,527,1003,5.6,16.1,2594,1176,1418,12.4,27.4,-1064,-11.3,32.2,0,161,161,881
1986,30,e) 4,992,1014,6117,6651,37,3.4,199,18.1,983,125,858,1.9,14.8,2051,985,1066,14.8,30.8,-1068,-16,29.6,0,157,157,774
1986,30,f) 5,960,999,7152,7790,40,3.7,175,16.3,1069,198,871,2.5,13.7,2345,976,1369,12.5,30.1,-1276,-16.4,27.4,0,130,130,763
1986,30,g) 6 to 10,3778,4115,30824,32062,209,4.9,535,12.5,4735,1006,3729,3.1,14.8,7212,2654,4558,8.3,22.5,-2477,-7.7,29.6,0,359,361,1762
1986,30,l) Left Censored,6611,8634,133644,136175,289,3.3,752,8.5,12434,2343,10091,1.7,9.1,17496,5324,12172,3.9,12.8,-5062,-3.7,18.2,0,404,404,2258
1986,31,a) 0,2964,2990,17338,8684,2982,199.5,0,0,17309,17309,0,199.3,199.3,0,0,0,0,0,17309,199.3,0,0,,,
1986,31,b) 1,2774,2800,19642,19108,70,2.3,533,17.5,6188,1675,4513,8.8,32.4,5120,2539,2581,13.3,26.8,1068,5.6,53.6,0,379,379,2160
1986,31,c) 2,2356,2394,15510,15951,83,3.3,357,14,2983,610,2373,3.8,18.7,3864,1844,2020,11.6,24.2,-881,-5.5,37.4,0,246,246,1249
1986,31,d) 3,1768,1894,17168,17892,77,3.8,323,16,2564,773,1791,4.3,14.3,4012,1737,2275,9.7,22.4,-1448,-8.1,28.6,0,230,230,968
1986,31,e) 4,1594,1659,13062,13567,54,3,268,15.1,1904,231,1673,1.7,14,2914,1242,1672,9.2,21.5,-1010,-7.5,28,0,199,199,821
1986,31,f) 5,1511,1597,11836,12055,54,3.2,230,13.6,1886,170,1716,1.4,15.6,2323,912,1411,7.6,19.3,-437,-3.7,31.2,0,163,164,666
1986,31,g) 6 to 10,5809,6322,49193,50676,221,3.4,743,11.3,7409,2135,5274,4.2,14.6,10374,4252,6122,8.4,20.5,-2965,-5.9,29.2,0,533,533,2787
1986,31,l) Left Censored,14061,18443,374409,376504,602,3.2,1528,8.1,41118,12682,28436,3.4,10.9,45307,12476,32831,3.3,12,-4189,-1.1,21.8,0,828,834,4928
1986,32,a) 0,2733,2765,18799,9428,2756,199.3,0,0,18742,18742,0,198.8,198.8,0,0,0,0,0,18742,198.8,0,0,,,
1986,32,b) 1,1868,1894,19100,18245,42,1.9,637,28.8,7058,1506,5552,8.3,38.7,5347,3159,2188,17.3,29.3,1711,9.4,58.6,0,486,486,2365
1986,32,c) 2,1593,1627,16171,17171,74,4.1,435,23.9,3388,514,2874,3,19.7,5388,2626,2762,15.3,31.4,-2000,-11.7,39.4,0,340,340,2281
1986,32,d) 3,1138,1203,12677,13500,56,4.3,237,18.3,2445,353,2092,2.6,18.1,4090,2289,1801,17,30.3,-1645,-12.2,36.2,0,188,188,2049
1986,32,e) 4,1169,1235,15093,15600,58,4.4,198,15.2,2706,556,2150,3.6,17.3,3719,2111,1608,13.5,23.8,-1013,-6.5,34.6,0,146,146,1015
1986,32,f) 5,1061,1126,11352,11562,52,4.4,173,14.6,1961,402,1559,3.5,17,2380,976,1404,8.4,20.6,-419,-3.6,34,0,122,122,638
1986,32,g) 6 to 10,3537,3888,52476,52301,198,4.9,543,13.4,10867,2220,8647,4.2,20.8,10517,4609,5908,8.8,20.1,350,0.7,40.2,0,340,340,2794
1986,32,l) Left Censored,5117,7432,249147,247663,429,5.7,666,8.8,34377,10550,23827,4.3,13.9,31409,12795,18614,5.2,12.7,2968,1.2,25.4,0,295,296,3057
1986,33,a) 0,3752,3769,22063,11249,3763,199.7,0,0,21628,21628,0,192.3,192.3,0,0,0,0,0,21628,192.3,0,0,,,
1986,33,b) 1,2618,2640,19199,17883,47,1.6,578,19.8,6813,1129,5684,6.3,38.1,4181,2507,1674,14,23.4,2632,14.7,46.8,0,425,425,2021
1986,33,c) 2,2047,2084,18474,18347,71,3.2,317,14.3,4338,412,3926,2.2,23.6,4083,1874,2209,10.2,22.3,255,1.3,44.6,0,233,233,1580
1986,33,d) 3,1374,1411,12814,12423,59,4,193,13,2812,585,2227,4.7,22.6,2029,878,1151,7.1,16.3,783,6.3,32.6,0,148,148,686
1986,33,e) 4,1172,1205,13264,12874,32,2.5,168,13.2,2786,524,2262,4.1,21.6,2006,930,1076,7.2,15.6,780,6,31.2,0,126,126,621
1986,33,f) 5,998,1028,11064,11226,42,3.9,126,11.8,2253,333,1920,3,20.1,2576,1205,1371,10.7,22.9,-323,-2.8,40.2,0,94,94,1065
1986,33,g) 6 to 10,3762,4189,46413,46608,221,5.1,469,10.9,7945,1784,6161,3.8,17,8334,3087,5247,6.6,17.9,-389,-0.9,34,0,319,319,1965
1986,33,l) Left Censored,7649,9949,290041,291602,501,5,797,7.9,39323,11535,27788,4,13.5,42446,17721,24725,6.1,14.6,-3123,-1.1,27,0,445,447,4122
1986,34,a) 0,18148,18235,101569,50894,18192,199.5,0,0,101350,101350,0,199.1,199.1,0,0,0,0,0,101350,199.1,0,0,,,
1986,34,b) 1,13613,13750,99125,91665,287,1.9,3155,20.7,37568,9722,27846,10.6,41,22647,12489,10158,13.6,24.7,14921,16.3,49.4,0,2148,2148,9276
1986,34,c) 2,10977,11139,103338,104971,411,3.4,1940,16.2,20889,2411,18478,2.3,19.9,24155,12084,12071,11.5,23,-3266,-3.1,39.8,0,1393,1394,9068
1986,34,d) 3,8626,8746,76408,77790,329,3.5,1446,15.5,15009,1587,13422,2,19.3,17773,8048,9725,10.3,22.8,-2764,-3.5,38.6,0,1076,1076,5875
1986,34,e) 4,7849,8072,82545,81661,255,3,1147,13.4,17831,1740,16091,2.1,21.8,16065,6028,10037,7.4,19.7,1766,2.1,39.4,0,811,813,4022
1986,34,f) 5,7122,7372,74521,75174,263,3.4,852,11.1,12459,1691,10768,2.2,16.6,13765,5381,8384,7.2,18.3,-1306,-1.7,33.2,0,612,617,3410
1986,34,g) 6 to 10,25104,26704,277473,277524,983,3.6,2821,10.2,52339,9109,43230,3.3,18.9,52442,19087,33355,6.9,18.9,-103,0,37.8,0,1939,1953,11699
1986,34,l) Left Censored,58918,77221,2171366,2184630,2958,3.7,6257,7.9,296242,86583,209659,4,13.6,322771,97262,225509,4.5,14.8,-26529,-1.2,27.2,0,3510,3515,26794
1986,35,a) 0,3384,3412,19647,9846,3401,199.4,0,0,19602,19602,0,199.1,199.1,0,0,0,0,0,19602,199.1,0,0,,,
1986,35,b) 1,2546,2579,18827,18747,56,1.9,752,25.5,6152,1352,4800,7.2,32.8,5991,3353,2638,17.9,32,161,0.8,64,0,532,532,2442
1986,35,c) 2,2232,2276,15322,15950,109,4.4,471,19,3295,554,2741,3.5,20.7,4551,2196,2355,13.8,28.5,-1256,-7.8,41.4,0,342,342,1654
1986,35,d) 3,1674,1806,16705,17365,122,6.3,365,18.9,3401,1043,2358,6,19.6,4721,2050,2671,11.8,27.2,-1320,-7.6,39.2,0,263,263,1525
1986,35,e) 4,1385,1443,21259,21621,70,4.6,244,15.9,2996,552,2444,2.6,13.9,3720,1832,1888,8.5,17.2,-724,-3.3,27.8,0,185,185,1439
1986,35,f) 5,1396,1466,12981,13675,66,4.2,236,15.2,2351,380,1971,2.8,17.2,3739,1592,2147,11.6,27.3,-1388,-10.1,34.4,0,159,159,856
1986,35,g) 6 to 10,4902,5405,50553,51723,275,4.9,683,12.1,9044,1505,7539,2.9,17.5,11383,4254,7129,8.2,22,-2339,-4.5,35,0,431,431,2768
1986,35,l) Left Censored,8080,11522,231472,234346,642,5.5,963,8.2,30222,10729,19493,4.6,12.9,35970,7840,28130,3.3,15.3,-5748,-2.4,25.8,0,491,494,3176
1986,36,a) 0,39316,39519,201111,100827,39420,199.5,0,0,200568,200568,0,198.9,198.9,0,0,0,0,0,200568,198.9,0,0,,,
1986,36,b) 1,31305,31581,222290,207580,697,2,7091,20.3,82459,24330,58129,11.7,39.7,53038,28955,24083,13.9,25.6,29421,14.1,51.2,0,4998,4999,20662
1986,36,c) 2,25422,25818,200712,204109,864,3.1,4707,16.9,45150,5060,40090,2.5,22.1,51944,25652,26292,12.6,25.4,-6794,-3.3,44.2,0,3510,3511,19435
1986,36,d) 3,19964,20347,170337,171250,743,3.4,3506,16.1,36454,4295,32159,2.5,21.3,38280,19047,19233,11.1,22.4,-1826,-1.1,42.6,0,2650,2650,14064
1986,36,e) 4,17608,18161,164288,168114,562,2.9,2571,13.4,27889,2987,24902,1.8,16.6,35541,14556,20985,8.7,21.1,-7652,-4.5,33.2,0,1969,1970,11597
1986,36,f) 5,15770,16302,173468,175262,485,2.8,2135,12.5,28384,3738,24646,2.1,16.2,31971,11148,20823,6.4,18.2,-3587,-2,32.4,0,1574,1575,7901
1986,36,g) 6 to 10,54255,58852,656471,655254,2015,3.3,6756,11,115338,18009,97329,2.7,17.6,112903,39869,73034,6.1,17.2,2435,0.4,34.4,0,4718,4752,25589
1986,36,l) Left Censored,137006,175228,4805247,4817486,5507,3.1,14685,8.2,593807,156209,437598,3.2,12.3,618286,203374,414912,4.2,12.8,-24479,-0.5,24.6,0,8906,8950,63483
1986,37,a) 0,13855,13997,73667,37103,13965,199.5,0,0,73129,73129,0,197.1,197.1,0,0,0,0,0,73129,197.1,0,0,,,
1986,37,b) 1,10978,11138,81689,77466,244,2,2749,22,29971,10761,19210,13.9,38.7,21525,12689,8836,16.4,27.8,8446,10.9,55.6,0,1984,2018,9886
1986,37,c) 2,10372,10603,78222,79320,379,3.3,1767,15.6,18455,3415,15040,4.3,23.3,20651,11290,9361,14.2,26,-2196,-2.7,46.6,0,1329,1329,8865
1986,37,d) 3,6155,6341,56403,57765,229,3.4,1017,15,11162,1845,9317,3.2,19.3,13887,6647,7240,11.5,24,-2725,-4.7,38.6,0,774,774,5333
1986,37,e) 4,5180,5452,52754,53628,221,3.9,766,13.4,9503,1330,8173,2.5,17.7,11251,5219,6032,9.7,21,-1748,-3.3,35.4,0,554,563,3666
1986,37,f) 5,4722,4993,80095,71371,189,3.6,638,12.2,27608,1897,25711,2.7,38.7,10159,5023,5136,7,14.2,17449,24.5,28.4,0,471,471,3778
1986,37,g) 6 to 10,17331,19231,198593,198380,793,4,1928,9.7,33606,6325,27281,3.2,16.9,33179,11266,21913,5.7,16.7,427,0.2,33.4,0,1291,1298,7418
1986,37,l) Left Censored,37980,58154,1735585,1725062,2747,4.7,4111,7,215572,72296,143276,4.2,12.5,194527,56446,138081,3.3,11.3,21045,1.2,22.6,0,2078,2120,14093
1986,38,a) 0,1352,1361,6850,3430,1358,199.6,0,0,6840,6840,0,199.4,199.4,0,0,0,0,0,6840,199.4,0,0,,,
1986,38,b) 1,1183,1200,6796,7099,33,2.4,301,22.3,1637,480,1157,6.8,23.1,2243,1114,1129,15.7,31.6,-606,-8.5,46.2,0,221,221,952
1986,38,c) 2,1075,1087,5719,6127,31,2.6,219,18.4,1129,183,946,3,18.4,1945,1066,879,17.4,31.7,-816,-13.3,36.8,0,167,167,909
1986,38,d) 3,804,884,6739,7510,26,2.8,139,14.7,1168,485,683,6.5,15.6,2709,756,1953,10.1,36.1,-1541,-20.5,31.2,0,109,109,601
1986,38,e) 4,767,792,5229,5432,22,2.6,121,14.4,740,91,649,1.7,13.6,1146,489,657,9,21.1,-406,-7.5,27.2,0,94,94,374
1986,38,f) 5,717,742,6891,6748,26,3.4,91,11.7,1242,83,1159,1.2,18.4,956,413,543,6.1,14.2,286,4.2,28.4,0,55,55,229
1986,38,g) 6 to 10,2665,2861,21076,22187,118,4,305,10.3,3002,664,2338,3,13.5,5223,1469,3754,6.6,23.5,-2221,-10,27,0,211,214,972
1986,38,l) Left Censored,6100,7955,129737,131030,262,3.2,596,7.3,12243,2779,9464,2.1,9.3,14828,4358,10470,3.3,11.3,-2585,-2,18.6,0,309,309,1904
1986,39,a) 0,17341,17522,106053,53083,17483,199.6,0,0,105941,105941,0,199.6,199.6,0,0,0,0,0,105941,199.6,0,0,,,
1986,39,b) 1,13765,14053,118882,110044,457,3,3102,20.1,46709,15592,31117,14.2,42.4,29032,14066,14966,12.8,26.4,17677,16,52.8,0,2255,2255,11137
1986,39,c) 2,12149,12439,108888,111164,408,3.1,2129,15.9,23319,3056,20263,2.7,21,27871,13778,14093,12.4,25.1,-4552,-4.1,42,0,1599,1599,11258
1986,39,d) 3,8551,8878,79755,80362,315,3.3,1381,14.6,14987,2082,12905,2.6,18.6,16201,7945,8256,9.9,20.2,-1214,-1.6,37.2,0,1063,1063,6314
1986,39,e) 4,7858,8253,74974,75687,272,3.1,1191,13.7,14360,2552,11808,3.4,19,15785,8090,7695,10.7,20.9,-1425,-1.9,38,0,882,890,5777
1986,39,f) 5,7478,7981,96129,95906,250,3,935,11.2,16014,1980,14034,2.1,16.7,15567,7104,8463,7.4,16.2,447,0.5,32.4,0,677,679,4100
1986,39,g) 6 to 10,27336,31251,330154,329633,1265,3.9,3270,10.1,56033,10246,45787,3.1,17,54991,22953,32038,7,16.7,1042,0.3,33.4,0,2118,2119,13736
1986,39,l) Left Censored,70335,105430,2860534,2871855,4418,4.1,7906,7.4,337295,88764,248531,3.1,11.7,359937,118855,241082,4.1,12.5,-22642,-0.8,23.4,0,4019,4046,56311
1986,40,a) 0,6755,6793,39112,19602,6770,199.3,0,0,39021,39021,0,199.1,199.1,0,0,0,0,0,39021,199.1,0,0,,,
1986,40,b) 1,5484,5577,36921,38235,117,1.8,1974,30.1,12264,3382,8882,8.8,32.1,14891,8828,6063,23.1,38.9,-2627,-6.8,64.2,0,1577,1577,7362
1986,40,c) 2,5185,5245,35220,37428,200,3.5,1224,21.1,7568,1551,6017,4.1,20.2,11983,6296,5687,16.8,32,-4415,-11.8,40.4,0,1006,1006,5122
1986,40,d) 3,3593,3727,26850,28891,182,4.4,879,21.5,4874,880,3994,3,16.9,8955,4797,4158,16.6,31,-4081,-14.1,33.8,0,677,677,3781
1986,40,e) 4,3659,3844,35681,37611,140,3.3,790,18.9,5127,827,4300,2.2,13.6,8987,3932,5055,10.5,23.9,-3860,-10.3,27.2,0,625,625,3053
1986,40,f) 5,3108,3276,32936,34285,95,2.7,594,16.8,5126,878,4248,2.6,15,7823,3488,4335,10.2,22.8,-2697,-7.8,30,0,454,454,2439
1986,40,g) 6 to 10,10236,11351,106836,112256,460,3.8,1697,14.2,15249,3779,11470,3.4,13.6,26089,9360,16729,8.3,23.2,-10840,-9.6,27.2,0,1210,1218,6305
1986,40,l) Left Censored,19555,28471,622365,636536,1381,4.7,2683,9.2,73296,22810,50486,3.6,11.5,101638,31644,69994,5,16,-28342,-4.5,23,0,1354,1364,9267
1986,41,a) 0,7347,7386,37422,18752,7352,199.1,0,0,37340,37340,0,199.1,199.1,0,0,0,0,0,37340,199.1,0,0,,,
1986,41,b) 1,5422,5492,35907,36124,112,1.8,1578,25.1,11026,2397,8629,6.6,30.5,11459,6977,4482,19.3,31.7,-433,-1.2,61,0,1160,1160,5003
1986,41,c) 2,4579,4659,33694,35126,224,4.4,1035,20.3,7531,1463,6068,4.2,21.4,10395,5228,5167,14.9,29.6,-2864,-8.2,42.8,0,819,819,4323
1986,41,d) 3,3207,3468,34664,35874,190,5.1,630,17.1,6608,1537,5071,4.3,18.4,9027,4114,4913,11.5,25.2,-2419,-6.8,36.8,0,467,467,2555
1986,41,e) 4,3107,3257,29382,30431,107,3.1,478,13.9,5096,649,4447,2.1,16.7,7194,3607,3587,11.9,23.6,-2098,-6.9,33.4,0,372,372,2956
1986,41,f) 5,3003,3176,26661,27682,135,4,453,13.6,4562,855,3707,3.1,16.5,6603,2467,4136,8.9,23.9,-2041,-7.4,33,0,331,331,1850
1986,41,g) 6 to 10,10381,11447,107001,107833,589,5,1482,12.5,19513,4710,14803,4.4,18.1,21176,8924,12252,8.3,19.6,-1663,-1.5,36.2,0,969,969,5301
1986,41,l) Left Censored,18416,25913,552095,552707,1124,4.3,2142,8.1,68178,17618,50560,3.2,12.3,69402,22333,47069,4,12.6,-1224,-0.3,24.6,0,1107,1112,8173
1986,42,a) 0,20663,20856,142144,71212,20788,199.3,0,0,141865,141865,0,199.2,199.2,0,0,0,0,0,141865,199.2,0,0,,,
1986,42,b) 1,15862,16211,140607,130768,473,2.7,3160,17.9,48746,15298,33448,11.7,37.3,29068,13918,15150,10.6,22.2,19678,15.1,44.4,0,2173,2173,10093
1986,42,c) 2,13911,14431,132162,134063,685,4.5,2068,13.6,29531,7684,21847,5.7,22,33333,16229,17104,12.1,24.9,-3802,-2.9,44,0,1518,1518,13145
1986,42,d) 3,9902,10163,91313,92689,405,3.8,1517,14.1,17471,2709,14762,2.9,18.8,20222,9454,10768,10.2,21.8,-2751,-3,37.6,0,1155,1155,7448
1986,42,e) 4,9001,9493,102285,102949,356,3.6,1185,11.9,16854,3420,13434,3.3,16.4,18181,7703,10478,7.5,17.7,-1327,-1.3,32.8,0,842,842,5238
1986,42,f) 5,8123,8546,99497,99290,318,3.6,982,11,17903,2585,15318,2.6,18,17488,7287,10201,7.3,17.6,415,0.4,35.2,0,682,693,4734
1986,42,g) 6 to 10,30762,34360,368495,370613,1461,4.1,3500,9.9,60517,12472,48045,3.4,16.3,64754,25488,39266,6.9,17.5,-4237,-1.2,32.6,0,2318,2326,15207
1986,42,l) Left Censored,81092,114678,3062426,3075067,4656,4,8809,7.5,356446,90179,266267,2.9,11.6,381728,116825,264903,3.8,12.4,-25282,-0.8,23.2,0,4735,4749,43410
1986,44,a) 0,2337,2346,12709,6359,2341,199.6,0,0,12700,12700,0,199.7,199.7,0,0,0,0,0,12700,199.7,0,0,,,
1986,44,b) 1,1783,1796,13201,12148,42,2.1,368,18.7,4800,938,3862,7.7,39.5,2693,1551,1142,12.8,22.2,2107,17.3,44.4,0,257,257,1135
1986,44,c) 2,1441,1453,12549,12654,56,3.6,249,16,2482,306,2176,2.4,19.6,2692,1217,1475,9.6,21.3,-210,-1.7,39.2,0,170,170,945
1986,44,d) 3,1032,1049,8777,8827,39,3.5,163,14.6,1628,200,1428,2.3,18.4,1728,921,807,10.4,19.6,-100,-1.2,36.8,0,117,117,560
1986,44,e) 4,875,909,9726,9665,21,2.2,145,14.9,1713,64,1649,0.7,17.7,1590,604,986,6.2,16.5,123,1.2,33,0,108,108,469
1986,44,f) 5,847,867,9567,9492,27,3,91,10.1,1431,334,1097,3.5,15.1,1280,613,667,6.5,13.5,151,1.6,27,0,68,68,451
1986,44,g) 6 to 10,3166,3387,36832,36715,146,4.2,333,9.6,5786,926,4860,2.5,15.8,5552,1785,3767,4.9,15.1,234,0.7,30.2,0,235,235,1268
1986,44,l) Left Censored,8650,10541,276359,273793,395,3.7,792,7.4,34225,8941,25284,3.3,12.5,29092,10664,18428,3.9,10.6,5133,1.9,21.2,0,480,484,5750
1986,45,a) 0,6743,6792,38663,19355,6769,199.3,0,0,38616,38616,0,199.5,199.5,0,0,0,0,0,38616,199.5,0,0,,,
1986,45,b) 1,5476,5576,42534,40966,113,1.8,1341,21.5,13639,3275,10364,8,33.3,10503,5628,4875,13.7,25.6,3136,7.7,51.2,0,981,982,4225
1986,45,c) 2,4840,4961,41623,41603,214,4,814,15.4,9323,2063,7260,5,22.4,9282,4416,4866,10.6,22.3,41,0.1,44.6,0,588,588,3253
1986,45,d) 3,3049,3153,28937,29369,123,3.6,571,16.8,5985,985,5000,3.4,20.4,6849,2942,3907,10,23.3,-864,-2.9,40.8,0,420,420,2243
1986,45,e) 4,2724,2875,27545,28956,103,3.4,382,12.6,5143,645,4498,2.2,17.8,7965,3576,4389,12.3,27.5,-2822,-9.7,35.6,0,280,280,2214
1986,45,f) 5,2372,2530,27233,27583,91,3.4,322,12.1,5376,1344,4032,4.9,19.5,6075,3204,2871,11.6,22,-699,-2.5,39,0,241,241,2427
1986,45,g) 6 to 10,8507,9497,96737,101262,399,4,1084,11,15427,2219,13208,2.2,15.2,24476,7134,17342,7,24.2,-9049,-9,30.4,0,715,715,4281
1986,45,l) Left Censored,18453,27796,755232,755460,1324,4.7,2060,7.3,95992,26502,69490,3.5,12.7,96447,32237,64210,4.3,12.8,-455,-0.1,25.4,0,1025,1027,7998
1986,46,a) 0,1434,1439,7523,3770,1432,199,0,0,7507,7507,0,199.1,199.1,0,0,0,0,0,7507,199.1,0,0,,,
1986,46,b) 1,1270,1279,7141,7456,28,2,310,21.6,1930,497,1433,6.7,25.9,2559,1470,1089,19.7,34.3,-629,-8.4,51.8,0,202,202,1184
1986,46,c) 2,1141,1153,6351,6718,43,3.5,202,16.3,1165,123,1042,1.8,17.3,1898,1097,801,16.3,28.3,-733,-11,34.6,0,154,154,970
1986,46,d) 3,752,830,6279,6357,28,3.2,139,15.7,1374,105,1269,1.7,21.6,1530,672,858,10.6,24.1,-156,-2.5,43.2,0,100,100,459
1986,46,e) 4,686,705,4946,5036,30,4,103,13.9,861,232,629,4.6,17.1,1041,562,479,11.2,20.7,-180,-3.6,34.2,0,77,77,439
1986,46,f) 5,663,685,6450,6603,21,2.9,98,13.5,721,98,623,1.5,10.9,1027,475,552,7.2,15.6,-306,-4.7,21.8,0,66,66,401
1986,46,g) 6 to 10,2590,2816,20562,20972,112,3.8,317,10.8,3068,617,2451,2.9,14.6,3888,1619,2269,7.7,18.5,-820,-3.9,29.2,0,198,198,987
1986,46,l) Left Censored,6414,8047,133973,136096,243,3,597,7.3,13196,3303,9893,2.4,9.7,17442,4745,12697,3.5,12.8,-4246,-3.1,19.4,0,318,319,2283
1986,47,a) 0,9536,9638,59688,29899,9607,199.4,0,0,59579,59579,0,199.3,199.3,0,0,0,0,0,59579,199.3,0,0,,,
1986,47,b) 1,7223,7363,56525,55386,147,1.8,2043,24.4,19236,4728,14508,8.5,34.7,16957,10421,6536,18.8,30.6,2279,4.1,61.2,0,1552,1552,7648
1986,47,c) 2,7003,7096,56871,58812,243,3.2,1293,16.9,13207,2057,11150,3.5,22.5,17088,9856,7232,16.8,29.1,-3881,-6.6,45,0,1019,1019,8388
1986,47,d) 3,4384,4533,40740,41842,221,4.6,824,17,8800,1516,7284,3.6,21,11004,6003,5001,14.3,26.3,-2204,-5.3,42,0,647,647,4565
1986,47,e) 4,3731,3918,41165,42566,135,3.2,588,14.1,7051,1138,5913,2.7,16.6,9852,5264,4588,12.4,23.1,-2801,-6.5,33.2,0,437,437,3878
1986,47,f) 5,3322,3536,42932,43188,139,3.8,451,12.2,7463,1212,6251,2.8,17.3,7974,2639,5335,6.1,18.5,-511,-1.2,34.6,0,336,336,1853
1986,47,g) 6 to 10,12574,14183,160259,161683,630,4.3,1641,11.2,27261,5045,22216,3.1,16.9,30109,12820,17289,7.9,18.6,-2848,-1.7,33.8,0,1104,1112,8858
1986,47,l) Left Censored,28015,41550,1179570,1169688,1948,4.6,3173,7.5,156513,40465,116048,3.5,13.4,136750,40647,96103,3.5,11.7,19763,1.7,23.4,0,1595,1600,11945
1986,48,a) 0,38602,39106,246914,123797,38970,199.3,0,0,246235,246235,0,198.9,198.9,0,0,0,0,0,246235,198.9,0,0,,,
1986,48,b) 1,29904,30595,240694,241706,686,1.9,9890,27.9,82706,17267,65439,7.1,34.2,84729,49188,35541,20.4,35.1,-2023,-0.9,68.4,0,7748,7748,39202
1986,48,c) 2,26030,26911,232603,249145,1041,3.5,6387,21.5,54930,7499,47431,3,22,88013,47899,40114,19.2,35.3,-33083,-13.3,44,0,5069,5069,37159
1986,48,d) 3,19240,19933,181686,195495,845,3.9,4170,19.2,37981,6579,31402,3.4,19.4,65598,35103,30495,18,33.6,-27617,-14.2,38.8,0,3298,3298,25096
1986,48,e) 4,17738,18787,177587,188756,716,3.5,3400,16.9,31654,4794,26860,2.5,16.8,53991,23025,30966,12.2,28.6,-22337,-11.8,33.6,0,2558,2560,17451
1986,48,f) 5,23060,24561,254757,268642,887,3.4,3597,13.9,42580,8440,34140,3.1,15.9,70349,30782,39567,11.5,26.2,-27769,-10.3,31.8,0,2701,2703,21395
1986,48,g) 6 to 10,43051,50275,564315,584692,2445,4.7,6481,12.4,97370,23497,73873,4,16.7,138123,49625,88498,8.5,23.6,-40753,-6.9,33.4,0,4247,4284,30392
1986,48,l) Left Censored,80117,138091,3663987,3708903,7324,5.2,12231,8.7,498124,158403,339721,4.3,13.4,587956,164818,423138,4.4,15.9,-89832,-2.5,26.8,0,5435,5537,41033
1986,49,a) 0,3195,3234,22067,11041,3225,199.4,0,0,22052,22052,0,199.7,199.7,0,0,0,0,0,22052,199.7,0,0,,,
1986,49,b) 1,2484,2517,20088,20102,48,1.6,826,28.2,7023,1157,5866,5.8,34.9,7050,4399,2651,21.9,35.1,-27,-0.2,69.8,0,606,606,3395
1986,49,c) 2,2025,2073,18939,20258,119,5.2,508,22.3,4481,867,3614,4.3,22.1,7118,4127,2991,20.4,35.1,-2637,-13,44.2,0,392,392,3149
1986,49,d) 3,1467,1598,17592,18219,122,7.1,346,20.2,5217,2697,2520,14.8,28.6,6471,2441,4030,13.4,35.5,-1254,-6.9,57.2,0,269,269,2048
1986,49,e) 4,1466,1548,14511,14700,72,4.4,249,15.2,2623,491,2132,3.3,17.8,3001,1435,1566,9.8,20.4,-378,-2.6,35.6,0,178,184,1086
1986,49,f) 5,1348,1446,18553,18226,75,5,199,13.2,3815,835,2980,4.6,20.9,3160,1118,2042,6.1,17.3,655,3.6,34.6,0,140,140,781
1986,49,g) 6 to 10,4723,5196,54045,55129,255,4.7,697,12.9,9759,1612,8147,2.9,17.7,11927,4963,6964,9,21.6,-2168,-3.9,35.4,0,450,450,3064
1986,49,l) Left Censored,8551,12538,322001,323616,648,5.1,1110,8.7,43115,13901,29214,4.3,13.3,46347,12807,33540,4,14.3,-3232,-1,26.6,0,516,519,4321
1986,50,a) 0,1878,1884,9475,4743,1880,199.6,0,0,9464,9464,0,199.5,199.5,0,0,0,0,0,9464,199.5,0,0,,,
1986,50,b) 1,1430,1445,8757,8520,24,1.5,308,19.3,2543,307,2236,3.6,29.8,2068,1008,1060,11.8,24.3,475,5.5,48.6,0,212,212,818
1986,50,c) 2,1193,1221,7992,7907,48,3.7,204,15.6,1854,217,1637,2.7,23.4,1683,780,903,9.9,21.3,171,2.1,42.6,0,157,157,667
1986,50,d) 3,829,842,4954,5114,29,3.2,144,16,964,106,858,2.1,18.9,1283,806,477,15.8,25.1,-319,-6.2,37.8,0,118,118,697
1986,50,e) 4,735,753,6132,6106,21,2.6,116,14.4,1158,108,1050,1.8,19,1105,555,550,9.1,18.1,53,0.9,36.2,0,86,86,420
1986,50,f) 5,648,675,5668,5783,20,2.8,94,13.2,743,41,702,0.7,12.8,973,399,574,6.9,16.8,-230,-4,25.6,0,68,68,295
1986,50,g) 6 to 10,2261,2457,23827,23783,107,4.2,310,12.1,3916,511,3405,2.1,16.5,3828,1733,2095,7.3,16.1,88,0.4,32.2,0,214,214,1315
1986,50,l) Left Censored,4794,5962,133287,132384,209,3.4,447,7.3,14743,3186,11557,2.4,11.1,12937,4072,8865,3.1,9.8,1806,1.3,19.6,0,265,265,1513
1986,51,a) 0,12716,12805,75942,38084,12755,199.2,0,0,75716,75716,0,198.8,198.8,0,0,0,0,0,75716,198.8,0,0,,,
1986,51,b) 1,9841,10023,96339,85805,208,1.9,2267,20.4,38872,6370,32502,7.4,45.3,17803,9301,8502,10.8,20.7,21069,24.6,41.4,0,1627,1627,7018
1986,51,c) 2,8216,8382,64622,66502,272,3,1364,15.2,14311,1780,12531,2.7,21.5,18070,8087,9983,12.2,27.2,-3759,-5.7,43,0,1002,1002,6327
1986,51,d) 3,5342,5496,49833,50066,184,3.1,871,14.9,10690,1809,8881,3.6,21.4,11156,5667,5489,11.3,22.3,-466,-0.9,42.8,0,646,652,4406
1986,51,e) 4,4757,5001,54520,55063,173,3.3,699,13.3,10235,1310,8925,2.4,18.6,11321,5454,5867,9.9,20.6,-1086,-2,37.2,0,489,491,3636
1986,51,f) 5,4343,4636,57517,57673,194,4,587,12.2,9665,1905,7760,3.3,16.8,9977,4316,5661,7.5,17.3,-312,-0.5,33.6,0,389,389,2254
1986,51,g) 6 to 10,15149,17234,204911,202681,704,4,1814,10.2,38064,9050,29014,4.5,18.8,33604,12204,21400,6,16.6,4460,2.2,33.2,0,1176,1179,7151
1986,51,l) Left Censored,32657,50997,1382584,1360824,2615,5.1,3512,6.8,189876,60285,129591,4.4,14,146355,44412,101943,3.3,10.8,43521,3.2,21.6,0,1733,1737,11686
1986,53,a) 0,11527,11660,61049,30585,11627,199.4,0,0,60929,60929,0,199.2,199.2,0,0,0,0,0,60929,199.2,0,0,,,
1986,53,b) 1,8529,8657,59419,56958,182,1.9,2334,23.7,20716,4822,15894,8.5,36.4,15793,9063,6730,15.9,27.7,4923,8.7,55.4,0,1631,1635,6649
1986,53,c) 2,7670,7849,57395,59198,377,4.4,1674,19.6,13503,2211,11292,3.7,22.8,17109,9491,7618,16,28.9,-3606,-6.1,45.6,0,1234,1234,7865
1986,53,d) 3,5497,5795,56924,58213,289,4.7,1027,16.6,11788,3484,8304,6,20.2,14365,6298,8067,10.8,24.7,-2577,-4.5,40.4,0,788,788,4438
1986,53,e) 4,4868,5086,44105,45048,192,3.5,807,14.9,8730,1259,7471,2.8,19.4,10616,5264,5352,11.7,23.6,-1886,-4.2,38.8,0,567,567,3725
1986,53,f) 5,4434,4682,44807,44557,204,4.1,646,13.1,9361,1359,8002,3.1,21,8861,3969,4892,8.9,19.9,500,1.1,39.8,0,475,476,3163
1986,53,g) 6 to 10,15860,17563,176790,182046,891,4.9,2299,12.6,30954,5012,25942,2.8,17,41466,12427,29039,6.8,22.8,-10512,-5.8,34,0,1453,1453,7874
1986,53,l) Left Censored,27237,39626,910008,903798,1943,4.8,3374,8.4,134379,32514,101865,3.6,14.9,121959,43226,78733,4.8,13.5,12420,1.4,27,0,1663,1700,13504
1986,54,a) 0,2915,2934,15447,7730,2925,199.4,0,0,15434,,,,199.7,0,0,0,0,0,15434,199.7,0,1,,,
1986,54,b) 1,2291,2330,26275,22177,55,2.1,682,25.6,13739,,,,62,5543,2887,2656,13,25,8196,37,50,1,516,518,2275
1986,54,c) 2,2173,2195,13494,14025,68,2.9,357,15.2,2512,265,2247,1.9,17.9,3574,1929,1645,13.8,25.5,-1062,-7.6,35.8,0,273,273,1509
1986,54,d) 3,1316,1354,10138,10695,53,3.7,233,16.1,1687,224,1463,2.1,15.8,2801,1444,1357,13.5,26.2,-1114,-10.4,31.6,0,160,160,1027
1986,54,e) 4,1312,1353,13983,14369,45,3.1,224,15.5,2409,145,2264,1,16.8,3180,1466,1714,10.2,22.1,-771,-5.3,33.6,0,158,158,1184
1986,54,f) 5,1191,1219,11659,11878,42,3.3,174,13.5,1753,209,1544,1.8,14.8,2191,1116,1075,9.4,18.4,-438,-3.6,29.6,0,126,126,643
1986,54,g) 6 to 10,4382,4920,43352,43802,239,4.7,603,11.8,7006,2059,4947,4.7,16,7905,3180,4725,7.3,18,-899,-2,32,0,361,361,1618
1986,54,l) Left Censored,11629,15902,313774,321381,569,3.5,1381,8.5,34600,9620,24980,3,10.8,49814,21274,28540,6.6,15.5,-15214,-4.7,21.6,0,708,712,4173
1986,55,a) 0,7422,7493,44023,22012,7493,200,0,0,44023,44023,0,200,200,0,0,0,0,0,44023,200,0,0,,,
1986,55,b) 1,6198,6286,43608,44462,129,1.7,2264,30.2,14288,4524,9764,10.2,32.1,15995,11971,4024,26.9,36,-1707,-3.9,64.2,0,1198,1198,6187
1986,55,c) 2,5745,5835,44991,47834,155,2.3,1568,23.7,8653,1463,7190,3.1,18.1,14339,9625,4714,20.1,30,-5686,-11.9,36.2,0,862,862,4639
1986,55,d) 3,3842,3959,34150,37059,101,2.2,1082,24,5785,977,4808,2.6,15.6,11603,7645,3958,20.6,31.3,-5818,-15.7,31.2,0,566,566,3628
1986,55,e) 4,3705,3894,35887,37587,109,2.5,871,20.2,5299,831,4468,2.2,14.1,8698,5515,3183,14.7,23.1,-3399,-9,28.2,0,470,470,2428
1986,55,f) 5,3574,3733,36649,38634,97,2.4,724,17.8,5476,827,4649,2.1,14.2,9446,5368,4078,13.9,24.4,-3970,-10.2,28.4,0,380,380,2342
1986,55,g) 6 to 10,14232,15790,150096,153742,567,3.4,2294,13.7,23503,4845,18658,3.2,15.3,30794,16094,14700,10.5,20,-7291,-4.7,30.6,0,1354,1358,7816
1986,55,l) Left Censored,35898,48102,1213337,1218213,1774,3.6,4070,8.2,137495,33986,103509,2.8,11.3,147247,52900,94347,4.3,12.1,-9752,-0.8,22.6,0,2084,2115,15138
1986,56,a) 0,1170,1173,6014,3010,1170,199.5,0,0,6008,,,,199.6,0,0,0,0,0,6008,199.6,0,1,,,
1986,56,b) 1,1050,1056,6291,6516,14,1.2,302,25,1872,,,,28.7,2322,1445,877,22.2,35.6,-450,-6.9,57.4,1,215,215,1034
1986,56,c) 2,903,908,6195,6609,43,4.3,214,21.3,1104,274,830,4.1,16.7,1931,980,951,14.8,29.2,-827,-12.5,33.4,0,163,163,752
1986,56,d) 3,732,800,6351,6606,52,6,188,21.5,1517,503,1014,7.6,23,2027,803,1224,12.2,30.7,-510,-7.7,46,0,152,152,704
1986,56,e) 4,769,815,5228,5671,41,4.7,145,16.7,842,217,625,3.8,14.8,1728,827,901,14.6,30.5,-886,-15.7,29.6,0,111,111,648
1986,56,f) 5,725,752,5028,5388,23,2.8,137,16.9,751,136,615,2.5,13.9,1471,683,788,12.7,27.3,-720,-13.4,27.8,0,101,101,481
1986,56,g) 6 to 10,2270,2511,21089,22130,116,4.4,342,13,3209,803,2406,3.6,14.5,5291,2045,3246,9.2,23.9,-2082,-9.4,29,0,236,236,1193
1986,56,l) Left Censored,3747,5006,75969,77735,209,4,516,10,9630,2856,6774,3.7,12.4,13161,3671,9490,4.7,16.9,-3531,-4.5,24.8,0,261,262,1722
1987,01,a) 0,7929,8124,54316,30775,8078,198.9,0,0,47082,47082,0,153,153,0,0,0,0,0,47082,153,0,0,,,
1987,01,b) 1,5688,5864,49991,50067,126,1.9,1652,24.6,13872,1681,12191,3.4,27.7,14023,7309,6714,14.6,28,-151,-0.3,55.4,0,1280,1280,5420
1987,01,c) 2,4573,4742,38447,40589,265,5.1,1060,20.4,8269,2016,6253,5,20.4,12553,6084,6469,15,30.9,-4284,-10.5,40.8,0,769,769,4029
1987,01,d) 3,4606,4748,41236,42705,194,3.8,737,14.6,8568,1026,7542,2.4,20.1,11506,4858,6648,11.4,26.9,-2938,-6.8,40.2,0,550,550,3082
1987,01,e) 4,2845,3019,26310,27038,161,5.1,444,14,5277,1304,3973,4.8,19.5,6733,2996,3737,11.1,24.9,-1456,-5.4,39,0,355,355,2023
1987,01,f) 5,2482,2651,29220,29643,99,3.5,361,12.9,6082,835,5247,2.8,20.5,6927,3236,3691,10.9,23.4,-845,-2.9,41,0,266,267,2454
1987,01,g) 6 to 10,11808,13594,155440,158457,688,4.9,1550,11,26337,5142,21195,3.2,16.6,32370,10667,21703,6.7,20.4,-6033,-3.8,33.2,0,1014,1022,5638
1987,01,l) Left Censored,20327,31071,812886,820965,1702,5.4,2832,8.9,101123,26635,74488,3.2,12.3,117281,37195,80086,4.5,14.3,-16158,-2,24.6,0,1326,1360,11064
1987,02,a) 0,1383,1420,9033,5324,1402,197.5,0,0,7419,7419,0,139.4,139.4,0,0,0,0,0,7419,139.4,0,0,,,
1987,02,b) 1,1121,1155,8743,9639,26,1.8,553,38.3,2188,327,1861,3.4,22.7,3980,2118,1862,22,41.3,-1792,-18.6,45.4,0,423,423,1740
1987,02,c) 2,975,1019,7403,8131,77,6.6,325,28.1,1849,462,1387,5.7,22.7,3304,1753,1551,21.6,40.6,-1455,-17.9,45.4,0,250,250,1475
1987,02,d) 3,854,888,5724,6655,61,6.1,251,25.2,1216,445,771,6.7,18.3,3078,1698,1380,25.5,46.3,-1862,-28,36.6,0,201,201,1490
1987,02,e) 4,671,734,4919,5539,53,6.6,186,23.1,1167,274,893,4.9,21.1,2407,1041,1366,18.8,43.5,-1240,-22.4,42.2,0,144,146,813
1987,02,f) 5,538,579,4282,4792,26,4.1,136,21.4,777,172,605,3.6,16.2,1797,942,855,19.7,37.5,-1020,-21.3,32.4,0,91,91,604
1987,02,g) 6 to 10,2036,2308,24034,25883,123,5,381,15.6,3686,795,2891,3.1,14.2,7383,2918,4465,11.3,28.5,-3697,-14.3,28.4,0,214,220,2010
1987,02,l) Left Censored,2331,3581,75808,79044,246,6.7,449,12.2,10710,3039,7671,3.8,13.5,17182,5633,11549,7.1,21.7,-6472,-8.2,27,0,130,136,1001
1987,04,a) 0,9470,9733,63689,35504,9651,198.3,0,0,56370,56370,0,158.8,158.8,0,0,0,0,0,56370,158.8,0,0,,,
1987,04,b) 1,6824,7048,60534,61808,145,1.8,2164,26.5,17722,2478,15244,4,28.7,20270,11607,8663,18.8,32.8,-2548,-4.1,57.4,0,1669,1670,8993
1987,04,c) 2,5605,5778,53864,57927,390,6.2,1394,22,12361,2902,9459,5,21.3,20487,10860,9627,18.7,35.4,-8126,-14.1,42.6,0,1027,1027,6534
1987,04,d) 3,4669,4948,43859,47417,316,5.9,986,18.6,10504,2746,7758,5.8,22.2,17620,8831,8789,18.6,37.2,-7116,-15,44.4,0,730,730,6191
1987,04,e) 4,3454,3868,47604,48658,292,7.2,617,15.2,10106,3489,6617,7.2,20.8,12213,5577,6636,11.5,25.1,-2107,-4.3,41.6,0,458,462,3704
1987,04,f) 5,3235,3536,44017,43807,171,4.6,555,14.8,9995,1374,8621,3.1,22.8,9575,4211,5364,9.6,21.9,420,0.9,43.8,0,402,404,3138
1987,04,g) 6 to 10,11840,13497,164470,170479,852,6.1,1732,12.4,29285,6404,22881,3.8,17.2,41302,15399,25903,9,24.2,-12017,-7,34.4,0,1075,1104,8962
1987,04,l) Left Censored,13221,23094,655534,658097,1728,7.4,2214,9.5,98941,39764,59177,6,15,104068,41446,62622,6.3,15.8,-5127,-0.8,30,0,824,846,7877
1987,05,a) 0,4847,4926,29153,16358,4884,198.3,0,0,25591,25591,0,156.4,156.4,0,0,0,0,0,25591,156.4,0,0,,,
1987,05,b) 1,3490,3570,29976,30506,65,1.6,1111,26.8,7353,845,6508,2.8,24.1,8413,5104,3309,16.7,27.6,-1060,-3.5,48.2,0,937,937,4506
1987,05,c) 2,3024,3099,27895,27986,182,5.4,681,20.1,7880,1599,6281,5.7,28.2,8062,4244,3818,15.2,28.8,-182,-0.6,56.4,0,553,554,3094
1987,05,d) 3,3036,3112,18967,20115,150,4.5,501,15.1,3865,1053,2812,5.2,19.2,6160,3241,2919,16.1,30.6,-2295,-11.4,38.4,0,423,423,2183
1987,05,e) 4,2014,2121,18128,17963,98,4.4,295,13.2,4272,872,3400,4.9,23.8,3941,1864,2077,10.4,21.9,331,1.9,43.8,0,224,224,1374
1987,05,f) 5,1760,1823,16151,16782,58,3,279,14.3,2824,449,2375,2.7,16.8,4085,2038,2047,12.1,24.3,-1261,-7.5,33.6,0,217,219,1315
1987,05,g) 6 to 10,8379,9263,91416,93073,423,4.4,1145,11.9,15826,2698,13128,2.9,17,19139,8522,10617,9.2,20.6,-3313,-3.6,34,0,762,770,5278
1987,05,l) Left Censored,13348,18554,471036,476564,982,5.2,1648,8.7,52727,13473,39254,2.8,11.1,63783,21582,42201,4.5,13.4,-11056,-2.3,22.2,0,830,850,8434
1987,06,a) 0,70629,72428,475088,248494,72012,198.9,0,0,453188,453188,0,182.4,182.4,0,0,0,0,0,453188,182.4,0,0,,,
1987,06,b) 1,51176,52923,515848,513424,1073,1.8,13849,23,141762,16148,125614,3.1,27.6,136913,77653,59260,15.1,26.7,4849,0.9,53.4,0,10429,10436,58685
1987,06,c) 2,42258,43806,395892,407808,2979,6.3,8924,18.9,109044,22685,86359,5.6,26.7,132876,73468,59408,18,32.6,-23832,-5.9,53.4,0,6612,6628,43674
1987,06,d) 3,36407,38050,369549,374124,2242,5.6,6318,15.7,93134,16683,76451,4.5,24.9,102284,52345,49939,14,27.3,-9150,-2.4,49.8,0,4766,4771,41525
1987,06,e) 4,27521,29648,373088,374412,1752,5.6,4395,14.1,83680,15427,68253,4.1,22.3,86328,33747,52581,9,23.1,-2648,-0.8,44.6,0,3324,3353,24758
1987,06,f) 5,26703,28678,317958,317502,1415,4.7,4137,13.7,68855,11418,57437,3.6,21.7,67942,30019,37923,9.5,21.4,913,0.3,42.8,0,2809,2859,18470
1987,06,g) 6 to 10,112110,126280,1560314,1567561,7256,5.5,15665,12,305007,64065,240942,4.1,19.5,319501,130965,188536,8.4,20.4,-14494,-0.9,39,0,9786,9961,78281
1987,06,l) Left Censored,131834,209977,6017348,6080420,12401,5.8,21036,9.8,885666,246068,639598,4,14.6,1011811,389428,622383,6.4,16.6,-126145,-2,29.2,0,9294,9564,99061
1987,08,a) 0,9638,9869,59653,31485,9804,198.7,0,0,56336,56336,0,178.9,178.9,0,0,0,0,0,56336,178.9,0,0,,,
1987,08,b) 1,7067,7221,55371,59466,118,1.4,2482,29.2,14548,1662,12886,2.8,24.5,22738,13982,8756,23.5,38.2,-8190,-13.7,49,0,1923,1923,11235
1987,08,c) 2,6256,6435,50303,53788,389,5.5,1547,21.9,12201,3433,8768,6.4,22.7,19171,10038,9133,18.7,35.6,-6970,-12.9,45.4,0,1225,1237,8039
1987,08,d) 3,5347,5563,42965,46365,303,5,1214,20.1,9146,2962,6184,6.4,19.7,15945,7406,8539,16,34.4,-6799,-14.7,39.4,0,937,937,5700
1987,08,e) 4,3901,4415,58324,61604,303,6.5,810,17.3,10975,4785,6190,7.8,17.8,17534,9255,8279,15,28.5,-6559,-10.7,35.6,0,604,608,7763
1987,08,f) 5,3617,3831,32991,35109,161,3.9,717,17.4,5715,1099,4616,3.1,16.3,9950,4747,5203,13.5,28.3,-4235,-12,32.6,0,513,517,3310
1987,08,g) 6 to 10,14830,16581,161624,169788,966,5.6,2476,14.2,28132,7198,20934,4.2,16.6,44460,18737,25723,11,26.2,-16328,-9.6,33.2,0,1588,1620,10932
1987,08,l) Left Censored,18119,27997,695915,721636,1831,6.4,3249,11.3,92428,33006,59422,4.6,12.8,143872,54917,88955,7.6,19.9,-51444,-7.1,25.6,0,1197,1244,10670
1987,09,a) 0,8605,8754,51165,26866,8689,198.5,0,0,48599,48599,0,180.9,180.9,0,0,0,0,0,48599,180.9,0,0,,,
1987,09,b) 1,6221,6354,54708,51653,93,1.3,1248,17.8,17205,2622,14583,5.1,33.3,11095,4913,6182,9.5,21.5,6110,11.8,43,0,930,931,3579
1987,09,c) 2,5107,5222,42335,42466,270,4.9,833,15,9927,1756,8171,4.1,23.4,10189,4876,5313,11.5,24,-262,-0.6,46.8,0,624,624,3568
1987,09,d) 3,4360,4483,40659,39984,199,4.2,579,12.3,10043,1350,8693,3.4,25.1,8693,3877,4816,9.7,21.7,1350,3.4,43.4,0,455,455,3310
1987,09,e) 4,3162,3299,33049,33472,173,5,477,13.8,7384,2014,5370,6,22.1,8229,3195,5034,9.5,24.6,-845,-2.5,44.2,0,367,367,2398
1987,09,f) 5,3012,3164,39123,39164,122,3.7,396,12,5985,769,5216,2,15.3,6066,2718,3348,6.9,15.5,-81,-0.2,30.6,0,305,306,2037
1987,09,g) 6 to 10,12737,13943,164472,163231,591,4.1,1537,10.6,28826,4470,24356,2.7,17.7,26343,10109,16234,6.2,16.1,2483,1.6,32.2,0,1061,1067,7316
1987,09,l) Left Censored,25147,33430,1064023,1063158,1620,4.7,2915,8.5,125354,30667,94687,2.9,11.8,123624,44262,79362,4.2,11.6,1730,0.2,23.2,0,1541,1556,14491
1987,10,a) 0,1532,1563,11106,6426,1553,198.7,0,0,9361,9361,0,145.7,145.7,0,0,0,0,0,9361,145.7,0,0,,,
1987,10,b) 1,1118,1161,7716,16388,42,3.2,281,21.7,2871,272,2599,1.7,17.5,20214,1218,18996,7.4,123.3,-17343,-105.8,35,0,210,210,992
1987,10,c) 2,932,955,7466,7470,59,5.8,151,15,1901,489,1412,6.5,25.4,1908,912,996,12.2,25.5,-7,-0.1,50.8,0,117,117,648
1987,10,d) 3,835,859,8293,8172,44,4.9,120,13.4,1765,251,1514,3.1,21.6,1523,883,640,10.8,18.6,242,3,37.2,0,86,86,416
1987,10,e) 4,591,622,5822,5815,28,4.3,80,12.3,1138,210,928,3.6,19.6,1124,339,785,5.8,19.3,14,0.3,38.6,0,54,54,260
1987,10,f) 5,515,529,5699,5636,29,5.3,63,11.5,1086,129,957,2.3,19.3,960,319,641,5.7,17,126,2.3,34,0,53,53,285
1987,10,g) 6 to 10,2220,2471,30209,30440,122,4.8,283,11.1,5232,718,4514,2.4,17.2,5694,2369,3325,7.8,18.7,-462,-1.5,34.4,0,174,175,1363
1987,10,l) Left Censored,4409,5985,194469,191934,370,6.1,500,8.3,28888,5276,23612,2.7,15.1,23817,8543,15274,4.5,12.4,5071,2.7,24.8,0,234,235,1449
1987,11,a) 0,1418,1441,10208,5156,1433,198.9,0,0,10105,10105,0,196,196,0,0,0,0,0,10105,196,0,0,,,
1987,11,b) 1,1152,1167,14578,14423,23,1.8,244,18.9,3293,354,2939,2.5,22.8,2983,1631,1352,11.3,20.7,310,2.1,41.4,0,179,179,1305
1987,11,c) 2,1009,1024,15560,14918,66,6.1,161,15,3719,429,3290,2.9,24.9,2435,1193,1242,8,16.3,1284,8.6,32.6,0,128,128,953
1987,11,d) 3,950,971,10721,10964,46,4.5,125,12.3,1933,355,1578,3.2,17.6,2418,988,1430,9,22.1,-485,-4.5,35.2,0,101,101,776
1987,11,e) 4,837,861,7919,8438,30,3.3,121,13.3,1847,358,1489,4.2,21.9,2885,1437,1448,17,34.2,-1038,-12.3,43.8,0,84,84,1186
1987,11,f) 5,712,734,8853,8463,34,4.4,114,14.6,2377,936,1441,11.1,28.1,1596,692,904,8.2,18.9,781,9.2,37.8,0,75,75,398
1987,11,g) 6 to 10,2840,3114,68554,66118,158,4.9,358,11.1,12207,2814,9393,4.3,18.5,7334,2436,4898,3.7,11.1,4873,7.4,22.2,0,182,183,1073
1987,11,l) Left Censored,5910,7908,271803,271107,415,5.1,775,9.6,34241,8811,25430,3.3,12.6,32849,12028,20821,4.4,12.1,1392,0.5,24.2,0,316,325,3155
1987,12,a) 0,38634,39511,239251,124427,39305,199,0,0,229648,229648,0,184.6,184.6,0,0,0,0,0,229648,184.6,0,0,,,
1987,12,b) 1,27373,28122,225438,229044,466,1.4,8347,25.7,64878,5960,58918,2.6,28.3,72089,39257,32832,17.1,31.5,-7211,-3.2,56.6,0,6714,6717,31098
1987,12,c) 2,22018,22784,185920,195191,1387,5.6,5170,20.8,43538,8932,34606,4.6,22.3,62079,30484,31595,15.6,31.8,-18541,-9.5,44.6,0,4250,4252,25862
1987,12,d) 3,18402,19080,166535,174056,1032,5.1,3443,16.9,35949,7221,28728,4.1,20.7,50990,25951,25039,14.9,29.3,-15041,-8.6,41.4,0,2802,2803,20740
1987,12,e) 4,13710,14462,130112,135970,750,4.9,2470,16.1,28652,6602,22050,4.9,21.1,40367,20264,20103,14.9,29.7,-11715,-8.6,42.2,0,1949,1958,15165
1987,12,f) 5,12804,13543,143175,147120,544,3.8,1953,13.7,25484,3137,22347,2.1,17.3,33374,13776,19598,9.4,22.7,-7890,-5.4,34.6,0,1476,1489,9931
1987,12,g) 6 to 10,47281,53188,587667,602135,2832,5.1,7022,12.7,109514,25427,84087,4.2,18.2,138451,57123,81328,9.5,23,-28937,-4.8,36.4,0,4711,4788,36701
1987,12,l) Left Censored,55395,95383,2374626,2377185,6706,6.9,9026,9.3,359072,129173,229899,5.4,15.1,364191,133560,230631,5.6,15.3,-5119,-0.2,30.2,0,3894,3974,35832
1987,13,a) 0,14635,15081,104470,57232,14982,198.7,0,0,94477,94477,0,165.1,165.1,0,0,0,0,0,94477,165.1,0,0,,,
1987,13,b) 1,10964,11267,107764,106570,204,1.6,3105,24.1,28714,2934,25780,2.8,26.9,26326,15416,10910,14.5,24.7,2388,2.2,49.4,0,2417,2417,12321
1987,13,c) 2,9020,9309,76565,79795,563,5.6,1917,19.1,20939,5471,15468,6.9,26.2,27399,15448,11951,19.4,34.3,-6460,-8.1,52.4,0,1481,1481,9008
1987,13,d) 3,7865,8198,75650,77947,450,5.2,1312,15.2,16489,4060,12429,5.2,21.2,21083,10498,10585,13.5,27,-4594,-5.8,42.4,0,1027,1027,7824
1987,13,e) 4,5389,5787,53775,54911,357,5.9,893,14.7,12842,3894,8948,7.1,23.4,15114,6688,8426,12.2,27.5,-2272,-4.1,46.8,0,674,675,5104
1987,13,f) 5,4807,5205,57382,59055,230,4.2,690,12.7,10717,2284,8433,3.9,18.1,14062,5552,8510,9.4,23.8,-3345,-5.7,36.2,0,474,476,3812
1987,13,g) 6 to 10,19816,22468,271517,275314,1190,5.1,2662,11.4,50309,14476,35833,5.3,18.3,57903,23368,34535,8.5,21,-7594,-2.7,36.6,0,1683,1699,12572
1987,13,l) Left Censored,31740,52449,1551301,1554204,3418,6.4,4772,9,225573,75207,150366,4.8,14.5,231378,75621,155757,4.9,14.9,-5805,-0.4,29,0,1964,2019,16812
1987,15,a) 0,2309,2403,17859,10271,2381,198.2,0,0,15177,15177,0,147.8,147.8,0,0,0,0,0,15177,147.8,0,0,,,
1987,15,b) 1,1624,1699,17022,16254,59,3.1,422,22.2,5090,1074,4016,6.6,31.3,3554,2110,1444,13,21.9,1536,9.4,43.8,0,339,341,1816
1987,15,c) 2,1516,1581,12002,12572,109,6.5,256,15.3,2745,731,2014,5.8,21.8,3884,1686,2198,13.4,30.9,-1139,-9.1,43.6,0,207,207,1474
1987,15,d) 3,1124,1175,10088,10265,66,5.3,187,15.1,1927,512,1415,5,18.8,2280,1110,1170,10.8,22.2,-353,-3.4,37.6,0,151,151,980
1987,15,e) 4,1110,1167,9818,9883,77,6.3,174,14.3,1846,397,1449,4,18.7,1976,1021,955,10.3,20,-130,-1.3,37.4,0,137,137,781
1987,15,f) 5,1037,1091,10487,10286,57,5,155,13.5,2432,420,2012,4.1,23.6,2030,950,1080,9.2,19.7,402,3.9,39.4,0,105,106,618
1987,15,g) 6 to 10,4373,5032,57192,59056,296,5.7,535,10.4,10227,3304,6923,5.6,17.3,13955,3802,10153,6.4,23.6,-3728,-6.3,34.6,0,323,328,2091
1987,15,l) Left Censored,6406,9666,227278,224697,477,4.8,864,8.7,36897,8462,28435,3.8,16.4,31735,14188,17547,6.3,14.1,5162,2.3,28.2,0,359,362,3261
1987,16,a) 0,2189,2235,13057,7346,2210,197.8,0,0,11423,11423,0,155.5,155.5,0,0,0,0,0,11423,155.5,0,0,,,
1987,16,b) 1,1682,1709,10437,10789,30,1.6,387,20.2,2945,379,2566,3.5,27.3,3648,2107,1541,19.5,33.8,-703,-6.5,54.6,0,275,275,1407
1987,16,c) 2,1496,1543,9504,10033,91,5.5,283,17,2258,596,1662,5.9,22.5,3315,1527,1788,15.2,33,-1057,-10.5,45,0,201,201,1155
1987,16,d) 3,1320,1363,8887,9485,84,5.9,205,14.4,1720,441,1279,4.6,18.1,2916,1256,1660,13.2,30.7,-1196,-12.6,36.2,0,147,147,967
1987,16,e) 4,963,1062,9109,9652,60,5.4,154,13.8,1454,420,1034,4.4,15.1,2540,1085,1455,11.2,26.3,-1086,-11.2,30.2,0,116,116,568
1987,16,f) 5,826,878,6636,7336,26,2.7,160,16.9,1019,119,900,1.6,13.9,2419,1297,1122,17.7,33,-1400,-19.1,27.8,0,99,100,1013
1987,16,g) 6 to 10,4034,4391,39254,40726,217,4.7,548,12,6791,1145,5646,2.8,16.7,9734,4627,5107,11.4,23.9,-2943,-7.2,33.4,0,364,367,3478
1987,16,l) Left Censored,5865,8419,156983,159254,450,5.2,900,10.4,19958,5787,14171,3.6,12.5,24500,8112,16388,5.1,15.4,-4542,-2.9,25,0,333,342,1909
1987,17,a) 0,21047,21554,140514,75461,21424,198.8,0,0,130106,130106,0,172.4,172.4,0,0,0,0,0,130106,172.4,0,0,,,
1987,17,b) 1,15836,16337,147530,143819,340,1.9,3425,18.9,39435,5637,33798,3.9,27.4,32013,17204,14809,12,22.3,7422,5.1,44.6,0,2485,2485,11997
1987,17,c) 2,14170,14611,130971,132299,770,5,2375,15.3,28926,6945,21981,5.2,21.9,31582,15441,16141,11.7,23.9,-2656,-2,43.8,0,1837,1838,10840
1987,17,d) 3,12569,13077,118642,124439,625,4.6,1816,13.2,22172,5272,16900,4.2,17.8,33765,13567,20198,10.9,27.1,-11593,-9.3,35.6,0,1376,1377,8272
1987,17,e) 4,9092,9635,103666,105033,506,5,1361,13.5,20466,5919,14547,5.6,19.5,23200,9945,13255,9.5,22.1,-2734,-2.6,39,0,1024,1028,6426
1987,17,f) 5,8905,9391,104148,105257,348,3.5,1226,12.4,18268,2477,15791,2.4,17.4,20485,9349,11136,8.9,19.5,-2217,-2.1,34.8,0,908,912,6886
1987,17,g) 6 to 10,37417,41422,488014,486051,2027,4.7,4843,11.3,85480,18309,67171,3.8,17.6,81553,32966,48587,6.8,16.8,3927,0.8,33.6,0,3096,3134,18870
1987,17,l) Left Censored,72987,102956,2995974,3060247,4893,4.6,9840,9.3,342227,90598,251629,3,11.2,470774,176285,294489,5.8,15.4,-128547,-4.2,22.4,0,4644,4702,41515
1987,18,a) 0,10081,10329,68773,37371,10276,199,0,0,62805,62805,0,168.1,168.1,0,0,0,0,0,62805,168.1,0,0,,,
1987,18,b) 1,7737,7959,69694,66695,173,2,1726,19.5,22115,2973,19142,4.5,33.2,16117,8320,7797,12.5,24.2,5998,9,48.4,0,1373,1373,6575
1987,18,c) 2,6709,6970,78343,69588,369,5,1211,16.3,33375,2917,30458,4.2,48,15864,7665,8199,11,22.8,17511,25.2,45.6,0,956,957,5755
1987,18,d) 3,6168,6496,59341,60095,353,5.2,918,13.5,13716,4727,8989,7.9,22.8,15223,7528,7695,12.5,25.3,-1507,-2.5,45.6,0,703,704,5441
1987,18,e) 4,4275,4426,44598,44597,145,3.1,594,12.7,8996,1668,7328,3.7,20.2,8994,4949,4045,11.1,20.2,2,0,40.4,0,484,484,3825
1987,18,f) 5,3679,3967,40266,40458,166,4,527,12.7,7600,1435,6165,3.5,18.8,7983,3913,4070,9.7,19.7,-383,-0.9,37.6,0,398,403,2991
1987,18,g) 6 to 10,16939,19177,213428,213991,930,4.7,2069,10.5,37747,7713,30034,3.6,17.6,38873,17621,21252,8.2,18.2,-1126,-0.6,35.2,0,1360,1372,10468
1987,18,l) Left Censored,33246,49486,1385961,1390348,2503,5,4463,8.8,167591,42790,124801,3.1,12.1,176367,60972,115395,4.4,12.7,-8776,-0.6,24.2,0,2051,2082,15507
1987,19,a) 0,5028,5158,32903,18125,5126,198.8,0,0,29557,29557,0,163.1,163.1,0,0,0,0,0,29557,163.1,0,0,,,
1987,19,b) 1,3718,3804,36206,36995,77,1.8,966,22.4,6967,1271,5696,3.4,18.8,8544,5207,3337,14.1,23.1,-1577,-4.3,37.6,0,761,763,4219
1987,19,c) 2,3364,3494,26562,26978,198,5.3,648,17.3,5363,1646,3717,6.1,19.9,6194,2932,3262,10.9,23,-831,-3.1,39.8,0,515,516,2242
1987,19,d) 3,3601,3701,24485,24467,187,4.8,532,13.7,6125,1402,4723,5.7,25,6089,2616,3473,10.7,24.9,36,0.1,49.8,0,388,388,1845
1987,19,e) 4,2333,2573,20422,20940,115,4.2,401,14.7,3456,769,2687,3.7,16.5,4491,2479,2012,11.8,21.4,-1035,-4.9,33,0,292,294,1585
1987,19,f) 5,2199,2306,19875,20137,100,4.1,355,14.6,3523,1050,2473,5.2,17.5,4047,2041,2006,10.1,20.1,-524,-2.6,35,0,242,243,1484
1987,19,g) 6 to 10,11042,12557,105962,106359,658,5.1,1410,10.9,17476,4274,13202,4,16.4,18269,7377,10892,6.9,17.2,-793,-0.8,32.8,0,934,947,4865
1987,19,l) Left Censored,22206,30770,619552,625781,1342,4.3,2864,9.1,71755,18674,53081,3,11.5,84215,28538,55677,4.6,13.5,-12460,-2,23,0,1354,1388,8731
1987,20,a) 0,5290,5394,36943,20827,5342,198.1,0,0,32232,32232,0,154.8,154.8,0,0,0,0,0,32232,154.8,0,0,,,
1987,20,b) 1,4043,4153,35196,36820,93,2,1192,25,7872,1148,6724,3.1,21.4,11120,6535,4585,17.7,30.2,-3248,-8.8,42.8,0,919,922,4954
1987,20,c) 2,3630,3732,25890,27236,203,5,774,19.1,5361,1282,4079,4.7,19.7,8052,4421,3631,16.2,29.6,-2691,-9.9,39.4,0,614,614,3432
1987,20,d) 3,3503,3617,26739,27813,149,3.8,639,16.5,5299,888,4411,3.2,19.1,7446,3601,3845,12.9,26.8,-2147,-7.7,38.2,0,510,510,3180
1987,20,e) 4,2448,2611,18933,19003,128,4.6,400,14.5,4062,1254,2808,6.6,21.4,4202,1853,2349,9.8,22.1,-140,-0.7,42.8,0,314,316,1394
1987,20,f) 5,2233,2325,19806,20615,90,3.7,333,13.5,2601,434,2167,2.1,12.6,4219,1845,2374,8.9,20.5,-1618,-7.9,25.2,0,251,256,1469
1987,20,g) 6 to 10,9616,10847,99993,102258,518,4.6,1303,11.6,17242,4702,12540,4.6,16.9,21771,9300,12471,9.1,21.3,-4529,-4.4,33.8,0,861,877,6035
1987,20,l) Left Censored,18144,25205,522208,543772,1175,4.5,2491,9.6,61122,17423,43699,3.2,11.2,104250,55484,48766,10.2,19.2,-43128,-8,22.4,0,1170,1196,7437
1987,21,a) 0,6754,6865,42080,22025,6830,199,0,0,40110,40110,0,182.1,182.1,0,0,0,0,0,40110,182.1,0,0,,,
1987,21,b) 1,5127,5275,52746,52706,83,1.4,1035,17.8,11616,1166,10450,2.2,22,11536,6296,5240,11.9,21.9,80,0.1,43.8,0,787,787,4403
1987,21,c) 2,4254,4362,37059,37908,212,4.5,861,18.3,8060,1281,6779,3.4,21.3,9757,5462,4295,14.4,25.7,-1697,-4.4,42.6,0,685,685,4347
1987,21,d) 3,4175,4317,36330,36843,157,3.4,677,14.7,7244,1627,5617,4.4,19.7,8269,3943,4326,10.7,22.4,-1025,-2.7,39.4,0,501,501,2911
1987,21,e) 4,2684,2809,39956,40068,112,3.7,466,15.6,6668,1056,5612,2.6,16.6,6892,3427,3465,8.6,17.2,-224,-0.6,33.2,0,346,346,2094
1987,21,f) 5,2543,2660,26240,26592,88,3.1,388,13.8,4578,782,3796,2.9,17.2,5281,2586,2695,9.7,19.9,-703,-2.7,34.4,0,287,287,1712
1987,21,g) 6 to 10,10413,11495,134451,136169,504,4.2,1424,11.9,22875,4149,18726,3,16.8,26310,10005,16305,7.3,19.3,-3435,-2.5,33.6,0,919,923,5641
1987,21,l) Left Censored,20426,29535,744497,749618,1390,4.6,2760,9.1,84853,21378,63475,2.9,11.3,95095,35777,59318,4.8,12.7,-10242,-1.4,22.6,0,1315,1324,8932
1987,22,a) 0,7121,7285,53429,30222,7216,198.1,0,0,46414,46414,0,153.6,153.6,0,0,0,0,0,46414,153.6,0,0,,,
1987,22,b) 1,5727,5851,45356,48422,99,1.4,1976,28.7,11632,1451,10181,3,24,17763,9407,8356,19.4,36.7,-6131,-12.7,48,0,1643,1644,8024
1987,22,c) 2,4903,5069,37344,41245,262,4.6,1420,24.9,8469,2208,6261,5.4,20.5,16270,8450,7820,20.5,39.4,-7801,-18.9,41,0,1176,1178,7190
1987,22,d) 3,4789,4961,43076,45851,217,4,1013,18.8,7893,2124,5769,4.6,17.2,13442,5815,7627,12.7,29.3,-5549,-12.1,34.4,0,788,793,3987
1987,22,e) 4,3624,3811,31490,34507,187,4.5,735,17.9,6199,2372,3827,6.9,18,12233,5354,6879,15.5,35.5,-6034,-17.5,36,0,552,555,4306
1987,22,f) 5,3692,3960,32523,35349,149,3.5,729,17.1,5238,1398,3840,4,14.8,10889,4977,5912,14.1,30.8,-5651,-16,29.6,0,551,552,3347
1987,22,g) 6 to 10,13977,15424,168416,178990,702,4.3,2628,16,26068,5670,20398,3.2,14.6,47215,19629,27586,11,26.4,-21147,-11.8,29.2,0,1655,1675,11424
1987,22,l) Left Censored,22578,34290,748535,779402,1785,5,4136,11.6,92869,29013,63856,3.7,11.9,154605,55196,99409,7.1,19.8,-61736,-7.9,23.8,0,1745,1796,14479
1987,23,a) 0,3586,3649,21026,11856,3632,199.1,0,0,18341,18341,0,154.7,154.7,0,0,0,0,0,18341,154.7,0,0,,,
1987,23,b) 1,2531,2584,14822,14403,41,1.4,562,19.6,4423,398,4025,2.8,30.7,3584,2137,1447,14.8,24.9,839,5.8,49.8,0,402,402,1539
1987,23,c) 2,1975,2026,13684,13545,100,4.6,351,16.2,3439,808,2631,6,25.4,3161,1467,1694,10.8,23.3,278,2.1,46.6,0,254,254,1102
1987,23,d) 3,1682,1742,15111,14231,95,5.2,232,12.8,4320,762,3558,5.4,30.4,2559,1312,1247,9.2,18,1761,12.4,36,0,176,176,997
1987,23,e) 4,1185,1216,9396,9572,48,3.8,159,12.5,1869,336,1533,3.5,19.5,2220,1316,904,13.7,23.2,-351,-3.7,39,0,120,120,843
1987,23,f) 5,1001,1044,10503,10316,38,3.5,129,11.8,1855,280,1575,2.7,18,1481,719,762,7,14.4,374,3.6,28.8,0,89,89,507
1987,23,g) 6 to 10,4609,5110,53694,53452,281,5.3,558,10.6,10060,2022,8038,3.8,18.8,9576,4638,4938,8.7,17.9,484,0.9,35.8,0,373,375,2456
1987,23,l) Left Censored,7897,10761,254001,252646,585,5.3,930,8.5,31342,8787,22555,3.5,12.4,28631,10943,17688,4.3,11.3,2711,1.1,22.6,0,498,502,3276
1987,24,a) 0,9941,10143,67607,35998,10089,198.9,0,0,63218,63218,0,175.6,175.6,0,0,0,0,0,63218,175.6,0,0,,,
1987,24,b) 1,7670,7856,68904,68422,143,1.6,1834,20.9,18831,1882,16949,2.8,27.5,17866,9594,8272,14,26.1,965,1.4,52.2,0,1389,1389,7371
1987,24,c) 2,6275,6553,60792,61324,390,5.6,1143,16.4,16020,3307,12713,5.4,26.1,17084,8086,8998,13.2,27.9,-1064,-1.8,52.2,0,887,889,6079
1987,24,d) 3,5118,5299,53772,54257,237,4.2,735,13.2,11592,2725,8867,5,21.4,12561,5373,7188,9.9,23.2,-969,-1.8,42.8,0,569,569,4437
1987,24,e) 4,3931,4147,41096,41979,210,4.8,581,13.4,9301,2151,7150,5.1,22.2,11066,5330,5736,12.7,26.4,-1765,-4.2,44.4,0,411,423,3439
1987,24,f) 5,3371,3633,42986,43431,149,3.9,480,12.6,8386,2054,6332,4.7,19.3,9276,4168,5108,9.6,21.4,-890,-2.1,38.6,0,330,333,2306
1987,24,g) 6 to 10,14098,15756,206814,205375,731,4.5,1769,10.9,39869,7339,32530,3.6,19.4,36991,14567,22424,7.1,18,2878,1.4,36,0,1104,1123,8412
1987,24,l) Left Censored,25205,38358,1129134,1114017,2521,6.5,3161,8.2,181834,76520,105314,6.9,16.3,151600,47336,104264,4.2,13.6,30234,2.7,27.2,0,1415,1444,12357
1987,25,a) 0,14570,14878,106909,57708,14776,198.6,0,0,98403,98403,0,170.5,170.5,0,0,0,0,0,98403,170.5,0,0,,,
1987,25,b) 1,10862,11135,99500,103518,151,1.2,2249,18.3,27909,4000,23909,3.9,27,35945,12922,23023,12.5,34.7,-8036,-7.7,54,0,1664,1665,9063
1987,25,c) 2,9008,9238,92185,92358,427,4.3,1547,15.7,21650,3721,17929,4,23.4,21995,10221,11774,11.1,23.8,-345,-0.4,46.8,0,1176,1177,7178
1987,25,d) 3,7482,7717,85631,82421,378,4.7,1020,12.6,24753,3663,21090,4.4,30,18333,6634,11699,8,22.2,6420,7.8,44.4,0,791,791,5541
1987,25,e) 4,5548,5803,60239,60744,295,4.9,775,12.8,12770,2436,10334,4,21,13780,5629,8151,9.3,22.7,-1010,-1.7,42,0,570,570,4307
1987,25,f) 5,5102,5379,78142,78367,211,3.8,664,11.8,12037,2051,9986,2.6,15.4,12486,4766,7720,6.1,15.9,-449,-0.5,30.8,0,492,495,3769
1987,25,g) 6 to 10,20809,23442,336883,336779,1074,4.4,2518,10.4,56480,10885,45595,3.2,16.8,56272,21077,35195,6.3,16.7,208,0.1,33.4,0,1689,1709,13974
1987,25,l) Left Censored,43463,59454,1874660,1903340,2522,4.1,5140,8.4,219973,51418,168555,2.7,11.6,277334,100060,177274,5.3,14.6,-57361,-3,23.2,0,2740,2764,27649
1987,26,a) 0,17328,17716,117382,65227,17597,198.7,0,0,104311,104311,0,159.9,159.9,0,0,0,0,0,104311,159.9,0,0,,,
1987,26,b) 1,12571,12940,112540,109531,227,1.6,2812,19.5,31809,5418,26391,4.9,29,25791,12443,13348,11.4,23.5,6018,5.5,47,0,2121,2121,9789
1987,26,c) 2,10966,11370,98257,100973,600,4.9,1986,16.3,24536,4950,19586,4.9,24.3,29968,14561,15407,14.4,29.7,-5432,-5.4,48.6,0,1544,1546,10111
1987,26,d) 3,9772,10227,97767,98368,533,5,1458,13.6,21077,4552,16525,4.6,21.4,22279,10093,12186,10.3,22.6,-1202,-1.2,42.8,0,1120,1120,7228
1987,26,e) 4,7035,7509,72002,72917,408,5.2,959,12.3,14829,4226,10603,5.8,20.3,16658,6790,9868,9.3,22.8,-1829,-2.5,40.6,0,753,754,5238
1987,26,f) 5,6174,6558,69811,70228,265,3.9,817,11.9,12291,2165,10126,3.1,17.5,13125,5301,7824,7.5,18.7,-834,-1.2,35,0,595,596,3614
1987,26,g) 6 to 10,28076,31831,364313,366205,1654,5,3664,11.1,65974,15023,50951,4.1,18,69758,26687,43071,7.3,19,-3784,-1,36,0,2440,2473,16833
1987,26,l) Left Censored,50665,75383,2244813,2263853,3619,4.7,6465,8.4,260782,64255,196527,2.8,11.5,298862,96124,202738,4.2,13.2,-38080,-1.7,23,0,3121,3181,24014
1987,27,a) 0,8454,8669,58623,31731,8586,198.1,0,0,53784,53784,0,169.5,169.5,0,0,0,0,0,53784,169.5,0,0,,,
1987,27,b) 1,6702,6935,66472,65883,160,2.1,1508,19.6,16157,3283,12874,5,24.5,14978,8029,6949,12.2,22.7,1179,1.8,45.4,0,1153,1153,5955
1987,27,c) 2,5932,6162,56334,56583,307,4.7,1056,16,12777,2618,10159,4.6,22.6,13274,6836,6438,12.1,23.5,-497,-0.9,45.2,0,839,840,5194
1987,27,d) 3,5354,5632,53410,53514,279,4.7,807,13.6,11194,3296,7898,6.2,20.9,11402,5868,5534,11,21.3,-208,-0.4,41.8,0,623,623,4560
1987,27,e) 4,3671,4052,43679,44140,219,5.2,592,13.9,9196,1780,7416,4,20.8,10118,5139,4979,11.6,22.9,-922,-2.1,41.6,0,438,438,3413
1987,27,f) 5,3315,3529,36794,37607,169,4.6,509,13.7,6077,964,5113,2.6,16.2,7702,3641,4061,9.7,20.5,-1625,-4.3,32.4,0,387,391,2942
1987,27,g) 6 to 10,15630,17640,201165,202283,942,5.2,2092,11.5,36540,8806,27734,4.4,18.1,38778,17988,20790,8.9,19.2,-2238,-1.1,36.2,0,1282,1296,9960
1987,27,l) Left Censored,28654,40214,1150199,1160642,2033,5,3570,8.7,143104,35698,107406,3.1,12.3,163990,65650,98340,5.7,14.1,-20886,-1.8,24.6,0,1565,1594,30655
1987,28,a) 0,4620,4697,27569,14969,4658,198.3,0,0,25200,25200,0,168.3,168.3,0,0,0,0,0,25200,168.3,0,0,,,
1987,28,b) 1,3263,3321,28335,29640,45,1.2,1059,27.2,6182,639,5543,2.2,20.9,8792,5113,3679,17.3,29.7,-2610,-8.8,41.8,0,861,864,4317
1987,28,c) 2,2891,2967,22052,23381,172,5.3,653,20.2,4816,1319,3497,5.6,20.6,7474,3672,3802,15.7,32,-2658,-11.4,41.2,0,525,525,2656
1987,28,d) 3,2893,2939,20525,21664,127,4.1,446,14.3,3892,1045,2847,4.8,18,6169,2847,3322,13.1,28.5,-2277,-10.5,36,0,342,342,2239
1987,28,e) 4,1857,1940,14663,14859,93,4.5,300,14.6,3535,1349,2186,9.1,23.8,3927,2061,1866,13.9,26.4,-392,-2.6,47.6,0,222,222,1598
1987,28,f) 5,1655,1726,14742,15605,76,4.2,256,14,1992,421,1571,2.7,12.8,3717,1075,2642,6.9,23.8,-1725,-11,25.6,0,192,192,775
1987,28,g) 6 to 10,7887,8769,92294,93856,416,4.6,1050,11.5,14189,3216,10973,3.4,15.1,17313,6873,10440,7.3,18.4,-3124,-3.3,30.2,0,685,691,3852
1987,28,l) Left Censored,13686,19980,470696,478412,973,4.8,1799,8.8,57520,14450,43070,3,12,72952,21346,51606,4.5,15.2,-15432,-3.2,24,0,886,910,7797
1987,29,a) 0,11320,11578,77024,43188,11472,198.2,0,0,67672,67672,0,156.7,156.7,0,0,0,0,0,67672,156.7,0,0,,,
1987,29,b) 1,8237,8491,69270,70369,206,2.2,2169,22.7,18145,2331,15814,3.3,25.8,20343,11146,9197,15.8,28.9,-2198,-3.1,51.6,0,1690,1693,8824
1987,29,c) 2,7562,7775,63319,65523,337,4,1548,18.3,13758,2428,11330,3.7,21,18165,9781,8384,14.9,27.7,-4407,-6.7,42,0,1239,1242,8415
1987,29,d) 3,6191,6445,53167,54997,282,4.1,998,14.6,9655,2163,7492,3.9,17.6,13315,6404,6911,11.6,24.2,-3660,-6.6,35.2,0,779,779,4281
1987,29,e) 4,4405,4693,44572,45933,259,5.3,616,12.6,8613,2421,6192,5.3,18.8,11334,5090,6244,11.1,24.7,-2721,-5.9,37.6,0,478,483,3169
1987,29,f) 5,3835,4116,38344,40211,157,3.6,572,13.2,6190,785,5405,2,15.4,9924,4483,5441,11.1,24.7,-3734,-9.3,30.8,0,420,431,3284
1987,29,g) 6 to 10,17582,19899,216423,217014,1138,5.6,2221,10.8,39564,10211,29353,4.7,18.2,40746,17893,22853,8.2,18.8,-1182,-0.6,36.4,0,1423,1435,8757
1987,29,l) Left Censored,32631,47636,1329904,1333082,2631,5.4,4452,9.2,180747,49598,131149,3.7,13.6,187102,65079,122023,4.9,14,-6355,-0.4,27.2,0,2041,2082,17502
1987,30,a) 0,2245,2275,12169,7038,2255,198.2,0,0,10262,10262,0,145.8,145.8,0,0,0,0,0,10262,145.8,0,0,,,
1987,30,b) 1,1644,1672,9343,9765,23,1.2,529,27.1,2452,299,2153,3.1,25.1,3296,1827,1469,18.7,33.8,-844,-8.7,50.2,0,375,375,1378
1987,30,c) 2,1436,1461,9679,9890,76,4.7,369,22.7,2584,290,2294,2.9,26.1,3005,1581,1424,16,30.4,-421,-4.3,52.2,0,278,278,1208
1987,30,d) 3,1356,1402,7466,7889,79,5.3,236,15.9,1586,285,1301,3.6,20.1,2432,1084,1348,13.7,30.8,-846,-10.7,40.2,0,168,168,680
1987,30,e) 4,1036,1172,8538,8938,68,5.5,172,14,1531,399,1132,4.5,17.1,2331,1183,1148,13.2,26.1,-800,-9,34.2,0,122,126,725
1987,30,f) 5,860,880,5365,5687,36,3.8,156,16.5,954,244,710,4.3,16.8,1597,678,919,11.9,28.1,-643,-11.3,33.6,0,114,114,504
1987,30,g) 6 to 10,4277,4677,35581,36577,241,4.9,629,12.8,5823,1282,4541,3.5,15.9,7814,2842,4972,7.8,21.4,-1991,-5.5,31.8,0,414,418,1860
1987,30,l) Left Censored,6151,8183,130747,131992,408,4.8,842,10,16057,4216,11841,3.2,12.2,18547,6582,11965,5,14.1,-2490,-1.9,24.4,0,406,414,2449
1987,31,a) 0,3063,3111,22059,13518,3082,198.1,0,0,17083,17083,0,126.4,126.4,0,0,0,0,0,17083,126.4,0,0,,,
1987,31,b) 1,2370,2440,17917,17627,51,1.9,526,19.4,5692,809,4883,4.6,32.3,5111,2586,2525,14.7,29,581,3.3,58,0,378,378,1607
1987,31,c) 2,2431,2490,18941,19241,97,3.7,363,13.7,3966,607,3359,3.2,20.6,4565,2407,2158,12.5,23.7,-599,-3.1,41.2,0,291,291,1872
1987,31,d) 3,2140,2210,15309,15353,112,4.9,265,11.5,3353,916,2437,6,21.8,3440,1449,1991,9.4,22.4,-87,-0.6,43.6,0,195,195,1177
1987,31,e) 4,1569,1717,17202,17092,89,4.9,243,13.5,2963,641,2322,3.8,17.3,2743,1173,1570,6.9,16,220,1.3,32,0,189,191,782
1987,31,f) 5,1440,1511,12058,12532,61,3.8,200,12.6,2052,470,1582,3.8,16.4,2999,1855,1144,14.8,23.9,-947,-7.5,32.8,0,160,160,1468
1987,31,g) 6 to 10,6743,7419,59689,60530,347,4.5,826,10.7,9447,2164,7283,3.6,15.6,11128,4785,6343,7.9,18.4,-1681,-2.8,31.2,0,568,572,2943
1987,31,l) Left Censored,13312,17730,368599,371327,790,4.4,1505,8.3,42661,9658,33003,2.6,11.5,48116,18869,29247,5.1,13,-5455,-1.5,23,0,743,765,4908
1987,32,a) 0,2951,3040,23651,12540,3015,198.4,0,0,22223,22223,0,177.2,177.2,0,0,0,0,0,22223,177.2,0,0,,,
1987,32,b) 1,2037,2108,19331,19058,53,2.2,626,25.7,6214,589,5625,3.1,32.6,5668,2934,2734,15.4,29.7,546,2.9,59.4,0,503,503,2438
1987,32,c) 2,1555,1617,18242,18634,112,6.4,366,20.8,5843,2557,3286,13.7,31.4,6626,3043,3583,16.3,35.6,-783,-4.2,62.8,0,293,293,2656
1987,32,d) 3,1390,1448,16918,17025,91,5.9,258,16.7,3653,624,3029,3.7,21.5,3867,2018,1849,11.9,22.7,-214,-1.2,43,0,194,194,1197
1987,32,e) 4,1010,1095,12718,12598,75,6.5,186,16.2,3013,482,2531,3.8,23.9,2773,1208,1565,9.6,22,240,1.9,44,0,133,136,856
1987,32,f) 5,1045,1143,17928,17457,74,6.2,177,14.8,3988,541,3447,3.1,22.8,3046,997,2049,5.7,17.4,942,5.4,34.8,0,124,126,767
1987,32,g) 6 to 10,4275,4661,66388,64796,282,5.8,590,12.2,14964,1724,13240,2.7,23.1,11779,6260,5519,9.7,18.2,3185,4.9,36.4,0,354,363,2432
1987,32,l) Left Censored,4872,7197,258720,253735,524,7.2,773,10.5,42619,13187,29432,5.2,16.8,32648,10345,22303,4.1,12.9,9971,3.9,25.8,0,272,278,4329
1987,33,a) 0,4128,4177,22067,11466,4156,199,0,0,21203,21203,0,184.9,184.9,0,0,0,0,0,21203,184.9,0,0,,,
1987,33,b) 1,3033,3104,26089,25602,49,1.4,663,19.3,6924,461,6463,1.8,27,5950,3180,2770,12.4,23.2,974,3.8,46.4,0,481,482,2469
1987,33,c) 2,2278,2320,18661,18785,106,4.3,386,15.6,4256,454,3802,2.4,22.7,4503,1906,2597,10.1,24,-247,-1.3,45.4,0,290,290,1305
1987,33,d) 3,1821,1885,18100,18036,93,4.7,261,13.2,4201,726,3475,4,23.3,4073,1982,2091,11,22.6,128,0.7,45.2,0,209,211,1738
1987,33,e) 4,1216,1285,12560,12584,63,4.7,180,13.4,3099,1236,1863,9.8,24.6,3147,987,2160,7.8,25,-48,-0.4,49.2,0,142,142,844
1987,33,f) 5,1090,1136,12480,12726,56,4.8,130,11.1,2231,392,1839,3.1,17.5,2723,960,1763,7.5,21.4,-492,-3.9,35,0,102,103,670
1987,33,g) 6 to 10,4434,4942,58125,58403,294,5.8,553,10.9,10783,2344,8439,4,18.5,11338,4641,6697,7.9,19.4,-555,-0.9,37,0,383,383,2893
1987,33,l) Left Censored,7250,9708,285268,286709,584,5.9,857,8.7,36316,9733,26583,3.4,12.7,39199,13955,25244,4.9,13.7,-2883,-1,25.4,0,425,426,4499
1987,34,a) 0,19394,19615,118718,62549,19501,198.8,0,0,112338,112338,0,179.6,179.6,0,0,0,0,0,112338,179.6,0,0,,,
1987,34,b) 1,14519,14775,117671,115380,217,1.3,3309,20.1,33331,4145,29186,3.6,28.9,28749,14633,14116,12.7,24.9,4582,4,49.8,0,2441,2441,10824
1987,34,c) 2,11928,12181,97083,98698,611,4.7,2004,15.5,24748,5466,19282,5.5,25.1,27977,12726,15251,12.9,28.3,-3229,-3.2,50.2,0,1520,1523,8860
1987,34,d) 3,9828,10074,103917,103164,456,4.3,1438,13.6,22511,3647,18864,3.5,21.8,21005,9116,11889,8.8,20.4,1506,1.4,40.8,0,1113,1113,7072
1987,34,e) 4,7845,8135,76328,76456,413,4.9,1036,12.2,20157,6081,14076,8,26.4,20412,11061,9351,14.5,26.7,-255,-0.3,52.8,0,794,794,9164
1987,34,f) 5,7094,7361,80476,81495,295,3.8,963,12.5,14370,1780,12590,2.2,17.6,16409,6337,10072,7.8,20.1,-2039,-2.5,35.2,0,727,734,4429
1987,34,g) 6 to 10,29830,31866,340119,344920,1373,4.2,3466,10.5,61121,12296,48825,3.6,17.7,70723,25368,45355,7.4,20.5,-9602,-2.8,35.4,0,2402,2412,15959
1987,34,l) Left Censored,55230,74063,2170732,2170380,3545,4.7,6753,8.9,332570,107361,225209,4.9,15.3,331866,118872,212994,5.5,15.3,704,0,30.6,0,3495,3538,30283
1987,35,a) 0,3291,3373,24492,13997,3341,198.1,0,0,20991,20991,0,150,150,0,0,0,0,0,20991,150,0,0,,,
1987,35,b) 1,2551,2598,18752,19675,46,1.5,751,25,4640,550,4090,2.8,23.6,6486,3355,3131,17.1,33,-1846,-9.4,47.2,0,610,610,2780
1987,35,c) 2,2113,2189,17307,17993,150,6.3,476,20,4059,1268,2791,7,22.6,5431,2591,2840,14.4,30.2,-1372,-7.6,45.2,0,366,366,1998
1987,35,d) 3,1945,2009,15841,16555,114,5.3,353,16.5,3428,616,2812,3.7,20.7,4856,2379,2477,14.4,29.3,-1428,-8.6,41.4,0,259,259,1869
1987,35,e) 4,1470,1644,15382,15970,105,6.1,263,15.2,2979,952,2027,6,18.7,4154,1698,2456,10.6,26,-1175,-7.3,37.4,0,201,204,1338
1987,35,f) 5,1232,1291,19042,19950,58,4.2,197,14.4,1971,351,1620,1.8,9.9,3787,1764,2023,8.8,19,-1816,-9.1,19.8,0,142,144,1487
1987,35,g) 6 to 10,5751,6345,60774,62429,337,5.1,825,12.5,11870,2942,8928,4.7,19,15179,5889,9290,9.4,24.3,-3309,-5.3,38,0,551,552,3806
1987,35,l) Left Censored,7584,11010,223889,226738,603,5.3,1122,9.9,30898,9237,21661,4.1,13.6,36595,11942,24653,5.3,16.1,-5697,-2.5,27.2,0,479,487,3195
1987,36,a) 0,41253,41753,260600,152977,41520,198.9,0,0,215247,215247,0,140.7,140.7,0,0,0,0,0,215247,140.7,0,0,,,
1987,36,b) 1,31437,31977,283076,281293,303,0.8,7106,19.9,63192,5310,57882,1.9,22.5,59625,29427,30198,10.5,21.2,3567,1.3,42.4,0,5335,5337,22544
1987,36,c) 2,26812,27277,209083,212829,1269,4.3,5075,17.3,51783,9415,42368,4.4,24.3,59275,29244,30031,13.7,27.9,-7492,-3.6,48.6,0,4026,4028,22901
1987,36,d) 3,22550,23203,197418,199861,1051,4.3,3486,14.2,43303,7183,36120,3.6,21.7,48190,22352,25838,11.2,24.1,-4887,-2.4,43.4,0,2791,2792,18398
1987,36,e) 4,17870,18510,162597,167370,908,4.7,2694,13.8,33194,7816,25378,4.7,19.8,42740,17586,25154,10.5,25.5,-9546,-5.7,39.6,0,2091,2096,11221
1987,36,f) 5,15771,16391,161186,161632,558,3.2,2249,13,29349,3754,25595,2.3,18.2,30241,12561,17680,7.8,18.7,-892,-0.5,36.4,0,1726,1729,9031
1987,36,g) 6 to 10,63952,69427,820508,823827,2601,3.6,8120,11.2,140790,20777,120013,2.5,17.1,147427,59880,87547,7.3,17.9,-6637,-0.8,34.2,0,5809,5840,46176
1987,36,l) Left Censored,126969,165858,4721954,4761153,6285,3.7,15625,9.2,571083,127491,443592,2.7,12,649481,211259,438222,4.4,13.6,-78398,-1.6,24,0,9197,9278,71489
1987,37,a) 0,14104,14492,82501,43851,14407,198.8,0,0,77301,77301,0,176.3,176.3,0,0,0,0,0,77301,176.3,0,0,,,
1987,37,b) 1,10783,11140,85734,85730,201,1.6,2775,22.1,23000,3642,19358,4.2,26.8,22992,13400,9592,15.6,26.8,8,0,53.6,0,2192,2193,10578
1987,37,c) 2,9249,9552,76771,78910,517,5,1883,18.2,18500,4037,14463,5.1,23.4,22778,10484,12294,13.3,28.9,-4278,-5.5,46.8,0,1507,1507,8465
1987,37,d) 3,9351,9794,76382,77431,480,4.7,1253,12.3,15710,4222,11488,5.5,20.3,17807,7602,10205,9.8,23,-2097,-2.7,40.6,0,964,964,5516
1987,37,e) 4,5549,5761,53345,54362,204,3.4,726,12,9542,1149,8393,2.1,17.6,11575,5143,6432,9.5,21.3,-2033,-3.7,35.2,0,579,581,3918
1987,37,f) 5,4691,5001,52109,51968,213,4.1,641,12.3,10177,1558,8619,3,19.6,9894,4627,5267,8.9,19,283,0.6,38,0,466,467,2971
1987,37,g) 6 to 10,20452,23000,259794,269995,1176,5,2437,10.3,43831,9635,34196,3.6,16.2,64233,18439,45794,6.8,23.8,-20402,-7.6,32.4,0,1539,1549,12452
1987,37,l) Left Censored,35734,56904,1719604,1725948,3496,6.1,4721,8.2,220543,59833,160710,3.5,12.8,233230,81206,152024,4.7,13.5,-12687,-0.7,25.6,0,2024,2043,17899
1987,38,a) 0,1454,1474,8462,4735,1464,198.6,0,0,7454,7454,0,157.4,157.4,0,0,0,0,0,7454,157.4,0,0,,,
1987,38,b) 1,1049,1064,6022,6377,15,1.2,275,22.7,1284,292,992,4.6,20.1,1994,1130,864,17.7,31.3,-710,-11.2,40.2,0,214,217,920
1987,38,c) 2,1010,1038,6178,6432,37,3.3,177,15.9,1158,193,965,3,18,1665,889,776,13.8,25.9,-507,-7.9,36,0,144,144,669
1987,38,d) 3,949,977,5205,5465,47,4.6,151,14.6,1135,421,714,7.7,20.8,1654,706,948,12.9,30.3,-519,-9.5,41.6,0,120,120,611
1987,38,e) 4,701,793,5839,6018,36,4.3,119,14.2,808,187,621,3.1,13.4,1166,411,755,6.8,19.4,-358,-6,26.8,0,91,94,348
1987,38,f) 5,681,708,4494,4838,28,3.7,104,13.9,716,138,578,2.9,14.8,1403,814,589,16.8,29,-687,-14.2,29.6,0,78,78,404
1987,38,g) 6 to 10,3126,3366,26075,26587,168,4.8,399,11.4,3755,923,2832,3.5,14.1,4779,2034,2745,7.7,18,-1024,-3.9,28.2,0,262,263,1312
1987,38,l) Left Censored,5785,7638,129598,130346,324,4.1,646,8.3,14061,3243,10818,2.5,10.8,15557,4854,10703,3.7,11.9,-1496,-1.1,21.6,0,286,288,1770
1987,39,a) 0,18603,19111,126402,68933,18979,198.6,0,0,114938,114938,0,166.7,166.7,0,0,0,0,0,114938,166.7,0,0,,,
1987,39,b) 1,13935,14477,126954,123531,418,2.6,3033,19,37213,6108,31105,4.9,30.1,30367,17145,13222,13.9,24.6,6846,5.5,49.2,0,2291,2291,12408
1987,39,c) 2,11882,12355,119718,118980,657,5,2115,16,31176,7369,23807,6.2,26.2,29699,14256,15443,12,25,1477,1.2,50,0,1657,1660,10620
1987,39,d) 3,10815,11271,98510,102075,515,4.4,1550,13.1,20330,4249,16081,4.2,19.9,27461,14358,13103,14.1,26.9,-7131,-7,39.8,0,1206,1206,10483
1987,39,e) 4,7624,8184,80331,81342,442,5.2,1125,13.1,15800,4157,11643,5.1,19.4,17822,8322,9500,10.2,21.9,-2022,-2.5,38.8,0,815,817,5336
1987,39,f) 5,7076,7700,74090,74594,448,5.6,993,12.4,14069,2792,11277,3.7,18.9,15076,6620,8456,8.9,20.2,-1007,-1.3,37.8,0,754,757,4541
1987,39,g) 6 to 10,32414,37195,427187,425638,1875,4.9,3807,9.9,78255,16896,61359,4,18.4,75156,27499,47657,6.5,17.7,3099,0.7,35.4,0,2412,2432,16385
1987,39,l) Left Censored,66052,101665,2818545,2839136,5059,4.9,8825,8.5,353004,96645,256359,3.4,12.4,394186,150828,243358,5.3,13.9,-41182,-1.5,24.8,0,3934,4033,34392
1987,40,a) 0,6257,6416,47749,28424,6353,198,0,0,38651,38651,0,136,136,0,0,0,0,0,38651,136,0,0,,,
1987,40,b) 1,4879,4991,39078,42437,83,1.4,1708,29,8869,1110,7759,2.6,20.9,15587,8946,6641,21.1,36.7,-6718,-15.8,41.8,0,1403,1403,7329
1987,40,c) 2,4342,4467,30479,33256,246,4.9,1242,24.8,7046,1933,5113,5.8,21.2,12599,6958,5641,20.9,37.9,-5553,-16.7,42.4,0,1007,1011,5987
1987,40,d) 3,4375,4500,31735,32872,177,3.6,865,17.7,7900,1229,6671,3.7,24,10174,5330,4844,16.2,31,-2274,-7,48,0,706,706,4063
1987,40,e) 4,3061,3270,24190,25831,212,6,643,18.3,5009,1977,3032,7.7,19.4,8290,3173,5117,12.3,32.1,-3281,-12.7,38.8,0,506,510,2588
1987,40,f) 5,3100,3285,29980,32482,142,4,628,17.7,3495,873,2622,2.7,10.8,8498,3510,4988,10.8,26.2,-5003,-15.4,21.6,0,474,480,2850
1987,40,g) 6 to 10,11798,13060,125597,133047,560,4,2009,14.5,16812,3902,12910,2.9,12.6,31712,12874,18838,9.7,23.8,-14900,-11.2,25.2,0,1373,1380,7906
1987,40,l) Left Censored,18094,26925,575900,597367,1528,5.5,3063,11,66152,22927,43225,3.8,11.1,109086,37237,71849,6.2,18.3,-42934,-7.2,22.2,0,1253,1309,9773
1987,41,a) 0,7663,7828,42403,21756,7785,198.9,0,0,41294,41294,0,189.8,189.8,0,0,0,0,0,41294,189.8,0,0,,,
1987,41,b) 1,5470,5586,40410,41206,90,1.4,1684,26,10692,1183,9509,2.9,25.9,12284,7371,4913,17.9,29.8,-1592,-3.9,51.8,0,1251,1251,5754
1987,41,c) 2,4536,4661,32923,33842,278,5.5,1001,19.8,8241,1999,6242,5.9,24.4,10078,5463,4615,16.1,29.8,-1837,-5.4,48.8,0,755,757,4204
1987,41,d) 3,3976,4131,32698,33165,236,5.4,712,16.2,8040,1825,6215,5.5,24.2,8974,4477,4497,13.5,27.1,-934,-2.9,48.4,0,564,564,3799
1987,41,e) 4,2864,3201,35302,35252,206,6.2,473,14.1,6530,1929,4601,5.5,18.5,6429,2946,3483,8.4,18.2,101,0.3,36.4,0,356,359,2160
1987,41,f) 5,2721,2861,25655,26873,112,3.7,470,15.4,4235,686,3549,2.6,15.8,6671,3428,3243,12.8,24.8,-2436,-9,31.6,0,342,346,2478
1987,41,g) 6 to 10,12304,13597,130803,132614,791,5.6,1804,12.8,23692,5261,18431,4,17.9,27314,13491,13823,10.2,20.6,-3622,-2.7,35.8,0,1185,1192,8061
1987,41,l) Left Censored,17288,25040,552297,552190,1479,5.8,2407,9.4,72736,18106,54630,3.3,13.2,72522,24874,47648,4.5,13.1,214,0.1,26.2,0,1168,1181,8410
1987,42,a) 0,21859,22356,148362,82398,22210,198.7,0,0,131928,131928,0,160.1,160.1,0,0,0,0,0,131928,160.1,0,0,,,
1987,42,b) 1,16718,17182,162247,161271,306,1.6,3554,18.7,39999,3941,36058,2.4,24.8,38046,21445,16601,13.3,23.6,1953,1.2,47.2,0,2658,2659,16582
1987,42,c) 2,13988,14472,135038,136649,705,4.6,2164,14.1,30649,6366,24283,4.7,22.4,33871,17370,16501,12.7,24.8,-3222,-2.4,44.8,0,1595,1598,12850
1987,42,d) 3,12677,13429,132823,133189,661,4.7,1605,11.5,26958,6118,20840,4.6,20.2,27691,12333,15358,9.3,20.8,-733,-0.6,40.4,0,1202,1205,9099
1987,42,e) 4,8899,9345,89961,90971,450,4.6,1274,13,17572,4041,13531,4.4,19.3,19591,8478,11113,9.3,21.5,-2019,-2.2,38.6,0,955,955,5910
1987,42,f) 5,8215,8756,101241,101856,328,3.6,1006,11,17055,2812,14243,2.8,16.7,18284,7722,10562,7.6,18,-1229,-1.3,33.4,0,765,766,6144
1987,42,g) 6 to 10,36246,40564,465922,466648,1885,4.5,4198,10,79712,15785,63927,3.4,17.1,81164,32765,48399,7,17.4,-1452,-0.3,34.2,0,2745,2787,17618
1987,42,l) Left Censored,76095,110598,3019024,3038919,5355,4.7,9439,8.4,366619,97730,268889,3.2,12.1,406411,143044,263367,4.7,13.4,-39792,-1.3,24.2,0,4730,4798,39752
1987,44,a) 0,2661,2704,15693,8460,2688,198.8,0,0,14467,14467,0,171,171,0,0,0,0,0,14467,171,0,0,,,
1987,44,b) 1,1848,1873,13235,13313,19,0.9,446,21.2,3723,329,3394,2.5,28,3878,2375,1503,17.8,29.1,-155,-1.1,56,0,342,342,1978
1987,44,c) 2,1539,1560,12339,12508,68,4.1,271,16.2,3135,429,2706,3.4,25.1,3472,1784,1688,14.3,27.8,-337,-2.7,50.2,0,205,205,1451
1987,44,d) 3,1318,1344,12338,12380,74,5.3,174,12.4,2422,413,2009,3.3,19.6,2506,970,1536,7.8,20.2,-84,-0.6,39.2,0,137,137,770
1987,44,e) 4,928,953,8562,8664,46,4.6,138,13.8,1658,183,1475,2.1,19.1,1861,971,890,11.2,21.5,-203,-2.4,38.2,0,108,108,540
1987,44,f) 5,815,855,9402,9549,46,5.2,96,10.9,1602,242,1360,2.5,16.8,1895,848,1047,8.9,19.8,-293,-3,33.6,0,78,78,765
1987,44,g) 6 to 10,3784,4038,46878,46786,168,4,393,9.5,7801,1418,6383,3,16.7,7617,2973,4644,6.4,16.3,184,0.4,32.6,0,272,281,2195
1987,44,l) Left Censored,8092,10047,277650,277065,395,3.8,872,8.5,32826,7002,25824,2.5,11.8,31657,10524,21133,3.8,11.4,1169,0.4,22.8,0,495,499,3257
1987,45,a) 0,7132,7329,46739,25769,7288,198.9,0,0,41941,41941,0,162.8,162.8,0,0,0,0,0,41941,162.8,0,0,,,
1987,45,b) 1,5154,5311,52481,48593,115,1.9,1475,24.3,19508,1574,17934,3.2,40.1,11731,6387,5344,13.1,24.1,7777,16,48.2,0,1078,1078,4578
1987,45,c) 2,4541,4727,38725,40190,263,5.1,1002,19.5,8594,2171,6423,5.4,21.4,11524,5970,5554,14.9,28.7,-2930,-7.3,42.8,0,751,751,4145
1987,45,d) 3,4317,4558,40397,40958,266,5.6,642,13.5,8182,2377,5805,5.8,20,9303,4197,5106,10.2,22.7,-1121,-2.7,40,0,450,450,2867
1987,45,e) 4,2669,2768,27853,28283,99,3.4,433,14.7,5581,973,4608,3.4,19.7,6440,2842,3598,10,22.8,-859,-3.1,39.4,0,308,308,2014
1987,45,f) 5,2451,2616,25884,26286,94,3.4,340,12.4,4765,1048,3717,4,18.1,5569,2840,2729,10.8,21.2,-804,-3.1,36.2,0,234,247,2244
1987,45,g) 6 to 10,10054,11271,123351,124044,578,5,1275,10.9,20988,4040,16948,3.3,16.9,22374,8638,13736,7,18,-1386,-1.1,33.8,0,808,827,5545
1987,45,l) Left Censored,17465,27251,756881,755571,1620,5.9,2202,8,101744,29336,72408,3.9,13.5,99125,33888,65237,4.5,13.1,2619,0.4,26.2,0,1020,1027,9078
1987,46,a) 0,1520,1546,10880,7055,1518,196.4,0,0,7650,7650,0,108.4,108.4,0,0,0,0,0,7650,108.4,0,0,,,
1987,46,b) 1,1077,1099,6440,6893,22,1.7,329,26,1728,193,1535,2.8,25.1,2634,1623,1011,23.5,38.2,-906,-13.1,50.2,0,224,224,1157
1987,46,c) 2,1065,1086,6156,6616,63,5.3,234,19.8,1110,230,880,3.5,16.8,2029,1086,943,16.4,30.7,-919,-13.9,33.6,0,172,172,833
1987,46,d) 3,1021,1052,6325,6346,53,4.8,152,13.8,1296,406,890,6.4,20.4,1338,611,727,9.6,21.1,-42,-0.7,40.8,0,114,114,486
1987,46,e) 4,691,796,5594,5952,54,6.6,93,11.4,785,334,451,5.6,13.2,1501,371,1130,6.2,25.2,-716,-12,26.4,0,69,70,259
1987,46,f) 5,623,652,4390,4660,34,5,88,13,619,133,486,2.9,13.3,1158,533,625,11.4,24.8,-539,-11.5,26.6,0,57,57,343
1987,46,g) 6 to 10,3043,3296,28421,28311,183,5.4,382,11.2,4686,1397,3289,4.9,16.6,4465,1895,2570,6.7,15.8,221,0.8,31.6,0,237,239,1089
1987,46,l) Left Censored,6071,7669,132039,132400,293,3.7,660,8.4,14164,2757,11407,2.1,10.7,14886,5189,9697,3.9,11.2,-722,-0.5,21.4,0,329,333,2242
1987,47,a) 0,10084,10333,68778,38097,10270,198.8,0,0,61362,61362,0,161.1,161.1,0,0,0,0,0,61362,161.1,0,0,,,
1987,47,b) 1,7331,7542,68309,67994,125,1.5,1992,23.2,18575,1772,16803,2.6,27.3,17945,10703,7242,15.7,26.4,630,0.9,52.8,0,1610,1611,8515
1987,47,c) 2,5986,6203,51950,53530,329,4.9,1338,19.8,13877,2985,10892,5.6,25.9,17037,8747,8290,16.3,31.8,-3160,-5.9,51.8,0,1089,1090,7106
1987,47,d) 3,6174,6322,55518,56578,256,3.8,936,14,11329,1676,9653,3,20,13448,7125,6323,12.6,23.8,-2119,-3.8,40,0,741,742,5447
1987,47,e) 4,3882,4115,39276,39501,221,5.1,585,13.5,8867,2048,6819,5.2,22.4,9317,4225,5092,10.7,23.6,-450,-1.2,44.8,0,467,468,3270
1987,47,f) 5,3367,3584,39195,39609,165,4.4,472,12.6,7452,1253,6199,3.2,18.8,8280,3926,4354,9.9,20.9,-828,-2.1,37.6,0,361,362,3051
1987,47,g) 6 to 10,14728,16740,188615,195932,912,5.3,1888,10.9,34689,8460,26229,4.3,17.7,49323,27756,21567,14.2,25.2,-14634,-7.5,35.4,0,1269,1278,10010
1987,47,l) Left Censored,26514,40580,1181790,1181072,2413,5.9,3433,8.3,153422,38783,114639,3.3,13,151986,48495,103491,4.1,12.9,1436,0.1,25.8,0,1559,1578,11885
1987,48,a) 0,35807,36965,244640,128897,36715,198.6,0,0,231486,231486,0,179.6,179.6,0,0,0,0,0,231486,179.6,0,0,,,
1987,48,b) 1,28010,28990,244524,259725,566,1.7,9650,28.4,63417,8591,54826,3.3,24.4,93818,53271,40547,20.5,36.1,-30401,-11.7,48.8,0,7891,7905,43130
1987,48,c) 2,23577,24610,192738,215556,1399,5.1,6761,24.5,42793,11050,31743,5.1,19.9,88428,45131,43297,20.9,41,-45635,-21.1,39.8,0,5471,5477,34417
1987,48,d) 3,21633,22856,192769,209616,1171,4.7,4879,19.6,37938,9339,28599,4.5,18.1,71631,34105,37526,16.3,34.2,-33693,-16.1,36.2,0,3924,3930,26889
1987,48,e) 4,16312,17503,155695,168927,1085,5.8,3374,18,31546,10431,21115,6.2,18.7,58010,26789,31221,15.9,34.3,-26464,-15.6,37.4,0,2670,2694,19560
1987,48,f) 5,15279,16286,151659,164087,722,4.1,3089,17.6,26597,5388,21209,3.3,16.2,51452,22633,28819,13.8,31.4,-24855,-15.2,32.4,0,2212,2239,15355
1987,48,g) 6 to 10,58449,67255,726867,775044,3326,4.7,10436,14.7,116707,31547,85160,4.1,15.1,213060,83122,129938,10.7,27.5,-96353,-12.4,30.2,0,6784,6926,50132
1987,48,l) Left Censored,74335,131992,3454207,3556904,8593,6.3,14890,11,463362,158659,304703,4.5,13,668755,238601,430154,6.7,18.8,-205393,-5.8,26,0,5502,5689,47597
1987,49,a) 0,3374,3443,20823,10511,3426,199,0,0,20624,20624,0,196.2,196.2,0,0,0,0,0,20624,196.2,0,0,,,
1987,49,b) 1,2376,2435,23244,24237,36,1.3,747,26.4,5999,553,5446,2.3,24.8,7986,4861,3125,20.1,32.9,-1987,-8.1,49.6,0,569,570,3685
1987,49,c) 2,2069,2144,17786,18700,149,6.4,465,20,4239,1178,3061,6.3,22.7,6066,2552,3514,13.6,32.4,-1827,-9.7,45.4,0,366,366,2074
1987,49,d) 3,1718,1779,16607,17625,102,5.3,375,19.5,3908,825,3083,4.7,22.2,5944,3236,2708,18.4,33.7,-2036,-11.5,44.4,0,279,279,2422
1987,49,e) 4,1322,1504,17718,18183,123,7.9,217,14,3673,1411,2262,7.8,20.2,4603,1966,2637,10.8,25.3,-930,-5.1,40.4,0,155,157,1180
1987,49,f) 5,1276,1373,13250,13729,69,4.7,228,15.6,2564,665,1899,4.8,18.7,3521,1962,1559,14.3,25.6,-957,-6.9,37.4,0,150,153,1360
1987,49,g) 6 to 10,5539,6143,74258,74824,363,5.7,835,13,13266,2833,10433,3.8,17.7,14397,5205,9192,7,19.2,-1131,-1.5,35.4,0,543,575,3516
1987,49,l) Left Censored,8030,12041,316184,319175,741,6,1269,10.3,42958,10616,32342,3.3,13.5,48940,17893,31047,5.6,15.3,-5982,-1.8,27,0,460,466,3534
1987,50,a) 0,2005,2024,9999,5299,2009,198.5,0,0,9401,9401,0,177.4,177.4,0,0,0,0,0,9401,177.4,0,0,,,
1987,50,b) 1,1570,1591,11838,11499,21,1.2,273,15.7,2668,281,2387,2.4,23.2,1990,1043,947,9.1,17.3,678,5.9,34.6,0,200,200,850
1987,50,c) 2,1242,1277,8434,8484,61,4.5,207,15.2,2030,558,1472,6.6,23.9,2129,953,1176,11.2,25.1,-99,-1.2,47.8,0,161,163,751
1987,50,d) 3,1104,1138,7888,7943,61,5.2,136,11.5,1544,379,1165,4.8,19.4,1653,594,1059,7.5,20.8,-109,-1.4,38.8,0,103,104,453
1987,50,e) 4,733,758,4739,4830,38,4.7,112,14,1020,211,809,4.4,21.1,1201,618,583,12.8,24.9,-181,-3.8,42.2,0,85,85,484
1987,50,f) 5,670,696,5565,5840,27,3.7,88,12.1,813,90,723,1.5,13.9,1363,582,781,10,23.3,-550,-9.4,27.8,0,73,73,547
1987,50,g) 6 to 10,2685,2912,29951,29926,135,4.5,345,11.4,5057,896,4161,3,16.9,5007,2049,2958,6.8,16.7,50,0.2,33.4,0,271,271,1669
1987,50,l) Left Censored,4597,5849,135867,134051,304,5.1,422,7.1,17530,5802,11728,4.3,13.1,13898,5595,8303,4.2,10.4,3632,2.7,20.8,0,228,238,2006
1987,51,a) 0,13164,13467,81932,42358,13414,199.2,0,0,79148,79148,0,186.9,186.9,0,0,0,0,0,79148,186.9,0,0,,,
1987,51,b) 1,10051,10336,76641,75502,225,1.9,2453,21.2,24476,3449,21027,4.6,32.4,22198,12296,9902,16.3,29.4,2278,3,58.8,0,1893,1895,9175
1987,51,c) 2,8467,8862,85871,91173,564,6,1600,17,20372,4632,15740,5.1,22.3,30976,20305,10671,22.3,34,-10604,-11.7,44.6,0,1249,1251,7535
1987,51,d) 3,7277,7500,62796,63561,307,3.9,1073,13.5,13575,2677,10898,4.2,21.4,15105,6505,8600,10.2,23.8,-1530,-2.4,42.8,0,834,835,5051
1987,51,e) 4,4785,5057,46039,47763,284,5.4,718,13.6,8887,2134,6753,4.5,18.6,12335,6063,6272,12.7,25.8,-3448,-7.2,37.2,0,535,537,3989
1987,51,f) 5,4345,4643,52564,53263,230,4.8,594,12.3,9319,1863,7456,3.5,17.5,10716,4647,6069,8.7,20.1,-1397,-2.6,35,0,410,415,2926
1987,51,g) 6 to 10,18003,20572,265753,264685,1127,5.3,2420,11.4,47863,8975,38888,3.4,18.1,45726,18077,27649,6.8,17.3,2137,0.8,34.6,0,1459,1479,9868
1987,51,l) Left Censored,30826,50491,1412074,1398654,3459,6.8,4035,7.9,208042,70432,137610,5,14.9,181201,59132,122069,4.2,13,26841,1.9,26,0,1830,1873,15208
1987,53,a) 0,11929,12199,66513,34830,12126,198.8,0,0,63366,63366,0,181.9,181.9,0,0,0,0,0,63366,181.9,0,0,,,
1987,53,b) 1,8858,9144,67981,68342,178,1.7,2412,23.2,19601,2103,17498,3.1,28.7,20322,11717,8605,17.1,29.7,-721,-1,57.4,0,1817,1817,9208
1987,53,c) 2,7200,7434,55144,56576,475,5.9,1504,18.7,13806,3053,10753,5.4,24.4,16669,8769,7900,15.5,29.5,-2863,-5.1,48.8,0,1146,1146,6463
1987,53,d) 3,6755,7080,57418,57856,450,6,1160,15.5,14155,3558,10597,6.1,24.5,15031,6464,8567,11.2,26,-876,-1.5,49,0,893,893,5166
1987,53,e) 4,4800,5216,55920,56621,296,5.4,845,15.3,10294,3135,7159,5.5,18.2,11696,5151,6545,9.1,20.7,-1402,-2.5,36.4,0,620,622,3690
1987,53,f) 5,4378,4630,43306,43650,258,5.3,683,14.1,8985,1752,7233,4,20.6,9672,4297,5375,9.8,22.2,-687,-1.6,41.2,0,494,507,3268
1987,53,g) 6 to 10,18741,20690,216492,219138,1160,5.4,2650,12.3,40510,8293,32217,3.8,18.5,45802,17745,28057,8.1,20.9,-5292,-2.4,37,0,1654,1687,11121
1987,53,l) Left Censored,25383,38199,893361,886693,2392,6.1,3812,9.8,134444,39919,94525,4.5,15.2,121108,44665,76443,5,13.7,13336,1.5,27.4,0,1727,1766,14150
1987,54,a) 0,3087,3137,19593,11052,3107,198.1,0,0,17083,17083,0,154.6,154.6,0,0,0,0,0,17083,154.6,0,0,,,
1987,54,b) 1,2264,2337,16936,16807,65,2.5,579,22,4616,1138,3478,6.8,27.5,4358,2211,2147,13.2,25.9,258,1.6,51.8,0,452,452,1749
1987,54,c) 2,1921,1994,24736,25325,118,5.5,403,18.6,3463,898,2565,3.5,13.7,4641,2294,2347,9.1,18.3,-1178,-4.6,27.4,0,309,309,1885
1987,54,d) 3,1894,1916,12212,12630,61,3,290,14.2,2108,349,1759,2.8,16.7,2944,1502,1442,11.9,23.3,-836,-6.6,33.4,0,225,225,1160
1987,54,e) 4,1184,1269,9383,9792,74,5.6,163,12.3,1803,683,1120,7,18.4,2621,1148,1473,11.7,26.8,-818,-8.4,36.8,0,129,129,813
1987,54,f) 5,1180,1253,13187,13626,73,5.6,167,12.8,2343,686,1657,5,17.2,3220,1464,1756,10.7,23.6,-877,-6.4,34.4,0,120,120,923
1987,54,g) 6 to 10,5093,5692,52347,53451,302,5.1,718,12.1,8119,1692,6427,3.2,15.2,10327,4347,5980,8.1,19.3,-2208,-4.1,30.4,0,500,502,2652
1987,54,l) Left Censored,10920,15333,305498,309573,821,5.3,1358,8.7,35819,9872,25947,3.2,11.6,43969,15198,28771,4.9,14.2,-8150,-2.6,23.2,0,667,678,5167
1987,55,a) 0,9516,9923,66992,36551,9779,197.1,0,0,60883,60883,0,166.6,166.6,0,0,0,0,0,60883,166.6,0,0,,,
1987,55,b) 1,7016,7138,66711,63635,70,1,462,6.3,13737,1326,12411,2.1,21.6,7585,1891,5694,3,11.9,6152,9.7,23.8,0,45,45,162
1987,55,c) 2,6187,6438,50419,47362,477,7.5,347,5.5,12693,4659,8034,9.8,26.8,6578,1828,4750,3.9,13.9,6115,12.9,27.8,0,30,31,170
1987,55,d) 3,5739,5999,52311,48787,414,7,336,5.7,13549,6828,6721,14,27.8,6501,1975,4526,4,13.3,7048,14.5,26.6,0,24,24,292
1987,55,e) 4,3843,4170,41000,38239,369,9.1,224,5.5,10345,4841,5504,12.7,27.1,4823,1384,3439,3.6,12.6,5522,14.5,25.2,0,19,19,123
1987,55,f) 5,3622,3804,35997,36418,96,2.5,250,6.5,5412,691,4721,1.9,14.9,6254,2544,3710,7,17.2,-842,-2.3,29.8,0,26,29,461
1987,55,g) 6 to 10,17079,18887,190242,188913,814,4.2,1734,9,30279,5273,25006,2.8,16,27621,10345,17276,5.5,14.6,2658,1.4,29.2,0,159,174,1181
1987,55,l) Left Censored,33962,46662,1216327,1212638,2377,5,3833,8.1,139072,35727,103345,2.9,11.5,131694,40309,91385,3.3,10.9,7378,0.6,21.8,0,1554,1598,15197
1987,56,a) 0,1179,1194,7105,4520,1176,197,0,0,5171,5171,0,114.4,114.4,0,0,0,0,0,5171,114.4,0,0,,,
1987,56,b) 1,903,914,4688,5125,11,1.1,239,22.9,1030,155,875,3,20.1,1903,1081,822,21.1,37.1,-873,-17,40.2,0,157,157,786
1987,56,c) 2,868,884,5257,5571,51,5.3,183,18.9,1328,350,978,6.3,23.8,1955,897,1058,16.1,35.1,-627,-11.3,47.6,0,128,128,663
1987,56,d) 3,762,783,5111,5579,42,5,153,18.1,842,344,498,6.2,15.1,1778,840,938,15.1,31.9,-936,-16.8,30.2,0,127,127,748
1987,56,e) 4,603,692,5125,5788,31,4.1,143,19,527,111,416,1.9,9.1,1853,688,1165,11.9,32,-1326,-22.9,18.2,0,120,121,612
1987,56,f) 5,652,693,4414,4802,22,2.9,144,19.1,670,93,577,1.9,14,1446,546,900,11.4,30.1,-776,-16.1,28,0,96,96,383
1987,56,g) 6 to 10,2629,2871,22068,23645,128,4.2,476,15.6,2964,612,2352,2.6,12.5,6117,2149,3968,9.1,25.9,-3153,-13.4,25,0,315,319,1418
1987,56,l) Left Censored,3434,4629,67923,72384,212,4.4,592,12.3,6958,2101,4857,2.9,9.6,15879,6093,9786,8.4,21.9,-8921,-12.3,19.2,0,245,248,1602
1988,01,a) 0,6844,6903,43925,22058,6849,198.4,0,0,43735,43735,0,198.3,198.3,0,0,0,0,0,43735,198.3,0,0,,,
1988,01,b) 1,5840,6060,57966,58246,52,0.7,1944,27.4,14671,2267,12404,3.9,25.2,15231,9607,5624,16.5,26.1,-560,-0.9,50.4,0,1610,1610,7670
1988,01,c) 2,4671,4874,42919,44012,227,4.2,1133,21.1,10267,2348,7919,5.3,23.3,12453,6109,6344,13.9,28.3,-2186,-5,46.6,0,889,889,4336
1988,01,d) 3,3938,4097,35729,36832,192,4.4,789,17.9,7588,1751,5837,4.8,20.6,9794,4866,4928,13.2,26.6,-2206,-6,41.2,0,573,573,3726
1988,01,e) 4,4146,4323,41818,42443,193,4.3,609,13.4,7856,1793,6063,4.2,18.5,9106,3864,5242,9.1,21.5,-1250,-3,37,0,441,441,2760
1988,01,f) 5,2545,2714,24504,25336,83,2.9,371,13,4039,520,3519,2.1,15.9,5703,2462,3241,9.7,22.5,-1664,-6.6,31.8,0,257,257,1700
1988,01,g) 6 to 10,10853,12019,153997,156142,430,3.4,1351,10.8,22806,4090,18716,2.6,14.6,27095,9435,17660,6,17.4,-4289,-2.8,29.2,0,901,901,5517
1988,01,h) 11 to 15,2324,3185,41923,41415,150,4.6,243,7.5,7150,1512,5638,3.7,17.3,6134,1859,4275,4.5,14.8,1016,2.5,29.6,0,121,121,632
1988,01,l) Left Censored,18972,29899,782120,781816,1660,5.5,2451,8.1,103973,35054,68919,4.5,13.3,103364,35431,67933,4.5,13.2,609,0.1,26.4,0,1044,1044,6918
1988,02,a) 0,1209,1228,7027,3607,1207,196.6,0,0,6840,6840,0,189.6,189.6,0,0,0,0,0,6840,189.6,0,0,,,
1988,02,b) 1,958,993,8597,9299,7,0.6,392,32.5,2013,359,1654,3.9,21.6,3417,2503,914,26.9,36.7,-1404,-15.1,43.2,0,303,303,1456
1988,02,c) 2,910,945,6718,7004,39,3.7,232,22.1,1947,154,1793,2.2,27.8,2518,1321,1197,18.9,36,-571,-8.2,55.6,0,182,182,1176
1988,02,d) 3,822,869,6449,6860,45,4.8,176,18.7,1423,120,1303,1.7,20.7,2245,702,1543,10.2,32.7,-822,-12,41.4,0,138,138,625
1988,02,e) 4,723,766,5194,5448,45,5.4,159,19.2,1072,224,848,4.1,19.7,1580,763,817,14,29,-508,-9.3,39.4,0,117,117,578
1988,02,f) 5,557,622,4432,4668,33,4.9,134,19.8,1009,209,800,4.5,21.6,1481,558,923,12,31.7,-472,-10.1,43.2,0,102,102,438
1988,02,g) 6 to 10,1942,2144,18494,18896,108,4.8,283,12.6,3881,788,3093,4.2,20.5,4684,1825,2859,9.7,24.8,-803,-4.3,41,0,195,195,1217
1988,02,h) 11 to 15,381,520,5766,5852,29,5.5,47,8.9,880,179,701,3.1,15,1051,234,817,4,18,-171,-3,30,0,22,22,127
1988,02,l) Left Censored,2220,3415,68876,71605,301,8.6,438,12.6,11125,3942,7183,5.5,15.5,16583,7496,9087,10.5,23.2,-5458,-7.7,31,0,89,89,795
1988,04,a) 0,8222,8352,54217,27221,8288,198.5,0,0,53993,53993,0,198.4,198.4,0,0,0,0,0,53993,198.4,0,0,,,
1988,04,b) 1,6842,7108,69917,69471,64,0.8,2457,29.2,19998,2580,17418,3.7,28.8,19106,12252,6854,17.6,27.5,892,1.3,55,0,2010,2010,9710
1988,04,c) 2,5623,5855,48068,51048,266,4.1,1390,21.6,11272,1981,9291,3.9,22.1,17231,8821,8410,17.3,33.8,-5959,-11.7,44.2,0,1104,1104,7049
1988,04,d) 3,4799,4981,48581,51112,259,4.8,1024,19,11631,3066,8565,6,22.8,16693,8673,8020,17,32.7,-5062,-9.9,45.6,0,809,809,6745
1988,04,e) 4,4110,4447,40540,42152,280,6,773,16.4,9035,2462,6573,5.8,21.4,12259,6029,6230,14.3,29.1,-3224,-7.7,42.8,0,595,595,4696
1988,04,f) 5,3064,3503,45905,46825,158,4.3,517,14,7167,1580,5587,3.4,15.3,9006,3565,5441,7.6,19.2,-1839,-3.9,30.6,0,409,409,3009
1988,04,g) 6 to 10,11969,13225,155006,158884,593,4.3,1585,11.5,26824,4593,22231,2.9,16.9,34579,12634,21945,8,21.8,-7755,-4.9,33.8,0,1071,1071,7181
1988,04,h) 11 to 15,1849,2611,43580,43364,154,5.8,260,9.8,8210,2223,5987,5.1,18.9,7777,2715,5062,6.3,17.9,433,1,35.8,0,135,135,904
1988,04,l) Left Censored,12353,22710,661443,651739,1846,8.1,2146,9.4,116838,43960,72878,6.7,17.9,97430,32415,65015,5,14.9,19408,3,29.8,0,632,632,5008
1988,05,a) 0,4097,4145,24295,12312,4105,198.1,0,0,23967,23967,0,194.7,194.7,0,0,0,0,0,23967,194.7,0,0,,,
1988,05,b) 1,3450,3537,33774,34803,29,0.7,1270,30,6042,725,5317,2.1,17.4,8100,5180,2920,14.9,23.3,-2058,-5.9,34.8,0,1039,1039,4364
1988,05,c) 2,2762,2849,21305,22516,84,2.6,724,22.6,4439,387,4052,1.7,19.7,6861,3211,3650,14.3,30.5,-2422,-10.8,39.4,0,611,611,2832
1988,05,d) 3,2573,2658,22929,25197,88,3.1,480,16.7,3864,877,2987,3.5,15.3,8400,2433,5967,9.7,33.3,-4536,-18,30.6,0,407,407,2159
1988,05,e) 4,2660,2737,18214,18401,66,2.3,386,13.2,3558,300,3258,1.6,19.3,3932,1857,2075,10.1,21.4,-374,-2.1,38.6,0,296,296,1409
1988,05,f) 5,1801,1915,18103,18136,76,3.8,259,12.9,3321,702,2619,3.9,18.3,3387,1595,1792,8.8,18.7,-66,-0.4,36.6,0,192,192,933
1988,05,g) 6 to 10,7816,8397,79845,80781,322,3.7,860,9.9,13688,2955,10733,3.7,16.9,15560,5181,10379,6.4,19.3,-1872,-2.4,33.8,0,627,627,3603
1988,05,h) 11 to 15,1536,2002,25163,25230,91,4.5,164,8.1,4458,857,3601,3.4,17.7,4591,1669,2922,6.6,18.2,-133,-0.5,35.4,0,87,87,586
1988,05,l) Left Censored,12109,17400,442156,439468,903,5.1,1540,8.7,57409,15296,42113,3.5,13.1,52034,19920,32114,4.5,11.8,5375,1.3,23.6,0,656,656,3746
1988,06,a) 0,62851,63784,421016,211846,63120,197.9,0,0,418340,418340,0,197.5,197.5,0,0,0,0,0,418340,197.5,0,0,,,
1988,06,b) 1,52767,54513,574761,570969,416,0.7,16515,26,159312,13274,146038,2.3,27.9,151727,86424,65303,15.1,26.6,7585,1.3,53.2,0,12841,12841,65180
1988,06,c) 2,43064,44996,402153,408796,2007,4.1,9329,19.1,105195,17022,88173,4.2,25.7,118480,59370,59110,14.5,29,-13285,-3.3,51.4,0,7314,7314,47565
1988,06,d) 3,36979,38649,382782,388081,1760,4.3,6678,16.2,89122,15822,73300,4.1,23,99720,44886,54834,11.6,25.7,-10598,-2.7,46,0,5143,5143,34526
1988,06,e) 4,32421,34248,352828,360595,1448,4,5157,14.3,74073,11996,62077,3.3,20.5,89606,37383,52223,10.4,24.8,-15533,-4.3,41,0,3873,3873,28188
1988,06,f) 5,24759,26959,361400,363054,1028,3.6,3635,12.9,69837,9352,60485,2.6,19.2,73144,29263,43881,8.1,20.1,-3307,-0.9,38.4,0,2570,2570,20401
1988,06,g) 6 to 10,109102,118928,1393518,1412517,5193,4.2,13977,11.3,249084,46637,202447,3.3,17.6,287082,107047,180035,7.6,20.3,-37998,-2.7,35.2,0,9173,9173,66215
1988,06,h) 11 to 15,19136,25616,432999,426232,1333,5.1,2633,10,85474,23266,62208,5.5,20.1,71939,23978,47961,5.6,16.9,13535,3.2,33.8,0,1264,1264,7475
1988,06,l) Left Censored,123936,204820,6040240,6007631,13326,6.4,17843,8.6,977697,267182,710515,4.4,16.3,912478,298152,614326,5,15.2,65219,1.1,30.4,0,7366,7367,49661
1988,08,a) 0,8451,8532,48591,24411,8445,198,0,0,48361,48361,0,198.1,198.1,0,0,0,0,0,48361,198.1,0,0,,,
1988,08,b) 1,6858,7082,58855,61188,73,0.9,2633,31.1,15920,2099,13821,3.4,26,20585,13627,6958,22.3,33.6,-4665,-7.6,52,0,2154,2154,10168
1988,08,c) 2,5695,5860,43299,46295,270,4.1,1541,23.6,9877,1390,8487,3,21.3,15869,9297,6572,20.1,34.3,-5992,-13,42.6,0,1282,1282,8144
1988,08,d) 3,5191,5376,45421,47939,229,3.9,1242,21,8747,1327,7420,2.8,18.2,13782,7327,6455,15.3,28.7,-5035,-10.5,36.4,0,1008,1008,5278
1988,08,e) 4,4608,4828,39394,41469,205,3.9,934,18,7553,1576,5977,3.8,18.2,11703,6294,5409,15.2,28.2,-4150,-10,36.4,0,732,732,4385
1988,08,f) 5,3416,3979,55401,56298,202,4.8,609,14.5,7985,2093,5892,3.7,14.2,9778,4077,5701,7.2,17.4,-1793,-3.2,28.4,0,494,494,2613
1988,08,g) 6 to 10,14357,15552,149730,153008,632,3.9,2110,13,25187,5112,20075,3.3,16.5,31743,12192,19551,8,20.7,-6556,-4.2,33,0,1452,1452,7750
1988,08,h) 11 to 15,2366,3213,35804,36649,196,6,341,10.4,6220,2233,3987,6.1,17,7909,2702,5207,7.4,21.6,-1689,-4.6,34,0,181,181,1382
1988,08,l) Left Censored,17031,27072,684592,688774,1939,7.1,2722,9.9,96586,28383,68203,4.1,14,104949,37366,67583,5.4,15.2,-8363,-1.2,28,0,1016,1016,5910
1988,09,a) 0,8075,8133,44906,22679,8068,198.4,0,0,44454,44454,0,196,196,0,0,0,0,0,44454,196,0,0,,,
1988,09,b) 1,6701,6860,55867,55610,56,0.7,1777,22.8,15326,1171,14155,2.1,27.6,14812,8217,6595,14.8,26.6,514,1,53.2,0,1421,1421,5628
1988,09,c) 2,5298,5459,46517,47267,195,3.3,995,16.9,10718,1336,9382,2.8,22.7,12218,5565,6653,11.8,25.8,-1500,-3.1,45.4,0,787,787,3706
1988,09,d) 3,4522,4660,41724,41929,165,3.3,694,14.1,8792,1475,7317,3.5,21,9202,3483,5719,8.3,21.9,-410,-0.9,42,0,543,543,2777
1988,09,e) 4,3904,4017,37184,38501,125,2.9,580,13.7,6813,931,5882,2.4,17.7,9447,3753,5694,9.7,24.5,-2634,-6.8,35.4,0,440,440,2789
1988,09,f) 5,2907,3049,28490,29756,107,3.4,356,11.2,4831,916,3915,3.1,16.2,7363,1849,5514,6.2,24.7,-2532,-8.5,32.4,0,261,261,1411
1988,09,g) 6 to 10,12287,13052,148087,153793,433,3.2,1293,9.6,22387,3837,18550,2.5,14.6,33799,17022,16777,11.1,22,-11412,-7.4,29.2,0,946,946,13563
1988,09,h) 11 to 15,2450,3085,45261,45145,148,4.7,257,8.2,7858,1463,6395,3.2,17.4,7626,3108,4518,6.9,16.9,232,0.5,33.8,0,134,134,1046
1988,09,l) Left Censored,23895,32571,1046304,1047739,1766,5.4,2478,7.5,140964,51166,89798,4.9,13.5,143833,52904,90929,5,13.7,-2869,-0.2,27,0,1172,1172,8026
1988,10,a) 0,1386,1392,9231,4759,1376,197.7,0,0,8944,8944,0,187.9,187.9,0,0,0,0,0,8944,187.9,0,0,,,
1988,10,b) 1,1156,1183,11091,11026,11,0.8,354,25.8,2754,151,2603,1.4,25,2624,1717,907,15.6,23.8,130,1.2,47.6,0,229,229,939
1988,10,c) 2,933,970,7307,7488,37,3.5,216,20.3,1894,399,1495,5.3,25.3,2255,1271,984,17,30.1,-361,-4.8,50.6,0,147,147,1053
1988,10,d) 3,804,826,6694,7024,34,3.8,155,17.4,1501,410,1091,5.8,21.4,2160,1058,1102,15.1,30.8,-659,-9.4,42.8,0,104,104,706
1988,10,e) 4,722,748,7612,7951,24,3,131,16.3,1471,274,1197,3.4,18.5,2148,1252,896,15.7,27,-677,-8.5,37,0,90,90,556
1988,10,f) 5,526,560,5380,5527,18,3,80,13.5,755,53,702,1,13.7,1048,571,477,10.3,19,-293,-5.3,27.4,0,50,50,243
1988,10,g) 6 to 10,2087,2229,27107,26569,92,4,248,10.8,5466,1334,4132,5,20.6,4390,2043,2347,7.7,16.5,1076,4.1,33,0,166,166,1248
1988,10,h) 11 to 15,466,602,11036,10562,28,4.6,37,6.1,1939,182,1757,1.7,18.4,990,264,726,2.5,9.4,949,9,18.8,0,24,24,143
1988,10,l) Left Censored,4232,5891,200829,197530,345,5.8,439,7.4,30607,9102,21505,4.6,15.5,24009,7731,16278,3.9,12.2,6598,3.3,24.4,0,172,172,1196
1988,11,a) 0,1275,1295,9801,5134,1289,199.1,0,0,9335,9335,0,181.8,181.8,0,0,0,0,0,9335,181.8,0,0,,,
1988,11,b) 1,1066,1095,18564,18548,12,0.9,334,26.3,3263,163,3100,0.9,17.6,3230,1815,1415,9.8,17.4,33,0.2,34.8,0,247,247,1452
1988,11,c) 2,971,985,9555,9883,34,3.2,213,19.8,2121,241,1880,2.4,21.5,2777,1513,1264,15.3,28.1,-656,-6.6,43,0,167,167,1189
1988,11,d) 3,919,936,12351,13976,33,3.4,119,12.1,2565,558,2007,4,18.4,5815,3889,1926,27.8,41.6,-3250,-23.2,36.8,0,92,92,3786
1988,11,e) 4,837,861,11131,10886,20,2.2,120,13.1,2469,376,2093,3.5,22.7,1978,756,1222,6.9,18.2,491,4.5,36.4,0,86,86,551
1988,11,f) 5,754,782,7332,7631,31,3.8,110,13.4,1617,454,1163,5.9,21.2,2215,931,1284,12.2,29,-598,-7.8,42.4,0,76,76,675
1988,11,g) 6 to 10,2696,2815,42035,42047,99,3.4,335,11.4,6313,889,5424,2.1,15,6339,2396,3943,5.7,15.1,-26,-0.1,30,0,209,209,1276
1988,11,h) 11 to 15,590,752,32257,33860,34,4.4,70,9.1,3236,728,2508,2.2,9.6,6441,1052,5389,3.1,19,-3205,-9.4,19.2,0,18,18,122
1988,11,l) Left Censored,5676,7899,269757,270710,579,7.3,586,7.4,39231,9348,29883,3.5,14.5,41136,8376,32760,3.1,15.2,-1905,-0.7,29,0,229,229,1368
1988,12,a) 0,35883,36411,211870,106704,36063,198.1,0,0,210332,210332,0,197.1,197.1,0,0,0,0,0,210332,197.1,0,0,,,
1988,12,b) 1,28113,29016,252614,256811,221,0.6,9916,28.9,69368,7445,61923,2.9,27,77762,48123,29639,18.7,30.3,-8394,-3.3,54,0,8276,8276,40881
1988,12,c) 2,22219,23046,184144,193023,913,3.6,5763,22.5,43691,6326,37365,3.3,22.6,61449,34110,27339,17.7,31.8,-17758,-9.2,45.2,0,4680,4680,27976
1988,12,d) 3,18733,19478,170398,177509,746,3.5,3956,18.7,34270,4214,30056,2.4,19.3,48491,24306,24185,13.7,27.3,-14221,-8,38.6,0,3215,3215,18788
1988,12,e) 4,16123,16819,153104,158265,620,3.5,2811,15.7,28408,4809,23599,3,17.9,38730,17265,21465,10.9,24.5,-10322,-6.6,35.8,0,2244,2244,13486
1988,12,f) 5,12257,13084,129291,129630,517,3.8,1879,13.6,27685,6091,21594,4.7,21.4,28362,11723,16639,9,21.9,-677,-0.5,42.8,0,1515,1515,9621
1988,12,g) 6 to 10,47259,51164,559096,567272,1951,3.7,6218,11.7,98341,20609,77732,3.6,17.3,114693,44681,70012,7.9,20.2,-16352,-2.9,34.6,0,4571,4571,29541
1988,12,h) 11 to 15,7886,10850,160583,157835,615,5.6,1057,9.6,37084,9268,27816,5.9,23.5,31588,10817,20771,6.9,20,5496,3.5,40,0,560,560,4237
1988,12,l) Left Censored,52394,94243,2402210,2381922,7062,7.4,8013,8.5,369510,119524,249986,5,15.5,328934,114915,214019,4.8,13.8,40576,1.7,27.6,0,3118,3120,21350
1988,13,a) 0,13358,13509,90536,45750,13385,198.2,0,0,89572,89572,0,195.8,195.8,0,0,0,0,0,89572,195.8,0,0,,,
1988,13,b) 1,10758,11197,120786,120207,107,0.8,3684,28,32758,2974,29784,2.5,27.3,31600,19243,12357,16,26.3,1158,1,52.6,0,2973,2973,15280
1988,13,c) 2,8991,9392,84754,88296,404,3.9,2156,20.9,18378,2806,15572,3.2,20.8,25461,13439,12022,15.2,28.8,-7083,-8,41.6,0,1767,1767,11364
1988,13,d) 3,7901,8211,72082,73855,333,3.8,1420,16.2,15449,3106,12343,4.2,20.9,18995,9164,9831,12.4,25.7,-3546,-4.8,41.8,0,1140,1140,7127
1988,13,e) 4,7064,7413,72665,73551,279,3.6,1012,13,14804,3380,11424,4.6,20.1,16575,6225,10350,8.5,22.5,-1771,-2.4,40.2,0,758,758,4724
1988,13,f) 5,4896,5311,52376,52353,220,4,686,12.4,10863,1301,9562,2.5,20.7,10816,4791,6025,9.2,20.7,47,0,41.4,0,523,523,3333
1988,13,g) 6 to 10,19192,21134,261292,260788,866,4,2226,10.2,49501,13321,36180,5.1,19,48493,17646,30847,6.8,18.6,1008,0.4,37.2,0,1483,1483,10689
1988,13,h) 11 to 15,3753,4884,69610,69642,273,5.5,462,9.3,13301,3213,10088,4.6,19.1,13364,4267,9097,6.1,19.2,-63,-0.1,38.2,0,234,234,1344
1988,13,l) Left Censored,29993,51634,1566641,1549935,3620,7,4175,8,245867,84008,161859,5.4,15.9,212454,73176,139278,4.7,13.7,33413,2.2,27.4,0,1583,1586,11352
1988,15,a) 0,2135,2173,14220,7146,2151,198,0,0,14148,14148,0,198,198,0,0,0,0,0,14148,198,0,0,,,
1988,15,b) 1,1739,1823,20276,20515,18,0.9,533,25.2,3910,324,3586,1.6,19.1,4388,2900,1488,14.1,21.4,-478,-2.3,38.2,0,423,423,1801
1988,15,c) 2,1372,1454,12798,13267,58,3.7,274,17.4,2461,456,2005,3.4,18.5,3399,1341,2058,10.1,25.6,-938,-7.1,37,0,229,229,1150
1988,15,d) 3,1356,1429,14684,13882,51,3.4,201,13.4,4062,346,3716,2.5,29.3,2457,1152,1305,8.3,17.7,1605,11.6,35.4,0,164,164,953
1988,15,e) 4,1016,1094,9539,9931,27,2.3,145,12.6,1417,128,1289,1.3,14.3,2200,843,1357,8.5,22.2,-783,-7.9,28.6,0,108,108,639
1988,15,f) 5,1021,1084,9275,9503,36,3.2,120,10.7,1347,207,1140,2.2,14.2,1802,653,1149,6.9,19,-455,-4.8,28.4,0,95,95,494
1988,15,g) 6 to 10,4280,4725,51972,51692,214,4.4,505,10.4,9032,1388,7644,2.7,17.5,8472,2829,5643,5.5,16.4,560,1.1,32.8,0,356,356,2030
1988,15,h) 11 to 15,749,1097,17303,17111,50,4.5,78,7,2451,739,1712,4.3,14.3,2066,651,1415,3.8,12.1,385,2.2,24.2,0,30,30,109
1988,15,l) Left Censored,6126,9422,231836,229776,482,5.1,702,7.4,32300,8217,24083,3.6,14.1,28179,10295,17884,4.5,12.3,4121,1.8,24.6,0,283,283,1791
1988,16,a) 0,1922,1937,11766,5948,1908,197,0,0,11637,11637,0,195.6,195.6,0,0,0,0,0,11637,195.6,0,0,,,
1988,16,b) 1,1586,1632,12040,12436,9,0.5,541,28,3083,259,2824,2.1,24.8,3875,2607,1268,21,31.2,-792,-6.4,49.6,0,424,424,1966
1988,16,c) 2,1404,1430,9385,9866,45,2.9,287,18.3,1869,266,1603,2.7,18.9,2831,1328,1503,13.5,28.7,-962,-9.8,37.8,0,226,226,1076
1988,16,d) 3,1288,1343,8938,9166,57,4,233,16.2,1845,232,1613,2.5,20.1,2300,1167,1133,12.7,25.1,-455,-5,40.2,0,180,180,881
1988,16,e) 4,1158,1202,8418,8644,44,3.4,187,14.6,1733,168,1565,1.9,20,2184,1194,990,13.8,25.3,-451,-5.3,40,0,147,147,1022
1988,16,f) 5,830,936,9137,9127,27,2.7,147,14.7,1703,408,1295,4.5,18.7,1683,806,877,8.8,18.4,20,0.3,36.8,0,108,108,642
1988,16,g) 6 to 10,3746,3964,34695,35170,136,3.3,449,10.9,6167,1031,5136,2.9,17.5,7117,2755,4362,7.8,20.2,-950,-2.7,35,0,324,324,1757
1988,16,h) 11 to 15,699,890,11546,10829,36,3.9,89,9.7,2997,1681,1316,15.5,27.7,1562,455,1107,4.2,14.4,1435,13.3,28.8,0,47,47,230
1988,16,l) Left Censored,5490,8121,154076,153355,484,5.9,631,7.7,20903,5764,15139,3.8,13.6,19462,6540,12922,4.3,12.7,1441,0.9,25.4,0,269,269,1685
1988,17,a) 0,19103,19288,129585,66602,19101,198.1,0,0,125966,125966,0,189.1,189.1,0,0,0,0,0,125966,189.1,0,0,,,
1988,17,b) 1,16345,16865,176598,171051,148,0.8,4370,22.8,48438,6131,42307,3.6,28.3,37343,22162,15181,13,21.8,11095,6.5,43.6,0,3427,3427,16842
1988,17,c) 2,13609,14143,123268,124830,538,3.5,2599,17.1,29773,5266,24507,4.2,23.9,32897,17617,15280,14.1,26.4,-3124,-2.5,47.8,0,2062,2062,14331
1988,17,d) 3,12585,13056,127695,129086,445,3.2,1924,13.9,23737,3807,19930,2.9,18.4,26518,11683,14835,9.1,20.5,-2781,-2.1,36.8,0,1510,1510,8955
1988,17,e) 4,11382,11971,118334,118720,427,3.4,1476,11.8,21622,3760,17862,3.2,18.2,22393,9009,13384,7.6,18.9,-771,-0.7,36.4,0,1076,1076,5776
1988,17,f) 5,8199,8761,112571,110544,323,3.5,1137,12.4,21157,3062,18095,2.8,19.1,17103,7485,9618,6.8,15.5,4054,3.6,31,0,815,815,4954
1988,17,g) 6 to 10,35827,38320,434152,438928,1323,3.3,3747,9.5,67973,14412,53561,3.3,15.5,77525,26464,51061,6,17.7,-9552,-2.2,31,0,2611,2611,16162
1988,17,h) 11 to 15,7348,9592,146791,145505,471,4.8,754,7.8,21745,4811,16934,3.3,14.9,19172,4655,14517,3.2,13.2,2573,1.7,26.4,0,410,410,1921
1988,17,l) Left Censored,68221,99235,2966238,2936315,5371,5.3,7725,7.7,407246,113377,293869,3.9,13.9,347400,119239,228161,4.1,11.8,59846,2.1,23.6,0,3588,3588,26975
1988,18,a) 0,8812,8911,58415,29339,8834,198.3,0,0,58152,58152,0,198.2,198.2,0,0,0,0,0,58152,198.2,0,0,,,
1988,18,b) 1,7634,7903,75086,75256,83,0.9,2296,25.2,18417,2567,15850,3.4,24.5,18756,11532,7224,15.3,24.9,-339,-0.4,49,0,1807,1807,8702
1988,18,c) 2,6528,6787,61484,61946,211,2.9,1293,17.6,13804,1536,12268,2.5,22.3,14728,6497,8231,10.5,23.8,-924,-1.5,44.6,0,1080,1080,5726
1988,18,d) 3,5897,6184,55244,66014,190,2.9,927,14.1,10474,1234,9240,1.9,15.9,32014,25417,6597,38.5,48.5,-21540,-32.6,31.8,0,745,745,24503
1988,18,e) 4,5628,5980,57336,58201,189,3,676,10.9,9630,2042,7588,3.5,16.5,11360,4899,6461,8.4,19.5,-1730,-3,33,0,491,491,3161
1988,18,f) 5,3885,4048,45139,44713,110,2.6,475,11.2,7579,729,6850,1.6,17,6727,2793,3934,6.2,15,852,2,30,0,377,377,2093
1988,18,g) 6 to 10,15882,17310,185665,187715,571,3.2,1720,9.6,28081,4369,23712,2.3,15,32181,10448,21733,5.6,17.1,-4100,-2.1,30,0,1189,1189,6272
1988,18,h) 11 to 15,3334,4614,68981,68076,249,5.3,366,7.8,12501,3441,9060,5.1,18.4,10691,3544,7147,5.2,15.7,1810,2.7,31.4,0,226,226,1602
1988,18,l) Left Censored,31511,47902,1371813,1359291,2538,5.2,3591,7.4,175714,48370,127344,3.6,12.9,150670,49158,101512,3.6,11.1,25044,1.8,22.2,0,1505,1505,9971
1988,19,a) 0,4363,4398,25942,13074,4362,198.4,0,0,25737,25737,0,196.9,196.9,0,0,0,0,0,25737,196.9,0,0,,,
1988,19,b) 1,3823,3959,40512,40987,45,1,1133,24.9,8013,1711,6302,4.2,19.6,8963,5652,3311,13.8,21.9,-950,-2.3,39.2,0,883,883,3879
1988,19,c) 2,3119,3196,24367,25282,97,2.8,651,18.6,4440,505,3935,2,17.6,6269,3625,2644,14.3,24.8,-1829,-7.2,35.2,0,526,526,3060
1988,19,d) 3,2925,3059,24568,25555,91,2.8,512,15.6,3546,348,3198,1.4,13.9,5519,2418,3101,9.5,21.6,-1973,-7.7,27.8,0,354,354,1486
1988,19,e) 4,3234,3353,24485,24437,113,3.2,439,12.5,4714,794,3920,3.2,19.3,4617,2336,2281,9.6,18.9,97,0.4,37.8,0,292,292,1698
1988,19,f) 5,2081,2332,21436,20898,94,3.8,330,13.5,4441,761,3680,3.6,21.3,3364,1607,1757,7.7,16.1,1077,5.2,32.2,0,265,265,1369
1988,19,g) 6 to 10,10130,11026,94927,94333,442,3.9,1057,9.3,14668,2689,11979,2.9,15.5,13480,4828,8652,5.1,14.3,1188,1.2,28.6,0,751,752,3273
1988,19,h) 11 to 15,2259,3096,32807,32256,122,3.9,240,7.6,5228,1078,4150,3.3,16.2,4126,1395,2731,4.3,12.8,1102,3.4,25.6,0,129,129,489
1988,19,l) Left Censored,20778,29407,630615,617076,1231,4.1,2203,7.4,87952,18571,69381,3,14.3,60875,22281,38594,3.6,9.9,27077,4.4,19.8,0,1100,1100,5269
1988,20,a) 0,4646,4703,27947,14169,4657,198,0,0,27556,27556,0,194.5,194.5,0,0,0,0,0,27556,194.5,0,0,,,
1988,20,b) 1,3918,4023,42073,42974,28,0.6,1277,27.1,7302,658,6644,1.5,17,9104,5774,3330,13.4,21.2,-1802,-4.2,34,0,1037,1037,4629
1988,20,c) 2,3367,3483,26983,27306,142,3.7,756,19.8,6280,1447,4833,5.3,23,6925,3545,3380,13,25.4,-645,-2.4,46,0,610,610,2709
1988,20,d) 3,3186,3291,24522,25228,114,3.2,548,15.6,4218,751,3467,3,16.7,5629,2659,2970,10.5,22.3,-1411,-5.6,33.4,0,423,423,2226
1988,20,e) 4,3179,3276,25340,25959,101,2.9,430,12.5,4197,694,3503,2.7,16.2,5434,2568,2866,9.9,20.9,-1237,-4.7,32.4,0,320,320,1527
1988,20,f) 5,2185,2354,17669,18232,99,4,339,13.7,3162,644,2518,3.5,17.3,4288,1975,2313,10.8,23.5,-1126,-6.2,34.6,0,258,258,1445
1988,20,g) 6 to 10,9077,9781,88658,89501,337,3.3,991,9.8,15198,3461,11737,3.9,17,16883,5883,11000,6.6,18.9,-1685,-1.9,34,0,748,748,4421
1988,20,h) 11 to 15,1877,2602,30302,29513,148,5.6,210,8,6110,2215,3895,7.5,20.7,4532,1461,3071,5,15.4,1578,5.3,30.8,0,115,115,435
1988,20,l) Left Censored,17141,24526,514916,514255,1368,5.5,1826,7.4,66015,20586,45429,4,12.8,64692,22459,42233,4.4,12.6,1323,0.2,25.2,0,817,817,6971
1988,21,a) 0,5697,5759,36241,18367,5707,198.2,0,0,35748,35748,0,194.6,194.6,0,0,0,0,0,35748,194.6,0,0,,,
1988,21,b) 1,5058,5178,52632,52617,35,0.6,1608,26.7,12721,847,11874,1.6,24.2,12691,7753,4938,14.7,24.1,30,0.1,48.2,0,1339,1339,6039
1988,21,c) 2,4232,4392,38392,39722,148,3.1,947,19.6,7592,1058,6534,2.7,19.1,10252,5414,4838,13.6,25.8,-2660,-6.7,38.2,0,789,789,4275
1988,21,d) 3,3729,3859,35117,35760,158,3.8,637,15.5,6938,1147,5791,3.2,19.4,8223,4021,4202,11.2,23,-1285,-3.6,38.8,0,515,515,3396
1988,21,e) 4,3776,3922,33500,33353,150,3.7,509,12.4,7584,1537,6047,4.6,22.7,7290,3130,4160,9.4,21.9,294,0.8,43.8,0,413,413,2352
1988,21,f) 5,2449,2578,22178,23411,115,4.3,339,12.6,4480,928,3552,4,19.1,6945,3729,3216,15.9,29.7,-2465,-10.6,38.2,0,271,271,2864
1988,21,g) 6 to 10,9966,10702,125189,123974,470,4.3,1066,9.7,22009,4222,17787,3.4,17.8,19578,7296,12282,5.9,15.8,2431,2,31.6,0,790,790,5289
1988,21,h) 11 to 15,2098,2691,36054,35989,137,5,235,8.6,5508,1539,3969,4.3,15.3,5378,1634,3744,4.5,14.9,130,0.4,29.8,0,138,138,654
1988,21,l) Left Censored,19076,28501,714242,707103,1717,6,2241,7.8,96044,30654,65390,4.3,13.6,81765,27013,54752,3.8,11.6,14279,2,23.2,0,1068,1068,5816
1988,22,a) 0,6072,6145,45193,22896,6083,198,0,0,44594,44594,0,194.8,194.8,0,0,0,0,0,44594,194.8,0,0,,,
1988,22,b) 1,5022,5178,52293,55005,46,0.7,1960,31.5,13439,1144,12295,2.1,24.4,18863,13191,5672,24,34.3,-5424,-9.9,48.8,0,1636,1636,9027
1988,22,c) 2,4626,4751,37057,38771,162,3.1,1178,22.2,8426,946,7480,2.4,21.7,11854,6002,5852,15.5,30.6,-3428,-8.9,43.4,0,983,983,5174
1988,22,d) 3,4158,4328,35263,36019,148,3.2,851,18.1,7636,1058,6578,2.9,21.2,9148,4585,4563,12.7,25.4,-1512,-4.2,42.4,0,700,700,3595
1988,22,e) 4,4254,4441,43384,43451,145,3.1,653,13.9,8899,933,7966,2.1,20.5,9032,4041,4991,9.3,20.8,-133,-0.3,41,0,513,513,3352
1988,22,f) 5,3209,3403,30541,31038,123,3.4,520,14.4,5758,963,4795,3.1,18.6,6752,3150,3602,10.1,21.8,-994,-3.2,37.2,0,376,376,2218
1988,22,g) 6 to 10,13662,14705,145192,146868,648,4.2,1966,12.8,25576,4985,20591,3.4,17.4,28928,11806,17122,8,19.7,-3352,-2.3,34.8,0,1393,1393,6973
1988,22,h) 11 to 15,2420,3130,42081,42523,201,6.3,337,10.5,7601,2989,4612,7,17.9,8485,2673,5812,6.3,20,-884,-2.1,35.8,0,183,183,1069
1988,22,l) Left Censored,21051,32964,738014,741342,2059,6.1,3137,9.3,99156,26611,72545,3.6,13.4,105812,36360,69452,4.9,14.3,-6656,-0.9,26.8,0,1369,1369,9390
1988,23,a) 0,3314,3345,17684,8947,3309,197.8,0,0,17474,17474,0,195.3,195.3,0,0,0,0,0,17474,195.3,0,0,,,
1988,23,b) 1,2715,2780,24691,22767,17,0.5,802,25,8707,506,8201,2.2,38.2,4859,2630,2229,11.6,21.3,3848,16.9,42.6,0,606,606,2037
1988,23,c) 2,2168,2219,14151,14419,81,3.4,423,17.6,3252,301,2951,2.1,22.6,3788,2010,1778,13.9,26.3,-536,-3.7,45.2,0,325,325,1604
1988,23,d) 3,1753,1813,13954,13678,60,3.1,247,12.9,3032,337,2695,2.5,22.2,2480,878,1602,6.4,18.1,552,4.1,36.2,0,198,198,711
1988,23,e) 4,1519,1586,14171,14617,49,3,193,11.6,2609,397,2212,2.7,17.8,3501,993,2508,6.8,24,-892,-6.2,35.6,0,151,151,754
1988,23,f) 5,1082,1122,9524,9448,40,3.4,133,11.4,1953,320,1633,3.4,20.7,1801,803,998,8.5,19.1,152,1.6,38.2,0,101,101,665
1988,23,g) 6 to 10,4307,4610,48377,48649,176,3.7,491,10.3,7440,979,6461,2,15.3,7983,2894,5089,5.9,16.4,-543,-1.1,30.6,0,363,363,1943
1988,23,h) 11 to 15,866,1152,16543,15801,57,4.9,96,8.2,4176,433,3743,2.7,26.4,2691,1423,1268,9,17,1485,9.4,34,0,64,64,266
1988,23,l) Left Censored,7422,10277,253941,251377,460,4.4,800,7.7,31126,6120,25006,2.4,12.4,25998,7701,18297,3.1,10.3,5128,2.1,20.6,0,383,383,2600
1988,24,a) 0,9383,9515,63240,32063,9428,198.2,0,0,62354,62354,0,194.5,194.5,0,0,0,0,0,62354,194.5,0,0,,,
1988,24,b) 1,7564,7770,79401,78285,69,0.8,2263,25.3,22471,2167,20304,2.8,28.7,20238,12752,7486,16.3,25.9,2233,2.8,51.8,0,1742,1742,9959
1988,24,c) 2,6549,6730,59865,59723,231,3.2,1299,17.8,15354,1929,13425,3.2,25.7,15070,7712,7358,12.9,25.2,284,0.5,50.4,0,1009,1009,5826
1988,24,d) 3,5526,5839,58110,59369,190,3.1,900,14.5,11353,1259,10094,2.1,19.1,13870,6796,7074,11.4,23.4,-2517,-4.3,38.2,0,710,710,5793
1988,24,e) 4,4606,4792,52291,66806,157,3.1,645,12.8,9606,1350,8256,2,14.4,38635,5767,32868,8.6,57.8,-29029,-43.4,28.8,0,467,467,3523
1988,24,f) 5,3585,3840,40150,40734,163,4.1,469,11.7,7573,1347,6226,3.3,18.6,8741,3100,5641,7.6,21.5,-1168,-2.9,37.2,0,342,342,2067
1988,24,g) 6 to 10,13587,14631,184576,187126,552,3.7,1484,9.8,32314,7695,24619,4.1,17.3,37413,15600,21813,8.3,20,-5099,-2.7,34.6,0,1036,1036,11747
1988,24,h) 11 to 15,2713,3662,60159,60524,183,4.9,316,8.5,8893,2569,6324,4.2,14.7,9622,2796,6826,4.6,15.9,-729,-1.2,29.4,0,163,163,879
1988,24,l) Left Censored,24094,37958,1130846,1113343,2557,6.7,2878,7.5,176365,54571,121794,4.9,15.8,141360,42649,98711,3.8,12.7,35005,3.1,25.4,0,1126,1126,7375
1988,25,a) 0,13187,13289,88207,44531,13170,198.2,0,0,87353,87353,0,196.2,196.2,0,0,0,0,0,87353,196.2,0,0,,,
1988,25,b) 1,11411,11713,114342,116327,99,0.7,2939,22.1,26591,2862,23729,2.5,22.9,30560,17500,13060,15,26.3,-3969,-3.4,45.8,0,2214,2214,10763
1988,25,c) 2,9352,9630,87753,89140,320,3.1,1722,16.6,18612,2563,16049,2.9,20.9,21386,10126,11260,11.4,24,-2774,-3.1,41.8,0,1351,1351,8263
1988,25,d) 3,8019,8283,91647,91761,267,3,1207,13.8,17917,4317,13600,4.7,19.5,18145,7838,10307,8.5,19.8,-228,-0.3,39,0,957,957,6367
1988,25,e) 4,6708,6919,73560,79313,178,2.4,952,13,12905,2027,10878,2.6,16.3,24410,15515,8895,19.6,30.8,-11505,-14.5,32.6,0,728,728,13737
1988,25,f) 5,5081,5374,58159,59069,199,3.6,622,11.1,9948,2077,7871,3.5,16.8,11767,4086,7681,6.9,19.9,-1819,-3.1,33.6,0,495,495,3429
1988,25,g) 6 to 10,20327,21863,295383,297571,717,3.2,2113,9.4,46674,7891,38783,2.7,15.7,51049,18503,32546,6.2,17.2,-4375,-1.5,31.4,0,1422,1422,11000
1988,25,h) 11 to 15,3922,5407,116056,116785,260,4.7,451,8.2,14075,2981,11094,2.6,12.1,15533,4671,10862,4,13.3,-1458,-1.2,24.2,0,237,237,1370
1988,25,l) Left Censored,41320,57605,1885757,1879824,2695,4.6,4398,7.5,262694,65400,197294,3.5,14,250827,74681,176146,4,13.3,11867,0.7,26.6,0,2134,2134,18425
1988,26,a) 0,15225,15438,98634,49624,15277,197.9,0,0,98020,98020,0,197.5,197.5,0,0,0,0,0,98020,197.5,0,0,,,
1988,26,b) 1,13442,13841,130365,130171,119,0.8,3664,23.2,30197,5402,24795,4.1,23.2,29809,15378,14431,11.8,22.9,388,0.3,45.8,0,2853,2853,11776
1988,26,c) 2,10664,11056,96448,97907,353,2.9,2130,17.8,21968,3712,18256,3.8,22.4,24886,13018,11868,13.3,25.4,-2918,-3,44.8,0,1619,1619,9790
1988,26,d) 3,9681,10123,96133,97588,346,3.2,1586,14.8,19102,4144,14958,4.2,19.6,22012,10231,11781,10.5,22.6,-2910,-3,39.2,0,1248,1248,7386
1988,26,e) 4,8821,9297,93485,95507,311,3.2,1185,12.2,16683,2625,14058,2.7,17.5,20727,9401,11326,9.8,21.7,-4044,-4.2,35,0,946,946,5318
1988,26,f) 5,6407,6932,70332,71522,214,3,811,11.2,12182,2504,9678,3.5,17,14562,4979,9583,7,20.4,-2380,-3.4,34,0,607,607,3817
1988,26,g) 6 to 10,26559,28802,316049,321293,965,3.2,2952,9.9,49108,10344,38764,3.2,15.3,59596,21159,38437,6.6,18.5,-10488,-3.2,30.6,0,2065,2065,14803
1988,26,h) 11 to 15,5279,7268,105506,105479,345,4.6,701,9.4,17396,4273,13123,4.1,16.5,17343,5700,11643,5.4,16.4,53,0.1,32.8,0,308,308,1845
1988,26,l) Left Censored,47912,72950,2202524,2216223,3605,4.9,5851,7.9,272574,77409,195165,3.5,12.3,299973,92005,207968,4.2,13.5,-27399,-1.2,24.6,0,2409,2409,15645
1988,27,a) 0,7750,7841,50039,25152,7773,198.3,0,0,49775,49775,0,197.9,197.9,0,0,0,0,0,49775,197.9,0,0,,,
1988,27,b) 1,6511,6733,72127,72510,63,0.8,1814,23.5,16117,1892,14225,2.6,22.2,16882,10348,6534,14.3,23.3,-765,-1.1,44.4,0,1400,1400,7584
1988,27,c) 2,5712,5950,49940,51858,180,2.8,1126,17.5,9900,1305,8595,2.5,19.1,13735,5907,7828,11.4,26.5,-3835,-7.4,38.2,0,899,899,4702
1988,27,d) 3,5252,5489,54764,55690,185,3.2,842,14.5,10474,1958,8516,3.5,18.8,12326,5326,7000,9.6,22.1,-1852,-3.3,37.6,0,667,667,4299
1988,27,e) 4,4792,5051,46820,49896,139,2.6,702,13.2,7536,1135,6401,2.3,15.1,13688,5485,8203,11,27.4,-6152,-12.3,30.2,0,512,512,3765
1988,27,f) 5,3341,3724,43426,43331,132,3.4,437,11.2,7650,1354,6296,3.1,17.7,7459,2700,4759,6.2,17.2,191,0.5,34.4,0,315,315,1875
1988,27,g) 6 to 10,14525,15876,174446,174291,620,3.8,1658,10.1,32866,6733,26133,3.9,18.9,32557,11995,20562,6.9,18.7,309,0.2,37.4,0,1137,1137,7883
1988,27,h) 11 to 15,3042,4000,66878,64360,179,4.4,361,8.8,14347,1819,12528,2.8,22.3,9310,3386,5924,5.3,14.5,5037,7.8,29,0,179,179,1141
1988,27,l) Left Censored,26792,38844,1152261,1141735,2061,5.2,3065,7.8,159738,39047,120691,3.4,14,138686,47468,91218,4.2,12.1,21052,1.9,24.2,0,1266,1266,11860
1988,28,a) 0,3855,3928,22758,11651,3878,197.5,0,0,22214,22214,0,190.7,190.7,0,0,0,0,0,22214,190.7,0,0,,,
1988,28,b) 1,3237,3330,32584,33577,24,0.6,1278,31.8,6334,695,5639,2.1,18.9,8319,5565,2754,16.6,24.8,-1985,-5.9,37.8,0,1060,1060,4113
1988,28,c) 2,2650,2720,20466,20410,108,3.6,657,21.8,5183,795,4388,3.9,25.4,5071,2737,2334,13.4,24.8,112,0.6,49.6,0,551,551,2444
1988,28,d) 3,2529,2597,20882,21371,88,3.2,438,15.8,4447,953,3494,4.5,20.8,5424,2768,2656,13,25.4,-977,-4.6,41.6,0,347,347,2183
1988,28,e) 4,2548,2603,21586,20980,83,3,393,14.2,5242,509,4733,2.4,25,4030,1952,2078,9.3,19.2,1212,5.8,38.4,0,308,308,1550
1988,28,f) 5,1688,1781,13463,13819,63,3.4,215,11.6,2389,293,2096,2.1,17.3,3101,1393,1708,10.1,22.4,-712,-5.1,34.6,0,163,163,949
1988,28,g) 6 to 10,7244,7825,84024,83834,304,3.7,879,10.8,14315,2617,11698,3.1,17.1,13935,4342,9593,5.2,16.6,380,0.5,33.2,0,639,639,3061
1988,28,h) 11 to 15,1501,1938,20016,20150,86,4.3,223,11.2,3260,903,2357,4.5,16.2,3527,1500,2027,7.4,17.5,-267,-1.3,32.4,0,126,127,822
1988,28,l) Left Censored,12763,19121,445778,444431,946,4.9,1559,8,55450,18432,37018,4.1,12.5,52757,17174,35583,3.9,11.9,2693,0.6,23.8,0,702,702,3927
1988,29,a) 0,9749,9836,54495,27395,9760,198.5,0,0,54201,54201,0,197.8,197.8,0,0,0,0,0,54201,197.8,0,0,,,
1988,29,b) 1,8227,8478,85874,86930,73,0.7,2907,29,20897,3803,17094,4.4,24,23010,14618,8392,16.8,26.5,-2113,-2.5,48,0,2212,2212,9677
1988,29,c) 2,6714,6984,54888,56603,227,2.9,1630,21.1,12002,1895,10107,3.3,21.2,15431,7963,7468,14.1,27.3,-3429,-6.1,42.4,0,1287,1287,6414
1988,29,d) 3,6574,6785,59031,61078,208,2.9,1151,15.8,10439,1444,8995,2.4,17.1,14532,6342,8190,10.4,23.8,-4093,-6.7,34.2,0,902,902,5139
1988,29,e) 4,5555,5811,51809,52734,198,3.2,768,12.6,8985,1572,7413,3,17,10834,4591,6243,8.7,20.5,-1849,-3.5,34,0,582,582,3574
1988,29,f) 5,3980,4297,44472,44380,163,3.6,529,11.8,8294,1966,6328,4.4,18.7,8109,3018,5091,6.8,18.3,185,0.4,36.6,0,397,397,2357
1988,29,g) 6 to 10,16501,18068,187603,189988,693,3.7,1860,10,31748,6788,24960,3.6,16.7,36518,13551,22967,7.1,19.2,-4770,-2.5,33.4,0,1293,1293,7953
1988,29,h) 11 to 15,3377,4674,67691,65990,261,5.5,340,7.2,13293,3380,9913,5.1,20.1,9890,3014,6876,4.6,15,3403,5.1,30,0,183,183,1081
1988,29,l) Left Censored,30521,45882,1255862,1269831,2635,5.7,3628,7.8,165023,49542,115481,3.9,13,192960,83034,109926,6.5,15.2,-27937,-2.2,26,0,1563,1563,9970
1988,30,a) 0,1924,1931,9533,4812,1904,197.2,0,0,9443,9443,0,196.2,196.2,0,0,0,0,0,9443,196.2,0,0,,,
1988,30,b) 1,1544,1577,9575,10732,14,0.7,638,33.2,2434,193,2241,1.8,22.7,4747,3460,1287,32.2,44.2,-2313,-21.5,45.4,0,440,440,1392
1988,30,c) 2,1326,1358,8331,8836,61,4,344,22.8,1662,285,1377,3.2,18.8,2672,1361,1311,15.4,30.2,-1010,-11.4,37.6,0,245,245,1060
1988,30,d) 3,1216,1242,8403,9062,54,4,260,19.2,1808,195,1613,2.2,20,3125,1282,1843,14.1,34.5,-1317,-14.5,40,0,186,186,995
1988,30,e) 4,1175,1220,6865,7123,52,4,219,16.7,1343,325,1018,4.6,18.9,1858,860,998,12.1,26.1,-515,-7.2,37.8,0,150,150,545
1988,30,f) 5,915,1058,8023,8269,40,3.6,150,13.5,1180,249,931,3,14.3,1672,785,887,9.5,20.2,-492,-5.9,28.6,0,110,110,589
1988,30,g) 6 to 10,3912,4167,29582,30614,168,3.9,512,11.8,4767,809,3958,2.6,15.6,6831,3369,3462,11,22.3,-2064,-6.7,31.2,0,360,360,2190
1988,30,h) 11 to 15,775,943,8328,8439,48,5,100,10.3,1144,215,929,2.5,13.6,1366,533,833,6.3,16.2,-222,-2.6,27.2,0,48,48,252
1988,30,l) Left Censored,5492,7569,108506,110200,336,4.3,645,8.3,12486,2933,9553,2.7,11.3,15873,4914,10959,4.5,14.4,-3387,-3.1,22.6,0,324,324,1766
1988,31,a) 0,2906,2964,18424,9300,2928,197.6,0,0,18248,18248,0,196.2,196.2,0,0,0,0,0,18248,196.2,0,0,,,
1988,31,b) 1,2314,2360,20027,20797,12,0.4,668,24.5,4385,303,4082,1.5,21.1,5924,4113,1811,19.8,28.5,-1539,-7.4,42.2,0,515,515,1955
1988,31,c) 2,1993,2065,16571,17182,80,3.6,413,18.4,3850,1177,2673,6.9,22.4,5071,2479,2592,14.4,29.5,-1221,-7.1,44.8,0,325,325,1714
1988,31,d) 3,2147,2210,19975,19416,52,2.2,312,13.3,4329,548,3781,2.8,22.3,3211,1667,1544,8.6,16.5,1118,5.8,33,0,254,254,1306
1988,31,e) 4,1962,2034,14444,14705,63,3,235,11.1,2561,477,2084,3.2,17.4,3082,1324,1758,9,21,-521,-3.6,34.8,0,171,171,983
1988,31,f) 5,1415,1571,17316,17207,56,3.4,188,11.4,2679,565,2114,3.3,15.6,2461,731,1730,4.2,14.3,218,1.3,28.6,0,127,127,499
1988,31,g) 6 to 10,6174,6584,56472,56452,210,3.1,672,9.9,9051,1608,7443,2.8,16,9010,3555,5455,6.3,16,41,0,32,0,494,494,2491
1988,31,h) 11 to 15,1367,1753,16694,16183,68,3.8,144,8,2985,795,2190,4.9,18.4,1962,711,1251,4.4,12.1,1023,6.3,24.2,0,91,91,363
1988,31,l) Left Censored,12005,16541,355202,350996,721,4.3,1235,7.3,47739,11430,36309,3.3,13.6,39327,14356,24971,4.1,11.2,8412,2.4,22.4,0,558,558,3106
1988,32,a) 0,2694,2726,19283,9717,2702,198.2,0,0,19133,19133,0,196.9,196.9,0,0,0,0,0,19133,196.9,0,0,,,
1988,32,b) 1,2122,2204,23128,23090,24,0.9,800,30.5,7742,276,7466,1.2,33.5,7665,4390,3275,19,33.2,77,0.3,66.4,0,604,604,3067
1988,32,c) 2,1673,1736,20901,20312,57,3,414,21.6,6297,258,6039,1.3,31,5118,2535,2583,12.5,25.2,1179,5.8,50.4,0,331,331,1933
1988,32,d) 3,1315,1383,17896,17983,63,4.2,274,18.3,5090,1928,3162,10.7,28.3,5263,2327,2936,12.9,29.3,-173,-1,56.6,0,204,204,1959
1988,32,e) 4,1243,1308,16700,16815,69,5,208,15.1,3530,693,2837,4.1,21,3760,1960,1800,11.7,22.4,-230,-1.4,42,0,154,154,1568
1988,32,f) 5,914,1003,12942,12843,51,4.9,143,13.6,2476,406,2070,3.2,19.3,2277,874,1403,6.8,17.7,199,1.6,35.4,0,108,108,775
1988,32,g) 6 to 10,4261,4592,66541,67147,219,4.6,514,10.8,11780,1761,10019,2.6,17.5,12992,4475,8517,6.7,19.3,-1212,-1.8,35,0,354,354,3064
1988,32,h) 11 to 15,697,917,19356,19422,82,9,67,7.4,3052,989,2063,5.1,15.7,3183,891,2292,4.6,16.4,-131,-0.7,31.4,0,34,34,229
1988,32,l) Left Censored,4690,7217,262246,257961,598,8.3,582,8.1,50248,15971,34277,6.2,19.5,41677,18189,23488,7.1,16.2,8571,3.3,32.4,0,223,223,1542
1988,33,a) 0,3620,3638,20477,10307,3603,198.1,0,0,20341,20341,0,197.4,197.4,0,0,0,0,0,20341,197.4,0,0,,,
1988,33,b) 1,3094,3142,22520,22940,17,0.5,971,26.5,5790,404,5386,1.8,25.2,6630,3824,2806,16.7,28.9,-840,-3.7,50.4,0,774,774,2965
1988,33,c) 2,2529,2617,22574,23493,100,3.5,565,19.8,4735,948,3787,4,20.2,6573,2857,3716,12.2,28,-1838,-7.8,40.4,0,443,443,2298
1988,33,d) 3,1999,2049,17394,18318,71,3.2,353,16.1,3283,639,2644,3.5,17.9,5131,2518,2613,13.7,28,-1848,-10.1,35.8,0,285,285,2004
1988,33,e) 4,1623,1685,15966,16736,47,2.6,228,12.8,2486,303,2183,1.8,14.9,4025,1334,2691,8,24,-1539,-9.1,29.8,0,177,177,1084
1988,33,f) 5,1107,1177,11630,11973,43,3.5,131,10.7,1930,147,1783,1.2,16.1,2615,837,1778,7,21.8,-685,-5.7,32.2,0,98,98,533
1988,33,g) 6 to 10,4231,4488,49604,50884,162,3.5,503,10.8,8254,2271,5983,4.5,16.2,10814,3798,7016,7.5,21.3,-2560,-5.1,32.4,0,346,346,2187
1988,33,h) 11 to 15,853,1160,18486,18430,64,5.4,113,9.6,2839,626,2213,3.4,15.4,2727,753,1974,4.1,14.8,112,0.6,29.6,0,56,56,391
1988,33,l) Left Censored,6777,9383,271286,266745,550,5.8,667,7.1,40083,12000,28083,4.5,15,31001,9417,21584,3.5,11.6,9082,3.4,23.2,0,324,324,2033
1988,34,a) 0,18265,18373,100911,50853,18197,198.1,0,0,100117,100117,0,196.9,196.9,0,0,0,0,0,100117,196.9,0,0,,,
1988,34,b) 1,14861,15097,132442,132890,97,0.6,4214,24.3,32985,3379,29606,2.5,24.8,33880,18105,15775,13.6,25.5,-895,-0.7,49.6,0,3243,3243,14164
1988,34,c) 2,12428,12722,99041,101912,476,3.5,2402,17.5,21554,3955,17599,3.9,21.1,27296,11799,15497,11.6,26.8,-5742,-5.7,42.2,0,1878,1878,9446
1988,34,d) 3,10604,10874,93743,95340,369,3.2,1629,14.1,19948,3142,16806,3.3,20.9,23141,9976,13165,10.5,24.3,-3193,-3.4,41.8,0,1289,1289,7424
1988,34,e) 4,8913,9150,99784,101116,292,3,1196,12.5,17433,2108,15325,2.1,17.2,20096,7319,12777,7.2,19.9,-2663,-2.7,34.4,0,922,922,5085
1988,34,f) 5,7125,7427,75392,75884,190,2.4,901,11.6,18537,1199,17338,1.6,24.4,19520,5187,14333,6.8,25.7,-983,-1.3,48.8,0,657,657,3758
1988,34,g) 6 to 10,28801,30206,326369,325726,977,3.1,3004,9.6,58391,8193,50198,2.5,17.9,57104,17936,39168,5.5,17.5,1287,0.4,35,0,2187,2187,11683
1988,34,h) 11 to 15,5647,6643,93986,93763,260,3.8,577,8.5,17025,4164,12861,4.4,18.2,16578,5801,10777,6.2,17.7,447,0.5,35.4,0,345,345,1669
1988,34,l) Left Censored,51937,71697,2133662,2135159,3678,5.1,5577,7.7,303134,89718,213416,4.2,14.2,306128,90309,215819,4.2,14.3,-2994,-0.1,28.4,0,2804,2804,17554
1988,35,a) 0,2847,2889,16075,8123,2856,197.7,0,0,15905,15905,0,195.8,195.8,0,0,0,0,0,15905,195.8,0,0,,,
1988,35,b) 1,2338,2416,22454,24051,19,0.7,877,30.3,4539,378,4161,1.6,18.9,7733,4930,2803,20.5,32.2,-3194,-13.3,37.8,0,700,700,3433
1988,35,c) 2,2062,2115,15943,16665,64,2.7,519,22,3509,289,3220,1.7,21.1,4953,2605,2348,15.6,29.7,-1444,-8.6,42.2,0,413,413,2122
1988,35,d) 3,1796,1884,15213,15986,99,4.9,369,18.2,2887,577,2310,3.6,18.1,4433,2276,2157,14.2,27.7,-1546,-9.6,36.2,0,286,286,1882
1988,35,e) 4,1680,1761,14184,15063,82,4.3,310,16.4,2648,650,1998,4.3,17.6,4406,2114,2292,14,29.3,-1758,-11.7,35.2,0,238,238,1770
1988,35,f) 5,1310,1489,14111,14455,61,3.9,216,13.8,2518,524,1994,3.6,17.4,3205,1349,1856,9.3,22.2,-687,-4.8,34.8,0,151,151,956
1988,35,g) 6 to 10,5381,5786,53646,55197,261,4.3,721,12,9249,1943,7306,3.5,16.8,12350,4193,8157,7.6,22.4,-3101,-5.6,33.6,0,514,514,3062
1988,35,h) 11 to 15,995,1275,14041,13751,71,5.4,143,10.9,3630,695,2935,5.1,26.4,3049,949,2100,6.9,22.2,581,4.2,44.4,0,66,66,359
1988,35,l) Left Censored,7131,10691,220102,219643,679,6.3,920,8.5,31205,8863,22342,4,14.2,30286,9904,20382,4.5,13.8,919,0.4,27.6,0,382,382,2323
1988,36,a) 0,38245,38475,212777,107058,38145,198.3,0,0,211439,211439,0,197.5,197.5,0,0,0,0,0,211439,197.5,0,0,,,
1988,36,b) 1,31864,32395,345643,344131,151,0.4,8747,23.6,69149,6053,63096,1.8,20.1,66125,39321,26804,11.4,19.2,3024,0.9,38.4,0,6884,6884,30199
1988,36,c) 2,26771,27343,203472,207256,872,2.9,5253,17.7,47774,5865,41909,2.8,23.1,55342,28154,27188,13.6,26.7,-7568,-3.6,46.2,0,4245,4245,22761
1988,36,d) 3,23534,24056,201640,205883,775,3,3922,15.3,39474,6651,32823,3.2,19.2,47959,21918,26041,10.6,23.3,-8485,-4.1,38.4,0,3130,3130,18095
1988,36,e) 4,20159,20862,190761,194003,664,3,2966,13.5,35911,5633,30278,2.9,18.5,42396,17835,24561,9.2,21.9,-6485,-3.4,37,0,2323,2323,12965
1988,36,f) 5,16024,16720,157501,160099,551,3.1,2293,13,28711,4596,24115,2.9,17.9,33907,13532,20375,8.5,21.2,-5196,-3.3,35.8,0,1749,1749,10129
1988,36,g) 6 to 10,61478,64857,723296,737210,1998,3,7461,11,115840,15768,100072,2.1,15.7,143667,43653,100014,5.9,19.5,-27827,-3.8,31.4,0,5498,5498,29280
1988,36,h) 11 to 15,11714,14848,245197,240860,592,3.9,1343,8.8,48180,10556,37624,4.4,20,39505,10762,28743,4.5,16.4,8675,3.6,32.8,0,806,807,4309
1988,36,l) Left Censored,118788,158936,4583942,4614930,7004,4.3,13050,8.1,602121,134155,467966,2.9,13,664098,193327,470771,4.2,14.4,-61977,-1.4,26,0,7113,7113,43597
1988,37,a) 0,13029,13220,83577,42007,13090,198,0,0,83140,83140,0,197.9,197.9,0,0,0,0,0,83140,197.9,0,0,,,
1988,37,b) 1,10543,10988,93045,93086,148,1.2,3301,25.9,26053,5271,20782,5.7,28,26135,13857,12278,14.9,28.1,-82,-0.1,56,0,2661,2661,10736
1988,37,c) 2,8972,9362,70574,72246,321,3.1,1942,19,14814,2150,12664,3,20.5,18158,8628,9530,11.9,25.1,-3344,-4.6,41,0,1567,1567,6474
1988,37,d) 3,8082,8421,75472,75883,298,3.3,1391,15.5,15221,2282,12939,3,20.1,16043,8178,7865,10.8,21.1,-822,-1,40.2,0,1094,1094,6531
1988,37,e) 4,8569,9025,73188,73982,274,2.9,988,10.5,13327,2374,10953,3.2,18,14914,5754,9160,7.8,20.2,-1587,-2.2,36,0,719,719,3680
1988,37,f) 5,5021,5266,50190,51798,153,2.8,619,11.2,7472,1026,6446,2,14.4,10688,3893,6795,7.5,20.6,-3216,-6.2,28.8,0,463,463,2497
1988,37,g) 6 to 10,19617,21418,252240,251138,830,3.8,2177,9.8,43351,12120,31231,4.8,17.3,41146,15502,25644,6.2,16.4,2205,0.9,32.8,0,1518,1518,9431
1988,37,h) 11 to 15,3818,5114,74362,72038,279,5.4,398,7.7,14476,4248,10228,5.9,20.1,9827,3188,6639,4.4,13.6,4649,6.5,27.2,0,233,233,1236
1988,37,l) Left Censored,34022,55940,1732127,1710931,3531,6.3,4299,7.6,235410,65131,170279,3.8,13.8,193017,64738,128279,3.8,11.3,42393,2.5,22.6,0,1561,1561,10317
1988,38,a) 0,1253,1266,7095,3561,1252,197.8,0,0,7068,7068,0,198.5,198.5,0,0,0,0,0,7068,198.5,0,0,,,
1988,38,b) 1,1089,1106,7725,8048,3,0.2,338,26.2,1707,21,1686,0.3,21.2,2352,1641,711,20.4,29.2,-645,-8,42.4,0,244,244,1082
1988,38,c) 2,894,914,5809,5920,29,2.9,169,17.1,1105,283,822,4.8,18.7,1326,602,724,10.2,22.4,-221,-3.7,37.4,0,121,121,496
1988,38,d) 3,870,903,5634,5792,32,3.3,160,16.5,938,117,821,2,16.2,1253,616,637,10.6,21.6,-315,-5.4,32.4,0,121,121,491
1988,38,e) 4,855,893,5474,5332,35,3.8,112,12,1241,118,1123,2.2,23.3,957,282,675,5.3,17.9,284,5.4,35.8,0,83,83,209
1988,38,f) 5,624,724,6103,5968,26,3.4,92,12.2,1143,221,922,3.7,19.2,872,380,492,6.4,14.6,271,4.6,29.2,0,73,73,344
1988,38,g) 6 to 10,2895,3076,22833,23398,117,3.7,318,10,3295,737,2558,3.1,14.1,4425,1755,2670,7.5,18.9,-1130,-4.8,28.2,0,217,217,1100
1988,38,h) 11 to 15,597,704,5887,5922,23,3.2,57,7.9,684,73,611,1.2,11.6,754,231,523,3.9,12.7,-70,-1.1,23.2,0,32,32,111
1988,38,l) Left Censored,5267,7064,116819,116676,267,3.7,556,7.7,13314,2797,10517,2.4,11.4,13028,4908,8120,4.2,11.2,286,0.2,22.4,0,250,250,1388
1988,39,a) 0,16541,16782,109069,55402,16592,197.7,0,0,107334,107334,0,193.7,193.7,0,0,0,0,0,107334,193.7,0,0,,,
1988,39,b) 1,14234,14764,147499,146070,219,1.3,4155,24.5,38172,8865,29307,6.1,26.1,35314,21075,14239,14.4,24.2,2858,1.9,48.4,0,3103,3103,13829
1988,39,c) 2,11757,12337,110371,111608,454,3.4,2532,18.9,24278,4668,19610,4.2,21.8,26751,13686,13065,12.3,24,-2473,-2.2,43.6,0,1838,1838,9847
1988,39,d) 3,10470,10991,111921,115677,355,3,1681,14.4,21166,3455,17711,3,18.3,28678,10852,17826,9.4,24.8,-7512,-6.5,36.6,0,1230,1230,7576
1988,39,e) 4,9848,10357,96022,97076,366,3.4,1269,11.7,17535,2877,14658,3,18.1,19643,8970,10673,9.2,20.2,-2108,-2.1,36.2,0,944,944,6329
1988,39,f) 5,6977,7643,79702,80028,343,4.3,886,11.2,15347,3373,11974,4.2,19.2,15998,5616,10382,7,20,-651,-0.8,38.4,0,673,673,3574
1988,39,g) 6 to 10,30672,33655,387893,383326,1168,3.4,3166,9.1,72379,23757,48622,6.2,18.9,63244,21238,42006,5.5,16.5,9135,2.4,33,0,2170,2170,13156
1988,39,h) 11 to 15,6438,9049,136535,131117,437,4.8,718,7.8,31216,4215,27001,3.2,23.8,20379,5713,14666,4.4,15.5,10837,8.3,31,0,335,335,2264
1988,39,l) Left Censored,63202,99108,2830749,2818781,5210,5.2,7716,7.7,361735,99701,262034,3.5,12.8,337800,107123,230677,3.8,12,23935,0.8,24,0,3181,3182,19646
1988,40,a) 0,5479,5517,34015,17102,5461,198,0,0,33827,33827,0,197.8,197.8,0,0,0,0,0,33827,197.8,0,0,,,
1988,40,b) 1,4360,4524,47210,48038,37,0.7,1746,31.9,11432,877,10555,1.8,23.8,13087,8562,4525,17.8,27.2,-1655,-3.4,47.6,0,1455,1455,7187
1988,40,c) 2,3909,4031,30236,31803,169,3.7,1071,23.7,6450,1349,5101,4.2,20.3,9584,5474,4110,17.2,30.1,-3134,-9.8,40.6,0,882,882,4256
1988,40,d) 3,3624,3752,27330,28688,138,3.4,819,19.9,5384,768,4616,2.7,18.8,8099,4468,3631,15.6,28.2,-2715,-9.4,37.6,0,620,620,3638
1988,40,e) 4,3736,3869,33061,32202,117,2.8,730,17.5,8214,916,7298,2.8,25.5,6495,3113,3382,9.7,20.2,1719,5.3,40.4,0,498,498,1984
1988,40,f) 5,2625,2839,23137,23769,124,4.1,509,16.8,4359,816,3543,3.4,18.3,5622,3271,2351,13.8,23.7,-1263,-5.4,36.6,0,369,369,2258
1988,40,g) 6 to 10,11312,12050,104430,107322,467,3.7,1722,13.5,17424,3772,13652,3.5,16.2,23208,10892,12316,10.1,21.6,-5784,-5.4,32.4,0,1158,1158,6122
1988,40,h) 11 to 15,1922,2659,31683,32287,153,5.6,290,10.6,5060,1446,3614,4.5,15.7,6267,2366,3901,7.3,19.4,-1207,-3.7,31.4,0,157,157,614
1988,40,l) Left Censored,16635,25590,544886,546144,1469,5.6,2387,9.2,74578,21424,53154,3.9,13.7,77093,25619,51474,4.7,14.1,-2515,-0.4,27.4,0,1054,1054,5870
1988,41,a) 0,6678,6727,36386,18334,6657,197.9,0,0,36105,36105,0,196.9,196.9,0,0,0,0,0,36105,196.9,0,0,,,
1988,41,b) 1,5597,5775,46289,46487,43,0.6,1899,27.9,12720,924,11796,2,27.4,13116,7677,5439,16.5,28.2,-396,-0.8,54.8,0,1538,1538,6317
1988,41,c) 2,4585,4710,35035,35065,249,4.8,1060,20.6,9675,1569,8106,4.5,27.6,9734,5471,4263,15.6,27.8,-59,-0.2,55.2,0,831,831,4659
1988,41,d) 3,3866,4008,31751,32357,204,4.7,805,18.6,6879,1632,5247,5,21.3,8091,3980,4111,12.3,25,-1212,-3.7,42.6,0,643,643,3116
1988,41,e) 4,3486,3639,33512,33204,138,3.6,608,15.7,7265,750,6515,2.3,21.9,6649,3275,3374,9.9,20,616,1.9,40,0,460,460,2213
1988,41,f) 5,2536,2878,34321,34608,103,3.4,406,13.4,5376,713,4663,2.1,15.5,5950,2364,3586,6.8,17.2,-574,-1.7,31,0,271,271,1434
1988,41,g) 6 to 10,11678,12537,112722,113700,531,4.1,1489,11.4,19758,3523,16235,3.1,17.4,21713,9046,12667,8,19.1,-1955,-1.7,34.8,0,984,984,5554
1988,41,h) 11 to 15,2176,2814,40100,39462,175,6.2,249,8.8,6993,1365,5628,3.5,17.7,5717,2224,3493,5.6,14.5,1276,3.2,29,0,139,139,722
1988,41,l) Left Censored,16126,24213,540358,534360,1438,5.9,1931,7.9,80803,21619,59184,4,15.1,68807,24607,44200,4.6,12.9,11996,2.2,25.8,0,857,857,5229
1988,42,a) 0,19877,20147,124220,62524,19949,198,0,0,123392,123392,0,197.4,197.4,0,0,0,0,0,123392,197.4,0,0,,,
1988,42,b) 1,17104,17598,165248,163988,142,0.7,4480,22.4,41728,7708,34020,4.7,25.4,39208,22435,16773,13.7,23.9,2520,1.5,47.8,0,3519,3522,16744
1988,42,c) 2,14404,14903,128859,138130,536,3.3,2640,16.5,27957,4627,23330,3.3,20.2,46499,30256,16243,21.9,33.7,-18542,-13.5,40.4,0,2101,2101,27702
1988,42,d) 3,12497,13001,132777,133974,448,3.3,1856,13.5,24935,4075,20860,3,18.6,27329,11613,15716,8.7,20.4,-2394,-1.8,37.2,0,1465,1465,8593
1988,42,e) 4,11529,12306,129349,130742,392,3,1471,11.4,21444,2832,18612,2.2,16.4,24230,8919,15311,6.8,18.5,-2786,-2.1,32.8,0,1088,1088,6337
1988,42,f) 5,8191,8664,88401,89366,273,3,943,10.5,14177,2332,11845,2.6,15.9,16107,5514,10593,6.2,18,-1930,-2.1,31.8,0,703,703,4012
1988,42,g) 6 to 10,34403,37112,418089,421504,1260,3.3,3544,9.3,63130,10896,52234,2.6,15,69959,25419,44540,6,16.6,-6829,-1.6,30,0,2439,2439,15173
1988,42,h) 11 to 15,7235,9519,150768,148741,503,5.2,786,8.2,24389,5975,18414,4,16.4,20334,6027,14307,4.1,13.7,4055,2.7,27.4,0,387,387,2260
1988,42,l) Left Censored,72026,107162,3019249,3009091,5104,4.7,8251,7.6,389554,100806,288748,3.4,12.9,369238,121919,247319,4.1,12.3,20316,0.6,24.6,0,3762,3762,25230
1988,44,a) 0,2468,2482,13040,6658,2456,197.9,0,0,12764,12764,0,191.7,191.7,0,0,0,0,0,12764,191.7,0,0,,,
1988,44,b) 1,2007,2051,16327,16754,13,0.5,605,25.4,3922,582,3340,3.5,23.4,4775,2969,1806,17.7,28.5,-853,-5.1,46.8,0,471,471,1954
1988,44,c) 2,1577,1608,11257,11662,59,3.4,307,17.6,2561,479,2082,4.1,22,3370,1923,1447,16.5,28.9,-809,-6.9,44,0,246,246,1506
1988,44,d) 3,1382,1404,12962,12651,49,3.3,210,14.2,3039,189,2850,1.5,24,2417,1080,1337,8.5,19.1,622,4.9,38.2,0,163,163,926
1988,44,e) 4,1189,1214,12299,12288,32,2.5,156,12.3,2064,171,1893,1.4,16.8,2042,862,1180,7,16.6,22,0.2,33.2,0,115,115,566
1988,44,f) 5,851,882,8281,8394,33,3.6,93,10.1,1484,482,1002,5.7,17.7,1710,560,1150,6.7,20.4,-226,-2.7,35.4,0,68,68,322
1988,44,g) 6 to 10,3483,3652,42878,42386,105,2.8,371,9.8,8177,723,7454,1.7,19.3,7193,2819,4374,6.7,17,984,2.3,34,0,253,253,1545
1988,44,h) 11 to 15,783,919,14271,14473,37,4,67,7.2,1936,322,1614,2.2,13.4,2339,415,1924,2.9,16.2,-403,-2.8,26.8,0,47,47,248
1988,44,l) Left Censored,7617,9559,270011,272660,389,4,854,8.7,32249,7458,24791,2.7,11.8,37547,12928,24619,4.7,13.8,-5298,-2,23.6,0,403,403,2790
1988,45,a) 0,6524,6607,55072,27662,6551,198.3,0,0,54821,54821,0,198.2,198.2,0,0,0,0,0,54821,198.2,0,0,,,
1988,45,b) 1,5291,5504,59516,57944,54,0.8,1743,27.1,16534,3764,12770,6.5,28.5,13389,7528,5861,13,23.1,3145,5.4,46.2,0,1392,1392,5968
1988,45,c) 2,4374,4554,35062,35717,242,4.9,940,19.1,8495,1293,7202,3.6,23.8,9804,4472,5332,12.5,27.4,-1309,-3.6,47.6,0,773,773,3748
1988,45,d) 3,4036,4235,36288,36709,214,4.8,680,15.2,7749,1643,6106,4.5,21.1,8590,3830,4760,10.4,23.4,-841,-2.3,42.2,0,545,545,2818
1988,45,e) 4,3945,4208,38482,38710,175,4,510,11.6,6791,1328,5463,3.4,17.5,7247,2820,4427,7.3,18.7,-456,-1.2,35,0,387,387,2222
1988,45,f) 5,2432,2522,25208,25837,92,3.5,333,12.6,4555,1273,3282,4.9,17.6,5813,2131,3682,8.2,22.5,-1258,-4.9,35.2,0,251,251,1546
1988,45,g) 6 to 10,9740,10663,121820,122428,409,3.7,1156,10.5,20116,4619,15497,3.8,16.4,21332,8132,13200,6.6,17.4,-1216,-1,32.8,0,797,797,5757
1988,45,h) 11 to 15,1861,2410,28580,27766,117,4.8,193,7.9,5473,1271,4202,4.6,19.7,3844,1170,2674,4.2,13.8,1629,5.9,27.6,0,98,98,383
1988,45,l) Left Censored,16326,26438,757725,748283,1584,5.9,2215,8.3,104515,32537,71978,4.3,14,85631,31002,54629,4.1,11.4,18884,2.6,22.8,0,886,886,4764
1988,46,a) 0,1349,1379,7414,3809,1360,197.2,0,0,7210,7210,0,189.3,189.3,0,0,0,0,0,7210,189.3,0,0,,,
1988,46,b) 1,1150,1178,10277,10547,11,0.8,351,25.8,1804,135,1669,1.3,17.1,2344,1405,939,13.3,22.2,-540,-5.1,34.2,0,268,268,960
1988,46,c) 2,926,947,5727,6020,53,5.2,191,18.7,1291,442,849,7.3,21.4,1877,818,1059,13.6,31.2,-586,-9.8,42.8,0,149,149,643
1988,46,d) 3,954,971,5876,5973,44,4.3,154,15,1056,211,845,3.5,17.7,1250,630,620,10.5,20.9,-194,-3.2,35.4,0,107,107,492
1988,46,e) 4,935,972,5759,5999,42,4.2,124,12.3,941,219,722,3.7,15.7,1421,649,772,10.8,23.7,-480,-8,31.4,0,92,92,508
1988,46,f) 5,624,729,5248,5386,24,3.2,87,11.4,872,218,654,4,16.2,1147,725,422,13.5,21.3,-275,-5.1,32.4,0,63,63,242
1988,46,g) 6 to 10,2819,2971,27132,26769,123,4,288,9.4,4223,704,3519,2.6,15.8,3497,1284,2213,4.8,13.1,726,2.7,26.2,0,188,188,794
1988,46,h) 11 to 15,603,747,6051,5967,45,5.9,77,10.1,911,208,703,3.5,15.3,743,289,454,4.8,12.5,168,2.8,25,0,42,42,99
1988,46,l) Left Censored,5593,7169,120758,120254,274,3.7,590,8,14410,3563,10847,3,12,13402,5000,8402,4.2,11.1,1008,0.9,22.2,0,293,293,1779
1988,47,a) 0,8945,9054,55877,28116,8975,198.3,0,0,55523,55523,0,197.5,197.5,0,0,0,0,0,55523,197.5,0,0,,,
1988,47,b) 1,7321,7614,74107,75367,95,1.1,2572,28.7,18294,3446,14848,4.6,24.3,20813,13357,7456,17.7,27.6,-2519,-3.3,48.6,0,2133,2133,11151
1988,47,c) 2,6074,6305,59085,59119,224,3.2,1398,20.2,15480,3272,12208,5.5,26.2,15548,8182,7366,13.8,26.3,-68,-0.1,52.4,0,1134,1134,6633
1988,47,d) 3,5179,5402,55293,53331,203,3.5,963,16.6,17794,7509,10285,14.1,33.4,13869,7203,6666,13.5,26,3925,7.4,52,0,765,765,4738
1988,47,e) 4,5660,5814,50612,52425,187,3.1,674,11.1,8092,1208,6884,2.3,15.4,11717,5341,6376,10.2,22.4,-3625,-7,30.8,0,528,528,3363
1988,47,f) 5,3520,3766,37032,38138,124,3.1,463,11.8,6264,1030,5234,2.7,16.4,8476,3231,5245,8.5,22.2,-2212,-5.8,32.8,0,360,360,2385
1988,47,g) 6 to 10,13866,15152,179081,178500,603,3.9,1556,9.9,31350,7375,23975,4.1,17.6,30187,10613,19574,5.9,16.9,1163,0.7,33.8,0,1096,1096,7177
1988,47,h) 11 to 15,2939,4305,70031,61503,485,11.4,358,8.4,26314,19927,6387,32.4,42.8,9257,3247,6010,5.3,15.1,17057,27.7,30.2,0,187,187,941
1988,47,l) Left Censored,24936,39399,1160887,1155528,2481,6.2,3087,7.8,166958,52858,114100,4.6,14.4,156239,56343,99896,4.9,13.5,10719,0.9,27,0,1197,1197,7593
1988,48,a) 0,31016,31662,211529,107156,31350,198,0,0,208747,208747,0,194.8,194.8,0,0,0,0,0,208747,194.8,0,0,,,
1988,48,b) 1,25274,26449,263988,270891,385,1.2,9922,31.3,69915,12182,57733,4.5,25.8,83720,51383,32337,19,30.9,-13805,-5.1,51.6,0,8299,8299,43207
1988,48,c) 2,22123,23176,190656,199321,943,3.6,6393,24.5,49067,8680,40387,4.4,24.6,66396,36279,30117,18.2,33.3,-17329,-8.7,49.2,0,5385,5385,30471
1988,48,d) 3,19601,20748,177750,186511,951,4.2,4666,20.6,39427,7909,31518,4.2,21.1,56949,27953,28996,15,30.5,-17522,-9.4,42.2,0,3885,3885,23456
1988,48,e) 4,18596,19758,171226,180141,692,3.2,3661,17.2,33269,6084,27185,3.4,18.5,51098,24458,26640,13.6,28.4,-17829,-9.9,37,0,2870,2870,18182
1988,48,f) 5,14279,15476,146517,151059,625,3.8,2610,15.8,28031,5054,22977,3.3,18.6,37115,16695,20420,11.1,24.6,-9084,-6,37.2,0,1987,1987,11149
1988,48,g) 6 to 10,57356,63031,650041,666568,2522,3.8,8765,13.2,114824,21978,92846,3.3,17.2,147877,60854,87023,9.1,22.2,-33053,-5,34.4,0,6106,6106,39195
1988,48,h) 11 to 15,9258,13299,177813,181291,826,6,1612,11.8,33039,9660,23379,5.3,18.2,39994,14443,25551,8,22.1,-6955,-3.9,36.4,0,793,793,5051
1988,48,l) Left Censored,69380,127808,3415576,3422946,8936,6.9,12470,9.6,526903,176827,350076,5.2,15.4,541644,193232,348412,5.6,15.8,-14741,-0.4,30.8,0,4625,4625,28206
1988,49,a) 0,3034,3095,23067,11613,3068,198.3,0,0,22909,22909,0,197.3,197.3,0,0,0,0,0,22909,197.3,0,0,,,
1988,49,b) 1,2341,2406,19749,20794,16,0.5,971,33.2,5461,527,4934,2.5,26.3,7551,5506,2045,26.5,36.3,-2090,-10,52.6,0,795,795,4234
1988,49,c) 2,1901,1958,20478,21080,86,3.9,523,23.8,4436,809,3627,3.8,21,5640,3033,2607,14.4,26.8,-1204,-5.8,42,0,418,418,2243
1988,49,d) 3,1742,1823,16790,17145,73,3.7,374,18.9,3596,609,2987,3.6,21,4306,2194,2112,12.8,25.1,-710,-4.1,42,0,301,301,1907
1988,49,e) 4,1466,1526,14542,15541,53,3.2,303,18.3,3153,559,2594,3.6,20.3,5151,2732,2419,17.6,33.1,-1998,-12.8,40.6,0,243,243,1987
1988,49,f) 5,1146,1335,16224,16804,57,4,212,15,2295,342,1953,2,13.7,3455,1288,2167,7.7,20.6,-1160,-6.9,27.4,0,164,164,1013
1988,49,g) 6 to 10,5282,5794,66514,67563,248,4.1,693,11.5,12475,2723,9752,4,18.5,14573,6524,8049,9.7,21.6,-2098,-3.1,37,0,456,456,3643
1988,49,h) 11 to 15,989,1254,17850,17630,98,7.7,133,10.4,3696,1257,2439,7.1,21,3256,1336,1920,7.6,18.5,440,2.5,37,0,67,67,353
1988,49,l) Left Censored,7612,11665,304364,304321,817,6.9,1038,8.8,42618,12856,29762,4.2,14,42531,14129,28402,4.6,14,87,0,28,0,391,391,3352
1988,50,a) 0,1892,1895,8877,4475,1872,197.6,0,0,8804,8804,0,196.7,196.7,0,0,0,0,0,8804,196.7,0,0,,,
1988,50,b) 1,1546,1566,10264,10862,10,0.6,425,23.7,2253,155,2098,1.4,20.7,3449,2358,1091,21.7,31.8,-1196,-11.1,41.4,0,332,332,1573
1988,50,c) 2,1360,1384,9181,9360,45,3,242,16.3,1858,178,1680,1.9,19.9,2216,1047,1169,11.2,23.7,-358,-3.8,39.8,0,199,199,804
1988,50,d) 3,1088,1124,8587,8491,38,3.2,183,15.3,1852,119,1733,1.4,21.8,1659,739,920,8.7,19.5,193,2.3,39,0,147,147,621
1988,50,e) 4,1001,1038,7942,7913,31,2.8,131,12,1494,317,1177,4,18.9,1435,609,826,7.7,18.1,59,0.8,36.2,0,100,100,454
1988,50,f) 5,667,697,4383,4547,30,4.1,87,12,668,167,501,3.7,14.7,995,432,563,9.5,21.9,-327,-7.2,29.4,0,66,66,357
1988,50,g) 6 to 10,2580,2700,25237,25396,83,3,271,9.7,3777,456,3321,1.8,14.9,4094,1667,2427,6.6,16.1,-317,-1.2,29.8,0,203,203,989
1988,50,h) 11 to 15,515,648,7943,8186,19,2.8,57,8.5,957,82,875,1,11.7,1443,411,1032,5,17.6,-486,-5.9,23.4,0,28,28,301
1988,50,l) Left Censored,4136,5432,123431,124945,240,4.3,421,7.6,13972,4055,9917,3.2,11.2,16999,5513,11486,4.4,13.6,-3027,-2.4,22.4,0,206,206,1831
1988,51,a) 0,12373,12503,76708,38567,12396,198.3,0,0,76282,76282,0,197.8,197.8,0,0,0,0,0,76282,197.8,0,0,,,
1988,51,b) 1,10000,10305,86912,85755,96,0.8,3021,25.4,26279,3214,23065,3.7,30.6,23964,14417,9547,16.8,27.9,2315,2.7,55.8,0,2386,2386,10865
1988,51,c) 2,8559,8888,73678,73630,365,3.8,1736,18.1,18563,3456,15107,4.7,25.2,18467,9490,8977,12.9,25.1,96,0.1,50.2,0,1381,1381,7695
1988,51,d) 3,7411,7826,75312,74723,267,3.2,1241,14.9,16813,1585,15228,2.1,22.5,15634,6571,9063,8.8,20.9,1179,1.6,41.8,0,982,982,5252
1988,51,e) 4,6541,6774,59883,60849,212,3,905,12.7,11178,1775,9403,2.9,18.4,13109,5493,7616,9,21.5,-1931,-3.1,36.8,0,689,689,4335
1988,51,f) 5,4272,4554,46231,45409,161,3.4,634,13.2,10753,4056,6697,8.9,23.7,9108,4083,5025,9,20.1,1645,3.6,40.2,0,463,463,2480
1988,51,g) 6 to 10,17682,19279,241684,241179,850,4.3,1869,9.4,42274,11178,31096,4.6,17.5,41264,13223,28041,5.5,17.1,1010,0.4,34.2,0,1255,1255,7478
1988,51,h) 11 to 15,3320,4742,77314,76925,306,6.4,395,8.3,14206,4994,9212,6.5,18.5,13428,4534,8894,5.9,17.5,778,1,35,0,173,173,1224
1988,51,l) Left Censored,29313,49799,1421574,1408623,3251,6.5,3730,7.4,202845,63022,139823,4.5,14.4,176945,61427,115518,4.4,12.6,25900,1.8,25.2,0,1401,1401,8251
1988,53,a) 0,10728,10874,60140,30351,10758,197.9,0,0,59578,59578,0,196.3,196.3,0,0,0,0,0,59578,196.3,0,0,,,
1988,53,b) 1,8696,8980,75644,75802,74,0.7,2902,27.4,19856,1681,18175,2.2,26.2,20172,11468,8704,15.1,26.6,-316,-0.4,52.4,0,2233,2233,8890
1988,53,c) 2,7371,7671,56471,58061,333,4,1670,19.9,13854,2400,11454,4.1,23.9,17033,8374,8659,14.4,29.3,-3179,-5.4,47.8,0,1298,1298,6909
1988,53,d) 3,6255,6521,54296,54430,299,4.3,1166,16.7,12238,2173,10065,4,22.5,12506,5843,6663,10.7,23,-268,-0.5,45,0,907,907,4339
1988,53,e) 4,5966,6303,55183,55931,256,3.8,985,14.7,11744,1549,10195,2.8,21,13240,5655,7585,10.1,23.7,-1496,-2.7,42,0,685,685,4293
1988,53,f) 5,4359,4784,53928,54297,212,4.2,592,11.9,9832,2167,7665,4,18.1,10569,3909,6660,7.2,19.5,-737,-1.4,36.2,0,441,441,2503
1988,53,g) 6 to 10,18041,19420,190392,191744,783,3.9,2117,10.5,33008,5037,27971,2.6,17.2,35711,13150,22561,6.9,18.6,-2703,-1.4,34.4,0,1440,1440,8833
1988,53,h) 11 to 15,3378,4318,57285,56821,268,6.1,423,9.6,10062,2416,7646,4.3,17.7,9134,3065,6069,5.4,16.1,928,1.6,32.2,0,191,191,1004
1988,53,l) Left Censored,23979,37116,897574,883874,2510,6.7,3233,8.6,153122,36995,116127,4.2,17.3,125722,46230,79492,5.2,14.2,27400,3.1,28.4,0,1302,1304,9448
1988,54,a) 0,2752,2777,16161,8123,2743,197.6,0,0,16076,16076,0,197.9,197.9,0,0,0,0,0,16076,197.9,0,0,,,
1988,54,b) 1,2267,2324,19734,20175,14,0.5,749,27.5,4443,90,4353,0.4,22,5325,3398,1927,16.8,26.4,-882,-4.4,44,0,624,624,3065
1988,54,c) 2,1896,1981,16144,15778,77,3.6,404,18.7,4283,646,3637,4.1,27.1,3551,1854,1697,11.8,22.5,732,4.6,45,0,332,332,1587
1988,54,d) 3,1728,1821,25106,24965,85,4.5,269,14.1,3365,613,2752,2.5,13.5,3082,1247,1835,5,12.3,283,1.2,24.6,0,217,217,1040
1988,54,e) 4,1715,1739,11510,11861,48,2.6,214,11.7,1670,309,1361,2.6,14.1,2372,983,1389,8.3,20,-702,-5.9,28.2,0,174,174,867
1988,54,f) 5,1072,1155,8946,9158,41,3.4,154,12.7,1546,339,1207,3.7,16.9,1969,593,1376,6.5,21.5,-423,-4.6,33.8,0,111,111,416
1988,54,g) 6 to 10,4767,5147,46901,47751,176,3.3,530,10,6858,1494,5364,3.1,14.4,8558,3004,5554,6.3,17.9,-1700,-3.5,28.8,0,357,357,2132
1988,54,h) 11 to 15,1042,1337,16304,16461,63,4.6,137,10,2528,623,1905,3.8,15.4,2842,830,2012,5,17.3,-314,-1.9,30.8,0,68,68,220
1988,54,l) Left Censored,10272,14692,291568,293517,677,4.5,1158,7.8,36566,10350,26216,3.5,12.5,40464,13724,26740,4.7,13.8,-3898,-1.3,25,0,512,512,3278
1988,55,a) 0,8204,8330,49653,24949,8254,198.2,0,0,49409,49409,0,198,198,0,0,0,0,0,49409,198,0,0,,,
1988,55,b) 1,7418,7827,77708,77736,76,0.9,1970,22.2,16209,1827,14382,2.4,20.9,16265,9866,6399,12.7,20.9,-56,0,41.8,0,1457,1457,6701
1988,55,c) 2,6020,6152,54903,54840,167,2.5,1048,15.8,11767,1369,10398,2.5,21.5,11640,5732,5908,10.5,21.2,127,0.3,42.4,0,819,819,4409
1988,55,d) 3,5524,5789,47929,49252,144,2.4,777,12.7,9074,1445,7629,2.9,18.4,11720,5914,5806,12,23.8,-2646,-5.4,36.8,0,618,618,5050
1988,55,e) 4,5227,5500,49678,50678,118,2.1,623,10.8,8341,1058,7283,2.1,16.5,10341,4050,6291,8,20.4,-2000,-3.9,33,0,489,489,2961
1988,55,f) 5,3493,3823,39879,40273,89,2.2,426,10.7,5709,583,5126,1.4,14.2,6496,2617,3879,6.5,16.1,-787,-1.9,28.4,0,332,332,2003
1988,55,g) 6 to 10,15957,16928,176107,174477,497,2.8,1612,9.2,27630,5308,22322,3,15.8,24369,8441,15928,4.8,14,3261,1.8,28,0,1174,1174,5927
1988,55,h) 11 to 15,3342,4547,56673,55697,258,5.6,358,7.8,8945,1814,7131,3.3,16.1,6992,2009,4983,3.6,12.6,1953,3.5,25.2,0,209,209,916
1988,55,l) Left Censored,32437,45351,1243690,1227701,1961,4.3,3134,6.8,157493,41241,116252,3.4,12.8,125514,37218,88296,3,10.2,31979,2.6,20.4,0,1565,1565,10182
1988,56,a) 0,1001,1007,4939,2485,998,198.2,0,0,4908,4908,0,197.5,197.5,0,0,0,0,0,4908,197.5,0,0,,,
1988,56,b) 1,818,832,6052,6436,5,0.5,334,33,1092,40,1052,0.6,17,1860,1213,647,18.8,28.9,-768,-11.9,34,0,266,266,995
1988,56,c) 2,763,775,4267,4397,35,4.2,158,18.7,914,171,743,3.9,20.8,1173,558,615,12.7,26.7,-259,-5.9,41.6,0,115,115,407
1988,56,d) 3,742,756,4985,5109,33,4,157,19.2,1066,77,989,1.5,20.9,1313,651,662,12.7,25.7,-247,-4.8,41.8,0,127,127,529
1988,56,e) 4,684,703,4835,4978,21,2.8,108,14.5,733,47,686,0.9,14.7,1019,551,468,11.1,20.5,-286,-5.8,29.4,0,83,83,424
1988,56,f) 5,531,624,4946,5048,25,3.8,83,12.7,900,330,570,6.5,17.8,1104,618,486,12.2,21.9,-204,-4.1,35.6,0,60,60,325
1988,56,g) 6 to 10,2563,2727,18648,19319,105,3.7,342,12,3010,357,2653,1.8,15.6,4351,1646,2705,8.5,22.5,-1341,-6.9,31.2,0,230,230,1106
1988,56,h) 11 to 15,429,529,5595,5761,19,3.5,61,11.1,899,102,797,1.8,15.6,1231,346,885,6,21.4,-332,-5.8,31.2,0,29,29,106
1988,56,l) Left Censored,3234,4431,65193,66074,239,5.3,402,8.9,8516,2638,5878,4,12.9,10277,3697,6580,5.6,15.6,-1761,-2.7,25.8,0,150,150,860
1989,01,a) 0,6756,6852,41054,20629,6795,198.3,0,0,40851,40851,0,198,198,0,0,0,0,0,40851,198,0,0,,,
1989,01,b) 1,5200,5291,44312,44356,41,0.7,1580,25.9,12175,1133,11042,2.6,27.4,12262,7842,4420,17.7,27.6,-87,-0.2,54.8,0,1275,1275,6565
1989,01,c) 2,4928,5159,54245,56316,199,3.5,1093,19.5,9306,1648,7658,2.9,16.5,13448,8381,5067,14.9,23.9,-4142,-7.4,33,0,847,849,6330
1989,01,d) 3,4144,4352,41766,42233,203,4.4,737,16,8128,1974,6154,4.7,19.2,9061,3777,5284,8.9,21.5,-933,-2.3,38.4,0,563,563,3010
1989,01,e) 4,3558,3740,35805,35792,214,5.5,584,14.9,7169,1620,5549,4.5,20,7142,3795,3347,10.6,20,27,0,40,0,452,453,2999
1989,01,f) 5,3886,4076,38566,38508,183,4.4,431,10.3,6084,1620,4464,4.2,15.8,5967,2120,3847,5.5,15.5,117,0.3,31,0,332,332,1457
1989,01,g) 6 to 10,10531,11516,156552,154416,500,4.2,1202,10.1,25986,6063,19923,3.9,16.8,21714,7414,14300,4.8,14.1,4272,2.7,28.2,0,882,893,5020
1989,01,h) 11 to 15,4245,5538,70248,70038,262,4.7,452,8,11132,2087,9045,3,15.9,10711,3146,7565,4.5,15.3,421,0.6,30.6,0,277,277,1538
1989,01,l) Left Censored,18058,29490,806666,797085,1612,5.4,2079,7,112178,34172,78006,4.3,14.1,93016,24605,68411,3.1,11.7,19162,2.4,23.4,0,1032,1043,8009
1989,02,a) 0,977,983,9768,4928,976,198.6,0,0,9680,9680,0,196.4,196.4,0,0,0,0,0,9680,196.4,0,0,,,
1989,02,b) 1,729,759,6553,6960,10,1,466,46.8,1794,191,1603,2.7,25.8,2607,1893,714,27.2,37.5,-813,-11.7,51.6,0,207,207,805
1989,02,c) 2,680,712,11278,10065,40,4.7,317,37.1,4918,624,4294,6.2,48.9,2491,1803,688,17.9,24.7,2427,24.2,49.4,0,126,126,862
1989,02,d) 3,671,703,5637,6211,31,3.8,275,33.4,1126,90,1036,1.4,18.1,2273,1288,985,20.7,36.6,-1147,-18.5,36.2,0,114,114,492
1989,02,e) 4,624,673,5786,6121,38,4.9,237,30.7,1122,139,983,2.3,18.3,1791,1208,583,19.7,29.3,-669,-11,36.6,0,88,88,270
1989,02,f) 5,576,623,4751,4943,40,5.8,178,25.6,1114,265,849,5.4,22.5,1497,918,579,18.6,30.3,-383,-7.8,45,0,68,68,333
1989,02,g) 6 to 10,1733,1979,16124,17765,71,3.2,511,23.4,2752,440,2312,2.5,15.5,6033,3667,2366,20.6,34,-3281,-18.5,31,0,156,156,819
1989,02,h) 11 to 15,597,787,8602,9149,51,6.1,155,18.4,1417,396,1021,4.3,15.5,2510,1335,1175,14.6,27.4,-1093,-11.9,31,0,36,36,154
1989,02,l) Left Censored,1931,3165,68776,68480,238,7.2,480,14.6,11986,4335,7651,6.3,17.5,11393,5634,5759,8.2,16.6,593,0.9,33.2,0,89,92,482
1989,04,a) 0,7921,8058,52898,26553,8018,199,0,0,52691,52691,0,198.4,198.4,0,0,0,0,0,52691,198.4,0,0,,,
1989,04,b) 1,6061,6206,52838,53366,56,0.8,2085,28.6,16957,781,16176,1.5,31.8,18012,10613,7399,19.9,33.8,-1055,-2,63.6,0,1620,1620,8998
1989,04,c) 2,5520,5810,63733,66673,254,3.9,1515,23.5,13718,2469,11249,3.7,20.6,19600,12397,7203,18.6,29.4,-5882,-8.8,41.2,0,1197,1201,10644
1989,04,d) 3,4738,4972,43400,45998,205,3.8,1069,19.8,8762,1243,7519,2.7,19,13958,7410,6548,16.1,30.3,-5196,-11.3,38,0,844,845,5991
1989,04,e) 4,4148,4345,46925,48082,161,3.4,804,17.2,10160,3072,7088,6.4,21.1,12474,6310,6164,13.1,25.9,-2314,-4.8,42.2,0,591,591,4772
1989,04,f) 5,3629,3992,37662,38955,177,4.2,629,14.9,7509,1448,6061,3.7,19.3,10094,5097,4997,13.1,25.9,-2585,-6.6,38.6,0,441,445,3623
1989,04,g) 6 to 10,11982,13598,173090,176352,638,4.5,1793,12.7,29494,6822,22672,3.9,16.7,36018,15651,20367,8.9,20.4,-6524,-3.7,33.4,0,1214,1219,9925
1989,04,h) 11 to 15,3439,4365,65220,66019,246,5.5,504,11.2,10090,2306,7784,3.5,15.3,11687,4484,7203,6.8,17.7,-1597,-2.4,30.6,0,292,304,2424
1989,04,l) Left Censored,11933,22512,670371,665755,1724,7.6,1900,8.4,107024,37785,69239,5.7,16.1,97792,27573,70219,4.1,14.7,9232,1.4,29.4,0,627,637,5807
1989,05,a) 0,3956,3991,25102,12622,3966,198.7,0,0,24961,24961,0,197.8,197.8,0,0,0,0,0,24961,197.8,0,0,,,
1989,05,b) 1,3126,3197,24523,25118,25,0.7,935,25.4,6892,335,6557,1.3,27.4,8081,4973,3108,19.8,32.2,-1189,-4.8,54.8,0,727,731,4279
1989,05,c) 2,2900,3011,28213,30704,118,3.6,662,20.2,4385,684,3701,2.2,14.3,9367,6525,2842,21.3,30.5,-4982,-16.2,28.6,0,515,515,5927
1989,05,d) 3,2443,2533,19501,20368,103,3.8,439,16.3,3385,695,2690,3.4,16.6,5118,2203,2915,10.8,25.1,-1733,-8.5,33.2,0,351,351,1784
1989,05,e) 4,2299,2399,22829,23570,81,3.2,374,14.7,3566,630,2936,2.7,15.1,5048,2414,2634,10.2,21.4,-1482,-6.3,30.2,0,287,288,2066
1989,05,f) 5,2426,2506,20031,19200,88,3.4,335,12.8,5329,2831,2498,14.7,27.8,3666,1959,1707,10.2,19.1,1663,8.7,38.2,0,244,244,1490
1989,05,g) 6 to 10,7489,8120,82991,83556,235,2.8,861,10.2,13323,2683,10640,3.2,15.9,14453,5963,8490,7.1,17.3,-1130,-1.4,31.8,0,629,661,3815
1989,05,h) 11 to 15,2865,3461,41473,40496,148,4.2,305,8.6,7754,1961,5793,4.8,19.1,5799,1908,3891,4.7,14.3,1955,4.8,28.6,0,183,186,1059
1989,05,l) Left Censored,11698,17249,453870,447337,982,5.7,1139,6.6,58787,18551,40236,4.1,13.1,45721,13447,32274,3,10.2,13066,2.9,20.4,0,626,646,4989
1989,06,a) 0,61808,62560,412782,207213,62137,198.6,0,0,411139,411139,0,198.4,198.4,0,0,0,0,0,411139,198.4,0,0,,,
1989,06,b) 1,48703,49892,437538,432500,378,0.7,13559,23.8,150954,8991,141963,2.1,34.9,140880,74761,66119,17.3,32.6,10074,2.3,65.2,0,9773,9777,58062
1989,06,c) 2,44059,45812,522406,544005,1866,3.7,10284,20.5,104580,12329,92251,2.3,19.2,147777,87044,60733,16,27.2,-43197,-8,38.4,0,7510,7528,70548
1989,06,d) 3,37451,39445,405887,405935,1670,4,7180,17,97115,13347,83768,3.3,23.9,97210,47942,49268,11.8,23.9,-95,0,47.8,0,5196,5204,35752
1989,06,e) 4,32639,34408,372229,376443,1346,3.7,5695,15.6,79933,11110,68823,3,21.2,88361,39968,48393,10.6,23.5,-8428,-2.3,42.4,0,3933,3955,28111
1989,06,f) 5,28417,30308,343871,346798,1208,3.7,5140,15.9,72622,11813,60809,3.4,20.9,78475,35774,42701,10.3,22.6,-5853,-1.7,41.8,0,3206,3212,22930
1989,06,g) 6 to 10,100134,110559,1458759,1491583,4477,3.8,19826,16.8,260918,40633,220285,2.7,17.5,326566,161761,164805,10.8,21.9,-65648,-4.4,35,0,9254,9280,70379.5
1989,06,h) 11 to 15,33233,42058,669101,672537,2137,4.9,6134,13.9,124598,33404,91194,5,18.5,131469,54199,77270,8.1,19.5,-6871,-1,37,0,2447,2475,22104
1989,06,l) Left Censored,110883,195138,6050501,6039212,12466,6.2,22260,11.1,912718,280322,632396,4.6,15.1,890141,304773,585368,5,14.7,22577,0.4,29.4,0,7603,7824,63596
1989,08,a) 0,8131,8202,47383,23813,8136,198.4,0,0,47140,47140,0,198,198,0,0,0,0,0,47140,198,0,0,,,
1989,08,b) 1,6328,6446,47095,48102,49,0.7,2066,27.5,14905,1991,12914,4.1,31,16918,10861,6057,22.6,35.2,-2013,-4.2,62,0,1578,1578,8973
1989,08,c) 2,5589,5822,54474,56555,226,3.5,1446,22.4,11029,1819,9210,3.2,19.5,15191,8638,6553,15.3,26.9,-4162,-7.4,39,0,1128,1129,7006
1989,08,d) 3,4758,4926,39532,41331,164,3,1090,20.2,7489,683,6806,1.7,18.1,11086,6193,4893,15,26.8,-3597,-8.7,36.2,0,874,880,5488
1989,08,e) 4,4541,4724,41900,43472,194,3.8,843,16.7,7673,1201,6472,2.8,17.7,10817,5064,5753,11.6,24.9,-3144,-7.2,35.4,0,648,648,3936
1989,08,f) 5,4059,4272,37530,38264,142,3.1,691,15.2,7465,2283,5182,6,19.5,8932,4594,4338,12,23.3,-1467,-3.8,39,0,511,513,3762
1989,08,g) 6 to 10,13955,15522,177530,179015,650,4,2019,12.5,27968,5466,22502,3.1,15.6,30939,13697,17242,7.7,17.3,-2971,-1.7,31.2,0,1345,1348,8325
1989,08,h) 11 to 15,4559,5622,64459,63524,255,4.4,553,9.6,12196,1826,10370,2.9,19.2,10325,4312,6013,6.8,16.3,1871,2.9,32.6,0,341,341,2217
1989,08,l) Left Censored,16075,26152,691226,688371,1464,5.5,2346,8.8,99808,32126,67682,4.7,14.5,94098,34312,59786,5,13.7,5710,0.8,27.4,0,941,961,8951
1989,09,a) 0,7474,7544,40470,20322,7488,198.5,0,0,40296,40296,0,198.3,198.3,0,0,0,0,0,40296,198.3,0,0,,,
1989,09,b) 1,6359,6479,52979,51593,38,0.5,1660,22.6,16278,1290,14988,2.5,31.6,13506,7698,5808,14.9,26.2,2772,5.4,52.4,0,1282,1282,6323
1989,09,c) 2,5626,5788,51100,53334,175,2.8,1207,19.1,9341,1571,7770,2.9,17.5,13809,6627,7182,12.4,25.9,-4468,-8.4,35,0,939,939,5217
1989,09,d) 3,4661,4835,42770,44764,166,3.2,793,15.4,6692,902,5790,2,14.9,10680,4290,6390,9.6,23.9,-3988,-9,29.8,0,608,608,3165
1989,09,e) 4,4100,4276,40230,40985,139,3.1,539,12,6834,852,5982,2.1,16.7,8343,2559,5784,6.2,20.4,-1509,-3.7,33.4,0,404,404,1971
1989,09,f) 5,3560,3673,36013,36660,102,2.7,451,11.7,5611,916,4695,2.5,15.3,6905,2777,4128,7.6,18.8,-1294,-3.5,30.6,0,337,337,2214
1989,09,g) 6 to 10,12090,12889,137824,139688,379,2.8,1319,9.9,20316,3560,16756,2.5,14.5,24044,8564,15480,6.1,17.2,-3728,-2.7,29,0,940,942,5864
1989,09,h) 11 to 15,4330,5098,68122,69485,181,3.5,444,8.5,7962,1176,6786,1.7,11.5,10688,3442,7246,5,15.4,-2726,-3.9,23,0,287,288,2112
1989,09,l) Left Censored,22619,31497,1042362,1043284,1412,4.4,2539,7.9,133672,38749,94923,3.7,12.8,135516,43059,92457,4.1,13,-1844,-0.2,25.6,0,1305,1346,12178
1989,10,a) 0,1539,1550,8675,4350,1542,199,0,0,8650,8650,0,198.9,198.9,0,0,0,0,0,8650,198.9,0,0,,,
1989,10,b) 1,1126,1132,9632,9663,5,0.4,258,20.4,2415,36,2379,0.4,25,2476,1105,1371,11.4,25.6,-61,-0.6,50,0,182,182,892
1989,10,c) 2,1028,1054,10776,10840,70,6.3,197,17.6,2211,566,1645,5.2,20.4,2338,1375,963,12.7,21.6,-127,-1.2,40.8,0,137,139,1053
1989,10,d) 3,847,884,7414,7373,54,5.8,143,15.5,1707,562,1145,7.6,23.2,1625,635,990,8.6,22,82,1.2,44,0,94,94,431
1989,10,e) 4,751,791,7425,7240,57,7,104,12.8,1693,277,1416,3.8,23.4,1322,510,812,7,18.3,371,5.1,36.6,0,78,78,397
1989,10,f) 5,669,696,7158,7397,27,3.7,85,11.8,1091,305,786,4.1,14.7,1568,579,989,7.8,21.2,-477,-6.5,29.4,0,69,69,449
1989,10,g) 6 to 10,2136,2286,26752,27496,88,3.8,216,9.2,4139,795,3344,2.9,15.1,5627,1344,4283,4.9,20.5,-1488,-5.4,30.2,0,141,141,814
1989,10,h) 11 to 15,798,977,16553,16254,49,5,69,7,2594,582,2012,3.6,16,1995,570,1425,3.5,12.3,599,3.7,24.6,0,37,37,184
1989,10,l) Left Censored,4085,5868,210131,204966,386,6.6,396,6.7,33576,13869,19707,6.8,16.4,23245,4845,18400,2.4,11.3,10331,5.1,22.6,0,197,199,2102
1989,11,a) 0,1149,1174,8827,4423,1167,198.8,0,0,8808,8808,0,199.1,199.1,0,0,0,0,0,8808,199.1,0,0,,,
1989,11,b) 1,1014,1034,13238,13357,6,0.5,266,22.8,2682,91,2591,0.7,20.1,2920,1790,1130,13.4,21.9,-238,-1.8,40.2,0,185,185,1233
1989,11,c) 2,904,931,8857,9427,34,3.4,193,19.1,2024,253,1771,2.7,21.5,3163,1871,1292,19.8,33.6,-1139,-12.1,43,0,136,136,1693
1989,11,d) 3,867,885,8974,9273,35,3.7,137,14.6,1568,153,1415,1.6,16.9,2166,817,1349,8.8,23.4,-598,-6.5,33.8,0,100,100,653
1989,11,e) 4,840,863,12952,12368,25,2.8,101,11.2,3370,1229,2141,9.9,27.2,2202,1040,1162,8.4,17.8,1168,9.4,35.6,0,71,71,573
1989,11,f) 5,760,805,10755,10913,47,5.6,104,12.5,2164,681,1483,6.2,19.8,2480,770,1710,7.1,22.7,-316,-2.9,39.6,0,75,76,651
1989,11,g) 6 to 10,2727,2867,38332,39352,129,4.3,366,12.3,5634,1370,4264,3.5,14.3,7675,3488,4187,8.9,19.5,-2041,-5.2,28.6,0,251,251,1882
1989,11,h) 11 to 15,1015,1221,44908,43216,69,5.6,101,8.2,6903,601,6302,1.4,16,3518,860,2658,2,8.1,3385,7.9,16.2,0,42,42,202
1989,11,l) Left Censored,5464,7891,263563,263650,543,6.9,576,7.3,35262,8100,27162,3.1,13.4,35436,10939,24497,4.1,13.4,-174,0,26.8,0,237,238,3189
1989,12,a) 0,34275,34593,198791,99699,34379,198.8,0,0,198185,198185,0,198.8,198.8,0,0,0,0,0,198185,198.8,0,0,,,
1989,12,b) 1,27452,28216,213800,212865,242,0.7,8182,25.3,68815,5281,63534,2.5,32.3,66945,38446,28499,18.1,31.4,1870,0.9,62.8,0,6396,6398,31440
1989,12,c) 2,23051,23952,236519,243397,868,3.3,5874,22.2,48969,6384,42585,2.6,20.1,62725,35342,27383,14.5,25.8,-13756,-5.7,40.2,0,4706,4720,29046
1989,12,d) 3,19091,19973,173305,178682,878,4.1,3974,18.5,37705,5943,31762,3.3,21.1,48459,25545,22914,14.3,27.1,-10754,-6,42.2,0,3208,3211,20571
1989,12,e) 4,16460,17261,166450,169967,638,3.5,2924,15.9,32219,4898,27321,2.9,19,39253,19197,20056,11.3,23.1,-7034,-4.1,38,0,2242,2257,15235
1989,12,f) 5,14428,15186,150375,152860,530,3.3,2212,13.8,27217,3676,23541,2.4,17.8,32186,13773,18413,9,21.1,-4969,-3.3,35.6,0,1715,1727,10538
1989,12,g) 6 to 10,47482,51279,578179,585563,1774,3.3,6036,11.3,96334,16164,80170,2.8,16.5,111101,44679,66422,7.6,19,-14767,-2.5,33,0,4407,4470,31331
1989,12,h) 11 to 15,14624,18675,256363,257628,920,4.8,1843,9.6,43955,11629,32326,4.5,17.1,46485,15621,30864,6.1,18,-2530,-0.9,34.2,0,1106,1124,8383
1989,12,l) Left Censored,49295,92782,2467402,2440092,5810,6.2,7376,7.9,383794,129668,254126,5.3,15.7,329174,100130,229044,4.1,13.5,54620,2.2,27,0,2995,3036,27098
1989,13,a) 0,12850,13057,82773,41538,12977,198.8,0,0,82471,82471,0,198.5,198.5,0,0,0,0,0,82471,198.5,0,0,,,
1989,13,b) 1,10103,10377,86725,87909,124,1,3141,26.3,25502,2543,22959,2.9,29,27869,16678,11191,19,31.7,-2367,-2.7,58,0,2492,2494,13748
1989,13,c) 2,8830,9262,109535,114097,338,3.3,2224,21.7,26337,2847,23490,2.5,23.1,35460,25170,10290,22.1,31.1,-9123,-8,46.2,0,1755,1756,20149
1989,13,d) 3,7801,8219,77048,79253,326,3.7,1501,17.1,15736,2208,13528,2.8,19.9,20145,9983,10162,12.6,25.4,-4409,-5.5,39.8,0,1158,1158,7460
1989,13,e) 4,7047,7367,71239,73035,267,3.4,1116,14.3,12487,1968,10519,2.7,17.1,16078,7044,9034,9.6,22,-3591,-4.9,34.2,0,835,837,5227
1989,13,f) 5,6416,6782,70800,71670,210,3,853,12,13102,1679,11423,2.3,18.3,14843,6347,8496,8.9,20.7,-1741,-2.4,36.6,0,625,626,4694
1989,13,g) 6 to 10,19145,21227,260840,261989,831,3.8,2239,10.2,43400,8774,34626,3.3,16.6,45697,14651,31046,5.6,17.4,-2297,-0.8,33.2,0,1583,1586,9689
1989,13,h) 11 to 15,6813,8310,116299,117400,435,5.1,827,9.7,19527,4939,14588,4.2,16.6,21729,8328,13401,7.1,18.5,-2202,-1.9,33.2,0,465,475,3648
1989,13,l) Left Censored,28573,51171,1589783,1585884,3299,6.4,3888,7.6,253073,96582,156491,6.1,16,245276,59900,185376,3.8,15.5,7797,0.5,31,0,1481,1514,12390.5
1989,15,a) 0,2032,2065,16288,8227,2045,198.1,0,0,16123,16123,0,196,196,0,0,0,0,0,16123,196,0,0,,,
1989,15,b) 1,1746,1848,15040,14710,26,1.3,373,18.4,4497,555,3942,3.8,30.6,3836,2181,1655,14.8,26.1,661,4.5,52.2,0,261,261,1531
1989,15,c) 2,1471,1564,19328,19806,57,3.4,314,18.5,2892,640,2252,3.2,14.6,3848,2148,1700,10.8,19.4,-956,-4.8,29.2,0,249,249,1405
1989,15,d) 3,1210,1296,13023,12966,45,3.3,206,15,2683,219,2464,1.7,20.7,2568,1200,1368,9.3,19.8,115,0.9,39.6,0,144,144,778
1989,15,e) 4,1195,1270,14013,14351,40,3,206,15.3,2834,891,1943,6.2,19.7,3509,1407,2102,9.8,24.5,-675,-4.8,39.4,0,164,164,1069
1989,15,f) 5,900,993,9171,9136,45,4.3,140,13.4,1820,599,1221,6.6,19.9,1749,743,1006,8.1,19.1,71,0.8,38.2,0,105,105,575
1989,15,g) 6 to 10,4279,4732,53346,53439,172,3.5,477,9.8,7727,1290,6437,2.4,14.5,7913,3156,4757,5.9,14.8,-186,-0.3,29,0,327,327,2317
1989,15,h) 11 to 15,1373,1798,25422,25317,72,3.9,151,8.2,3753,521,3232,2.1,14.8,3543,1623,1920,6.4,14,210,0.8,28,0,90,90,871
1989,15,l) Left Censored,5849,9302,238469,235132,468,5,561,6,30239,8004,22235,3.4,12.9,23565,6952,16613,3,10,6674,2.9,20,0,274,274,1635
1989,16,a) 0,1984,2009,11273,5654,1993,198.4,0,0,11238,11238,0,198.8,198.8,0,0,0,0,0,11238,198.8,0,0,,,
1989,16,b) 1,1517,1533,12835,12287,6,0.3,379,21.8,4005,160,3845,1.3,32.6,2908,1818,1090,14.8,23.7,1097,8.9,47.4,0,282,282,1495
1989,16,c) 2,1351,1415,11580,11898,60,3.9,299,19.5,2608,373,2235,3.1,21.9,3244,1833,1411,15.4,27.3,-636,-5.4,43.8,0,228,228,1479
1989,16,d) 3,1258,1290,9543,9477,50,3.7,190,14,2128,377,1751,4,22.5,1996,921,1075,9.7,21.1,132,1.4,42.2,0,148,148,719
1989,16,e) 4,1141,1188,8935,8964,42,3.3,203,16,2078,497,1581,5.5,23.2,2136,963,1173,10.7,23.8,-58,-0.6,46.4,0,139,139,652
1989,16,f) 5,1031,1077,8128,8324,41,3.6,163,14.3,1617,251,1366,3,19.4,2009,952,1057,11.4,24.1,-392,-4.7,38.8,0,111,111,702
1989,16,g) 6 to 10,3542,3845,39560,38850,161,4,449,11.3,7858,1508,6350,3.9,20.2,6438,2567,3871,6.6,16.6,1420,3.6,33.2,0,289,289,1569
1989,16,h) 11 to 15,1377,1616,18239,17869,83,5,144,8.7,3011,562,2449,3.1,16.9,2271,796,1475,4.5,12.7,740,4.2,25.4,0,89,89,520
1989,16,l) Left Censored,5193,7869,162818,158569,400,5,642,8.1,24501,8749,15752,5.5,15.5,16004,5811,10193,3.7,10.1,8497,5.4,20.2,0,288,310,2249
1989,17,a) 0,19098,19309,122918,61670,19205,198.9,0,0,122496,122496,0,198.6,198.6,0,0,0,0,0,122496,198.6,0,0,,,
1989,17,b) 1,15321,15609,137958,134062,219,1.3,3693,21.2,42477,8983,33494,6.7,31.7,34685,20110,14575,15,25.9,7792,5.8,51.8,0,2732,2736,16544
1989,17,c) 2,14107,14667,167232,169259,514,3.3,2661,16.9,29611,3865,25746,2.3,17.5,33666,18016,15650,10.6,19.9,-4055,-2.4,35,0,2027,2032,15040
1989,17,d) 3,12117,12665,118477,120869,445,3.3,1897,14.2,22858,2413,20445,2,18.9,27641,11831,15810,9.8,22.9,-4783,-4,37.8,0,1403,1403,9149
1989,17,e) 4,11399,11976,126625,128452,415,3.3,1529,12.2,21193,3636,17557,2.8,16.5,24847,9789,15058,7.6,19.3,-3654,-2.8,33,0,1173,1175,7852
1989,17,f) 5,10489,11132,117401,117805,397,3.4,1257,10.9,18769,3790,14979,3.2,15.9,19576,7402,12174,6.3,16.6,-807,-0.7,31.8,0,931,931,5868
1989,17,g) 6 to 10,35082,37651,474666,475376,1222,3.1,3678,9.5,70954,10286,60668,2.2,14.9,72374,28043,44331,5.9,15.2,-1420,-0.3,29.8,0,2585,2608,19327
1989,17,h) 11 to 15,13066,15979,229526,227249,624,3.8,1356,8.3,34142,6654,27488,2.9,15,29588,10051,19537,4.4,13,4554,2,26,0,824,841,5830
1989,17,l) Left Censored,64512,96616,2992503,2978711,4787,4.9,7501,7.7,390874,129026,261848,4.3,13.1,363291,103973,259318,3.5,12.2,27583,0.9,24.4,0,3546,3698,30317
1989,18,a) 0,8968,9101,58782,29478,9047,198.8,0,0,58609,58609,0,198.8,198.8,0,0,0,0,0,58609,198.8,0,0,,,
1989,18,b) 1,7020,7133,65973,63720,58,0.7,1740,21.7,19353,1794,17559,2.8,30.4,14847,8843,6004,13.9,23.3,4506,7.1,46.6,0,1369,1369,7330
1989,18,c) 2,6481,6753,69071,71322,281,3.8,1408,19.2,12104,1991,10113,2.8,17,16606,8998,7608,12.6,23.3,-4502,-6.3,34,0,1130,1130,7250
1989,18,d) 3,5767,6050,58785,60366,185,2.9,934,14.6,11704,1870,9834,3.1,19.4,14865,6842,8023,11.3,24.6,-3161,-5.2,38.8,0,730,730,4768
1989,18,e) 4,5384,5744,55511,55519,201,3.4,686,11.5,9759,1438,8321,2.6,17.6,9774,4705,5069,8.5,17.6,-15,0,35.2,0,540,541,3877
1989,18,f) 5,5233,5602,58408,57538,172,3,560,9.7,11018,1758,9260,3.1,19.1,9277,4274,5003,7.4,16.1,1741,3,32.2,0,422,424,3372
1989,18,g) 6 to 10,15704,17042,193204,194139,498,2.8,1584,9,30269,4840,25429,2.5,15.6,32138,13007,19131,6.7,16.6,-1869,-1,31.2,0,1148,1156,9408
1989,18,h) 11 to 15,5993,7565,108259,106717,280,3.6,566,7.4,16830,3560,13270,3.3,15.8,13746,4521,9225,4.2,12.9,3084,2.9,25.8,0,363,372,2846
1989,18,l) Left Censored,30068,47246,1418218,1398288,2394,5,3167,6.7,177878,47184,130694,3.4,12.7,138018,42407,95611,3,9.9,39860,2.8,19.8,0,1492,1520,14475
1989,19,a) 0,4474,4529,25678,12861,4506,199,0,0,25634,,,,199.3,0,0,0,0,0,25634,199.3,0,1,,,
1989,19,b) 1,3484,3536,26081,25966,30,0.8,837,21.1,7229,558,6671,2.1,27.8,6998,4099,2899,15.8,27,231,0.8,54,0,660,660,3423
1989,19,c) 2,3289,3440,50068,45131,137,3.7,642,17.3,17338,,,,38.4,7464,4264,3200,9.4,16.5,9874,21.9,33,1,490,490,3582
1989,19,d) 3,2768,2853,22698,22679,99,3.3,455,15,4531,510,4021,2.2,20,4492,2318,2174,10.2,19.8,39,0.2,39.6,0,355,355,1704
1989,19,e) 4,2687,2826,24832,24664,140,4.8,379,12.9,4332,1086,3246,4.4,17.6,3995,1890,2105,7.7,16.2,337,1.4,32.4,0,297,297,1394
1989,19,f) 5,3106,3226,25190,24851,144,4.4,282,8.6,4694,1294,3400,5.2,18.9,4015,1585,2430,6.4,16.2,679,2.7,32.4,0,200,200,1211
1989,19,g) 6 to 10,9578,10566,97771,97861,345,3.2,1003,9.2,14760,2148,12612,2.2,15.1,14940,5775,9165,5.9,15.3,-180,-0.2,30.2,0,746,746,3844
1989,19,h) 11 to 15,3997,5066,53176,52316,169,3.3,400,7.7,7883,1213,6670,2.3,15.1,6162,2097,4065,4,11.8,1721,3.3,23.6,0,249,249,1241
1989,19,l) Left Censored,19834,28619,651013,641126,1073,3.7,1852,6.4,81029,22517,58512,3.5,12.6,61255,20723,40532,3.2,9.6,19774,3,19.2,0,997,1002,6013
1989,20,a) 0,4543,4572,25805,12947,4546,198.9,0,0,25716,25716,0,198.6,198.6,0,0,0,0,0,25716,198.6,0,0,,,
1989,20,b) 1,3602,3699,26508,27685,35,0.8,1016,24.1,6305,762,5543,2.8,22.8,8659,5399,3260,19.5,31.3,-2354,-8.5,45.6,0,779,779,4105
1989,20,c) 2,3281,3405,38911,40315,136,3.7,727,19.6,5172,736,4436,1.8,12.8,7980,4609,3371,11.4,19.8,-2808,-7,25.6,0,583,584,4045
1989,20,d) 3,2990,3118,26796,27028,120,3.6,496,15,5324,1232,4092,4.6,19.7,5788,2451,3337,9.1,21.4,-464,-1.7,39.4,0,389,390,1999
1989,20,e) 4,2797,2908,22535,23630,106,3.4,505,16.3,3456,435,3021,1.8,14.6,5646,2658,2988,11.2,23.9,-2190,-9.3,29.2,0,408,415,2265
1989,20,f) 5,2894,3000,26014,25717,85,2.7,381,12.1,4660,1221,3439,4.7,18.1,4065,1785,2280,6.9,15.8,595,2.3,31.6,0,309,310,1528
1989,20,g) 6 to 10,8957,9655,88050,89612,289,2.9,1054,10.5,13105,2222,10883,2.5,14.6,16229,6286,9943,7,18.1,-3124,-3.5,29.2,0,772,772,3883
1989,20,h) 11 to 15,3257,4188,44478,44227,204,4.8,345,8.1,7337,1820,5517,4.1,16.6,6835,2185,4650,4.9,15.5,502,1.1,31,0,237,237,1351
1989,20,l) Left Censored,16256,23805,551862,533766,1088,4.5,1805,7.5,95077,46337,48740,8.7,17.8,58884,18783,40101,3.5,11,36193,6.8,22,0,906,920,7173
1989,21,a) 0,5889,5932,39111,19620,5898,198.9,0,0,38982,38982,0,198.7,198.7,0,0,0,0,0,38982,198.7,0,0,,,
1989,21,b) 1,4611,4712,38521,37846,52,1,1061,20.2,11699,2646,9053,7,30.9,10348,6402,3946,16.9,27.3,1351,3.6,54.6,0,843,843,5523
1989,21,c) 2,4295,4425,47292,47925,151,3.1,871,18.1,8682,1025,7657,2.1,18.1,9947,5301,4646,11.1,20.8,-1265,-2.7,36.2,0,744,744,4674
1989,21,d) 3,3666,3836,36098,37154,139,3.4,681,16.6,6562,1214,5348,3.3,17.7,8673,4158,4515,11.2,23.3,-2111,-5.6,35.4,0,543,544,3467
1989,21,e) 4,3351,3492,36483,36836,119,3.2,496,13.5,5915,891,5024,2.4,16.1,6621,2615,4006,7.1,18,-706,-1.9,32.2,0,387,387,1900
1989,21,f) 5,3475,3637,32249,33589,97,2.6,387,10.2,5039,821,4218,2.4,15,7719,3289,4430,9.8,23,-2680,-8,30,0,299,299,1921
1989,21,g) 6 to 10,9797,10514,128704,128892,327,3,1148,10.5,20389,2749,17640,2.1,15.8,20764,9096,11668,7.1,16.1,-375,-0.3,31.6,0,852,856,5297
1989,21,h) 11 to 15,3703,4451,54964,54658,169,3.7,378,8.3,8894,1734,7160,3.2,16.3,8282,3404,4878,6.2,15.2,612,1.1,30.4,0,234,234,1377
1989,21,l) Left Censored,18113,27896,724992,719179,1351,4.8,1986,7,90564,24192,66372,3.4,12.6,78939,24011,54928,3.3,11,11625,1.6,22,0,993,1013,7539
1989,22,a) 0,5668,5725,37225,18709,5677,198.3,0,0,37032,37032,0,197.9,197.9,0,0,0,0,0,37032,197.9,0,0,,,
1989,22,b) 1,4647,4779,42922,44485,60,1.1,1389,25.4,12922,1564,11358,3.5,29,16047,8202,7845,18.4,36.1,-3125,-7.1,58,0,1078,1078,6571
1989,22,c) 2,4116,4258,46783,49240,126,2.7,1003,21.3,8494,864,7630,1.8,17.3,13407,8364,5043,17,27.2,-4913,-9.9,34.6,0,816,816,6718
1989,22,d) 3,3991,4117,36488,37441,137,3.1,790,17.8,7429,780,6649,2.1,19.8,9335,5282,4053,14.1,24.9,-1906,-5.1,39.6,0,612,613,4169
1989,22,e) 4,3624,3818,34685,35005,164,4,684,16.8,7814,1855,5959,5.3,22.3,8453,4600,3853,13.1,24.1,-639,-1.8,44.6,0,523,524,3535
1989,22,f) 5,3848,4045,42050,42522,161,3.8,577,13.6,6892,1217,5675,2.9,16.2,7835,3663,4172,8.6,18.4,-943,-2.2,32.4,0,441,441,3067
1989,22,g) 6 to 10,13557,14747,151412,152087,606,4,1709,11.2,27155,6276,20879,4.1,17.9,28504,10897,17607,7.2,18.7,-1349,-0.8,35.8,0,1239,1242,7948
1989,22,h) 11 to 15,4353,5190,66286,66157,188,3.5,486,9.1,11144,2026,9118,3.1,16.8,10885,3660,7225,5.5,16.5,259,0.3,33,0,292,297,2103
1989,22,l) Left Censored,19825,31841,745261,741044,1522,4.7,2685,8.3,105010,30914,74096,4.2,14.2,96575,29644,66931,4,13,8435,1.2,26,0,1185,1218,8300
1989,23,a) 0,3134,3149,17737,8921,3112,197.7,0,0,17632,17632,0,197.6,197.6,0,0,0,0,0,17632,197.6,0,0,,,
1989,23,b) 1,2604,2642,17363,17495,15,0.5,681,22.7,4804,250,4554,1.4,27.5,5067,2958,2109,16.9,29,-263,-1.5,55,0,516,516,2478
1989,23,c) 2,2320,2401,20281,22520,94,3.6,481,18.5,3665,382,3283,1.7,16.3,8143,2349,5794,10.4,36.2,-4478,-19.9,32.6,0,358,358,1802
1989,23,d) 3,1912,1975,13930,14166,77,3.7,333,15.9,2778,395,2383,2.8,19.6,3250,1437,1813,10.1,22.9,-472,-3.3,39.2,0,252,252,1069
1989,23,e) 4,1576,1632,13646,13757,48,2.8,229,13.3,2979,219,2760,1.6,21.7,3201,1564,1637,11.4,23.3,-222,-1.6,43.4,0,174,174,1180
1989,23,f) 5,1392,1461,14059,14136,47,3.1,179,11.7,2459,244,2215,1.7,17.4,2612,1293,1319,9.1,18.5,-153,-1.1,34.8,0,139,139,1151
1989,23,g) 6 to 10,4239,4535,50421,50896,167,3.6,473,10.1,7603,1600,6003,3.1,14.9,8552,3496,5056,6.9,16.8,-949,-1.9,29.8,0,328,331,2668
1989,23,h) 11 to 15,1601,2012,25137,25352,118,5.8,179,8.8,4091,893,3198,3.5,16.1,4520,1711,2809,6.7,17.8,-429,-1.7,32.2,0,120,120,652
1989,23,l) Left Censored,7027,10068,254614,253048,499,4.9,724,7.1,31031,6576,24455,2.6,12.3,27898,8781,19117,3.5,11,3133,1.3,22,0,388,418,3345
1989,24,a) 0,9205,9284,55005,27596,9230,198.8,0,0,54818,54818,0,198.6,198.6,0,0,0,0,0,54818,198.6,0,0,,,
1989,24,b) 1,7416,7560,63506,63852,49,0.6,1940,22.7,18383,1380,17003,2.2,28.8,19074,11161,7913,17.5,29.9,-691,-1.1,57.6,0,1450,1450,9252
1989,24,c) 2,6503,6733,74063,75970,272,3.8,1276,17.6,13690,2346,11344,3.1,18,17504,8090,9414,10.6,23,-3814,-5,36,0,1000,1000,6628
1989,24,d) 3,5786,5981,56600,57857,206,3.2,943,14.8,12173,1468,10705,2.5,21,14687,6036,8651,10.4,25.4,-2514,-4.4,42,0,751,752,4781
1989,24,e) 4,5017,5334,56258,57246,203,3.6,704,12.6,9792,1658,8134,2.9,17.1,11767,4907,6860,8.6,20.6,-1975,-3.5,34.2,0,511,513,3414
1989,24,f) 5,4243,4457,51937,52093,155,3.3,498,10.8,8997,1403,7594,2.7,17.3,9309,3312,5997,6.4,17.9,-312,-0.6,34.6,0,381,385,2661
1989,24,g) 6 to 10,13820,14994,186833,189369,547,3.5,1442,9.3,29936,5382,24554,2.8,15.8,35007,12340,22667,6.5,18.5,-5071,-2.7,31.6,0,995,999,8437
1989,24,h) 11 to 15,4827,6078,89976,89993,237,3.8,482,7.8,14248,3181,11067,3.5,15.8,14282,3870,10412,4.3,15.9,-34,-0.1,31.6,0,275,278,1892
1989,24,l) Left Censored,22966,37435,1133926,1135426,2162,5.7,2698,7.2,155228,52696,102532,4.6,13.7,158228,43410,114818,3.8,13.9,-3000,-0.2,27.4,0,1108,1121,9401
1989,25,a) 0,11954,12205,76392,38507,12059,197.6,0,0,75770,75770,0,196.8,196.8,0,0,0,0,0,75770,196.8,0,0,,,
1989,25,b) 1,10584,10738,99145,97606,88,0.7,2562,21.3,27609,3612,23997,3.7,28.3,24531,12985,11546,13.3,25.1,3078,3.2,50.2,0,1933,1933,10609
1989,25,c) 2,9785,10126,105387,106113,352,3.2,1947,17.8,22034,5489,16545,5.2,20.8,23486,11684,11802,11,22.1,-1452,-1.3,41.6,0,1531,1534,9267
1989,25,d) 3,8220,8526,84320,86321,254,2.8,1403,15.5,15750,2042,13708,2.4,18.2,19752,8996,10756,10.4,22.9,-4002,-4.7,36.4,0,1104,1110,7469
1989,25,e) 4,7163,7417,82588,84494,247,3.2,1080,13.8,13803,1859,11944,2.2,16.3,17615,7433,10182,8.8,20.8,-3812,-4.5,32.6,0,818,818,5499
1989,25,f) 5,6104,6344,70048,71903,182,2.7,803,12.1,11817,1203,10614,1.7,16.4,15527,7139,8388,9.9,21.6,-3710,-5.2,32.8,0,609,609,5910
1989,25,g) 6 to 10,20362,21897,301962,303247,651,2.9,2212,9.8,49002,8416,40586,2.8,16.2,51572,18642,32930,6.1,17,-2570,-0.8,32.4,0,1559,1577,11702
1989,25,h) 11 to 15,6979,8937,170852,171176,322,3.5,731,8,21269,3458,17811,2,12.4,21917,5825,16092,3.4,12.8,-648,-0.4,24.8,0,451,460,3132
1989,25,l) Left Censored,39162,56207,1868045,1877321,2546,4.5,4106,7.2,243143,67162,175981,3.6,13,261694,68145,193549,3.6,13.9,-18551,-0.9,26,0,2193,2329,23383
1989,26,a) 0,14780,14997,94950,47681,14887,198.5,0,0,94539,94539,0,198.3,198.3,0,0,0,0,0,94539,198.3,0,0,,,
1989,26,b) 1,12146,12409,106763,104321,109,0.8,3000,21.5,33279,3535,29744,3.4,31.9,28395,14260,14135,13.7,27.2,4884,4.7,54.4,0,2290,2290,11018
1989,26,c) 2,11648,12084,123568,125734,402,3.1,2136,16.5,23455,2909,20546,2.3,18.7,27786,13686,14100,10.9,22.1,-4331,-3.4,37.4,0,1648,1649,11049
1989,26,d) 3,9661,10086,92098,93801,402,3.8,1428,13.5,18132,2664,15468,2.8,19.3,21538,9250,12288,9.9,23,-3406,-3.7,38.6,0,1111,1112,6810
1989,26,e) 4,8760,9269,92820,93883,330,3.4,1203,12.4,16614,2598,14016,2.8,17.7,18739,8586,10153,9.1,20,-2125,-2.3,35.4,0,929,933,6650
1989,26,f) 5,8129,8662,91710,92769,264,2.9,945,10.5,15884,2434,13450,2.6,17.1,18001,8151,9850,8.8,19.4,-2117,-2.3,34.2,0,702,702,4747
1989,26,g) 6 to 10,26186,28632,329254,330199,916,3.1,2669,9.1,52067,9565,42502,2.9,15.8,53958,18897,35061,5.7,16.3,-1891,-0.5,31.6,0,1949,1952,14227
1989,26,h) 11 to 15,9732,12274,165630,164980,522,4.2,945,7.6,23548,4449,19099,2.7,14.3,22248,7100,15148,4.3,13.5,1300,0.8,27,0,589,596,3945
1989,26,l) Left Censored,45878,71898,2235935,2219573,3814,5.3,4992,6.9,277749,68870,208879,3.1,12.5,245025,64539,180486,2.9,11,32724,1.5,22,0,2390,2441,21842.5
1989,27,a) 0,7714,7797,46887,23496,7755,198.9,0,0,46782,46782,0,199.1,199.1,0,0,0,0,0,46782,199.1,0,0,,,
1989,27,b) 1,6255,6381,50360,50366,54,0.8,1472,20.7,14023,1008,13015,2,27.8,14034,8405,5629,16.7,27.9,-11,-0.1,55.6,0,1070,1070,6400
1989,27,c) 2,5571,5825,71543,71026,221,3.5,1105,17.6,15946,5014,10932,7.1,22.5,14911,9208,5703,13,21,1035,1.5,42,0,827,830,7091
1989,27,d) 3,5078,5352,49249,49428,206,3.6,806,14.3,9468,1377,8091,2.8,19.2,9826,4532,5294,9.2,19.9,-358,-0.7,38.4,0,636,636,3583
1989,27,e) 4,4739,5012,56058,55324,161,3.1,647,12.3,10438,1410,9028,2.5,18.9,8969,4360,4609,7.9,16.2,1469,2.7,32.4,0,494,495,3253
1989,27,f) 5,4410,4647,49909,48281,132,2.7,516,10.7,10681,3777,6904,7.8,22.1,7424,3516,3908,7.3,15.4,3257,6.7,30.8,0,367,370,2336
1989,27,g) 6 to 10,14127,15589,186124,184407,534,3.3,1493,9.3,29096,5733,23363,3.1,15.8,25662,9588,16074,5.2,13.9,3434,1.9,27.8,0,1092,1103,6921
1989,27,h) 11 to 15,5498,6872,95671,99391,303,4.3,512,7.3,13377,3433,9944,3.5,13.5,20817,3802,17015,3.8,20.9,-7440,-7.4,27,0,297,303,2245
1989,27,l) Left Censored,25788,38229,1164616,1158888,2048,5.3,2645,6.9,142485,39777,102708,3.4,12.3,131028,49508,81520,4.3,11.3,11457,1,22.6,0,1191,1204,11664
1989,28,a) 0,3831,3854,24012,12056,3820,198.2,0,0,23912,23912,0,198.3,198.3,0,0,0,0,0,23912,198.3,0,0,,,
1989,28,b) 1,2934,3018,24894,24242,39,1.1,888,25.6,8346,1061,7285,4.4,34.4,7042,4220,2822,17.4,29,1304,5.4,58,0,709,709,3291
1989,28,c) 2,2612,2729,27935,30255,111,3.7,695,22.9,3984,689,3295,2.3,13.2,8624,5666,2958,18.7,28.5,-4640,-15.3,26.4,0,562,562,5108
1989,28,d) 3,2315,2386,18919,19622,100,3.9,433,17,3495,533,2962,2.7,17.8,4901,2316,2585,11.8,25,-1406,-7.2,35.6,0,328,328,1733
1989,28,e) 4,2273,2351,20204,20614,74,3,327,13.2,3281,904,2377,4.4,15.9,4100,1526,2574,7.4,19.9,-819,-4,31.8,0,265,265,1265
1989,28,f) 5,2365,2426,18203,19108,74,2.9,269,10.7,2622,416,2206,2.2,13.7,4432,2331,2101,12.2,23.2,-1810,-9.5,27.4,0,196,196,2016
1989,28,g) 6 to 10,7087,7687,82057,83687,298,3.8,857,10.8,11755,2086,9669,2.5,14,15014,6607,8407,7.9,17.9,-3259,-3.9,28,0,610,629,3499
1989,28,h) 11 to 15,2659,3213,32330,32829,120,3.6,284,8.6,4533,850,3683,2.6,13.8,5531,2311,3220,7,16.8,-998,-3,27.6,0,172,172,850
1989,28,l) Left Censored,12100,18768,456358,453568,947,5,1309,6.9,56138,15452,40686,3.4,12.4,50557,14863,35694,3.3,11.1,5581,1.3,22.2,0,673,685,4661
1989,29,a) 0,9936,10079,56556,28403,10027,199,0,0,56306,56306,0,198.2,198.2,0,0,0,0,0,56306,198.2,0,0,,,
1989,29,b) 1,7608,7776,59322,59016,63,0.7,2083,23.6,18883,2441,16442,4.1,32,18271,10588,7683,17.9,31,612,1,62,0,1612,1612,8533
1989,29,c) 2,7071,7341,78473,80296,389,4.9,1499,18.9,15334,3434,11900,4.3,19.1,18979,11294,7685,14.1,23.6,-3645,-4.5,38.2,0,1205,1207,9821
1989,29,d) 3,5947,6199,53497,54487,246,3.7,1040,15.8,10469,1842,8627,3.4,19.2,12448,5869,6579,10.8,22.8,-1979,-3.6,38.4,0,819,823,4633
1989,29,e) 4,5885,6122,58526,58751,193,3,880,13.6,11246,1582,9664,2.7,19.1,11696,5311,6385,9,19.9,-450,-0.8,38.2,0,672,675,4350
1989,29,f) 5,5098,5363,48566,49159,172,3.1,622,11.1,8409,1997,6412,4.1,17.1,9595,4021,5574,8.2,19.5,-1186,-2.4,34.2,0,459,466,3193
1989,29,g) 6 to 10,16269,17888,196030,197083,622,3.4,1788,9.7,31778,6107,25671,3.1,16.1,33883,12565,21318,6.4,17.2,-2105,-1.1,32.2,0,1233,1249,8285
1989,29,h) 11 to 15,6070,7761,100052,101396,392,5,615,7.8,15038,3173,11865,3.1,14.8,17726,4402,13324,4.3,17.5,-2688,-2.7,29.6,0,390,393,2586
1989,29,l) Left Censored,28998,44824,1286167,1271962,2187,4.8,3224,7.1,173024,43226,129798,3.4,13.6,144614,41565,103049,3.3,11.4,28410,2.2,22.8,0,1546,1571,12141
1989,30,a) 0,1801,1825,8757,4400,1813,198.7,0,0,8714,8714,0,198,198,0,0,0,0,0,8714,198,0,0,,,
1989,30,b) 1,1467,1488,8702,9104,13,0.8,427,24.9,2083,118,1965,1.3,22.9,2886,1580,1306,17.4,31.7,-803,-8.8,45.8,0,307,307,1226
1989,30,c) 2,1343,1378,10056,9803,120,8.1,309,20.9,3314,1910,1404,19.5,33.8,2807,1384,1423,14.1,28.6,507,5.2,57.2,0,230,230,1133
1989,30,d) 3,1223,1258,8302,8299,82,6.3,177,13.5,1615,346,1269,4.2,19.5,1608,811,797,9.8,19.4,7,0.1,38.8,0,130,130,563
1989,30,e) 4,1071,1099,7834,8062,60,5.1,196,16.8,1427,272,1155,3.4,17.7,1882,815,1067,10.1,23.3,-455,-5.6,35.4,0,148,148,589
1989,30,f) 5,1069,1127,7116,6998,69,5.9,155,13.2,1642,396,1246,5.7,23.5,1406,680,726,9.7,20.1,236,3.4,40.2,0,120,120,567
1989,30,g) 6 to 10,3846,4174,32049,32330,197,4.5,526,12.1,5532,1129,4403,3.5,17.1,6094,2941,3153,9.1,18.8,-562,-1.7,34.2,0,324,326,1830
1989,30,h) 11 to 15,1393,1621,14009,13777,80,4.8,146,8.8,2233,427,1806,3.1,16.2,1768,695,1073,5,12.8,465,3.4,25.6,0,101,101,499
1989,30,l) Left Censored,5234,7286,110618,109450,267,3.6,524,7.1,13310,2817,10493,2.6,12.2,10973,2997,7976,2.7,10,2337,2.2,20,0,279,279,1265
1989,31,a) 0,2837,2860,16249,8286,2849,199.2,0,0,15927,15927,0,192.2,192.2,0,0,0,0,0,15927,192.2,0,0,,,
1989,31,b) 1,2295,2390,18528,18578,36,1.3,589,21.9,5488,1418,4070,7.6,29.5,5587,3112,2475,16.8,30.1,-99,-0.6,59,0,447,447,2348
1989,31,c) 2,1975,2026,20244,20006,84,3.8,403,18.4,4358,1810,2548,9,21.8,3881,2319,1562,11.6,19.4,477,2.4,38.8,0,308,308,2005
1989,31,d) 3,1751,1807,14944,15397,64,3.3,316,16.4,2653,419,2234,2.7,17.2,3559,2125,1434,13.8,23.1,-906,-5.9,34.4,0,227,232,1376
1989,31,e) 4,1904,1976,20277,20205,53,2.5,282,13.5,3682,501,3181,2.5,18.2,3538,1699,1839,8.4,17.5,144,0.7,35,0,223,223,1455
1989,31,f) 5,1819,1915,14353,14494,78,4,196,9.9,2655,969,1686,6.7,18.3,2936,1100,1836,7.6,20.3,-281,-2,36.6,0,148,148,949
1989,31,g) 6 to 10,5959,6481,61222,61320,234,3.5,645,9.7,8400,1317,7083,2.1,13.7,8595,3665,4930,6,14,-195,-0.3,27.4,0,467,468,2675
1989,31,h) 11 to 15,2450,2963,29672,29853,133,4.4,228,7.6,4168,1000,3168,3.3,14,4530,1842,2688,6.2,15.2,-362,-1.2,28,0,149,149,1050
1989,31,l) Left Censored,11522,16156,362806,358599,762,4.7,1117,6.8,46070,10888,35182,3,12.8,37655,11626,26029,3.2,10.5,8415,2.3,21,0,556,560,3622
1989,32,a) 0,3012,3027,21682,10912,3006,198.6,0,0,21541,21541,0,197.4,197.4,0,0,0,0,0,21541,197.4,0,0,,,
1989,32,b) 1,2069,2106,22908,20903,18,0.7,604,25,9207,511,8696,2.4,44,5197,2925,2272,14,24.9,4010,19.1,49.8,0,486,487,2399
1989,32,c) 2,1794,1881,23125,22931,100,4.9,408,20,6863,790,6073,3.4,29.9,6474,3450,3024,15,28.2,389,1.7,56.4,0,316,316,2965
1989,32,d) 3,1475,1545,20472,20528,83,5.1,264,16.1,4338,667,3671,3.2,21.1,4449,1738,2711,8.5,21.7,-111,-0.6,42.2,0,186,187,1292
1989,32,e) 4,1188,1256,17160,17480,72,5.5,198,15,4089,875,3214,5,23.4,4728,1411,3317,8.1,27,-639,-3.6,46.8,0,130,134,884
1989,32,f) 5,1133,1211,18060,17518,48,3.8,154,12.2,4651,1212,3439,6.9,26.5,3566,1468,2098,8.4,20.4,1085,6.1,40.8,0,120,120,1119
1989,32,g) 6 to 10,4191,4615,74368,74659,215,4.5,488,10.3,14923,2271,12652,3,20,15504,7413,8091,9.9,20.8,-581,-0.8,40,0,317,317,5717
1989,32,h) 11 to 15,1292,1573,29323,28763,84,5.2,153,9.5,5162,1225,3937,4.3,17.9,4044,1310,2734,4.6,14.1,1118,3.8,28.2,0,89,90,697
1989,32,l) Left Censored,4502,7151,269514,264545,516,7.2,587,8.2,45590,11805,33785,4.5,17.2,35652,13819,21833,5.2,13.5,9938,3.7,27,0,216,217,2024
1989,33,a) 0,3100,3131,20443,10268,3105,198.3,0,0,20351,20351,0,198.2,198.2,0,0,0,0,0,20351,198.2,0,0,,,
1989,33,b) 1,2775,2800,21021,20921,20,0.6,823,25.5,5967,815,5152,3.9,28.5,5767,3609,2158,17.3,27.6,200,0.9,55.2,0,646,646,2710
1989,33,c) 2,2607,2661,19908,21194,96,3.3,563,19.4,3671,710,2961,3.4,17.3,6242,2993,3249,14.1,29.5,-2571,-12.2,34.6,0,454,454,2317
1989,33,d) 3,2137,2224,19965,21286,68,2.8,462,19.1,2980,472,2508,2.2,14,5621,3013,2608,14.2,26.4,-2641,-12.4,28,0,360,360,2489
1989,33,e) 4,1732,1787,16193,16830,54,2.8,309,16.1,3146,509,2637,3,18.7,4420,2340,2080,13.9,26.3,-1274,-7.6,37.4,0,251,252,1942
1989,33,f) 5,1454,1521,14907,15471,39,2.4,206,12.9,2188,202,1986,1.3,14.1,3315,1543,1772,10,21.4,-1127,-7.3,28.2,0,156,156,1155
1989,33,g) 6 to 10,4193,4467,47282,49121,134,2.9,515,11.1,6912,1661,5251,3.4,14.1,10589,3670,6919,7.5,21.6,-3677,-7.5,28.2,0,399,399,2528
1989,33,h) 11 to 15,1524,1899,26860,27521,79,4.1,163,8.4,3723,798,2925,2.9,13.5,5044,1594,3450,5.8,18.3,-1321,-4.8,27,0,108,108,1035
1989,33,l) Left Censored,6442,9231,272893,272982,483,5.2,666,7.2,30407,8891,21516,3.3,11.1,30584,7450,23134,2.7,11.2,-177,-0.1,22.2,0,341,366,2869
1989,34,a) 0,16703,16780,89735,45140,16647,198.4,0,0,89191,89191,0,197.6,197.6,0,0,0,0,0,89191,197.6,0,0,,,
1989,34,b) 1,14487,14650,111765,109060,88,0.5,3687,22.3,34084,3194,30890,2.9,31.3,28673,16138,12535,14.8,26.3,5411,5,52.6,0,2696,2696,12765
1989,34,c) 2,12696,12951,120604,124415,448,3.2,2578,18.4,21360,2395,18965,1.9,17.2,28981,14379,14602,11.6,23.3,-7621,-6.1,34.4,0,1959,1959,11026
1989,34,d) 3,10892,11213,97529,100262,379,3.2,1911,16,17933,2314,15619,2.3,17.9,23399,10136,13263,10.1,23.3,-5466,-5.4,35.8,0,1435,1438,7812
1989,34,e) 4,9529,9833,91414,92894,311,3,1376,13.3,17095,2019,15076,2.2,18.4,20055,7887,12168,8.5,21.6,-2960,-3.2,36.8,0,1044,1045,6084
1989,34,f) 5,8049,8282,95828,98330,219,2.5,1093,12.5,12826,1637,11189,1.7,13,17830,6172,11658,6.3,18.1,-5004,-5.1,26,0,809,809,4395
1989,34,g) 6 to 10,28673,30146,330015,342099,836,2.7,3176,10.1,50197,8305,41892,2.4,14.7,74365,25070,49295,7.3,21.7,-24168,-7,29.4,0,2252,2254,17794
1989,34,h) 11 to 15,9935,11325,147933,149378,413,3.6,991,8.5,21051,4541,16510,3,14.1,23940,7037,16903,4.7,16,-2889,-1.9,28.2,0,625,626,3845
1989,34,l) Left Censored,48991,69630,2125460,2124902,3643,5.2,5710,8.1,307909,95698,212211,4.5,14.5,306792,83429,223363,3.9,14.4,1117,0.1,28.8,0,2872,2921,25347
1989,35,a) 0,2930,2971,16421,8290,2951,198.7,0,0,16262,16262,0,196.2,196.2,0,0,0,0,0,16262,196.2,0,0,,,
1989,35,b) 1,2163,2223,15562,15811,39,1.5,670,26.2,4778,490,4288,3.1,30.2,5276,2991,2285,18.9,33.4,-498,-3.2,60.4,0,505,511,2389
1989,35,c) 2,1909,2002,20437,21266,103,4.7,501,22.7,3452,907,2545,4.3,16.2,5110,2892,2218,13.6,24,-1658,-7.8,32.4,0,400,400,2214
1989,35,d) 3,1749,1795,14272,15144,76,3.9,399,20.4,2902,568,2334,3.8,19.2,4645,2788,1857,18.4,30.7,-1743,-11.5,38.4,0,313,314,2292
1989,35,e) 4,1594,1691,14842,15052,64,3.6,275,15.4,2871,413,2458,2.7,19.1,3290,1388,1902,9.2,21.9,-419,-2.8,38.2,0,200,200,1122
1989,35,f) 5,1528,1613,14055,14163,73,4.3,242,14.3,2494,659,1835,4.7,17.6,2709,1061,1648,7.5,19.1,-215,-1.5,35.2,0,177,177,786
1989,35,g) 6 to 10,5341,5896,57605,58594,261,4.3,702,11.5,9164,1762,7402,3,15.6,11141,4076,7065,7,19,-1977,-3.4,31.2,0,463,463,2618
1989,35,h) 11 to 15,1776,2122,21144,21933,103,4.7,225,10.3,3821,959,2862,4.4,17.4,5399,1510,3889,6.9,24.6,-1578,-7.2,34.8,0,126,132,804
1989,35,l) Left Censored,6776,10395,219780,219739,555,5.3,839,8,29702,8428,21274,3.8,13.5,29620,8769,20851,4,13.5,82,0,27,0,384,389,3325
1989,36,a) 0,37348,37585,208919,104995,37302,198.5,0,0,207848,207848,0,198,198,0,0,0,0,0,207848,198,0,0,,,
1989,36,b) 1,30414,30821,234726,229439,210,0.6,7612,21.9,68436,4895,63541,2.1,29.8,57861,32849,25012,14.3,25.2,10575,4.6,50.4,0,5704,5704,25582
1989,36,c) 2,27164,27743,319683,326022,931,3.1,5542,18.4,45426,6723,38703,2.1,13.9,58103,29109,28994,8.9,17.8,-12677,-3.9,27.8,0,4337,4339,24108
1989,36,d) 3,23422,24002,189544,194622,730,2.8,4153,16.2,37854,4361,33493,2.2,19.5,48010,22951,25059,11.8,24.7,-10156,-5.2,39,0,3259,3259,18455
1989,36,e) 4,21019,21574,190974,196258,684,3,3205,14,32908,3948,28960,2,16.8,43476,18179,25297,9.3,22.2,-10568,-5.4,33.6,0,2454,2455,14525
1989,36,f) 5,18248,18841,174314,180095,535,2.7,2479,12.5,27941,2709,25232,1.5,15.5,39503,16604,22899,9.2,21.9,-11562,-6.4,31,0,1903,1926,11646
1989,36,g) 6 to 10,61586,65055,741854,747966,1990,2.9,7251,10.7,114755,17861,96894,2.4,15.3,126979,44390,82589,5.9,17,-12224,-1.7,30.6,0,5317,5319,33206
1989,36,h) 11 to 15,20868,24811,370293,372688,813,3.2,2364,9.2,55272,10481,44791,2.8,14.8,60062,25519,34543,6.8,16.1,-4790,-1.3,29.6,0,1550,1560,12679
1989,36,l) Left Censored,111686,153901,4554492,4570271,7407,4.7,12760,8.2,559087,152326,406761,3.3,12.2,590645,161802,428843,3.5,12.9,-31558,-0.7,24.4,0,7054,7200,55581
1989,37,a) 0,12700,12864,73991,37151,12782,198.7,0,0,73680,73680,0,198.3,198.3,0,0,0,0,0,73680,198.3,0,0,,,
1989,37,b) 1,10106,10324,84827,84839,90,0.8,2847,24.2,27725,3324,24401,3.9,32.7,27749,12313,15436,14.5,32.7,-24,0,65.4,0,2184,2185,10171
1989,37,c) 2,8945,9443,88887,90087,363,3.6,1870,18.3,18329,3616,14713,4,20.3,20729,11392,9337,12.6,23,-2400,-2.7,40.6,0,1454,1455,9453
1989,37,d) 3,7913,8330,70545,70485,269,3,1322,14.9,14876,2043,12833,2.9,21.1,14756,6971,7785,9.9,20.9,120,0.2,41.8,0,1017,1017,5107
1989,37,e) 4,7332,7698,75387,76776,243,3,1004,12.4,13069,1352,11717,1.8,17,15846,6263,9583,8.2,20.6,-2777,-3.6,34,0,745,745,4194
1989,37,f) 5,7938,8444,70270,71751,284,3.3,865,9.9,11227,2541,8686,3.5,15.6,14189,5580,8609,7.8,19.8,-2962,-4.2,31.2,0,620,622,4110
1989,37,g) 6 to 10,19633,21408,262574,262676,742,3.4,2013,9.1,42574,10882,31692,4.1,16.2,42777,15599,27178,5.9,16.3,-203,-0.1,32.4,0,1397,1400,11002
1989,37,h) 11 to 15,7108,8820,118501,118821,361,4,742,8.2,16788,3858,12930,3.2,14.1,17428,5515,11913,4.6,14.7,-640,-0.6,28.2,0,434,454,2464
1989,37,l) Left Censored,32727,55255,1748245,1744619,3165,5.7,3901,7,218389,68621,149768,3.9,12.5,211136,56144,154992,3.2,12.1,7253,0.4,24.2,0,1615,1646,12386
1989,38,a) 0,1158,1162,6045,3031,1152,198.3,0,0,6028,6028,0,198.9,198.9,0,0,0,0,0,6028,198.9,0,0,,,
1989,38,b) 1,993,1016,7105,7106,10,0.9,250,21.8,1789,165,1624,2.3,25.2,1790,972,818,13.7,25.2,-1,0,50.4,0,178,178,715
1989,38,c) 2,959,977,6762,7127,42,4,164,15.8,975,112,863,1.6,13.7,1705,918,787,12.9,23.9,-730,-10.2,27.4,0,132,132,780
1989,38,d) 3,797,820,5617,5706,32,3.7,127,14.6,1105,222,883,3.9,19.4,1282,748,534,13.1,22.5,-177,-3.1,38.8,0,104,104,628
1989,38,e) 4,790,821,5134,5366,26,3,111,12.9,691,54,637,1,12.9,1155,460,695,8.6,21.5,-464,-8.6,25.8,0,87,87,397
1989,38,f) 5,768,817,5301,5386,33,3.9,104,12.2,789,151,638,2.8,14.6,958,390,568,7.2,17.8,-169,-3.2,29.2,0,81,82,329
1989,38,g) 6 to 10,2789,3056,24590,24898,105,3.3,287,9.1,3212,739,2473,3,12.9,3828,1270,2558,5.1,15.4,-616,-2.5,25.8,0,204,204,825
1989,38,h) 11 to 15,1075,1207,9648,9780,39,3.1,103,8.3,1098,131,967,1.3,11.2,1361,532,829,5.4,13.9,-263,-2.7,22.4,0,62,62,353
1989,38,l) Left Censored,5045,6901,117158,116582,234,3.4,408,5.8,13302,4131,9171,3.5,11.4,12149,4066,8083,3.5,10.4,1153,1,20.8,0,221,223,1236
1989,39,a) 0,16155,16392,116074,58269,16282,198.7,0,0,115610,115610,0,198.4,198.4,0,0,0,0,0,115610,198.4,0,0,,,
1989,39,b) 1,13345,13702,121590,118464,152,1,3123,20.4,38575,4323,34252,3.6,32.6,32323,18274,14049,15.4,27.3,6252,5.3,54.6,0,2381,2381,14819
1989,39,c) 2,12305,12850,133560,135487,570,4.1,2425,17.6,25978,4119,21859,3,19.2,29831,17003,12828,12.5,22,-3853,-2.8,38.4,0,1869,1869,13048
1989,39,d) 3,10571,11087,110478,110403,539,4.6,1790,15.3,21957,3719,18238,3.4,19.9,21807,10410,11397,9.4,19.8,150,0.1,39.6,0,1316,1317,8299
1989,39,e) 4,9519,10182,116196,116039,439,4.1,1344,12.6,20958,5452,15506,4.7,18.1,20643,10163,10480,8.8,17.8,315,0.3,35.6,0,1026,1026,6391
1989,39,f) 5,9091,9629,96653,96467,291,2.9,1059,10.6,17101,3382,13719,3.5,17.7,16729,7381,9348,7.7,17.3,372,0.4,34.6,0,799,801,5033
1989,39,g) 6 to 10,29984,33021,398967,399748,1062,3.1,3032,8.9,59323,10837,48486,2.7,14.8,60886,24531,36355,6.1,15.2,-1563,-0.4,29.6,0,2112,2161,16356
1989,39,h) 11 to 15,11483,14735,200661,204975,547,3.6,1153,7.7,32531,7308,25223,3.6,15.9,41159,14438,26721,7,20.1,-8628,-4.2,31.8,0,697,716,4150
1989,39,l) Left Censored,60036,97435,2872310,2856431,4836,4.9,6595,6.7,367580,111678,255902,3.9,12.9,335823,104282,231541,3.7,11.8,31757,1.1,23.6,0,3119,3168,24281
1989,40,a) 0,5470,5514,33754,16966,5477,198.7,0,0,33576,33576,0,197.9,197.9,0,0,0,0,0,33576,197.9,0,0,,,
1989,40,b) 1,4128,4201,35243,34600,23,0.5,1284,26.4,12021,1007,11014,2.9,34.7,10735,6837,3898,19.8,31,1286,3.7,62,0,1026,1037,5907
1989,40,c) 2,3514,3674,38844,42927,131,3.2,970,23.7,6087,872,5215,2,14.2,14252,10390,3862,24.2,33.2,-8165,-19,28.4,0,773,775,8784
1989,40,d) 3,3342,3471,29665,29896,127,3.4,679,18.1,6308,1669,4639,5.6,21.1,6769,3322,3447,11.1,22.6,-461,-1.5,42.2,0,558,558,2872
1989,40,e) 4,3251,3398,26424,26982,174,4.9,550,15.4,4750,829,3921,3.1,17.6,5866,2512,3354,9.3,21.7,-1116,-4.1,35.2,0,436,437,1902
1989,40,f) 5,3466,3598,34397,33658,193,5.2,465,12.5,6916,1179,5737,3.5,20.5,5437,2021,3416,6,16.2,1479,4.3,32.4,0,364,365,1648
1989,40,g) 6 to 10,11199,12094,110714,110840,575,4.6,1462,11.7,18543,4164,14379,3.8,16.7,18794,7616,11178,6.9,17,-251,-0.3,33.4,0,1048,1053,5286
1989,40,h) 11 to 15,3630,4427,48931,48619,204,4.5,418,9.2,7905,1524,6381,3.1,16.3,7281,2806,4475,5.8,15,624,1.3,30,0,262,264,1531
1989,40,l) Left Censored,15837,24830,546060,546604,1320,5.2,2098,8.3,68590,17485,51105,3.2,12.5,69677,23231,46446,4.3,12.7,-1087,-0.2,25,0,967,979,6970
1989,41,a) 0,5636,5665,32277,16167,5641,199.2,0,0,32220,32220,0,199.3,199.3,0,0,0,0,0,32220,199.3,0,0,,,
1989,41,b) 1,4520,4577,37032,36509,38,0.7,2111,37.4,14886,1554,13332,4.3,40.8,13840,10475,3365,28.7,37.9,1046,2.9,75.8,0,1018,1018,5212
1989,41,c) 2,4092,4257,40441,43171,166,3.3,1654,33,8700,890,7810,2.1,20.2,14160,10294,3866,23.8,32.8,-5460,-12.6,40.4,0,801,803,5289
1989,41,d) 3,3490,3615,32148,33546,143,3.4,1233,29.6,9127,770,8357,2.3,27.2,11923,8268,3655,24.6,35.5,-2796,-8.3,54.4,0,569,570,3446
1989,41,e) 4,3030,3180,28504,30284,116,3.2,950,26.4,5651,1004,4647,3.3,18.7,9211,6338,2873,20.9,30.4,-3560,-11.7,37.4,0,426,426,3051
1989,41,f) 5,2806,2951,29307,31226,136,4.1,816,24.8,5741,1426,4315,4.6,18.4,9578,5894,3684,18.9,30.7,-3837,-12.3,36.8,0,317,317,2148
1989,41,g) 6 to 10,10010,10986,122119,125207,504,4.2,2634,21.9,23708,4039,19669,3.2,18.9,29883,18508,11375,14.8,23.9,-6175,-5,37.8,0,945,960,5709
1989,41,h) 11 to 15,3646,4483,57418,58102,231,4.8,849,17.7,11502,1714,9788,2.9,19.8,12869,7278,5591,12.5,22.1,-1367,-2.3,39.6,0,261,263,1531
1989,41,l) Left Censored,13983,22288,546682,545209,1227,5.3,3200,13.8,89060,24072,64988,4.4,16.3,86114,45171,40943,8.3,15.8,2946,0.5,31.6,0,806,821,5439
1989,42,a) 0,19607,19815,123917,62443,19681,198.6,0,0,122949,122949,0,196.9,196.9,0,0,0,0,0,122949,196.9,0,0,,,
1989,42,b) 1,16183,16518,129200,126834,153,0.8,3614,19.7,38351,4277,34074,3.4,30.2,33618,20365,13253,16.1,26.5,4733,3.7,53,0,2690,2691,15655
1989,42,c) 2,14888,15394,151136,154241,457,2.8,2585,15.7,26078,3006,23072,1.9,16.9,32287,17300,14987,11.2,20.9,-6209,-4,33.8,0,1963,1963,12906
1989,42,d) 3,12877,13359,122707,124706,373,2.6,1894,13.4,21636,2592,19044,2.1,17.3,25634,11708,13926,9.4,20.6,-3998,-3.3,34.6,0,1458,1461,9604
1989,42,e) 4,11362,11956,135396,134759,368,2.9,1471,11.8,23761,3364,20397,2.5,17.6,22486,9710,12776,7.2,16.7,1275,0.9,33.4,0,1126,1126,7602
1989,42,f) 5,10752,11449,120265,122232,359,3,1096,9.3,17291,2569,14722,2.1,14.1,21225,7913,13312,6.5,17.4,-3934,-3.3,28.2,0,818,819,6238
1989,42,g) 6 to 10,34115,36799,433487,433822,1211,3.2,3372,8.9,64476,10030,54446,2.3,14.9,65145,24760,40385,5.7,15,-669,-0.1,29.8,0,2374,2393,16548
1989,42,h) 11 to 15,12809,15838,228199,227326,648,4,1243,7.7,32677,8120,24557,3.6,14.4,30930,12266,18664,5.4,13.6,1747,0.8,27.2,0,813,821,5937
1989,42,l) Left Censored,68545,104821,3028809,3023054,4929,4.7,7532,7.1,365897,103172,262725,3.4,12.1,354386,109013,245373,3.6,11.7,11511,0.4,23.4,0,3743,3883,31379
1989,44,a) 0,2302,2329,14552,7336,2300,197.5,0,0,14432,14432,0,196.7,196.7,0,0,0,0,0,14432,196.7,0,0,,,
1989,44,b) 1,1927,1949,14992,14795,7,0.3,512,23.1,4208,461,3747,3.1,28.4,3813,2046,1767,13.8,25.8,395,2.6,51.6,0,406,406,1784
1989,44,c) 2,1721,1765,14994,15259,72,3.8,365,19.1,2833,534,2299,3.5,18.6,3363,1710,1653,11.2,22,-530,-3.4,37.2,0,294,294,1416
1989,44,d) 3,1378,1416,10531,10916,39,2.6,234,15.5,1808,140,1668,1.3,16.6,2578,1144,1434,10.5,23.6,-770,-7,33.2,0,194,194,1028
1989,44,e) 4,1235,1261,11316,12045,39,2.9,193,14.5,1704,193,1511,1.6,14.1,3161,1333,1828,11.1,26.2,-1457,-12.1,28.2,0,156,156,1183
1989,44,f) 5,1077,1102,11435,11984,28,2.4,147,12.7,1655,303,1352,2.5,13.8,2752,896,1856,7.5,23,-1097,-9.2,27.6,0,108,108,696
1989,44,g) 6 to 10,3498,3677,40995,42499,114,3,348,9.2,5678,919,4759,2.2,13.4,8686,2464,6222,5.8,20.4,-3008,-7,26.8,0,259,260,1819
1989,44,h) 11 to 15,1302,1476,21409,21904,49,3.2,149,9.8,2651,522,2129,2.4,12.1,3640,1332,2308,6.1,16.6,-989,-4.5,24.2,0,93,93,831
1989,44,l) Left Censored,7352,9385,265780,267879,494,5.2,689,7.3,31729,10532,21197,3.9,11.8,35926,11730,24196,4.4,13.4,-4197,-1.6,23.6,0,382,408,5726.5
1989,45,a) 0,6009,6117,37213,18678,6074,198.6,0,0,37070,37070,0,198.5,198.5,0,0,0,0,0,37070,198.5,0,0,,,
1989,45,b) 1,5040,5139,61960,59760,44,0.7,1438,24.5,15848,1092,14756,1.8,26.5,11447,7056,4391,11.8,19.2,4401,7.3,38.4,0,1133,1133,5685
1989,45,c) 2,4474,4726,50709,53455,213,4.2,967,18.9,9997,1957,8040,3.7,18.7,15489,8920,6569,16.7,29,-5492,-10.3,37.4,0,762,762,7830
1989,45,d) 3,3796,3970,32859,33874,136,3.2,714,16.8,6412,659,5753,1.9,18.9,8441,4536,3905,13.4,24.9,-2029,-6,37.8,0,556,556,3465
1989,45,e) 4,3657,3874,34408,35335,139,3.4,510,12.6,6703,1974,4729,5.6,19,8556,4512,4044,12.8,24.2,-1853,-5.2,38,0,389,389,3833
1989,45,f) 5,3641,3934,36806,37203,122,3,392,9.6,5846,958,4888,2.6,15.7,6640,2516,4124,6.8,17.8,-794,-2.1,31.4,0,287,289,1849
1989,45,g) 6 to 10,9740,10625,128770,129401,400,3.7,1049,9.6,21437,4989,16448,3.9,16.6,22698,7492,15206,5.8,17.5,-1261,-0.9,33.2,0,741,741,5284
1989,45,h) 11 to 15,3474,4241,48861,49732,219,5.1,365,8.5,7186,1804,5382,3.6,14.4,8927,2900,6027,5.8,18,-1741,-3.6,28.8,0,212,216,1571
1989,45,l) Left Censored,15761,26191,770108,764624,1547,5.9,1823,6.9,98838,30777,68061,4,12.9,87870,29236,58634,3.8,11.5,10968,1.4,23,0,775,786,6943.5
1989,46,a) 0,1304,1307,5987,2995,1304,199.5,0,0,5984,5984,0,199.8,199.8,0,0,0,0,0,5984,199.8,0,0,,,
1989,46,b) 1,1087,1121,7644,7659,6,0.5,250,20,1999,271,1728,3.5,26.1,2029,1280,749,16.7,26.5,-30,-0.4,52.2,0,194,194,1082
1989,46,c) 2,958,979,10577,10371,46,4.3,214,19.9,1980,447,1533,4.3,19.1,1567,1031,536,9.9,15.1,413,4,30.2,0,168,168,913
1989,46,d) 3,823,844,5585,5651,28,3.1,130,14.5,1147,171,976,3,20.3,1279,739,540,13.1,22.6,-132,-2.3,40.6,0,107,107,678
1989,46,e) 4,876,894,5867,5879,34,3.6,113,12.1,1121,232,889,3.9,19.1,1144,482,662,8.2,19.5,-23,-0.4,38.2,0,83,83,376
1989,46,f) 5,879,923,5789,5748,31,3.3,79,8.3,991,173,818,3,17.2,909,278,631,4.8,15.8,82,1.4,31.6,0,57,57,203
1989,46,g) 6 to 10,2705,2945,27342,26964,106,3.5,265,8.8,4375,557,3818,2.1,16.2,3619,1017,2602,3.8,13.4,756,2.8,26.8,0,189,189,729
1989,46,h) 11 to 15,1126,1303,11461,11675,56,4.2,92,7,1610,248,1362,2.1,13.8,2038,587,1451,5,17.5,-428,-3.7,27.6,0,62,62,311
1989,46,l) Left Censored,5373,7030,122766,121711,287,4,444,6.3,14872,3229,11643,2.7,12.2,12762,4331,8431,3.6,10.5,2110,1.7,21,0,256,256,1389
1989,47,a) 0,8823,8976,62932,31586,8919,198.7,0,0,62692,62692,0,198.5,198.5,0,0,0,0,0,62692,198.5,0,0,,,
1989,47,b) 1,6789,6902,54532,55484,51,0.6,2139,26.8,16454,1228,15226,2.2,29.7,18357,12008,6349,21.6,33.1,-1903,-3.4,59.4,0,1650,1650,10291
1989,47,c) 2,6115,6421,68162,71156,261,3.7,1431,20.4,12261,1958,10303,2.8,17.2,18249,10723,7526,15.1,25.6,-5988,-8.4,34.4,0,1158,1160,8751
1989,47,d) 3,5290,5547,54732,56985,181,3.1,959,16.2,9923,1255,8668,2.2,17.4,14429,6128,8301,10.8,25.3,-4506,-7.9,34.8,0,748,748,4625
1989,47,e) 4,4633,4876,55125,56966,154,3,697,13.5,8448,985,7463,1.7,14.8,12129,4659,7470,8.2,21.3,-3681,-6.5,29.6,0,533,542,3768
1989,47,f) 5,5218,5368,49500,49921,142,2.5,590,10.6,8437,907,7530,1.8,16.9,9278,4365,4913,8.7,18.6,-841,-1.7,33.8,0,445,446,3303
1989,47,g) 6 to 10,13753,15144,181475,181883,560,3.6,1448,9.3,29464,7034,22430,3.9,16.2,30280,10242,20038,5.6,16.6,-816,-0.4,32.4,0,1037,1086,6923
1989,47,h) 11 to 15,5306,7016,107838,105867,274,3.8,526,7.4,17275,3365,13910,3.2,16.3,13333,3994,9339,3.8,12.6,3942,3.7,25.2,0,318,320,2183
1989,47,l) Left Censored,23726,39057,1192792,1179475,2372,6,2817,7.2,172605,49514,123091,4.2,14.6,145970,45180,100790,3.8,12.4,26635,2.2,24.8,0,1309,1389,16978
1989,48,a) 0,30476,30941,213909,107409,30688,198.4,0,0,213000,213000,0,198.3,198.3,0,0,0,0,0,213000,198.3,0,0,,,
1989,48,b) 1,23480,24388,210240,213629,247,0.9,7288,25.9,64275,5118,59157,2.4,30.1,71053,42539,28514,19.9,33.3,-6778,-3.2,60.2,0,5784,5793,35571
1989,48,c) 2,20468,21579,225397,240525,813,3.4,5512,23,46687,5689,40998,2.4,19.4,76943,50153,26790,20.9,32,-30256,-12.6,38.8,0,4433,4453,42545
1989,48,d) 3,18580,19614,183340,188807,748,3.5,4313,20.2,42964,6045,36919,3.2,22.8,53898,28737,25161,15.2,28.5,-10934,-5.7,45.6,0,3362,3377,22560
1989,48,e) 4,16876,18073,167870,173327,663,3.4,3380,17.4,33925,4894,29031,2.8,19.6,44839,23616,21223,13.6,25.9,-10914,-6.3,39.2,0,2613,2619,16998
1989,48,f) 5,16434,17585,164470,168323,612,3.3,2833,15.2,32894,4652,28242,2.8,19.5,40600,19810,20790,11.8,24.1,-7706,-4.6,39,0,2110,2114,15045
1989,48,g) 6 to 10,57224,63393,667734,683075,2617,4,8101,12.3,116398,24717,91681,3.6,17,147081,66335,80746,9.7,21.5,-30683,-4.5,34,0,5623,5685,43838
1989,48,h) 11 to 15,16978,21910,280472,283397,989,4.4,2406,10.6,44520,9907,34613,3.5,15.7,50369,18348,32021,6.5,17.8,-5849,-2.1,31.4,0,1375,1430,9507
1989,48,l) Left Censored,64905,123404,3483240,3450102,7150,5.7,11480,9.2,545249,164069,381180,4.8,15.8,478973,159442,319531,4.6,13.9,66276,1.9,27.8,0,4344,4543,40433.5
1989,49,a) 0,2882,2923,21674,10929,2905,198.8,0,0,21490,21490,0,196.6,196.6,0,0,0,0,0,21490,196.6,0,0,,,
1989,49,b) 1,2260,2340,23985,23323,25,0.9,755,27.7,7619,245,7374,1.1,32.7,6295,3894,2401,16.7,27,1324,5.7,54,0,591,591,3295
1989,49,c) 2,1906,1974,18757,19121,84,3.8,501,22.9,4369,911,3458,4.8,22.8,5096,2951,2145,15.4,26.7,-727,-3.9,45.6,0,387,390,2377
1989,49,d) 3,1620,1684,20706,20669,61,3.3,327,18,4886,296,4590,1.4,23.6,4811,2797,2014,13.5,23.3,75,0.3,46.6,0,250,250,2179
1989,49,e) 4,1527,1629,18009,17706,77,4.5,276,16,4118,806,3312,4.6,23.3,3511,1907,1604,10.8,19.8,607,3.5,39.6,0,217,217,1571
1989,49,f) 5,1289,1358,13893,14211,60,4.2,223,15.5,2926,510,2416,3.6,20.6,3562,2152,1410,15.1,25.1,-636,-4.5,41.2,0,161,161,1814
1989,49,g) 6 to 10,5032,5650,70987,71080,233,4,695,11.8,13301,2479,10822,3.5,18.7,13487,5759,7728,8.1,19,-186,-0.3,37.4,0,454,463,3396
1989,49,h) 11 to 15,1798,2149,29522,29712,103,4.7,221,10,4167,706,3461,2.4,14,4547,1550,2997,5.2,15.3,-380,-1.3,28,0,126,126,678
1989,49,l) Left Censored,7181,11340,319679,313638,625,5.4,981,8.5,53755,19143,34612,6.1,17.1,41675,13167,28508,4.2,13.3,12080,3.8,26.6,0,390,460,4592
1989,50,a) 0,1917,1931,8698,4364,1921,199,0,0,8669,8669,0,198.6,198.6,0,0,0,0,0,8669,198.6,0,0,,,
1989,50,b) 1,1488,1495,8667,8735,10,0.6,398,23.5,2248,181,2067,2.1,25.7,2383,1540,843,17.6,27.3,-135,-1.6,51.4,0,299,299,1267
1989,50,c) 2,1337,1362,10225,10252,51,3.5,255,17.4,1930,464,1466,4.5,18.8,1984,961,1023,9.4,19.4,-54,-0.6,37.6,0,197,197,790
1989,50,d) 3,1182,1205,8743,8954,28,2.2,204,15.8,1469,94,1375,1,16.4,1890,892,998,10,21.1,-421,-4.7,32.8,0,161,161,728
1989,50,e) 4,973,1009,7783,8156,28,2.6,143,13.4,1163,131,1032,1.6,14.3,1908,814,1094,10,23.4,-745,-9.1,28.6,0,119,119,624
1989,50,f) 5,891,927,7453,7696,23,2.3,132,13.5,999,109,890,1.4,13,1485,616,869,8,19.3,-486,-6.3,26,0,103,103,534
1989,50,g) 6 to 10,2551,2679,23943,24237,78,2.8,274,9.9,3699,323,3376,1.3,15.3,4287,1962,2325,8.1,17.7,-588,-2.4,30.6,0,211,213,1146
1989,50,h) 11 to 15,955,1122,12889,12835,42,3.7,94,8.2,1666,455,1211,3.5,13,1557,484,1073,3.8,12.1,109,0.9,24.2,0,63,63,278
1989,50,l) Left Censored,3977,5364,129222,127074,263,4.9,361,6.7,15119,4390,10729,3.5,11.9,10822,3282,7540,2.6,8.5,4297,3.4,17,0,212,235,1750
1989,51,a) 0,11938,12103,74218,37201,12057,199.2,0,0,74034,74034,0,199,199,0,0,0,0,0,74034,199,0,0,,,
1989,51,b) 1,9666,9834,77987,77290,81,0.7,2663,23.8,23435,1541,21894,2,30.3,22040,12995,9045,16.8,28.5,1395,1.8,57,0,2063,2066,10949
1989,51,c) 2,8403,8730,81590,84316,321,3.4,1875,19.7,19014,3834,15180,4.5,22.6,24466,12104,12362,14.4,29,-5452,-6.4,45.2,0,1448,1448,9704
1989,51,d) 3,7528,7841,69208,70905,266,3.2,1302,15.6,13234,1976,11258,2.8,18.7,16627,8250,8377,11.6,23.4,-3393,-4.7,37.4,0,1022,1026,6484
1989,51,e) 4,6633,7145,72515,74315,282,3.8,989,13.2,12283,2075,10208,2.8,16.5,15882,5621,10261,7.6,21.4,-3599,-4.9,33,0,751,752,4228
1989,51,f) 5,5996,6251,59075,60311,192,2.9,719,11,10641,1726,8915,2.9,17.6,13112,4950,8162,8.2,21.7,-2471,-4.1,35.2,0,511,512,3358
1989,51,g) 6 to 10,17601,19319,248952,246952,797,4,1890,9.5,41591,9401,32190,3.8,16.8,37590,13304,24286,5.4,15.2,4001,1.6,30.4,0,1318,1324,9111
1989,51,h) 11 to 15,6157,8046,121266,120395,440,5.4,669,8.2,19422,3882,15540,3.2,16.1,17679,5454,12225,4.5,14.7,1743,1.4,29.4,0,376,382,1821
1989,51,l) Left Censored,27987,49486,1452935,1440118,3076,6.2,3450,7,195187,66747,128440,4.6,13.6,169553,47599,121954,3.3,11.8,25634,1.8,23.6,0,1332,1391,10846
1989,53,a) 0,8853,8956,52574,26335,8910,199,0,0,52478,52478,0,199.3,199.3,0,0,0,0,0,52478,199.3,0,0,,,
1989,53,b) 1,6589,6735,55393,57372,41,0.5,4050,45.9,20850,867,19983,1.5,36.3,24808,18654,6154,32.5,43.2,-3958,-6.9,72.6,0,1714,1715,8274
1989,53,c) 2,5919,6175,64228,69784,269,3.5,3011,39.7,14722,2190,12532,3.1,21.1,25834,19126,6708,27.4,37,-11112,-15.9,42.2,0,1258,1269,8481
1989,53,d) 3,5240,5489,77036,67081,217,3.3,2367,36,40246,1041,39205,1.6,60,20338,14267,6071,21.3,30.3,19908,29.7,60.6,0,872,873,4969
1989,53,e) 4,4625,4898,45589,49816,193,3.4,1813,31.7,8540,1200,7340,2.4,17.1,16994,12328,4666,24.7,34.1,-8454,-17,34.2,0,602,602,3568
1989,53,f) 5,4417,4759,46151,50575,233,4.2,1763,31.9,9065,1957,7108,3.9,17.9,17912,12343,5569,24.4,35.4,-8847,-17.5,35.8,0,552,554,3319
1989,53,g) 6 to 10,14782,16243,231050,219418,659,3.6,4990,27.1,81381,6587,74794,3,37.1,58117,39040,19077,17.8,26.5,23264,10.6,53,0,1469,1488,10057
1989,53,h) 11 to 15,5390,6747,89317,92366,370,5,1634,22.1,15204,4031,11173,4.4,16.5,21302,11643,9659,12.6,23.1,-6098,-6.6,33,0,406,407,2067
1989,53,l) Left Censored,19728,33122,896445,897852,2071,5.9,6062,17.3,143431,43566,99865,4.9,16,146246,75028,71218,8.4,16.3,-2815,-0.3,32,0,1239,1262,14261
1989,54,a) 0,2617,2647,17245,8652,2625,198.3,0,0,17186,17186,0,198.6,198.6,0,0,0,0,0,17186,198.6,0,0,,,
1989,54,b) 1,2139,2171,16524,16424,13,0.5,591,23.9,4935,272,4663,1.7,30,4735,3010,1725,18.3,28.8,200,1.2,57.6,0,463,463,2618
1989,54,c) 2,1918,1982,17700,18639,66,3.1,400,18.6,2839,216,2623,1.2,15.2,4716,2394,2322,12.8,25.3,-1877,-10.1,30.4,0,325,325,1847
1989,54,d) 3,1661,1746,14780,15563,57,3.1,290,15.6,2691,432,2259,2.8,17.3,4257,1808,2449,11.6,27.4,-1566,-10.1,34.6,0,233,233,1576
1989,54,e) 4,1554,1668,24263,24403,64,3.7,227,13,2792,783,2009,3.2,11.4,3072,1332,1740,5.5,12.6,-280,-1.2,22.8,0,165,166,994
1989,54,f) 5,1593,1620,11102,11201,37,2.2,161,9.6,1523,96,1427,0.9,13.6,1720,595,1125,5.3,15.4,-197,-1.8,27.2,0,123,123,465
1989,54,g) 6 to 10,4672,5080,50238,49708,198,3.8,476,9.1,8192,2608,5584,5.2,16.5,7132,2560,4572,5.2,14.3,1060,2.2,28.6,0,341,341,1928
1989,54,h) 11 to 15,1814,2232,25123,24694,110,4.8,192,8.5,4180,1548,2632,6.3,16.9,3322,1102,2220,4.5,13.5,858,3.4,27,0,120,120,474
1989,54,l) Left Censored,9746,14239,291247,292338,625,4.3,1061,7.3,33072,10221,22851,3.5,11.3,35253,10622,24631,3.6,12.1,-2181,-0.8,22.6,0,548,559,3991
1989,55,a) 0,8237,8318,48181,24252,8272,198.9,0,0,47858,47858,0,197.3,197.3,0,0,0,0,0,47858,197.3,0,0,,,
1989,55,b) 1,6663,6793,51780,50270,58,0.8,1476,19.5,15203,1759,13444,3.5,30.2,12182,7375,4807,14.7,24.2,3021,6,48.4,0,1103,1109,6309
1989,55,c) 2,6464,6876,71817,74144,252,3.4,1159,15.8,12062,1719,10343,2.3,16.3,16716,11357,5359,15.3,22.5,-4654,-6.2,32.6,0,866,866,9610
1989,55,d) 3,5346,5502,53819,54451,153,2.6,790,13.6,10278,1839,8439,3.4,18.9,11542,6015,5527,11,21.2,-1264,-2.3,37.8,0,625,625,3718
1989,55,e) 4,5041,5363,48609,49852,166,3,646,11.5,7549,909,6640,1.8,15.1,10035,3733,6302,7.5,20.1,-2486,-5,30.2,0,478,478,2618
1989,55,f) 5,4819,5110,48352,48836,132,2.5,532,10,7451,1263,6188,2.6,15.3,8418,3733,4685,7.6,17.2,-967,-1.9,30.6,0,411,411,2483
1989,55,g) 6 to 10,15198,16465,182571,182545,574,3.4,1585,9.3,26912,4583,22329,2.5,14.7,26859,9778,17081,5.4,14.7,53,0,29.4,0,1131,1134,6785
1989,55,h) 11 to 15,6149,7614,93713,92911,331,4.3,602,7.8,13581,2686,10895,2.9,14.6,11977,4544,7433,4.9,12.9,1604,1.7,25.8,0,372,373,2031
1989,55,l) Left Censored,30865,44168,1271780,1257355,1834,4.1,3033,6.8,155525,32024,123501,2.5,12.4,126675,36277,90398,2.9,10.1,28850,2.3,20.2,0,1550,1577,11128
1989,56,a) 0,950,968,4769,2393,963,199,0,0,4753,,,,198.6,0,0,0,0,0,4753,198.6,0,1,,,
1989,56,b) 1,784,790,5136,5049,4,0.4,206,22.9,1432,118,1314,2.3,28.4,1258,579,679,11.5,24.9,174,3.5,49.8,0,144,144,442
1989,56,c) 2,670,693,5530,5807,26,3.4,167,21.8,840,,,,14.5,1394,867,527,14.9,24,-554,-9.5,29,1,132,132,739
1989,56,d) 3,679,692,3831,4041,38,5.2,117,16,668,138,530,3.4,16.5,1087,587,500,14.5,26.9,-419,-10.4,33,0,90,90,523
1989,56,e) 4,642,655,5182,5039,16,2.3,115,16.3,1148,63,1085,1.3,22.8,862,416,446,8.3,17.1,286,5.7,34.2,0,87,87,322
1989,56,f) 5,600,621,4563,4695,20,3,99,15,805,119,686,2.5,17.1,1069,608,461,12.9,22.8,-264,-5.7,34.2,0,71,71,408
1989,56,g) 6 to 10,2461,2710,19660,19773,97,3.5,290,10.3,3397,296,3101,1.5,17.2,3622,1219,2403,6.2,18.3,-225,-1.1,34.4,0,193,193,791
1989,56,h) 11 to 15,836,970,9777,9722,57,5.8,86,8.7,1607,287,1320,3,16.5,1496,508,988,5.2,15.4,111,1.1,30.8,0,55,55,330
1989,56,l) Left Censored,3076,4259,65172,65059,202,4.7,348,8,8452,2548,5904,3.9,13,8226,2412,5814,3.7,12.6,226,0.4,25.2,0,160,165,1026
1990,01,a) 0,6676,6765,41637,20867,6737,199.2,0,0,41541,41541,0,199.1,199.1,0,0,0,0,0,41541,199.1,0,0,,,
1990,01,b) 1,5266,5387,42635,41950,37,0.6,1340,21.9,12765,776,11989,1.8,30.4,11394,6058,5336,14.4,27.2,1371,3.2,54.4,0,1123,1123,5015
1990,01,c) 2,4449,4563,41285,42837,176,3.6,818,16.6,7778,1084,6694,2.5,18.2,10882,5439,5443,12.7,25.4,-3104,-7.2,36.4,0,701,702,4969
1990,01,d) 3,4235,4484,52418,53087,199,4.1,818,17,8167,1414,6753,2.7,15.4,9504,4800,4704,9,17.9,-1337,-2.5,30.8,0,702,710,4173
1990,01,e) 4,3689,3921,40364,41023,166,4,597,14.4,7866,1198,6668,2.9,19.2,9184,3732,5452,9.1,22.4,-1318,-3.2,38.4,0,469,469,2781
1990,01,f) 5,3208,3394,33467,34123,139,3.9,446,12.5,5503,1028,4475,3,16.1,6815,3246,3569,9.5,20,-1312,-3.9,32.2,0,361,361,2621
1990,01,g) 6 to 10,11556,12492,161962,158852,437,3.4,1200,9.3,30845,5907,24938,3.7,19.4,24625,10178,14447,6.4,15.5,6220,3.9,31,0,889,894,6138
1990,01,h) 11 to 15,5898,7509,107938,107150,261,3.4,533,7,17285,2489,14796,2.3,16.1,15709,3273,12436,3.1,14.7,1576,1.4,29.4,0,373,374,2169
1990,01,l) Left Censored,17151,28643,808034,808158,1294,4.5,2093,7.2,85570,17353,68217,2.1,10.6,85817,22291,63526,2.8,10.6,-247,0,21.2,0,894,923,7322
1990,02,a) 0,1304,1317,6228,3125,1305,198.2,0,0,6206,6206,0,198.6,198.6,0,0,0,0,0,6206,198.6,0,0,,,
1990,02,b) 1,770,779,5586,7658,5,0.6,184,20.9,1598,13,1585,0.2,20.9,5741,653,5088,8.5,75,-4143,-54.1,41.8,0,121,121,502
1990,02,c) 2,749,788,7466,6993,161,20.8,121,15.6,2294,1171,1123,16.7,32.8,1347,758,589,10.8,19.3,947,13.5,38.6,0,96,96,665
1990,02,d) 3,715,753,8834,8324,155,21.2,102,13.9,2166,1219,947,14.6,26,1146,613,533,7.4,13.8,1020,12.2,27.6,0,76,76,394
1990,02,e) 4,690,724,5733,5691,134,18.8,112,15.7,1641,806,835,14.2,28.8,1557,1004,553,17.6,27.4,84,1.4,54.8,0,89,89,937
1990,02,f) 5,673,730,7034,6497,129,18.4,75,10.7,2227,1002,1225,15.4,34.3,1152,296,856,4.6,17.7,1075,16.6,35.4,0,50,50,231
1990,02,g) 6 to 10,2232,2466,21072,19263,401,17,183,7.8,6605,3411,3194,17.7,34.3,2986,1059,1927,5.5,15.5,3619,18.8,31,0,110,110,657
1990,02,h) 11 to 15,976,1236,13995,12871,184,15.5,79,6.7,3962,2028,1934,15.8,30.8,1714,629,1085,4.9,13.3,2248,17.5,26.6,0,45,45,193
1990,02,l) Left Censored,2048,3304,77886,73100,354,10.9,216,6.7,16464,6441,10023,8.8,22.5,6892,2276,4616,3.1,9.4,9572,13.1,18.8,0,61,62,466
1990,04,a) 0,7768,7839,47227,23668,7813,199.3,0,0,47119,47119,0,199.1,199.1,0,0,0,0,0,47119,199.1,0,0,,,
1990,04,b) 1,6093,6263,53285,52950,61,0.9,1651,23.1,17027,1380,15647,2.6,32.2,16356,8901,7455,16.8,30.9,671,1.3,61.8,0,1352,1352,6964
1990,04,c) 2,4996,5165,46219,49267,287,5.1,1193,21,10650,2233,8417,4.5,21.6,16746,9035,7711,18.3,34,-6096,-12.4,43.2,0,986,992,7885
1990,04,d) 3,4679,4968,58654,60988,240,4.5,1013,18.8,10088,1465,8623,2.4,16.5,14757,6753,8004,11.1,24.2,-4669,-7.7,33,0,825,825,5452
1990,04,e) 4,4138,4373,39900,41613,210,4.5,777,16.6,7607,1185,6422,2.8,18.3,11033,5353,5680,12.9,26.5,-3426,-8.2,36.6,0,606,607,4298
1990,04,f) 5,3691,3892,44652,45774,198,4.8,617,15,8148,1719,6429,3.8,17.8,10392,4162,6230,9.1,22.7,-2244,-4.9,35.6,0,461,474,3316
1990,04,g) 6 to 10,12486,14158,179913,182517,677,4.6,1666,11.3,32545,6184,26361,3.4,17.8,37753,15523,22230,8.5,20.7,-5208,-2.9,35.6,0,1144,1158,7178
1990,04,h) 11 to 15,5134,6423,93292,94970,318,4.8,647,9.8,14146,3125,11021,3.3,14.9,17501,6107,11394,6.4,18.4,-3355,-3.5,29.8,0,395,400,3380
1990,04,l) Left Censored,11354,21999,658608,660186,1462,6.6,1838,8.3,90558,30279,60279,4.6,13.7,93714,23300,70414,3.5,14.2,-3156,-0.5,27.4,0,596,608,4700
1990,05,a) 0,4153,4178,23502,11794,4155,198.9,0,0,23416,23416,0,198.5,198.5,0,0,0,0,0,23416,198.5,0,0,,,
1990,05,b) 1,3135,3172,25138,25227,23,0.6,724,20.2,7677,968,6709,3.8,30.4,7854,3432,4422,13.6,31.1,-177,-0.7,60.8,0,601,601,2955
1990,05,c) 2,2631,2705,22628,23130,98,3.3,509,17.3,4754,424,4330,1.8,20.6,5758,2926,2832,12.7,24.9,-1004,-4.3,41.2,0,433,433,2639
1990,05,d) 3,2513,2630,26389,26902,125,4.4,453,16.1,3931,748,3183,2.8,14.6,4956,1943,3013,7.2,18.4,-1025,-3.8,29.2,0,378,378,1608
1990,05,e) 4,2160,2252,17737,18520,77,3.2,340,14.2,2993,319,2674,1.7,16.2,4558,1622,2936,8.8,24.6,-1565,-8.4,32.4,0,284,285,1371
1990,05,f) 5,2104,2209,21328,22052,93,4,276,12,3078,501,2577,2.3,14,4525,1986,2539,9,20.5,-1447,-6.5,28,0,221,221,1653
1990,05,g) 6 to 10,7868,8461,86299,86247,309,3.5,789,9.1,13729,2698,11031,3.1,15.9,13624,4688,8936,5.4,15.8,105,0.1,31.6,0,601,601,3354
1990,05,h) 11 to 15,4164,4880,53749,53760,207,4.2,400,8,7719,1642,6077,3.1,14.4,7740,2542,5198,4.7,14.4,-21,0,28.8,0,255,255,1213
1990,05,l) Left Censored,11158,16825,467406,463244,689,4,1117,6.5,51873,10585,41288,2.3,11.2,43548,9968,33580,2.2,9.4,8325,1.8,18.8,0,546,547,3195
1990,06,a) 0,64460,65013,420357,210956,64723,199.1,0,0,418803,418803,0,198.5,198.5,0,0,0,0,0,418803,198.5,0,0,,,
1990,06,b) 1,49037,49982,439121,423213,390,0.7,11414,20.3,147875,17660,130215,4.2,34.9,116058,61113,54945,14.4,27.4,31817,7.5,54.8,0,8787,8796,50063
1990,06,c) 2,41730,43010,412973,422901,2209,4.8,8203,17.7,103986,15355,88631,3.6,24.6,123843,62583,61260,14.8,29.3,-19857,-4.7,49.2,0,6497,6509,51449
1990,06,d) 3,38760,40601,499664,508491,2306,5.3,6944,16.1,88089,15283,72806,3,17.3,105743,51020,54723,10,20.8,-17654,-3.5,34.6,0,5454,5463,41363
1990,06,e) 4,33687,35774,381177,390100,1898,5.1,5209,13.9,78660,14011,64649,3.6,20.2,96505,46872,49633,12,24.7,-17845,-4.5,40.4,0,4004,4009,32523
1990,06,f) 5,29730,31548,361094,363776,1706,5.2,4288,13,71722,14754,56968,4.1,19.7,77085,32060,45025,8.8,21.2,-5363,-1.5,39.4,0,3190,3203,23844
1990,06,g) 6 to 10,108093,118802,1619895,1594568,10440,8.7,11866,9.9,322804,100306,222498,6.3,20.2,272150,101088,171062,6.3,17.1,50654,3.1,34.2,0,8345,8374,69426
1990,06,h) 11 to 15,51022,62228,945017,922552,5636,9.1,5272,8.5,183515,55727,127788,6,19.9,138585,40512,98073,4.4,15,44930,4.9,30,0,3135,3180,22305
1990,06,l) Left Censored,109908,195869,6088785,6071665,15201,7.8,14149,7.2,870424,268206,602218,4.4,14.3,836185,224499,611686,3.7,13.8,34239,0.5,27.6,0,5902,5983,51727
1990,08,a) 0,8289,8363,46772,23493,8327,199.1,0,0,46558,46558,0,198.2,198.2,0,0,0,0,0,46558,198.2,0,0,,,
1990,08,b) 1,6456,6553,48377,48230,49,0.7,1553,21,14546,685,13861,1.4,30.2,14252,8814,5438,18.3,29.6,294,0.6,59.2,0,1236,1236,7458
1990,08,c) 2,5377,5554,42644,44570,290,4.8,1073,17.9,9494,1655,7839,3.7,21.3,13345,7600,5745,17.1,29.9,-3851,-8.6,42.6,0,919,921,6919
1990,08,d) 3,4859,5094,50647,52461,253,4.6,937,17.2,9104,1807,7297,3.4,17.4,12732,6924,5808,13.2,24.3,-3628,-6.9,34.8,0,753,757,5516
1990,08,e) 4,4222,4401,38090,38905,175,3.8,671,14.4,7535,867,6668,2.2,19.4,9164,4053,5111,10.4,23.6,-1629,-4.2,38.8,0,535,536,3142
1990,08,f) 5,4049,4248,40742,40976,194,4.3,642,14.3,7499,1407,6092,3.4,18.3,7967,3919,4048,9.6,19.4,-468,-1.1,36.6,0,501,501,3241
1990,08,g) 6 to 10,14291,15664,184136,185816,666,4.1,1817,11.2,28330,5514,22816,3,15.2,31690,13220,18470,7.1,17.1,-3360,-1.9,30.4,0,1250,1264,8609
1990,08,h) 11 to 15,6630,8030,90378,89778,361,4.4,740,9,16212,4445,11767,5,18.1,15012,4948,10064,5.5,16.7,1200,1.4,33.4,0,448,455,2691
1990,08,l) Left Censored,15243,25497,697991,696053,1445,5.6,2119,8.2,89781,30163,59618,4.3,12.9,85906,30431,55475,4.4,12.3,3875,0.6,24.6,0,802,808,8397
1990,09,a) 0,6381,6421,34840,17477,6390,199,0,0,34726,34726,0,198.7,198.7,0,0,0,0,0,34726,198.7,0,0,,,
1990,09,b) 1,5909,6005,42778,41427,56,0.8,1408,20.8,13731,2597,11134,6.3,33.1,11029,5451,5578,13.2,26.6,2702,6.5,53.2,0,1084,1084,4436
1990,09,c) 2,5282,5407,47846,50107,180,3,1100,18.5,8744,1376,7368,2.7,17.5,13266,6210,7056,12.4,26.5,-4522,-9,35,0,891,891,5096
1990,09,d) 3,4857,5017,47057,48973,193,3.6,894,16.5,7918,1299,6619,2.7,16.2,11749,5535,6214,11.3,24,-3831,-7.8,32.4,0,712,712,4492
1990,09,e) 4,4106,4274,37704,40149,145,3.2,661,14.5,5029,682,4347,1.7,12.5,9918,3739,6179,9.3,24.7,-4889,-12.2,25,0,527,527,2655
1990,09,f) 5,3708,3895,37583,38888,142,3.5,497,12.2,6101,1030,5071,2.6,15.7,8711,3167,5544,8.1,22.4,-2610,-6.7,31.4,0,380,380,2546
1990,09,g) 6 to 10,12444,13257,133220,139010,383,2.8,1304,9.5,16015,2492,13523,1.8,11.5,27595,8544,19051,6.1,19.9,-11580,-8.4,23,0,978,979,6491
1990,09,h) 11 to 15,6054,6967,90661,93869,220,3.1,628,8.7,10935,1919,9016,2,11.6,17351,6098,11253,6.5,18.5,-6416,-6.9,23.2,0,402,402,4145
1990,09,l) Left Censored,21559,30628,1014666,1027265,1316,4.2,2146,6.9,98926,28355,70571,2.8,9.6,124126,30926,93200,3,12.1,-25200,-2.5,19.2,0,999,1028,7852
1990,10,a) 0,1517,1528,7380,3703,1516,198.4,0,0,7354,7354,0,198.6,198.6,0,0,0,0,0,7354,198.6,0,0,,,
1990,10,b) 1,1235,1253,9255,8919,6,0.4,264,18.8,2829,42,2787,0.5,31.7,2156,1218,938,13.7,24.2,673,7.5,48.4,0,203,203,977
1990,10,c) 2,991,1003,10030,9938,34,3.2,150,14,2370,266,2104,2.7,23.8,2186,1015,1171,10.2,22,184,1.8,44,0,130,130,852
1990,10,d) 3,935,961,10110,10412,37,3.7,127,12.6,1711,355,1356,3.4,16.4,2314,797,1517,7.7,22.2,-603,-5.8,32.8,0,102,102,642
1990,10,e) 4,766,801,6960,7151,33,3.9,109,12.9,1195,152,1043,2.1,16.7,1576,668,908,9.3,22,-381,-5.3,33.4,0,81,81,484
1990,10,f) 5,678,717,7590,7481,27,3.6,93,12.4,1324,246,1078,3.3,17.7,1105,353,752,4.7,14.8,219,2.9,29.6,0,66,66,230
1990,10,g) 6 to 10,2253,2407,27973,28305,77,3.1,239,9.6,3911,730,3181,2.6,13.8,4574,1366,3208,4.8,16.2,-663,-2.4,27.6,0,174,174,1055
1990,10,h) 11 to 15,1126,1328,20089,20634,43,3.2,89,6.6,2297,357,1940,1.7,11.1,3387,604,2783,2.9,16.4,-1090,-5.3,22.2,0,57,57,453
1990,10,l) Left Censored,3960,5861,214103,212396,375,6.4,374,6.4,23549,4800,18749,2.3,11.1,20135,4064,16071,1.9,9.5,3414,1.6,19,0,145,145,1052
1990,11,a) 0,1100,1106,7533,3769,1103,199.5,0,0,7529,7529,0,199.8,199.8,0,0,0,0,0,7529,199.8,0,0,,,
1990,11,b) 1,952,985,9255,9056,17,1.6,179,16.6,2773,353,2420,3.9,30.6,2375,909,1466,10,26.2,398,4.4,52.4,0,133,133,475
1990,11,c) 2,877,902,12596,12863,46,4.7,162,16.7,2030,549,1481,4.3,15.8,2564,1008,1556,7.8,19.9,-534,-4.1,31.6,0,121,121,719
1990,11,d) 3,784,811,8477,8633,49,5.6,162,18.6,1739,296,1443,3.4,20.1,2050,1174,876,13.6,23.7,-311,-3.6,40.2,0,129,129,1054
1990,11,e) 4,765,780,8157,8526,29,3.5,122,14.7,1315,144,1171,1.7,15.4,2053,1042,1011,12.2,24.1,-738,-8.7,30.8,0,88,89,518
1990,11,f) 5,714,731,13059,12919,22,2.8,148,18.6,2278,640,1638,5,17.6,1998,1027,971,7.9,15.5,280,2.1,31,0,113,113,788
1990,11,g) 6 to 10,2741,2922,40354,41287,120,3.9,391,12.8,5786,1061,4725,2.6,14,7652,3346,4306,8.1,18.5,-1866,-4.5,28,0,286,286,1818
1990,11,h) 11 to 15,1327,1565,51764,52601,73,4.5,197,12.1,4415,903,3512,1.7,8.4,6088,1546,4542,2.9,11.6,-1673,-3.2,16.8,0,139,139,986
1990,11,l) Left Censored,5237,7666,255366,259085,421,5.4,609,7.8,28973,6581,22392,2.5,11.2,36411,7470,28941,2.9,14.1,-7438,-2.9,22.4,0,228,231,1321
1990,12,a) 0,34679,34958,203585,101949,34840,199.3,0,0,203273,203273,0,199.4,199.4,0,0,0,0,0,203273,199.4,0,0,,,
1990,12,b) 1,26789,27211,196326,196502,200,0.6,6828,22.1,60255,5060,55195,2.6,30.7,60607,32364,28243,16.5,30.8,-352,-0.1,61.4,0,5571,5571,27040
1990,12,c) 2,22788,23758,194086,202405,1046,4,5126,19.7,46262,7119,39143,3.5,22.9,62899,32471,30428,16,31.1,-16637,-8.2,45.8,0,4282,4292,27212
1990,12,d) 3,19637,20538,221635,228587,854,3.8,4038,18.2,40548,6138,34410,2.7,17.7,54451,28657,25794,12.5,23.8,-13903,-6.1,35.4,0,3320,3326,24807
1990,12,e) 4,16718,17632,163966,167930,761,4.1,2896,15.4,30925,5538,25387,3.3,18.4,38852,18419,20433,11,23.1,-7927,-4.7,36.8,0,2353,2356,15071
1990,12,f) 5,14660,15541,159829,161787,617,3.8,2246,13.7,28516,4206,24310,2.6,17.6,32431,14216,18215,8.8,20,-3915,-2.4,35.2,0,1792,1793,11233
1990,12,g) 6 to 10,49357,53248,599209,613820,1938,3.5,6252,11.3,91951,17604,74347,2.9,15,121173,44208,76965,7.2,19.7,-29222,-4.7,30,0,4748,4765,33345
1990,12,h) 11 to 15,20725,25583,348200,351330,1120,4.3,2449,9.3,55641,14889,40752,4.2,15.8,61901,20216,41685,5.8,17.6,-6260,-1.8,31.6,0,1581,1608,10685
1990,12,l) Left Censored,46453,91049,2460986,2460748,5144,5.6,6742,7.3,325700,97859,227841,4,13.2,325224,94342,230882,3.8,13.2,476,0,26.4,0,2690,2764,21807
1990,13,a) 0,12298,12372,77644,38876,12334,199.4,0,0,77537,77537,0,199.4,199.4,0,0,0,0,0,77537,199.4,0,0,,,
1990,13,b) 1,10038,10282,82533,82459,81,0.7,2564,22,24395,2192,22203,2.7,29.6,24246,13094,11152,15.9,29.4,149,0.2,58.8,0,2031,2033,10671
1990,13,c) 2,8354,8692,78567,82055,380,4,1900,19.9,17486,2837,14649,3.5,21.3,24461,12996,11465,15.8,29.8,-6975,-8.5,42.6,0,1572,1573,11195
1990,13,d) 3,7541,7981,115821,113162,314,3.6,1487,17.3,27674,1645,26029,1.5,24.5,22355,9573,12782,8.5,19.8,5319,4.7,39.6,0,1203,1204,7451
1990,13,e) 4,6870,7305,71525,73999,293,3.8,1146,14.8,12488,2225,10263,3,16.9,17435,7586,9849,10.3,23.6,-4947,-6.7,33.8,0,893,900,5502
1990,13,f) 5,6308,6642,66664,67869,253,3.6,927,13.2,11456,2121,9335,3.1,16.9,13865,5179,8686,7.6,20.4,-2409,-3.5,33.8,0,712,713,3770
1990,13,g) 6 to 10,20452,22504,259945,268882,785,3.4,2397,10.3,38187,8339,29848,3.1,14.2,56062,21479,34583,8,20.9,-17875,-6.7,28.4,0,1712,1737,13310
1990,13,h) 11 to 15,9512,11401,163171,163555,480,4.1,1022,8.7,27028,7315,19713,4.5,16.5,27796,9092,18704,5.6,17,-768,-0.5,33,0,629,635,4346
1990,13,l) Left Censored,27071,50383,1596995,1597091,2848,5.6,3620,7.1,207427,57088,150339,3.6,13,207618,59081,148537,3.7,13,-191,0,26,0,1376,1393,13447
1990,15,a) 0,2225,2251,15149,7592,2236,198.7,0,0,15115,15115,0,199.1,199.1,0,0,0,0,0,15115,199.1,0,0,,,
1990,15,b) 1,1703,1750,19171,17711,23,1.2,293,15.3,5730,1576,4154,8.9,32.4,2810,1193,1617,6.7,15.9,2920,16.5,31.8,0,214,214,961
1990,15,c) 2,1547,1663,15199,15067,79,4.5,229,13,3511,502,3009,3.3,23.3,3246,1241,2005,8.2,21.5,265,1.8,43,0,180,180,1043
1990,15,d) 3,1293,1392,19447,19358,58,3.9,216,14.6,2968,650,2318,3.4,15.3,2790,1283,1507,6.6,14.4,178,0.9,28.8,0,166,166,973
1990,15,e) 4,1100,1188,12587,12778,62,5,166,13.4,2701,362,2339,2.8,21.1,3082,1423,1659,11.1,24.1,-381,-3,42.2,0,128,128,1129
1990,15,f) 5,1108,1182,13851,13974,46,3.8,133,10.8,1872,378,1494,2.7,13.4,2117,757,1360,5.4,15.1,-245,-1.7,26.8,0,94,94,556
1990,15,g) 6 to 10,4141,4612,51345,51180,202,4.3,421,8.9,8433,1253,7180,2.4,16.5,8103,3279,4824,6.4,15.8,330,0.7,31.6,0,281,281,2480
1990,15,h) 11 to 15,2024,2572,36913,36842,135,5.2,208,8,5614,2086,3528,5.7,15.2,5471,1759,3712,4.8,14.8,143,0.4,29.6,0,126,126,943
1990,15,l) Left Censored,5634,9141,242718,240279,386,4.2,533,5.8,27830,5883,21947,2.4,11.6,22951,7534,15417,3.1,9.6,4879,2,19.2,0,229,232,3027
1990,16,a) 0,2357,2380,11940,5982,2367,198.9,0,0,11916,11916,0,199.2,199.2,0,0,0,0,0,11916,199.2,0,0,,,
1990,16,b) 1,1618,1651,11255,11152,15,0.8,326,17.8,3356,133,3223,1.2,30.1,3149,1287,1862,11.5,28.2,207,1.9,56.4,0,249,249,1058
1990,16,c) 2,1320,1343,12301,12469,55,3.8,217,15.1,2782,280,2502,2.2,22.3,3118,1328,1790,10.7,25,-336,-2.7,44.6,0,166,166,1052
1990,16,d) 3,1191,1264,11126,11346,61,4.6,206,15.4,2104,377,1727,3.3,18.5,2544,1190,1354,10.5,22.4,-440,-3.9,37,0,172,172,1097
1990,16,e) 4,1156,1189,9485,9497,59,4.8,153,12.3,1766,282,1484,3,18.6,1789,752,1037,7.9,18.8,-23,-0.2,37.2,0,125,125,668
1990,16,f) 5,1063,1104,9092,8974,58,5.1,138,12,1903,298,1605,3.3,21.2,1667,724,943,8.1,18.6,236,2.6,37.2,0,104,110,556
1990,16,g) 6 to 10,3670,3974,38586,38204,204,5,356,8.8,6826,1162,5664,3,17.9,6062,2211,3851,5.8,15.9,764,2,31.8,0,257,258,1574
1990,16,h) 11 to 15,2054,2336,28525,28216,110,4.6,161,6.8,4544,761,3783,2.7,16.1,3926,1460,2466,5.2,13.9,618,2.2,27.8,0,109,109,906
1990,16,l) Left Censored,5060,7798,163465,163159,382,4.9,434,5.5,19330,3345,15985,2.1,11.8,18718,4579,14139,2.8,11.5,612,0.3,23,0,206,206,1511
1990,17,a) 0,19051,19194,123513,61970,19090,198.9,0,0,123087,123087,0,198.6,198.6,0,0,0,0,0,123087,198.6,0,0,,,
1990,17,b) 1,15640,15891,125830,124298,122,0.7,3162,18,39580,5447,34133,4.4,31.8,36515,17625,18890,14.2,29.4,3065,2.4,58.8,0,2475,2475,13443
1990,17,c) 2,13340,13687,127970,132018,536,3.7,2218,15.2,25450,3744,21706,2.8,19.3,33546,16964,16582,12.8,25.4,-8096,-6.1,38.6,0,1817,1821,14613
1990,17,d) 3,12571,13170,163888,166499,534,3.8,1922,13.8,24118,2931,21187,1.8,14.5,29339,11594,17745,7,17.6,-5221,-3.1,29,0,1543,1551,9269
1990,17,e) 4,11002,11556,114813,116376,422,3.5,1454,12,20344,2725,17619,2.3,17.5,23470,10830,12640,9.3,20.2,-3126,-2.7,35,0,1141,1143,8366
1990,17,f) 5,10404,11016,126823,126946,351,3.1,1256,10.9,20567,5815,14752,4.6,16.2,20813,7924,12889,6.2,16.4,-246,-0.2,32.4,0,974,977,6148
1990,17,g) 6 to 10,36772,39576,503754,508068,1199,2.9,3491,8.6,66669,10974,55695,2.2,13.1,75297,25504,49793,5,14.8,-8628,-1.7,26.2,0,2501,2508,16788
1990,17,h) 11 to 15,18310,21821,309596,309951,802,3.6,1685,7.6,42632,8257,34375,2.7,13.8,43341,13488,29853,4.4,14,-709,-0.2,27.6,0,1061,1065,6867
1990,17,l) Left Censored,61466,93947,2990652,2988016,3972,4.2,6450,6.8,327658,80337,247321,2.7,11,322386,82856,239530,2.8,10.8,5272,0.2,21.6,0,2899,2932,22690
1990,18,a) 0,9093,9179,55447,27795,9136,199.1,0,0,55304,55304,0,199,199,0,0,0,0,0,55304,199,0,0,,,
1990,18,b) 1,7349,7519,63443,60529,70,0.8,1468,17.7,19254,1561,17693,2.6,31.8,13426,6378,7048,10.5,22.2,5828,9.6,44.4,0,1159,1159,5308
1990,18,c) 2,6000,6136,59067,60523,213,3.2,1096,16.5,12241,1285,10956,2.1,20.2,15152,7308,7844,12.1,25,-2911,-4.8,40.4,0,926,926,6229
1990,18,d) 3,5714,6008,67749,68296,223,3.5,915,14.4,10947,2301,8646,3.4,16,12040,5306,6734,7.8,17.6,-1093,-1.6,32,0,755,755,4043
1990,18,e) 4,5168,5468,56118,57404,176,3.1,718,12.5,10281,2478,7803,4.3,17.9,12852,6051,6801,10.5,22.4,-2571,-4.5,35.8,0,588,588,5019
1990,18,f) 5,4951,5302,52553,53674,187,3.4,589,10.7,8106,1797,6309,3.3,15.1,10348,3926,6422,7.3,19.3,-2242,-4.2,30.2,0,424,424,2835
1990,18,g) 6 to 10,16748,18216,205270,209455,565,3,1603,8.5,26916,4538,22378,2.2,12.9,35286,12013,23273,5.7,16.8,-8370,-3.9,25.8,0,1177,1179,7625
1990,18,h) 11 to 15,8514,10428,145043,145312,405,3.8,815,7.7,19964,4702,15262,3.2,13.7,20502,6392,14110,4.4,14.1,-538,-0.4,27.4,0,520,528,3839
1990,18,l) Left Censored,28651,46339,1426491,1423315,1965,4.2,2816,6,150225,34455,115770,2.4,10.6,143873,34702,109171,2.4,10.1,6352,0.5,20.2,0,1373,1392,9890
1990,19,a) 0,4474,4504,24484,12271,4488,199.3,0,0,24427,24427,0,199.1,199.1,0,0,0,0,0,24427,199.1,0,0,,,
1990,19,b) 1,3663,3747,26749,26227,39,0.9,736,17.8,7591,752,6839,2.9,28.9,6547,3641,2906,13.9,25,1044,3.9,50,0,565,565,3236
1990,19,c) 2,3023,3090,23288,24212,101,3,501,15.1,4475,512,3963,2.1,18.5,6323,2630,3693,10.9,26.1,-1848,-7.6,37,0,390,390,2096
1990,19,d) 3,2920,3118,52875,52932,121,3.7,453,13.7,5196,722,4474,1.4,9.8,5310,2467,2843,4.7,10,-114,-0.2,19.6,0,370,371,1940
1990,19,e) 4,2511,2595,21087,21402,77,2.8,318,11.7,3733,336,3397,1.6,17.4,4362,1834,2528,8.6,20.4,-629,-3,34.8,0,270,270,1496
1990,19,f) 5,2466,2611,24186,24965,73,2.7,281,10.3,3538,481,3057,1.9,14.2,5096,1657,3439,6.6,20.4,-1558,-6.2,28.4,0,213,213,1081
1990,19,g) 6 to 10,10208,11046,102609,103263,353,3.1,932,8.2,13957,2144,11813,2.1,13.5,15264,5751,9513,5.6,14.8,-1307,-1.3,27,0,706,710,4711
1990,19,h) 11 to 15,5563,7004,71932,72569,275,3.9,482,6.8,10245,2276,7969,3.1,14.1,11518,3361,8157,4.6,15.9,-1273,-1.8,28.2,0,308,310,1700
1990,19,l) Left Censored,18963,27842,659817,653832,949,3.4,1619,5.7,69368,14730,54638,2.3,10.6,57398,13418,43980,2.1,8.8,11970,1.8,17.6,0,882,888,5653
1990,20,a) 0,4427,4466,27067,13563,4438,198.7,0,0,27009,27009,0,199.1,199.1,0,0,0,0,0,27009,199.1,0,0,,,
1990,20,b) 1,3638,3691,27189,26349,38,0.9,834,20.2,8554,785,7769,3,32.5,6874,4088,2786,15.5,26.1,1680,6.4,52.2,0,679,679,3392
1990,20,c) 2,3022,3136,24780,25398,123,3.6,622,18.2,5235,879,4356,3.5,20.6,6470,3459,3011,13.6,25.5,-1235,-4.9,41.2,0,515,516,2781
1990,20,d) 3,2832,2947,36404,37439,109,3.4,521,16.4,3886,536,3350,1.4,10.4,5956,3111,2845,8.3,15.9,-2070,-5.5,20.8,0,422,423,2704
1990,20,e) 4,2640,2771,24866,25813,100,3.4,423,14.4,4026,782,3244,3,15.6,5919,3307,2612,12.8,22.9,-1893,-7.3,31.2,0,318,319,2675
1990,20,f) 5,2461,2583,21482,21982,100,3.6,398,14.5,3713,1100,2613,5,16.9,4712,2303,2409,10.5,21.4,-999,-4.5,33.8,0,334,334,1671
1990,20,g) 6 to 10,9454,10101,95347,96859,354,3.4,1094,10.4,14581,2913,11668,3,15.1,17605,6782,10823,7,18.2,-3024,-3.1,30.2,0,808,808,4169
1990,20,h) 11 to 15,4587,5678,61353,60768,184,3.2,434,7.5,9545,2110,7435,3.5,15.7,8375,2483,5892,4.1,13.8,1170,1.9,27.6,0,287,293,1599
1990,20,l) Left Censored,15471,23055,560178,556065,966,4.1,1678,7.2,63290,13990,49300,2.5,11.4,55063,15865,39198,2.9,9.9,8227,1.5,19.8,0,779,784,4474
1990,21,a) 0,6040,6081,38358,19193,6065,199.5,0,0,38331,38331,0,199.7,199.7,0,0,0,0,0,38331,199.7,0,0,,,
1990,21,b) 1,4833,4920,40717,39928,57,1.1,966,17.8,12663,1394,11269,3.5,31.7,11085,4697,6388,11.8,27.8,1578,3.9,55.6,0,781,781,4056
1990,21,c) 2,3936,4047,34362,36192,142,3.2,732,16.7,7228,1087,6141,3,20,10888,6308,4580,17.4,30.1,-3660,-10.1,40,0,600,600,5368
1990,21,d) 3,3675,3818,48661,47788,116,2.8,672,16.3,10631,1603,9028,3.4,22.2,8884,3959,4925,8.3,18.6,1747,3.6,37.2,0,562,562,3103
1990,21,e) 4,3289,3475,36633,36229,133,3.6,458,12.5,7316,2435,4881,6.7,20.2,6507,2436,4071,6.7,18,809,2.2,36,0,389,389,2140
1990,21,f) 5,3043,3178,34446,35408,122,3.7,412,12.4,5106,715,4391,2,14.4,7029,2419,4610,6.8,19.9,-1923,-5.5,28.8,0,319,319,1995
1990,21,g) 6 to 10,10714,11449,131115,132851,360,3,1070,9.1,19633,3627,16006,2.7,14.8,23105,8632,14473,6.5,17.4,-3472,-2.6,29.6,0,823,825,5588
1990,21,h) 11 to 15,5119,6098,84807,83313,240,3.8,522,8.3,13177,2785,10392,3.3,15.8,10189,3486,6703,4.2,12.2,2988,3.6,24.4,0,350,350,2240
1990,21,l) Left Censored,17280,27217,727203,724458,1216,4.4,1837,6.7,79271,18551,60720,2.6,10.9,73780,20401,53379,2.8,10.2,5491,0.7,20.4,0,877,889,5658
1990,22,a) 0,6030,6074,41283,20685,6033,198.6,0,0,41197,41197,0,199.2,199.2,0,0,0,0,0,41197,199.2,0,0,,,
1990,22,b) 1,4463,4541,39728,38309,39,0.8,1076,21,12070,832,11238,2.2,31.5,9232,5140,4092,13.4,24.1,2838,7.4,48.2,0,857,857,4263
1990,22,c) 2,3920,4098,41363,42117,205,4.6,797,18,9752,1826,7926,4.3,23.2,11260,6498,4762,15.4,26.7,-1508,-3.5,46.4,0,666,666,5156
1990,22,d) 3,3591,3762,43714,45162,182,4.5,660,16.5,7391,1293,6098,2.9,16.4,10286,5181,5105,11.5,22.8,-2895,-6.4,32.8,0,533,534,4599
1990,22,e) 4,3583,3730,36727,36509,179,4.6,533,13.6,8113,1239,6874,3.4,22.2,7677,3782,3895,10.4,21,436,1.2,42,0,422,422,2725
1990,22,f) 5,3246,3429,31431,32808,132,3.6,505,14,5660,905,4755,2.8,17.3,8413,4681,3732,14.3,25.6,-2753,-8.3,34.6,0,381,383,3797
1990,22,g) 6 to 10,13857,14888,162290,161567,525,3.4,1495,9.7,28799,5320,23479,3.3,17.8,27353,9963,17390,6.2,16.9,1446,0.9,33.8,0,1103,1113,7020
1990,22,h) 11 to 15,6477,7662,98377,98099,292,3.7,652,8.3,15762,2025,13737,2.1,16.1,15206,5440,9766,5.5,15.5,556,0.6,31,0,460,465,2447
1990,22,l) Left Censored,18746,30793,755019,749211,1352,4.3,2375,7.6,98337,25451,72886,3.4,13.1,86721,27788,58933,3.7,11.6,11616,1.5,23.2,0,1087,1121,8251
1990,23,a) 0,2615,2626,13312,6688,2612,198.9,0,0,13249,13249,0,198.1,198.1,0,0,0,0,0,13249,198.1,0,0,,,
1990,23,b) 1,2434,2452,15378,16452,11,0.4,609,21.7,3484,419,3065,2.5,21.2,5631,2878,2753,17.5,34.2,-2147,-13,42.4,0,459,459,2316
1990,23,c) 2,2110,2135,15019,16069,58,2.4,508,21.3,2827,343,2484,2.1,17.6,4926,2407,2519,15,30.7,-2099,-13.1,35.2,0,393,393,1841
1990,23,d) 3,1963,2054,18195,19174,78,3.5,394,17.7,2538,430,2108,2.2,13.2,4496,1962,2534,10.2,23.4,-1958,-10.2,26.4,0,311,311,1645
1990,23,e) 4,1663,1729,12249,13583,57,3.1,285,15.4,1766,249,1517,1.8,13,4434,1402,3032,10.3,32.6,-2668,-19.6,26,0,219,219,1104
1990,23,f) 5,1400,1454,12013,12599,49,3.2,206,13.4,1952,269,1683,2.1,15.5,3123,1288,1835,10.2,24.8,-1171,-9.3,31,0,153,153,1108
1990,23,g) 6 to 10,4425,4737,49992,51930,136,2.8,497,10.1,5681,992,4689,1.9,10.9,9557,2770,6787,5.3,18.4,-3876,-7.5,21.8,0,350,352,2002
1990,23,h) 11 to 15,2243,2692,32695,33449,78,2.8,241,8.7,4228,805,3423,2.4,12.6,5735,1782,3953,5.3,17.1,-1507,-4.5,25.2,0,156,156,777
1990,23,l) Left Censored,6609,9727,245714,250134,359,3.6,675,6.8,23166,6965,16201,2.8,9.3,32005,7236,24769,2.9,12.8,-8839,-3.5,18.6,0,364,367,2917
1990,24,a) 0,9075,9133,56359,28235,9101,199.3,0,0,56249,56249,0,199.2,199.2,0,0,0,0,0,56249,199.2,0,0,,,
1990,24,b) 1,7387,7489,56882,55648,52,0.6,1656,19.7,17077,884,16193,1.6,30.7,14609,8521,6088,15.3,26.3,2468,4.4,52.6,0,1291,1291,6932
1990,24,c) 2,6415,6563,59476,61052,254,3.6,1149,16.3,12881,1913,10968,3.1,21.1,16033,8700,7333,14.3,26.3,-3152,-5.2,42.2,0,919,919,7154
1990,24,d) 3,5714,5970,69984,71843,240,3.8,960,15.1,10225,1496,8729,2.1,14.2,13943,6914,7029,9.6,19.4,-3718,-5.2,28.4,0,745,745,4713
1990,24,e) 4,5173,5361,53726,54957,179,3.2,748,13.2,10136,1557,8579,2.8,18.4,12597,5461,7136,9.9,22.9,-2461,-4.5,36.8,0,552,552,4188
1990,24,f) 5,4578,4896,52626,54305,152,3,566,11.1,8901,1186,7715,2.2,16.4,12259,5673,6586,10.4,22.6,-3358,-6.2,32.8,0,422,422,4443
1990,24,g) 6 to 10,14632,15891,201246,201988,545,3.3,1449,8.9,32602,5920,26682,2.9,16.1,34085,10960,23125,5.4,16.9,-1483,-0.8,32.2,0,1025,1040,7305
1990,24,h) 11 to 15,6864,8333,121102,122927,334,3.9,644,7.6,15599,2932,12667,2.4,12.7,19249,5669,13580,4.6,15.7,-3650,-3,25.4,0,375,378,2986
1990,24,l) Left Censored,21951,36868,1135102,1135081,1965,5.3,2532,6.8,146564,40575,105989,3.6,12.9,146522,37981,108541,3.3,12.9,42,0,25.8,0,956,972,9280
1990,25,a) 0,10131,10203,64893,32492,10174,199.4,0,0,64803,64803,0,199.4,199.4,0,0,0,0,0,64803,199.4,0,0,,,
1990,25,b) 1,9457,9724,73169,74697,59,0.5,2223,20.3,19355,1699,17656,2.3,25.9,22411,9858,12553,13.2,30,-3056,-4.1,51.8,0,1699,1700,7782
1990,25,c) 2,8645,8822,86487,93574,297,3,2006,20.5,13662,1645,12017,1.8,14.6,27835,14161,13674,15.1,29.7,-14173,-15.1,29.2,0,1628,1628,11913
1990,25,d) 3,8163,8514,91680,97627,293,3.1,1756,18.8,11376,2007,9369,2.1,11.7,23269,10521,12748,10.8,23.8,-11893,-12.1,23.4,0,1395,1395,8726
1990,25,e) 4,7009,7327,73593,79470,226,2.9,1309,16.5,9896,1301,8595,1.6,12.5,21650,9016,12634,11.3,27.2,-11754,-14.7,25,0,1058,1058,7891
1990,25,f) 5,6340,6633,76228,80142,232,3.3,948,13.5,8790,1663,7127,2.1,11,16617,6076,10541,7.6,20.7,-7827,-9.7,22,0,757,757,4602
1990,25,g) 6 to 10,20904,22462,296972,310483,752,3.2,2405,10.3,36057,8342,27715,2.7,11.6,63080,20051,43029,6.5,20.3,-27023,-8.7,23.2,0,1789,1797,14920
1990,25,h) 11 to 15,9847,12185,208555,213980,421,3.4,1086,8.7,23390,4422,18968,2.1,10.9,34239,8926,25313,4.2,16,-10849,-5.1,21.8,0,654,655,5055
1990,25,l) Left Censored,37028,54260,1773391,1818804,2104,3.8,3897,7.1,172537,44019,128518,2.4,9.5,263362,66458,196904,3.7,14.5,-90825,-5,19,0,1867,1918,20070
1990,26,a) 0,14768,14903,87370,43793,14846,199.2,0,0,87154,87154,0,199,199,0,0,0,0,0,87154,199,0,0,,,
1990,26,b) 1,12146,12414,100121,98031,138,1,2423,17.7,31075,5885,25190,6,31.7,26894,11823,15071,12.1,27.4,4181,4.3,54.8,0,1845,1845,9443
1990,26,c) 2,10512,10806,97398,101251,388,3.3,1825,15.7,19453,2708,16745,2.7,19.2,27161,13053,14108,12.9,26.8,-7708,-7.6,38.4,0,1487,1487,10743
1990,26,d) 3,10348,10814,116471,119252,403,3.5,1569,13.7,17284,3224,14060,2.7,14.5,22845,9146,13699,7.7,19.2,-5561,-4.7,29,0,1234,1240,7339
1990,26,e) 4,8620,9046,90629,91544,283,3,1236,12.9,15650,2521,13129,2.8,17.1,17479,6985,10494,7.6,19.1,-1829,-2,34.2,0,972,975,5416
1990,26,f) 5,7997,8550,85882,88831,294,3.3,946,10.6,12615,1791,10824,2,14.2,18512,7306,11206,8.2,20.8,-5897,-6.6,28.4,0,731,734,5951
1990,26,g) 6 to 10,27206,29608,343767,351109,886,2.9,2852,9.3,46468,7681,38787,2.2,13.2,61151,19652,41499,5.6,17.4,-14683,-4.2,26.4,0,2068,2071,12720
1990,26,h) 11 to 15,13894,17124,223309,225556,667,3.8,1325,7.6,30865,6250,24615,2.8,13.7,35358,11536,23822,5.1,15.7,-4493,-2,27.4,0,801,807,5286
1990,26,l) Left Censored,43585,70206,2228789,2232865,2877,4,4497,6.3,247263,66732,180531,3,11.1,255415,61113,194302,2.7,11.4,-8152,-0.3,22.2,0,2165,2206,16326
1990,27,a) 0,7946,8039,48767,24438,8005,199.2,0,0,48659,48659,0,199.1,199.1,0,0,0,0,0,48659,199.1,0,0,,,
1990,27,b) 1,6433,6538,55913,51136,60,0.8,1204,16.8,22152,1138,21014,2.2,43.3,12597,7000,5597,13.7,24.6,9555,18.7,49.2,0,897,897,5289
1990,27,c) 2,5459,5607,45618,47081,207,3.5,874,14.6,10105,1332,8773,2.8,21.5,13031,6752,6279,14.3,27.7,-2926,-6.2,43,0,687,687,5518
1990,27,d) 3,4992,5250,68473,69359,210,3.8,733,13.2,9914,1524,8390,2.2,14.3,11686,5951,5735,8.6,16.8,-1772,-2.5,28.6,0,573,579,4644
1990,27,e) 4,4543,4837,46713,48003,195,3.8,661,13,7588,1586,6002,3.3,15.8,10168,4193,5975,8.7,21.2,-2580,-5.4,31.6,0,500,500,3170
1990,27,f) 5,4283,4562,51318,53184,118,2.5,543,11.4,7707,1326,6381,2.5,14.5,11438,3736,7702,7,21.5,-3731,-7,29,0,417,417,2604
1990,27,g) 6 to 10,14806,16214,201535,203274,518,3.1,1451,8.7,27573,4100,23473,2,13.6,31051,11929,19122,5.9,15.3,-3478,-1.7,27.2,0,1031,1045,7307
1990,27,h) 11 to 15,7810,9518,125481,125623,353,3.6,708,7.3,17149,2662,14487,2.1,13.7,17433,4635,12798,3.7,13.9,-284,-0.2,27.4,0,420,429,2458
1990,27,l) Left Censored,24709,37188,1179328,1173045,1496,4,2513,6.7,134470,29390,105080,2.5,11.5,121904,36228,85676,3.1,10.4,12566,1.1,20.8,0,1084,1090,8272
1990,28,a) 0,3960,3975,21708,10887,3950,198.7,0,0,21642,21642,0,198.8,198.8,0,0,0,0,0,21642,198.8,0,0,,,
1990,28,b) 1,2936,2961,22069,22683,18,0.5,810,23.8,6014,212,5802,0.9,26.5,7241,4637,2604,20.4,31.9,-1227,-5.4,53,0,675,675,4081
1990,28,c) 2,2452,2550,23316,24001,98,3.5,501,18,4859,722,4137,3,20.2,6229,3205,3024,13.4,26,-1370,-5.8,40.4,0,423,423,2745
1990,28,d) 3,2291,2427,29452,28590,126,4.9,413,16,6732,958,5774,3.4,23.5,5007,2475,2532,8.7,17.5,1725,6,35,0,339,340,1813
1990,28,e) 4,2016,2081,17762,18290,90,4,372,16.7,3355,263,3092,1.4,18.3,4410,2426,1984,13.3,24.1,-1055,-5.8,36.6,0,295,295,1612
1990,28,f) 5,2029,2112,19252,19667,77,3.5,285,12.8,2957,538,2419,2.7,15,3786,1657,2129,8.4,19.3,-829,-4.3,30,0,233,233,1402
1990,28,g) 6 to 10,7521,8032,79489,81468,307,3.7,791,9.5,11938,2913,9025,3.6,14.7,15896,5288,10608,6.5,19.5,-3958,-4.8,29.4,0,591,591,3195
1990,28,h) 11 to 15,3761,4480,48690,48479,170,3.7,404,8.8,7446,1624,5822,3.3,15.4,7024,2201,4823,4.5,14.5,422,0.9,29,0,271,271,1113
1990,28,l) Left Censored,11558,18249,463353,460155,749,4,1254,6.8,51181,10985,40196,2.4,11.1,44786,12072,32714,2.6,9.7,6395,1.4,19.4,0,579,600,3910
1990,29,a) 0,9698,9760,57620,28882,9708,198.9,0,0,57476,57476,0,199,199,0,0,0,0,0,57476,199,0,0,,,
1990,29,b) 1,7939,8105,56613,56478,62,0.7,1825,20.1,15973,1519,14454,2.7,28.3,15703,8958,6745,15.9,27.8,270,0.5,55.6,0,1442,1442,7482
1990,29,c) 2,6489,6669,54784,56772,249,3.4,1254,17.4,11457,1733,9724,3.1,20.2,15433,7919,7514,13.9,27.2,-3976,-7,40.4,0,1000,1000,6159
1990,29,d) 3,6163,6451,70585,72633,277,4,1082,15.7,11328,1922,9406,2.6,15.6,15424,7077,8347,9.7,21.2,-4096,-5.6,31.2,0,854,857,5777
1990,29,e) 4,5297,5546,51081,52170,191,3.3,782,13.3,9107,1989,7118,3.8,17.5,11285,4848,6437,9.3,21.6,-2178,-4.1,35,0,592,592,3236
1990,29,f) 5,5359,5622,56839,57699,198,3.4,666,11.3,8824,1974,6850,3.4,15.3,10544,3868,6676,6.7,18.3,-1720,-3,30.6,0,512,512,2930
1990,29,g) 6 to 10,17115,18719,205920,208949,627,3.3,1693,8.8,29864,5217,24647,2.5,14.3,35921,13289,22632,6.4,17.2,-6057,-2.9,28.6,0,1202,1213,8963
1990,29,h) 11 to 15,8656,10686,137225,137487,399,3.7,855,7.8,18371,4132,14239,3,13.4,18895,5586,13309,4.1,13.7,-524,-0.3,26.8,0,549,557,2719
1990,29,l) Left Censored,27704,43649,1279882,1281643,1900,4.3,2983,6.7,142369,35890,106479,2.8,11.1,145891,33578,112313,2.6,11.4,-3522,-0.3,22.2,0,1302,1313,8438
1990,30,a) 0,1840,1847,8546,4287,1835,198.7,0,0,8519,8519,0,198.7,198.7,0,0,0,0,0,8519,198.7,0,0,,,
1990,30,b) 1,1461,1507,9101,8957,19,1.1,309,18.6,2354,206,2148,2.3,26.3,2066,1060,1006,11.8,23.1,288,3.2,46.2,0,236,236,882
1990,30,c) 2,1265,1287,8472,8556,49,3.5,227,16.4,1869,183,1686,2.1,21.8,2037,866,1171,10.1,23.8,-168,-2,43.6,0,173,173,699
1990,30,d) 3,1190,1234,9720,9834,73,5.6,198,15.2,1835,460,1375,4.7,18.7,2062,1151,911,11.7,21,-227,-2.3,37.4,0,152,152,936
1990,30,e) 4,1115,1151,7531,7900,46,3.8,146,12.1,1348,169,1179,2.1,17.1,2086,1174,912,14.9,26.4,-738,-9.3,34.2,0,108,108,956
1990,30,f) 5,990,1021,8234,8029,48,4.5,120,11.3,1544,233,1311,2.9,19.2,1133,530,603,6.6,14.1,411,5.1,28.2,0,78,78,385
1990,30,g) 6 to 10,3868,4144,32165,32208,175,4.1,387,9.1,5419,1004,4415,3.1,16.8,5505,1792,3713,5.6,17.1,-86,-0.3,33.6,0,265,266,1371
1990,30,h) 11 to 15,2071,2407,21281,21052,97,3.9,210,8.5,3543,487,3056,2.3,16.8,3084,1323,1761,6.3,14.6,459,2.2,29.2,0,120,120,631
1990,30,l) Left Censored,4996,7051,113257,112538,241,3.4,475,6.6,11733,1823,9910,1.6,10.4,10295,3155,7140,2.8,9.1,1438,1.3,18.2,0,250,250,1047
1990,31,a) 0,2803,2829,16169,8105,2813,198.9,0,0,16128,16128,0,199,199,0,0,0,0,0,16128,199,0,0,,,
1990,31,b) 1,2326,2368,16222,16023,21,0.8,467,17.8,4906,188,4718,1.2,30.6,4507,2584,1923,16.1,28.1,399,2.5,56.2,0,362,362,2211
1990,31,c) 2,2002,2102,18006,18272,77,3.4,327,14.5,3602,936,2666,5.1,19.7,4134,1807,2327,9.9,22.6,-532,-2.9,39.4,0,265,265,1468
1990,31,d) 3,1758,1809,20298,20191,73,3.8,270,14.1,2925,303,2622,1.5,14.5,2710,1299,1411,6.4,13.4,215,1.1,26.8,0,221,221,1097
1990,31,e) 4,1583,1649,15359,14810,62,3.6,206,11.9,3153,519,2634,3.5,21.3,2055,1064,991,7.2,13.9,1098,7.4,27.8,0,166,166,927
1990,31,f) 5,1790,1873,19790,19693,76,4,171,8.9,2963,352,2611,1.8,15,2768,1159,1609,5.9,14.1,195,0.9,28.2,0,135,135,869
1990,31,g) 6 to 10,6189,6703,63977,64461,235,3.4,629,9.1,8636,1725,6911,2.7,13.4,9604,3457,6147,5.4,14.9,-968,-1.5,26.8,0,422,422,2129
1990,31,h) 11 to 15,3375,3993,40349,40258,143,3.5,326,8,6091,1312,4779,3.3,15.1,5908,2175,3733,5.4,14.7,183,0.4,29.4,0,215,216,1509
1990,31,l) Left Censored,11003,15681,368600,366449,548,3.4,1013,6.4,36916,7858,29058,2.1,10.1,32613,7942,24671,2.2,8.9,4303,1.2,17.8,0,486,486,2457
1990,32,a) 0,3056,3081,21471,10752,3071,199.4,0,0,21438,21438,0,199.4,199.4,0,0,0,0,0,21438,199.4,0,0,,,
1990,32,b) 1,2342,2367,25750,24326,15,0.6,605,22.4,9293,345,8948,1.4,38.2,6445,3644,2801,15,26.5,2848,11.7,53,0,495,495,2704
1990,32,c) 2,1740,1780,24044,23452,69,3.6,371,19.1,6646,485,6161,2.1,28.3,5462,2862,2600,12.2,23.3,1184,5,46.6,0,297,297,2088
1990,32,d) 3,1586,1681,20200,21224,91,5.1,268,15.1,3768,479,3289,2.3,17.8,5815,2040,3775,9.6,27.4,-2047,-9.6,35.6,0,212,212,1440
1990,32,e) 4,1313,1381,20700,20474,68,4.7,204,14,4029,654,3375,3.2,19.7,3576,1565,2011,7.6,17.5,453,2.2,35,0,163,164,1292
1990,32,f) 5,1094,1170,17899,17444,67,5.5,142,11.7,3743,680,3063,3.9,21.5,2833,1101,1732,6.3,16.2,910,5.3,32.4,0,115,115,900
1990,32,g) 6 to 10,4177,4638,73689,74490,239,5,506,10.6,12508,2589,9919,3.5,16.8,14110,4724,9386,6.3,18.9,-1602,-2.1,33.6,0,362,370,3941
1990,32,h) 11 to 15,2063,2429,54888,50603,130,5.3,170,6.9,14884,1549,13335,3.1,29.4,6315,2370,3945,4.7,12.5,8569,16.9,25,0,111,111,2001
1990,32,l) Left Censored,4429,7192,278299,273639,531,7.4,474,6.6,39922,8414,31508,3.1,14.6,30602,7608,22994,2.8,11.2,9320,3.4,22.4,0,158,158,1538
1990,33,a) 0,2561,2576,13662,6843,2563,199,0,0,13639,13639,0,199.3,199.3,0,0,0,0,0,13639,199.3,0,0,,,
1990,33,b) 1,2356,2393,20378,20288,19,0.7,667,24.2,6678,810,5868,4,32.9,6497,3116,3381,15.4,32,181,0.9,64,0,551,551,2712
1990,33,c) 2,2199,2232,16180,18611,81,3.2,596,23.7,2434,353,2081,1.9,13.1,7296,4129,3167,22.2,39.2,-4862,-26.1,26.2,0,508,508,3447
1990,33,d) 3,2086,2138,16555,18166,51,2.1,542,22.6,2201,242,1959,1.3,12.1,5423,2627,2796,14.5,29.9,-3222,-17.8,24.2,0,448,448,2121
1990,33,e) 4,1761,1854,16422,18084,70,3.4,416,20.4,1978,378,1600,2.1,10.9,5301,2614,2687,14.5,29.3,-3323,-18.4,21.8,0,324,324,2267
1990,33,f) 5,1514,1565,14551,15267,39,2.3,243,14.5,2185,289,1896,1.9,14.3,3616,1402,2214,9.2,23.7,-1431,-9.4,28.6,0,195,195,1132
1990,33,g) 6 to 10,4403,4686,46909,50015,137,2.8,572,11.6,5019,916,4103,1.8,10,11230,3665,7565,7.3,22.5,-6211,-12.5,20,0,419,419,2553
1990,33,h) 11 to 15,2098,2496,31680,32891,92,3.5,259,10,3944,1337,2607,4.1,12,6365,1721,4644,5.2,19.4,-2421,-7.4,24,0,172,172,844
1990,33,l) Left Censored,6147,9035,268212,274862,469,5.1,660,7.2,23565,6633,16932,2.4,8.6,36865,8693,28172,3.2,13.4,-13300,-4.8,17.2,0,269,271,2369
1990,34,a) 0,15446,15536,91233,45723,15470,199.2,0,0,91020,91020,0,199.1,199.1,0,0,0,0,0,91020,199.1,0,0,,,
1990,34,b) 1,13227,13318,97207,95276,71,0.5,3125,20.8,28680,1994,26686,2.1,30.1,24818,12527,12291,13.1,26,3862,4.1,52,0,2336,2341,9590
1990,34,c) 2,12214,12387,100857,105789,455,3.4,2453,18.2,20474,2206,18268,2.1,19.4,30337,15617,14720,14.8,28.7,-9863,-9.3,38.8,0,1928,1928,11938
1990,34,d) 3,11043,11314,113139,117023,443,3.7,1933,15.9,17151,3435,13716,2.9,14.7,24919,11097,13822,9.5,21.3,-7768,-6.6,29.4,0,1528,1528,8726
1990,34,e) 4,9616,9925,91787,94217,352,3.3,1502,14.2,15810,2062,13748,2.2,16.8,20670,8393,12277,8.9,21.9,-4860,-5.1,33.6,0,1171,1172,6796
1990,34,f) 5,8534,8847,87074,89984,290,3.1,1196,12.8,14164,1895,12269,2.1,15.7,19983,7321,12662,8.1,22.2,-5819,-6.5,31.4,0,926,927,6048
1990,34,g) 6 to 10,29242,30697,345514,357407,956,3,3061,9.6,46070,7403,38667,2.1,12.9,69855,21482,48373,6,19.5,-23785,-6.6,25.8,0,2272,2272,15735
1990,34,h) 11 to 15,14048,15724,192788,196762,457,2.8,1389,8.6,25629,5084,20545,2.6,13,33577,10876,22701,5.5,17.1,-7948,-4.1,26,0,941,948,6132
1990,34,l) Left Censored,46594,67860,2078313,2100279,3000,4.4,4643,6.8,242502,72222,170280,3.4,11.5,286435,75886,210549,3.6,13.6,-43933,-2.1,23,0,2261,2280,17284
1990,35,a) 0,2872,2881,16148,8114,2863,198.8,0,0,16069,16069,0,198,198,0,0,0,0,0,16069,198,0,0,,,
1990,35,b) 1,2310,2357,17475,16824,19,0.7,567,21.3,5887,333,5554,2,35,4584,2618,1966,15.6,27.2,1303,7.8,54.4,0,448,448,2245
1990,35,c) 2,1830,1901,14158,14687,94,4.6,365,17.7,3099,465,2634,3.2,21.1,4156,2484,1672,16.9,28.3,-1057,-7.2,42.2,0,306,306,2047
1990,35,d) 3,1658,1748,19685,20020,87,4.6,313,16.7,2667,455,2212,2.3,13.3,3337,1707,1630,8.5,16.7,-670,-3.4,26.6,0,244,244,1400
1990,35,e) 4,1571,1625,13752,13993,82,4.8,239,14,2558,440,2118,3.1,18.3,3040,1367,1673,9.8,21.7,-482,-3.4,36.6,0,180,180,963
1990,35,f) 5,1438,1539,14414,14585,85,5.3,220,13.6,2651,660,1991,4.5,18.2,2993,1381,1612,9.5,20.5,-342,-2.3,36.4,0,164,164,1010
1990,35,g) 6 to 10,5436,5925,57869,57783,257,4.2,628,10.3,10870,2464,8406,4.3,18.8,10698,4501,6197,7.8,18.5,172,0.3,37,0,410,411,2677
1990,35,h) 11 to 15,2675,3142,32022,32063,157,4.9,268,8.4,5107,1275,3832,4,15.9,5189,1723,3466,5.4,16.2,-82,-0.3,31.8,0,157,166,786
1990,35,l) Left Censored,6456,10090,224487,223271,494,4.8,804,7.8,27785,6734,21051,3,12.4,25352,7331,18021,3.3,11.4,2433,1,22.8,0,334,336,2159
1990,36,a) 0,35036,35160,194028,97228,35019,199.2,0,0,193601,193601,0,199.1,199.1,0,0,0,0,0,193601,199.1,0,0,,,
1990,36,b) 1,29881,30173,210938,208796,146,0.4,6810,20.1,60644,4057,56587,1.9,29,56360,28138,28222,13.5,27,4284,2,54,0,5285,5287,22165
1990,36,c) 2,25802,26162,207046,218905,906,3.2,5035,17.7,38099,4548,33551,2.1,17.4,61817,26625,35192,12.2,28.2,-23718,-10.8,34.8,0,4084,4084,21456
1990,36,d) 3,23631,24253,302135,310382,905,3.5,4136,15.9,33754,5480,28274,1.8,10.9,50247,22829,27418,7.4,16.2,-16493,-5.3,21.8,0,3379,3383,19017
1990,36,e) 4,20706,21302,170157,178653,737,3.3,3239,14.3,28532,3893,24639,2.2,16,45524,19686,25838,11,25.5,-16992,-9.5,32,0,2645,2645,16857
1990,36,f) 5,18866,19458,181331,186085,690,3.4,2701,13.2,29412,3695,25717,2,15.8,38920,16123,22797,8.7,20.9,-9508,-5.1,31.6,0,2106,2109,12946
1990,36,g) 6 to 10,63444,66797,748325,768074,2001,2.9,7178,10.3,98843,16903,81940,2.2,12.9,138341,45065,93276,5.9,18,-39498,-5.1,25.8,0,5533,5558,33392
1990,36,h) 11 to 15,29423,34287,480307,487966,1178,3.3,2955,8.4,66254,14447,51807,3,13.6,81571,21465,60106,4.4,16.7,-15317,-3.1,27.2,0,2053,2062,13235
1990,36,l) Left Censored,105145,148352,4496364,4525942,5349,3.5,10818,7.2,503018,112443,390575,2.5,11.1,562174,152720,409454,3.4,12.4,-59156,-1.3,22.2,0,5956,6048,48212
1990,37,a) 0,12861,12961,71194,35689,12900,199.1,0,0,71010,71010,0,199,199,0,0,0,0,0,71010,199,0,0,,,
1990,37,b) 1,10002,10203,77021,75462,76,0.7,2413,20.9,23869,2541,21328,3.4,31.6,20750,11189,9561,14.8,27.5,3119,4.1,55,0,1909,1912,9521
1990,37,c) 2,8551,8807,78425,80713,350,3.7,1692,17.7,19730,4647,15083,5.8,24.4,24306,12863,11443,15.9,30.1,-4576,-5.7,48.8,0,1384,1385,11301
1990,37,d) 3,7843,8382,88945,88412,364,4.1,1288,14.5,17806,2519,15287,2.8,20.1,16739,7629,9110,8.6,18.9,1067,1.2,37.8,0,1066,1066,6494
1990,37,e) 4,7033,7446,67359,68854,285,3.6,1110,14.1,11931,1610,10321,2.3,17.3,14920,7059,7861,10.3,21.7,-2989,-4.4,34.6,0,868,874,5261
1990,37,f) 5,6709,7084,74309,74707,289,3.9,833,11.3,12467,2269,10198,3,16.7,13262,4742,8520,6.3,17.8,-795,-1.1,33.4,0,635,637,3408
1990,37,g) 6 to 10,22530,24462,282432,283571,826,3.3,2158,8.6,41012,9486,31526,3.3,14.5,43289,14383,28906,5.1,15.3,-2277,-0.8,29,0,1500,1515,8652
1990,37,h) 11 to 15,10179,12273,167436,166702,451,3.6,887,7.1,23250,4080,19170,2.4,13.9,21782,7255,14527,4.4,13.1,1468,0.8,26.2,0,580,580,4245
1990,37,l) Left Censored,31239,54379,1760668,1754420,2595,4.7,3394,6.2,211611,54345,157266,3.1,12.1,199114,60214,138900,3.4,11.3,12497,0.8,22.6,0,1424,1444,19608
1990,38,a) 0,1173,1178,5799,2906,1170,198.6,0,0,5787,,,,199.1,0,0,0,0,0,5787,199.1,0,1,,,
1990,38,b) 1,938,943,5888,5932,4,0.4,192,18.3,1246,,,,21,1333,732,601,12.3,22.5,-87,-1.5,42,1,144,144,591
1990,38,c) 2,862,885,6228,6559,31,3.3,138,14.5,1023,63,960,1,15.6,1685,851,834,13,25.7,-662,-10.1,31.2,0,112,112,605
1990,38,d) 3,819,839,6751,6728,19,2.1,141,15.5,1115,121,994,1.8,16.6,1069,540,529,8,15.9,46,0.7,31.8,0,124,124,502
1990,38,e) 4,723,759,5472,5540,36,4.5,93,11.7,876,182,694,3.3,15.8,1011,389,622,7,18.2,-135,-2.4,31.6,0,72,72,294
1990,38,f) 5,716,748,4950,5047,14,1.8,84,10.7,656,41,615,0.8,13,850,341,509,6.8,16.8,-194,-3.8,26,0,66,66,274
1990,38,g) 6 to 10,2837,3097,24530,24530,94,2.9,270,8.5,3460,545,2915,2.2,14.1,3459,1473,1986,6,14.1,1,0,28.2,0,213,214,1137
1990,38,h) 11 to 15,1517,1704,14967,14883,53,3,132,7.6,1916,178,1738,1.2,12.9,1747,609,1138,4.1,11.7,169,1.2,23.4,0,97,97,447
1990,38,l) Left Censored,4809,6659,119236,118477,188,2.8,411,6.1,11683,1547,10136,1.3,9.9,10165,2942,7223,2.5,8.6,1518,1.3,17.2,0,216,216,928
1990,39,a) 0,16042,16163,102365,51668,16047,198.6,0,0,101395,101395,0,196.2,196.2,0,0,0,0,0,101395,196.2,0,0,,,
1990,39,b) 1,13425,13748,121377,118260,287,1.9,2618,17.4,34828,5788,29040,4.9,29.5,28593,15191,13402,12.8,24.2,6235,5.3,48.4,0,2016,2016,11985
1990,39,c) 2,11528,11905,110608,115521,402,3.1,1984,15.5,22450,2914,19536,2.5,19.4,32276,16287,15989,14.1,27.9,-9826,-8.5,38.8,0,1642,1642,14030
1990,39,d) 3,10855,11434,124467,127619,457,3.8,1753,14.4,20101,3930,16171,3.1,15.8,26404,13575,12829,10.6,20.7,-6303,-4.9,31.6,0,1404,1405,11956
1990,39,e) 4,9492,10037,101889,103567,349,3.3,1325,12.6,17025,3544,13481,3.4,16.4,20380,9002,11378,8.7,19.7,-3355,-3.3,32.8,0,1084,1086,7831
1990,39,f) 5,8726,9471,116202,116444,370,3.8,1014,10.3,18303,3853,14450,3.3,15.7,18787,6397,12390,5.5,16.1,-484,-0.4,31.4,0,797,798,5065
1990,39,g) 6 to 10,31127,34254,403705,409775,1075,3,3070,8.7,52479,9600,42879,2.3,12.8,64618,23321,41297,5.7,15.8,-12139,-3,25.6,0,2270,2283,17079
1990,39,h) 11 to 15,16314,20209,285000,284977,689,3.3,1448,7,37956,7498,30458,2.6,13.3,37909,12441,25468,4.4,13.3,47,0,26.6,0,927,939,5858
1990,39,l) Left Censored,57015,95084,2865801,2870819,4010,4.2,6276,6.5,304147,77826,226321,2.7,10.6,314183,74303,239880,2.6,10.9,-10036,-0.3,21.2,0,2817,2872,21842
1990,40,a) 0,5587,5626,30271,15176,5600,199.1,0,0,30190,30190,0,198.9,198.9,0,0,0,0,0,30190,198.9,0,0,,,
1990,40,b) 1,4304,4346,32904,32452,23,0.5,1054,21.4,11046,1540,9506,4.7,34,10141,6557,3584,20.2,31.2,905,2.8,62.4,0,863,863,5817
1990,40,c) 2,3486,3575,29272,32001,143,3.7,697,18,5874,912,4962,2.8,18.4,11332,4723,6609,14.8,35.4,-5458,-17,36.8,0,579,579,3932
1990,40,d) 3,3079,3248,39557,39226,169,4.9,561,16.2,7356,1652,5704,4.2,18.8,6694,2820,3874,7.2,17.1,662,1.7,34.2,0,456,458,2261
1990,40,e) 4,2983,3115,27928,28360,128,3.9,460,14,4827,742,4085,2.6,17,5690,2880,2810,10.2,20.1,-863,-3.1,34,0,379,379,2329
1990,40,f) 5,2877,3032,25740,25972,118,3.7,457,14.2,4524,803,3721,3.1,17.4,4988,2233,2755,8.6,19.2,-464,-1.8,34.8,0,350,350,1718
1990,40,g) 6 to 10,11734,12635,130827,129561,519,4,1335,10.2,21810,3213,18597,2.5,16.8,19278,6746,12532,5.2,14.9,2532,1.9,29.8,0,948,948,4420
1990,40,h) 11 to 15,5306,6291,67663,66881,282,4.4,590,9.1,11093,2988,8105,4.5,16.6,9528,3234,6294,4.8,14.2,1565,2.4,28.4,0,393,394,1749
1990,40,l) Left Censored,15012,23913,554805,551537,986,4,1858,7.6,63292,15332,47960,2.8,11.5,56755,18495,38260,3.4,10.3,6537,1.2,20.6,0,851,860,5730
1990,41,a) 0,7375,7410,41158,20614,7383,199.3,0,0,41089,41089,0,199.3,199.3,0,0,0,0,0,41089,199.3,0,0,,,
1990,41,b) 1,4513,4558,33220,32529,44,0.9,1010,19.8,10149,1172,8977,3.6,31.2,8766,4373,4393,13.4,26.9,1383,4.3,53.8,0,779,779,3388
1990,41,c) 2,4489,4566,34313,35479,750,16.4,684,15,10179,4993,5186,14.1,28.7,12510,4303,8207,12.1,35.3,-2331,-6.6,57.4,0,543,543,3505
1990,41,d) 3,4108,4277,44993,43683,663,15.5,597,14,11077,5207,5870,11.9,25.4,8457,3149,5308,7.2,19.4,2620,6,38.8,0,456,456,2347
1990,41,e) 4,3585,3699,31303,31572,546,14.9,434,11.9,8631,4117,4514,13,27.3,9169,2925,6244,9.3,29,-538,-1.7,54.6,0,342,351,2528
1990,41,f) 5,3108,3284,31570,30236,458,14.2,346,10.7,8070,3660,4410,12.1,26.7,5401,2161,3240,7.1,17.9,2669,8.8,35.8,0,268,268,1743
1990,41,g) 6 to 10,11562,12535,135563,132796,1763,14.4,1082,8.9,30131,15052,15079,11.3,22.7,24597,7399,17198,5.6,18.5,5534,4.2,37,0,769,774,4871
1990,41,h) 11 to 15,5772,6835,81503,79568,915,13.7,542,8.1,18411,9061,9350,11.4,23.1,14541,5771,8770,7.3,18.3,3870,4.8,36.6,0,332,347,2755
1990,41,l) Left Censored,14634,23181,568321,556415,2409,10.6,1499,6.6,91495,37092,54403,6.7,16.4,67682,20322,47360,3.7,12.2,23813,4.2,24.4,0,639,641,6702
1990,42,a) 0,18788,18926,109067,54656,18856,199.3,0,0,108823,108823,0,199.1,199.1,0,0,0,0,0,108823,199.1,0,0,,,
1990,42,b) 1,16204,16504,126192,124255,135,0.7,3100,17.1,34966,3954,31012,3.2,28.1,31091,16042,15049,12.9,25,3875,3.1,50,0,2414,2420,13495
1990,42,c) 2,14059,14435,119102,123336,501,3.2,2347,15.2,23435,3009,20426,2.4,19,31903,14819,17084,12,25.9,-8468,-6.9,38,0,1913,1916,12415
1990,42,d) 3,13329,13872,143671,146918,505,3.5,1880,12.9,20713,3253,17460,2.2,14.1,27207,12394,14813,8.4,18.5,-6494,-4.4,28.2,0,1516,1516,9832
1990,42,e) 4,11740,12222,118839,120564,396,3.1,1420,11.1,18721,2349,16372,1.9,15.5,22171,8293,13878,6.9,18.4,-3450,-2.9,31,0,1115,1115,5970
1990,42,f) 5,10469,11069,131259,133993,373,3.2,1198,10.4,17726,2603,15123,1.9,13.2,23193,9438,13755,7,17.3,-5467,-4.1,26.4,0,912,921,6667
1990,42,g) 6 to 10,36102,38949,466065,471194,1190,3,3386,8.4,63303,9555,53748,2,13.4,73561,27467,46094,5.8,15.6,-10258,-2.2,26.8,0,2456,2465,17468
1990,42,h) 11 to 15,18216,21880,298967,300114,757,3.4,1555,7,38583,7865,30718,2.6,12.9,40877,12127,28750,4,13.6,-2294,-0.7,25.8,0,1015,1025,6534
1990,42,l) Left Censored,65257,102367,3042325,3041163,4189,4,6551,6.3,326853,69307,257546,2.3,10.7,324531,77761,246770,2.6,10.7,2322,0,21.4,0,3248,3269,24699
1990,44,a) 0,2026,2036,10668,5338,2029,199.3,0,0,10661,10661,0,199.7,199.7,0,0,0,0,0,10661,199.7,0,0,,,
1990,44,b) 1,1805,1832,14329,15083,10,0.5,458,22,2984,198,2786,1.3,19.8,4491,1877,2614,12.4,29.8,-1507,-10,39.6,0,363,363,1508
1990,44,c) 2,1601,1629,10910,12244,53,3,354,19.8,2101,198,1903,1.6,17.2,4768,2194,2574,17.9,38.9,-2667,-21.7,34.4,0,278,278,1423
1990,44,d) 3,1456,1500,12894,13881,46,2.8,292,17.9,1572,143,1429,1,11.3,3545,1678,1867,12.1,25.5,-1973,-14.2,22.6,0,240,241,1477
1990,44,e) 4,1196,1236,9736,10094,29,2.2,187,14.1,1728,95,1633,0.9,17.1,2444,1068,1376,10.6,24.2,-716,-7.1,34.2,0,155,155,921
1990,44,f) 5,1087,1118,9874,10540,35,2.9,163,13.7,1164,146,1018,1.4,11,2496,1201,1295,11.4,23.7,-1332,-12.7,22,0,126,126,862
1990,44,g) 6 to 10,3601,3778,41515,43208,114,2.9,373,9.5,6153,1463,4690,3.4,14.2,9538,2779,6759,6.4,22.1,-3385,-7.9,28.4,0,282,282,1587
1990,44,h) 11 to 15,1832,2052,27100,27844,72,3.4,178,8.4,3478,391,3087,1.4,12.5,4966,1827,3139,6.6,17.8,-1488,-5.3,25,0,117,117,641
1990,44,l) Left Censored,7022,9057,255243,260272,302,3.3,599,6.5,21710,5722,15988,2.2,8.3,31768,6851,24917,2.6,12.2,-10058,-3.9,16.6,0,321,321,2444
1990,45,a) 0,6195,6235,38173,19131,6203,199,0,0,38085,38085,0,199.1,199.1,0,0,0,0,0,38085,199.1,0,0,,,
1990,45,b) 1,4781,4914,39046,37923,53,1,1089,19.7,12499,1193,11306,3.1,33,10252,5261,4991,13.9,27,2247,6,54,0,879,879,4572
1990,45,c) 2,4281,4428,62691,62057,190,4,811,17,11419,1299,10120,2.1,18.4,10151,4969,5182,8,16.4,1268,2,32.8,0,677,677,4157
1990,45,d) 3,3920,4167,49766,49812,186,4.2,678,15.3,9253,1354,7899,2.7,18.6,9344,4423,4921,8.9,18.8,-91,-0.2,37.2,0,543,544,3006
1990,45,e) 4,3394,3567,30659,31438,143,3.8,517,13.7,6295,770,5525,2.4,20,7853,3260,4593,10.4,25,-1558,-5,40,0,412,412,2831
1990,45,f) 5,3302,3526,34119,34221,125,3.4,443,12,6313,1291,5022,3.8,18.4,6517,3006,3511,8.8,19,-204,-0.6,36.8,0,335,335,2314
1990,45,g) 6 to 10,10821,11816,137704,138806,416,3.4,1178,9.6,22668,5778,16890,4.2,16.3,24871,10830,14041,7.8,17.9,-2203,-1.6,32.6,0,833,838,5993
1990,45,h) 11 to 15,4925,5912,75018,74192,269,4.5,476,7.9,12244,2442,9802,3.3,16.5,10591,3104,7487,4.2,14.3,1653,2.2,28.6,0,318,328,1929
1990,45,l) Left Censored,15026,25643,779454,776269,1220,4.7,1719,6.6,86580,21863,64717,2.8,11.2,80211,19878,60333,2.6,10.3,6369,0.9,20.6,0,754,757,5247
1990,46,a) 0,1544,1550,8161,4099,1543,199.1,0,0,8125,8125,0,198.2,198.2,0,0,0,0,0,8125,198.2,0,0,,,
1990,46,b) 1,1076,1081,6433,6181,6,0.5,212,17.8,1698,70,1628,1.1,27.5,1193,629,564,10.2,19.3,505,8.2,38.6,0,163,163,550
1990,46,c) 2,951,988,6672,7154,31,2.9,149,14.1,1076,130,946,1.8,15,2039,986,1053,13.8,28.5,-963,-13.5,30,0,120,120,821
1990,46,d) 3,841,862,10176,10315,31,3.4,131,14.2,1103,158,945,1.5,10.7,1381,518,863,5,13.4,-278,-2.7,21.4,0,100,100,388
1990,46,e) 4,748,772,5823,5625,26,3.2,83,10.3,1271,103,1168,1.8,22.6,875,361,514,6.4,15.6,396,7,31.2,0,64,64,283
1990,46,f) 5,803,828,6218,6073,35,4.1,95,11,1147,162,985,2.7,18.9,856,302,554,5,14.1,291,4.8,28.2,0,77,77,261
1990,46,g) 6 to 10,2847,3098,26724,26366,120,3.8,292,9.1,4233,595,3638,2.3,16.1,3517,1337,2180,5.1,13.3,716,2.8,26.6,0,214,214,954
1990,46,h) 11 to 15,1545,1769,17703,17892,52,2.9,140,7.7,2530,351,2179,2,14.1,2908,1508,1400,8.4,16.3,-378,-2.2,28.2,0,96,96,377
1990,46,l) Left Censored,5133,6808,124269,123121,244,3.5,440,6.4,15004,3917,11087,3.2,12.2,12708,4442,8266,3.6,10.3,2296,1.9,20.6,0,246,247,1823
1990,47,a) 0,8549,8650,57696,28972,8613,199.1,0,0,57448,57448,0,198.3,198.3,0,0,0,0,0,57448,198.3,0,0,,,
1990,47,b) 1,6832,7026,59800,61165,58,0.7,1778,22.2,16043,832,15211,1.4,26.2,18773,10270,8503,16.8,30.7,-2730,-4.5,52.4,0,1481,1481,8210
1990,47,c) 2,5705,5864,53496,53714,290,4.5,1196,18.8,14164,3279,10885,6.1,26.4,14599,7585,7014,14.1,27.2,-435,-0.8,52.8,0,1012,1012,6656
1990,47,d) 3,5268,5595,64791,66039,251,4.2,1002,16.7,9951,1737,8214,2.6,15.1,12447,6543,5904,9.9,18.8,-2496,-3.7,30.2,0,798,800,4850
1990,47,e) 4,4736,5031,50373,52286,219,4.1,703,13.3,8236,1443,6793,2.8,15.8,12062,4343,7719,8.3,23.1,-3826,-7.3,31.6,0,560,560,3557
1990,47,f) 5,4201,4438,46508,47133,171,3.7,565,12.1,7651,1291,6360,2.7,16.2,8901,3903,4998,8.3,18.9,-1250,-2.7,32.4,0,441,445,3107
1990,47,g) 6 to 10,15190,16509,193908,195577,546,3.2,1641,9.6,29324,6392,22932,3.3,15,32661,12701,19960,6.5,16.7,-3337,-1.7,30,0,1191,1193,7912
1990,47,h) 11 to 15,7402,9400,138399,139546,403,4.2,744,7.8,19757,4621,15136,3.3,14.2,22050,5509,16541,3.9,15.8,-2293,-1.6,28.4,0,459,465,3125
1990,47,l) Left Censored,22552,38184,1196762,1199800,1768,4.6,2623,6.8,132593,30817,101776,2.6,11.1,138669,36503,102166,3,11.6,-6076,-0.5,22.2,0,1105,1107,8031
1990,48,a) 0,31932,32338,230219,115323,32199,199.1,0,0,229793,229793,0,199.3,199.3,0,0,0,0,0,229793,199.3,0,0,,,
1990,48,b) 1,24073,24691,221685,216474,279,1,5796,20.8,71433,6766,64667,3.1,33,61011,33688,27323,15.6,28.2,10422,4.8,56.4,0,4726,4726,28904
1990,48,c) 2,19742,20717,194029,199910,946,4.2,4147,18.4,46737,8265,38472,4.1,23.4,58501,32610,25891,16.3,29.3,-11764,-5.9,46.8,0,3402,3416,26690
1990,48,d) 3,17562,18700,219330,221488,849,4.2,3524,17.5,42933,6128,36805,2.8,19.4,47248,25203,22045,11.4,21.3,-4315,-1.9,38.8,0,2812,2819,20719
1990,48,e) 4,16379,17503,182650,181543,891,4.8,2835,15.3,51235,6073,45162,3.3,28.2,49020,25730,23290,14.2,27,2215,1.2,54,0,2243,2246,19792
1990,48,f) 5,15036,16254,160248,163108,753,4.4,2464,14.4,32438,7312,25126,4.5,19.9,38158,17849,20309,10.9,23.4,-5720,-3.5,39.8,0,1893,1901,13891
1990,48,g) 6 to 10,58639,64571,694911,702059,2749,4.1,7341,11,123394,27229,96165,3.9,17.6,137690,55430,82260,7.9,19.6,-14296,-2,35.2,0,5276,5324,34823
1990,48,h) 11 to 15,25125,31701,399768,399499,1437,4.4,2819,8.7,66467,15378,51089,3.8,16.6,65929,21983,43946,5.5,16.5,538,0.1,33,0,1786,1813,11965
1990,48,l) Left Censored,61026,119815,3497145,3493868,6179,5.1,9831,8.1,464075,116383,347692,3.3,13.3,457521,155702,301819,4.5,13.1,6554,0.2,26.2,0,3807,3964,29280
1990,49,a) 0,2926,2957,20315,10164,2949,199.5,0,0,20303,20303,0,199.8,199.8,0,0,0,0,0,20303,199.8,0,0,,,
1990,49,b) 1,2327,2373,23377,21973,20,0.8,488,18.4,8202,581,7621,2.6,37.3,5394,2927,2467,13.3,24.5,2808,12.8,49,0,378,378,2478
1990,49,c) 2,1923,2018,24457,24099,99,4.5,380,17.5,5737,562,5175,2.3,23.8,5021,2496,2525,10.4,20.8,716,3,41.6,0,307,307,2147
1990,49,d) 3,1644,1714,18487,18443,77,4.2,307,16.7,3977,524,3453,2.8,21.6,3888,2072,1816,11.2,21.1,89,0.5,42.2,0,244,244,1766
1990,49,e) 4,1454,1515,20075,20257,67,4.2,215,13.5,3390,328,3062,1.6,16.7,3753,1844,1909,9.1,18.5,-363,-1.8,33.4,0,191,191,1702
1990,49,f) 5,1368,1484,19087,18503,65,4.2,204,13.1,4576,755,3821,4.1,24.7,3407,1229,2178,6.6,18.4,1169,6.3,36.8,0,160,160,964
1990,49,g) 6 to 10,4995,5586,71442,71842,246,4.3,548,9.5,11227,2127,9100,3,15.6,12027,5207,6820,7.2,16.7,-800,-1.1,31.2,0,382,382,3300
1990,49,h) 11 to 15,2597,3011,42994,42510,121,3.9,307,9.8,6544,1110,5434,2.6,15.4,5575,2118,3457,5,13.1,969,2.3,26.2,0,177,184,1413
1990,49,l) Left Censored,6868,11099,324187,322372,545,4.9,777,6.9,42140,10267,31873,3.2,13.1,38509,11434,27075,3.5,11.9,3631,1.2,23.8,0,320,325,2302
1990,50,a) 0,1579,1591,7096,3558,1584,199.1,0,0,7076,,,,198.9,0,0,0,0,0,7076,198.9,0,1,,,
1990,50,b) 1,1525,1546,9430,9031,9,0.5,352,20.2,3030,,,,33.6,2231,991,1240,11,24.7,799,8.9,49.4,1,271,271,825
1990,50,c) 2,1260,1267,7720,8171,35,2.5,245,17.7,1523,169,1354,2.1,18.6,2425,1148,1277,14,29.7,-902,-11.1,37.2,0,201,201,1025
1990,50,d) 3,1165,1184,9085,9620,50,3.9,214,16.8,1075,185,890,1.9,11.2,2145,945,1200,9.8,22.3,-1070,-11.1,22.4,0,166,166,743
1990,50,e) 4,1030,1057,7658,8194,27,2.4,163,14.4,985,131,854,1.6,12,2057,1011,1046,12.3,25.1,-1072,-13.1,24,0,140,140,916
1990,50,f) 5,854,892,7154,7448,19,2,131,13.8,831,116,715,1.6,11.2,1419,564,855,7.6,19.1,-588,-7.9,22.4,0,99,99,408
1990,50,g) 6 to 10,2793,2936,24624,25100,74,2.4,268,8.8,3104,249,2855,1,12.4,4055,1222,2833,4.9,16.2,-951,-3.8,24.8,0,213,213,1054
1990,50,h) 11 to 15,1308,1508,18365,18692,47,3.1,108,7,2260,496,1764,2.7,12.1,2913,601,2312,3.2,15.6,-653,-3.5,24.2,0,72,74,378
1990,50,l) Left Censored,3795,5206,124315,126178,164,3.1,308,5.8,11691,2228,9463,1.8,9.3,15416,4519,10897,3.6,12.2,-3725,-2.9,18.6,0,164,164,1035
1990,51,a) 0,11895,11980,65431,32833,11937,199.3,0,0,65197,65197,0,198.6,198.6,0,0,0,0,0,65197,198.6,0,0,,,
1990,51,b) 1,9461,9676,75259,74445,92,0.8,2291,21,21935,1358,20577,1.8,29.5,20307,10568,9739,14.2,27.3,1628,2.2,54.6,0,1824,1825,9074
1990,51,c) 2,8254,8474,73175,75200,372,4.1,1562,17.1,15222,2398,12824,3.2,20.2,19271,8910,10361,11.8,25.6,-4049,-5.4,40.4,0,1246,1249,7146
1990,51,d) 3,7339,7690,76838,78864,318,3.9,1289,15.7,13706,2646,11060,3.4,17.4,17758,8724,9034,11.1,22.5,-4052,-5.1,34.8,0,1034,1034,7156
1990,51,e) 4,6731,7065,65589,67162,286,3.8,999,13.4,11985,2003,9982,3,17.8,15131,6203,8928,9.2,22.5,-3146,-4.7,35.6,0,766,772,4549
1990,51,f) 5,6043,6600,69586,71143,268,3.9,775,11.3,12012,2593,9419,3.6,16.9,15126,5128,9998,7.2,21.3,-3114,-4.4,33.8,0,594,594,3790
1990,51,g) 6 to 10,19065,20690,261144,261601,744,3.5,1971,9.2,42234,5466,36768,2.1,16.1,43148,14798,28350,5.7,16.5,-914,-0.4,32.2,0,1406,1422,9694
1990,51,h) 11 to 15,8850,11212,165025,167316,456,4,836,7.3,22281,5659,16622,3.4,13.3,26863,7287,19576,4.4,16.1,-4582,-2.8,26.6,0,498,499,2668
1990,51,l) Left Censored,26735,49041,1458913,1454653,2867,5.8,3199,6.5,180334,56147,124187,3.9,12.4,171813,44924,126889,3.1,11.8,8521,0.6,23.6,0,1217,1245,9266
1990,53,a) 0,13296,13419,72268,36222,13362,199.2,0,0,72093,72093,0,199,199,0,0,0,0,0,72093,199,0,0,,,
1990,53,b) 1,7169,7308,58019,55008,62,0.8,1507,18.5,19364,1910,17454,3.5,35.2,13341,7735,5606,14.1,24.3,6023,10.9,48.6,0,1146,1146,6445
1990,53,c) 2,7125,7298,60153,56886,1653,23.6,967,13.8,22355,11973,10382,21,39.3,15821,5331,10490,9.4,27.8,6534,11.5,55.6,0,736,736,4090
1990,53,d) 3,6490,6799,74443,69895,1466,22.6,789,12.2,22045,11505,10540,16.5,31.5,12948,7800,5148,11.2,18.5,9097,13,37,0,628,628,4089
1990,53,e) 4,5833,6129,55634,66046,1322,22.8,647,11.2,18942,9714,9228,14.7,28.7,39766,3612,36154,5.5,60.2,-20824,-31.5,57.4,0,494,494,2328
1990,53,f) 5,5163,5481,54798,50151,1111,21.4,511,9.8,16901,9715,7186,19.4,33.7,7606,3355,4251,6.7,15.2,9295,18.5,30.4,0,382,383,2506
1990,53,g) 6 to 10,18725,20403,232958,231888,3958,20.6,1601,8.3,65893,37294,28599,16.1,28.4,63752,34132,29620,14.7,27.5,2141,0.9,55,0,1103,1109,30952
1990,53,h) 11 to 15,9053,10787,136245,136989,1924,18.8,748,7.3,32963,17338,15625,12.7,24.1,34451,23511,10940,17.2,25.1,-1488,-1,48.2,0,458,459,20469
1990,53,l) Left Censored,21896,35750,965514,930620,4793,13.9,2139,6.2,175592,68332,107260,7.3,18.9,105805,42789,63016,4.6,11.4,69787,7.5,22.8,0,775,791,6077
1990,54,a) 0,2697,2704,15041,7530,2693,199.2,0,0,15022,15022,0,199.5,199.5,0,0,0,0,0,15022,199.5,0,0,,,
1990,54,b) 1,2104,2147,17774,17433,27,1.1,451,18.8,5046,367,4679,2.1,28.9,4363,1962,2401,11.3,25,683,3.9,50,0,360,360,1639
1990,54,c) 2,1775,1814,14311,15284,61,3.1,365,18.3,2537,430,2107,2.8,16.6,4483,2415,2068,15.8,29.3,-1946,-12.7,33.2,0,289,289,1891
1990,54,d) 3,1679,1748,17236,17560,78,4.2,292,15.6,2830,551,2279,3.1,16.1,3477,1569,1908,8.9,19.8,-647,-3.7,32.2,0,232,232,1100
1990,54,e) 4,1469,1558,14200,14472,53,3.2,234,14.2,2565,694,1871,4.8,17.7,3109,1388,1721,9.6,21.5,-544,-3.8,35.4,0,191,191,1094
1990,54,f) 5,1399,1530,23436,23780,60,3.8,180,11.3,2274,620,1654,2.6,9.6,2962,1088,1874,4.6,12.5,-688,-2.9,19.2,0,151,151,944
1990,54,g) 6 to 10,5078,5444,52873,52981,175,3.1,473,8.4,7697,922,6775,1.7,14.5,7912,3029,4883,5.7,14.9,-215,-0.4,29,0,360,360,2382
1990,54,h) 11 to 15,2516,3023,32364,32667,142,4.6,240,7.8,4390,1012,3378,3.1,13.4,4995,1665,3330,5.1,15.3,-605,-1.9,26.8,0,171,171,1145
1990,54,l) Left Censored,9243,13803,295076,293262,548,3.9,942,6.7,34269,8085,26184,2.8,11.7,30641,9564,21077,3.3,10.4,3628,1.3,20.8,0,503,508,3762
1990,55,a) 0,8145,8231,47193,23653,8188,199,0,0,47081,47081,0,199,199,0,0,0,0,0,47081,199,0,0,,,
1990,55,b) 1,6846,6962,49512,48468,50,0.7,1228,16.1,13220,1038,12182,2.1,27.3,11131,5650,5481,11.7,23,2089,4.3,46,0,970,970,4941
1990,55,c) 2,5828,5945,49116,50360,178,2.8,946,14.9,9134,1163,7971,2.3,18.1,11621,6189,5432,12.3,23.1,-2487,-5,36.2,0,747,748,4524
1990,55,d) 3,5787,6197,69479,70378,262,4,863,13.2,9959,1542,8417,2.2,14.2,11756,6187,5569,8.8,16.7,-1797,-2.5,28.4,0,646,653,4418
1990,55,e) 4,4831,5005,53624,53574,155,3,610,11.6,9378,1950,7428,3.6,17.5,9278,3997,5281,7.5,17.3,100,0.2,34.6,0,499,499,3061
1990,55,f) 5,4598,4947,49022,48931,154,3,561,10.9,7429,1381,6048,2.8,15.2,7247,2887,4360,5.9,14.8,182,0.4,29.6,0,432,437,2223
1990,55,g) 6 to 10,16039,17375,196102,197163,509,2.8,1467,8.2,26573,4682,21891,2.4,13.5,28694,10611,18083,5.4,14.6,-2121,-1.1,27,0,1063,1071,7078
1990,55,h) 11 to 15,8612,10380,126380,126332,393,3.7,769,7.3,16577,3217,13360,2.5,13.1,16480,5925,10555,4.7,13,97,0.1,26,0,465,466,3513
1990,55,l) Left Censored,29546,43161,1285841,1278980,1567,3.6,2526,5.8,133997,32089,101908,2.5,10.5,120275,29765,90510,2.3,9.4,13722,1.1,18.8,0,1277,1285,8754
1990,56,a) 0,1033,1036,4548,2281,1031,199,0,0,4535,4535,0,198.8,198.8,0,0,0,0,0,4535,198.8,0,0,,,
1990,56,b) 1,766,788,5277,4989,11,1.3,165,18.8,1985,424,1561,8.5,39.8,1409,936,473,18.8,28.2,576,11.6,56.4,0,113,113,431
1990,56,c) 2,679,687,4788,4951,34,4.6,122,16.5,1064,117,947,2.4,21.5,1389,916,473,18.5,28.1,-325,-6.6,43,0,91,91,525
1990,56,d) 3,599,624,5540,5562,29,4.4,93,14.1,889,163,726,2.9,16,933,430,503,7.7,16.8,-44,-0.8,32,0,73,73,322
1990,56,e) 4,589,600,3725,3752,19,2.9,100,15.5,685,93,592,2.5,18.3,738,387,351,10.3,19.7,-53,-1.4,36.6,0,81,81,302
1990,56,f) 5,594,608,4739,4961,29,4.6,76,12,669,110,559,2.2,13.5,1112,360,752,7.3,22.4,-443,-8.9,27,0,56,56,216
1990,56,g) 6 to 10,2414,2642,20129,19859,94,3.5,252,9.2,3612,393,3219,2,18.2,3071,1172,1899,5.9,15.5,541,2.7,31,0,183,183,915
1990,56,h) 11 to 15,1237,1409,13828,13628,54,3.7,123,8.5,2384,217,2167,1.6,17.5,1984,692,1292,5.1,14.6,400,2.9,29.2,0,85,85,549
1990,56,l) Left Censored,2927,4104,66785,66432,160,3.8,321,7.7,8198,1943,6255,2.9,12.3,7492,2652,4840,4,11.3,706,1,22.6,0,141,142,689
1991,01,a) 0,6495,6601,39971,20074,6546,198.3,0,0,39795,39795,0,198.2,198.2,0,0,0,0,0,39795,198.2,0,0,,,
1991,01,b) 1,5271,5388,40254,40398,51,0.8,1307,21.6,11933,1283,10650,3.2,29.5,12221,6746,5475,16.7,30.3,-288,-0.8,59,0,951,952,5149
1991,01,c) 2,4466,4606,38813,40604,128,2.6,900,18,8706,1155,7551,2.8,21.4,12288,6108,6180,15,30.3,-3582,-8.9,42.8,0,685,685,4601
1991,01,d) 3,3888,4023,38719,39915,146,3.4,669,15.6,6007,813,5194,2,15,8399,3940,4459,9.9,21,-2392,-6,30,0,517,517,3231
1991,01,e) 4,3737,4015,49081,51283,158,3.7,635,15,6412,1470,4942,2.9,12.5,10815,5392,5423,10.5,21.1,-4403,-8.6,25,0,476,477,2964
1991,01,f) 5,3359,3580,38146,39168,123,3.3,473,12.6,6384,981,5403,2.5,16.3,8427,2714,5713,6.9,21.5,-2043,-5.2,32.6,0,353,356,2243
1991,01,g) 6 to 10,12027,13106,158617,162984,478,3.5,1304,9.7,20588,4976,15612,3.1,12.6,29322,10193,19129,6.3,18,-8734,-5.4,25.2,0,897,904,6824
1991,01,h) 11 to 15,7341,9174,129875,131125,411,4.4,749,8,19622,5985,13637,4.6,15,22121,5801,16320,4.4,16.9,-2499,-1.9,30,0,453,455,3612
1991,01,l) Left Censored,16378,28228,799946,805365,1683,5.9,2194,7.7,94370,33033,61337,4.1,11.7,105207,32438,72769,4,13.1,-10837,-1.4,23.4,0,843,892,8037
1991,02,a) 0,1297,1310,5654,2861,1293,197.4,0,0,5586,,,,195.2,0,0,0,0,0,5586,195.2,0,1,,,
1991,02,b) 1,1047,1065,6091,6205,10,0.8,241,20.3,1955,,,,31.5,2182,1108,1074,17.9,35.2,-227,-3.7,63,1,133,133,611
1991,02,c) 2,671,680,4947,5197,33,4.5,117,16.1,1121,144,977,2.8,21.6,1621,696,925,13.4,31.2,-500,-9.6,43.2,0,79,79,430
1991,02,d) 3,666,706,6950,7153,34,4.6,106,14.2,1204,226,978,3.2,16.8,1609,610,999,8.5,22.5,-405,-5.7,33.6,0,77,77,429
1991,02,e) 4,644,683,8172,8457,25,3.5,88,12.3,1118,86,1032,1,13.2,1687,665,1022,7.9,19.9,-569,-6.7,26.4,0,60,61,400
1991,02,f) 5,618,658,5419,5534,29,4.2,88,12.7,1002,215,787,3.9,18.1,1232,409,823,7.4,22.3,-230,-4.2,36.2,0,66,66,305
1991,02,g) 6 to 10,2394,2646,24172,24092,157,5.8,277,10.3,5144,1395,3749,5.8,21.4,4984,1255,3729,5.2,20.7,160,0.7,41.4,0,169,169,783
1991,02,h) 11 to 15,1287,1601,18529,18083,98,6.1,122,7.6,4065,1186,2879,6.6,22.5,3173,989,2184,5.5,17.5,892,5,35,0,70,71,476
1991,02,l) Left Censored,2004,3395,80035,78716,254,7.5,218,6.5,13071,3733,9338,4.7,16.6,10433,2365,8068,3,13.3,2638,3.3,26.6,0,70,70,793
1991,04,a) 0,8004,8099,48410,24357,8026,198.2,0,0,48106,48106,0,197.5,197.5,0,0,0,0,0,48106,197.5,0,0,,,
1991,04,b) 1,6174,6274,65164,56683,52,0.7,1511,21.4,33051,1069,31982,1.9,58.3,16089,7334,8755,12.9,28.4,16962,29.9,56.8,0,1107,1107,5608
1991,04,c) 2,5182,5389,48985,51052,229,3.9,1079,18.5,11030,1800,9230,3.5,21.6,15164,7160,8004,14,29.7,-4134,-8.1,43.2,0,793,809,5699
1991,04,d) 3,4365,4559,41856,44010,209,4.3,807,16.6,8716,1934,6782,4.4,19.8,13024,5955,7069,13.5,29.6,-4308,-9.8,39.6,0,631,631,5085
1991,04,e) 4,4142,4486,53525,56125,247,5.2,729,15.4,8705,2123,6582,3.8,15.5,13904,5959,7945,10.6,24.8,-5199,-9.3,31,0,545,556,4910
1991,04,f) 5,3654,3892,36995,38515,144,3.5,624,15.1,6017,1217,4800,3.2,15.6,9057,3569,5488,9.3,23.5,-3040,-7.9,31.2,0,462,465,2826
1991,04,g) 6 to 10,12875,14514,181037,187562,727,4.8,1844,12.2,26682,6971,19711,3.7,14.2,39732,15738,23994,8.4,21.2,-13050,-7,28.4,0,1242,1251,10611
1991,04,h) 11 to 15,6787,8471,118894,120229,504,5.8,863,10,20261,7632,12629,6.3,16.9,22930,7705,15225,6.4,19.1,-2669,-2.2,33.8,0,481,490,3496
1991,04,l) Left Censored,10919,21898,653002,656211,1624,7.4,1776,8.1,91817,38512,53305,5.9,14,98237,27265,70972,4.2,15,-6420,-1,28,0,547,559,7156
1991,05,a) 0,4192,4259,23196,11654,4223,198.3,0,0,23084,23084,0,198.1,198.1,0,0,0,0,0,23084,198.1,0,0,,,
1991,05,b) 1,3377,3444,25905,24694,72,1.9,755,19.8,9635,4960,4675,20.1,39,7212,3469,3743,14,29.2,2423,9.8,58.4,0,549,549,2831
1991,05,c) 2,2679,2725,24519,25824,70,2.4,499,16.9,4516,362,4154,1.4,17.5,7125,3391,3734,13.1,27.6,-2609,-10.1,35,0,391,394,2700
1991,05,d) 3,2269,2344,20023,21361,79,3.1,437,17.3,2990,437,2553,2,14,5666,2745,2921,12.9,26.5,-2676,-12.5,28,0,351,351,2191
1991,05,e) 4,2250,2394,25566,25991,107,4.3,344,13.7,3456,799,2657,3.1,13.3,4305,1747,2558,6.7,16.6,-849,-3.3,26.6,0,251,253,1342
1991,05,f) 5,1918,2009,16325,16876,66,3.1,298,14,2355,330,2025,2,14,3456,1373,2083,8.1,20.5,-1101,-6.5,28,0,230,230,1084
1991,05,g) 6 to 10,8027,8618,84431,86112,317,3.6,863,9.7,12890,3445,9445,4,15,16251,6034,10217,7,18.9,-3361,-3.9,30,0,613,617,3703
1991,05,h) 11 to 15,5258,6113,70474,70414,244,3.9,526,8.4,10077,2850,7227,4,14.3,9957,2867,7090,4.1,14.1,120,0.2,28.2,0,318,319,1681
1991,05,l) Left Censored,10649,16654,471892,470108,954,5.7,1183,7.1,56035,17518,38517,3.7,11.9,52467,13278,39189,2.8,11.2,3568,0.7,22.4,0,541,554,4494
1991,06,a) 0,62907,63722,373125,187928,63133,198.2,0,0,370394,370394,0,197.1,197.1,0,0,0,0,0,370394,197.1,0,0,,,
1991,06,b) 1,50992,51996,407044,411173,605,1,12559,21.5,128584,16485,112099,4,31.3,136841,66300,70541,16.1,33.3,-8257,-2,62.6,0,8679,8686,49730
1991,06,c) 2,42021,43268,366093,399084,1813,3.9,8212,17.6,77959,13458,64501,3.4,19.5,143940,63693,80247,16,36.1,-65981,-16.6,39,0,6035,6073,51272
1991,06,d) 3,36561,38089,353470,382337,1621,4,6506,16.1,66252,11548,54704,3,17.3,123986,50538,73448,13.2,32.4,-57734,-15.1,34.6,0,4773,4786,40290
1991,06,e) 4,34346,36350,444978,471773,1608,4.2,5964,15.5,59462,10880,48582,2.3,12.6,113051,49293,63758,10.4,24,-53589,-11.4,25.2,0,4275,4366,38018
1991,06,f) 5,30154,32474,339393,360049,1452,4.3,4760,14,59129,12667,46462,3.5,16.4,100441,37043,63398,10.3,27.9,-41312,-11.5,32.8,0,3391,3426,27285
1991,06,g) 6 to 10,109206,120716,1565339,1637386,5472,4.4,14046,11.2,243272,56089,187183,3.4,14.9,387366,126764,260602,7.7,23.7,-144094,-8.8,29.8,0,9278,9344,77333
1991,06,h) 11 to 15,65723,79893,1137388,1176680,4259,5.2,7730,9.5,163150,48838,114312,4.2,13.9,241733,69162,172571,5.9,20.5,-78583,-6.6,27.8,0,4536,4651,37846
1991,06,l) Left Censored,103943,192546,5926407,6010895,12267,6.3,16091,8.3,787954,248211,539743,4.1,13.1,956929,252934,703995,4.2,15.9,-168975,-2.8,26.2,0,6160,6317,65845
1991,08,a) 0,8952,9043,46819,23684,8980,198.6,0,0,46270,46270,0,195.4,195.4,0,0,0,0,0,46270,195.4,0,0,,,
1991,08,b) 1,6699,6824,48088,48196,63,0.8,1504,19.8,14205,1108,13097,2.3,29.5,14420,6865,7555,14.2,29.9,-215,-0.4,59,0,1092,1092,5451
1991,08,c) 2,5591,5738,45245,46236,217,3.5,1016,16.5,11368,2237,9131,4.8,24.6,13349,6563,6786,14.2,28.9,-1981,-4.3,49.2,0,789,790,5612
1991,08,d) 3,4726,4918,40207,41428,166,3.2,807,15.4,8071,1237,6834,3,19.5,10512,4547,5965,11,25.4,-2441,-5.9,39,0,641,641,3941
1991,08,e) 4,4352,4605,49362,50241,210,4.3,715,14.8,8394,1587,6807,3.2,16.7,10151,4854,5297,9.7,20.2,-1757,-3.5,33.4,0,543,548,3696
1991,08,f) 5,3765,3965,39844,41039,164,3.9,609,14.6,6368,1116,5252,2.7,15.5,8757,4566,4191,11.1,21.3,-2389,-5.8,31,0,451,457,3623
1991,08,g) 6 to 10,14735,16212,186333,189500,776,4.6,1777,10.6,31055,8461,22594,4.5,16.4,37388,13590,23798,7.2,19.7,-6333,-3.3,32.8,0,1215,1248,9197
1991,08,h) 11 to 15,8664,10394,120264,121791,539,5.1,898,8.5,18799,4539,14260,3.7,15.4,21853,6922,14931,5.7,17.9,-3054,-2.5,30.8,0,525,545,3684
1991,08,l) Left Censored,14641,25189,696251,693813,1683,6.6,2016,8,90858,32735,58123,4.7,13.1,85982,27807,58175,4,12.4,4876,0.7,24.8,0,717,740,6327
1991,09,a) 0,5604,5666,33522,16934,5607,197.9,0,0,33177,33177,0,195.9,195.9,0,0,0,0,0,33177,195.9,0,0,,,
1991,09,b) 1,5082,5168,33051,34016,56,1,1211,20.9,8496,944,7552,2.8,25,10426,5324,5102,15.7,30.7,-1930,-5.7,50,0,837,840,3867
1991,09,c) 2,4925,5028,34625,38312,152,2.8,1093,19.9,5928,1017,4911,2.7,15.5,13301,7074,6227,18.5,34.7,-7373,-19.2,31,0,833,833,5845
1991,09,d) 3,4485,4609,40216,43993,137,2.7,903,18.1,5296,946,4350,2.2,12,12850,4554,8296,10.4,29.2,-7554,-17.2,24,0,676,677,3321
1991,09,e) 4,4178,4336,47078,47192,151,3.2,836,17.9,10099,1018,9081,2.2,21.4,10326,4195,6131,8.9,21.9,-227,-0.5,42.8,0,615,616,3065
1991,09,f) 5,3577,3740,31863,34786,91,2.3,621,15.5,3349,553,2796,1.6,9.6,9194,3629,5565,10.4,26.4,-5845,-16.8,19.2,0,447,449,2591
1991,09,g) 6 to 10,12802,13662,130448,139241,420,2.9,1663,11.6,16605,4187,12418,3,11.9,34191,10859,23332,7.8,24.6,-17586,-12.7,23.8,0,1142,1144,6961
1991,09,h) 11 to 15,7553,8675,101861,107117,363,4.1,833,9.3,12724,4468,8256,4.2,11.9,23236,6878,16358,6.4,21.7,-10512,-9.8,23.8,0,500,507,3751
1991,09,l) Left Censored,20638,29977,989849,1002882,1509,5,2260,7.4,109169,39596,69573,3.9,10.9,135235,33925,101310,3.4,13.5,-26066,-2.6,21.8,0,973,1012,9136
1991,10,a) 0,1466,1479,10589,5316,1464,198,0,0,10546,10546,0,198.4,198.4,0,0,0,0,0,10546,198.4,0,0,,,
1991,10,b) 1,1175,1193,6912,7013,16,1.2,259,19.5,1797,286,1511,4.1,25.6,1998,911,1087,13,28.5,-201,-2.9,51.2,0,172,172,649
1991,10,c) 2,1047,1068,8069,8617,31,2.7,181,15.8,1495,254,1241,2.9,17.3,2591,1033,1558,12,30.1,-1096,-12.8,34.6,0,126,126,721
1991,10,d) 3,852,867,8583,9074,31,3.4,130,14.1,1196,176,1020,1.9,13.2,2177,753,1424,8.3,24,-981,-10.8,26.4,0,98,98,627
1991,10,e) 4,816,848,8965,9268,31,3.4,138,15.3,1229,185,1044,2,13.3,1835,691,1144,7.5,19.8,-606,-6.5,26.6,0,96,98,489
1991,10,f) 5,708,750,6360,6809,35,4.5,93,12,990,351,639,5.2,14.5,1888,682,1206,10,27.7,-898,-13.2,29,0,62,62,431
1991,10,g) 6 to 10,2388,2562,28230,29610,115,4.4,282,10.7,3130,733,2397,2.5,10.6,5890,1778,4112,6,19.9,-2760,-9.3,21.2,0,192,201,1280
1991,10,h) 11 to 15,1441,1687,29351,28930,86,5,139,8.1,5249,1468,3781,5.1,18.1,4407,803,3604,2.8,15.2,842,2.9,30.4,0,80,83,413
1991,10,l) Left Censored,3977,6100,204552,207653,493,8.2,403,6.7,23330,8865,14465,4.3,11.2,29531,9971,19560,4.8,14.2,-6201,-3,22.4,0,144,144,1331
1991,11,a) 0,1084,1087,7174,3629,1076,198,0,0,7090,7090,0,195.4,195.4,0,0,0,0,0,7090,195.4,0,0,,,
1991,11,b) 1,920,928,7895,7687,13,1.3,173,17,2118,513,1605,6.7,27.6,1701,652,1049,8.5,22.1,417,5.5,44.2,0,128,128,471
1991,11,c) 2,837,871,8630,8806,45,4.9,153,16.5,1981,264,1717,3,22.5,2333,1131,1202,12.8,26.5,-352,-4,45,0,104,104,903
1991,11,d) 3,780,802,11696,12230,38,4.5,134,15.8,1270,199,1071,1.6,10.4,2337,873,1464,7.1,19.1,-1067,-8.7,20.8,0,101,101,680
1991,11,e) 4,712,744,6587,7523,39,5,112,14.4,1086,235,851,3.1,14.4,2958,1270,1688,16.9,39.3,-1872,-24.9,28.8,0,75,75,1068
1991,11,f) 5,698,718,7529,7832,41,5.5,100,13.4,1262,614,648,7.8,16.1,1867,768,1099,9.8,23.8,-605,-7.7,32.2,0,72,72,589
1991,11,g) 6 to 10,2828,3022,43071,44737,133,4.3,330,10.6,5332,1513,3819,3.4,11.9,8663,2507,6156,5.6,19.4,-3331,-7.5,23.8,0,208,212,1614
1991,11,h) 11 to 15,1663,1949,59507,58706,125,6.3,179,9.1,8083,1685,6398,2.9,13.8,6480,1288,5192,2.2,11,1603,2.8,22,0,87,91,624
1991,11,l) Left Censored,5101,7437,235662,245852,477,6.3,733,9.7,23366,7909,15457,3.2,9.5,43745,9794,33951,4,17.8,-20379,-8.3,19,0,191,200,2127
1991,12,a) 0,34801,35187,196877,98784,34946,198.6,0,0,196187,196187,0,198.6,198.6,0,0,0,0,0,196187,198.6,0,0,,,
1991,12,b) 1,27737,28134,196633,198563,251,0.8,6525,20.7,58596,5303,53293,2.7,29.5,62455,28675,33780,14.4,31.5,-3859,-2,59,0,4603,4616,21370
1991,12,c) 2,22531,23057,166709,180244,860,3.4,4873,19.4,35827,5722,30105,3.2,19.9,62897,31039,31858,17.2,34.9,-27070,-15,39.8,0,3803,3809,24963
1991,12,d) 3,19539,20701,175433,188955,880,4,3987,17.9,31056,6035,25021,3.2,16.4,58099,27398,30701,14.5,30.7,-27043,-14.3,32.8,0,3071,3084,22997
1991,12,e) 4,17054,18023,200595,211973,753,3.9,3332,17.3,28561,5804,22757,2.7,13.5,51317,22066,29251,10.4,24.2,-22756,-10.7,27,0,2503,2547,16931
1991,12,f) 5,14753,15765,146208,154847,602,3.6,2508,15,23875,5019,18856,3.2,15.4,41153,15897,25256,10.3,26.6,-17278,-11.2,30.8,0,1876,1880,12070
1991,12,g) 6 to 10,51132,55558,601980,629731,2391,4.1,7021,12.1,90236,21162,69074,3.4,14.3,145738,53807,91931,8.5,23.1,-55502,-8.8,28.6,0,4999,5034,37788
1991,12,h) 11 to 15,26496,32385,409505,419360,1644,4.9,3333,10,66922,22425,44497,5.3,16,86634,27252,59382,6.5,20.7,-19712,-4.7,32,0,2022,2087,16932
1991,12,l) Left Censored,43869,89428,2431121,2455173,6108,6.8,8129,9,335405,124888,210517,5.1,13.7,383508,110973,272535,4.5,15.6,-48103,-1.9,27.4,0,2674,2840,26587
1991,13,a) 0,12699,12839,77244,38868,12742,198.5,0,0,76753,76753,0,197.5,197.5,0,0,0,0,0,76753,197.5,0,0,,,
1991,13,b) 1,10001,10153,76263,76781,134,1.2,2170,19.3,22765,3721,19044,4.8,29.6,23801,11920,11881,15.5,31,-1036,-1.4,59.2,0,1468,1469,8810
1991,13,c) 2,8560,8846,70084,76366,360,3.8,1729,18.1,14573,3078,11495,4,19.1,27136,11368,15768,14.9,35.5,-12563,-16.4,38.2,0,1283,1299,9470
1991,13,d) 3,7241,7641,73268,76456,372,4.6,1403,17.2,12546,2572,9974,3.4,16.4,18922,8288,10634,10.8,24.7,-6376,-8.3,32.8,0,1050,1050,6540
1991,13,e) 4,6639,7126,82876,98402,328,4.3,1214,16.1,10978,2743,8235,2.8,11.2,42030,30788,11242,31.3,42.7,-31052,-31.5,22.4,0,908,924,28753
1991,13,f) 5,6104,6550,66340,69079,270,3.9,1027,14.8,10980,2140,8840,3.1,15.9,16457,7136,9321,10.3,23.8,-5477,-7.9,31.8,0,762,771,5518
1991,13,g) 6 to 10,21730,23704,258498,269799,933,3.8,2771,11.3,37654,8946,28708,3.3,14,60256,22093,38163,8.2,22.3,-22602,-8.3,28,0,1894,1917,14049
1991,13,h) 11 to 15,11942,14484,196902,202648,754,5.1,1351,9.1,27010,9133,17877,4.5,13.3,38501,10739,27762,5.3,19,-11491,-5.7,26.6,0,775,787,5151
1991,13,l) Left Censored,25812,49685,1547464,1571012,3265,6.5,4062,8.1,203756,75025,128731,4.8,13,250851,71288,179563,4.5,16,-47095,-3,26,0,1312,1448,14300
1991,15,a) 0,2302,2326,16255,8190,2310,198.6,0,0,16131,16131,0,197,197,0,0,0,0,0,16131,197,0,0,,,
1991,15,b) 1,1838,1890,15551,15258,34,1.6,368,17.8,4431,588,3843,3.9,29,3844,1479,2365,9.7,25.2,587,3.8,50.4,0,283,283,1228
1991,15,c) 2,1512,1578,18411,18743,61,3.7,222,13.4,4022,468,3554,2.5,21.5,4685,1596,3089,8.5,25,-663,-3.5,43,0,165,165,1222
1991,15,d) 3,1393,1534,14049,14558,74,4.6,200,12.6,2596,336,2260,2.3,17.8,3614,1299,2315,8.9,24.8,-1018,-7,35.6,0,144,144,975
1991,15,e) 4,1174,1275,18631,19117,56,4.2,179,13.4,2236,790,1446,4.1,11.7,3207,1137,2070,5.9,16.8,-971,-5.1,23.4,0,129,131,683
1991,15,f) 5,1009,1099,11050,11645,47,4.1,132,11.6,2055,337,1718,2.9,17.6,3244,1315,1929,11.3,27.9,-1189,-10.3,35.2,0,95,98,1138
1991,15,g) 6 to 10,4192,4672,54427,55787,208,4.3,462,9.6,7920,2363,5557,4.2,14.2,10639,3315,7324,5.9,19.1,-2719,-4.9,28.4,0,313,313,1868
1991,15,h) 11 to 15,2627,3406,47262,47690,180,5.2,297,8.6,6628,1763,4865,3.7,13.9,7483,2739,4744,5.7,15.7,-855,-1.8,27.8,0,171,175,1200
1991,15,l) Left Censored,5467,9167,241228,241443,577,6.3,508,5.6,29348,10490,18858,4.3,12.2,29777,6496,23281,2.7,12.3,-429,-0.1,24.4,0,193,201,1956
1991,16,a) 0,2239,2249,11084,5572,2234,198.7,0,0,11024,11024,0,197.8,197.8,0,0,0,0,0,11024,197.8,0,0,,,
1991,16,b) 1,1931,1965,12444,12071,23,1.1,379,17.5,3865,811,3054,6.7,32,3119,1426,1693,11.8,25.8,746,6.2,51.6,0,236,236,954
1991,16,c) 2,1424,1462,10654,10935,47,3,227,14.6,2438,291,2147,2.7,22.3,3000,1501,1499,13.7,27.4,-562,-5.1,44.6,0,160,160,928
1991,16,d) 3,1193,1213,12154,12177,42,3.3,166,13,2917,564,2353,4.6,24,2963,1303,1660,10.7,24.3,-46,-0.3,48,0,124,124,1020
1991,16,e) 4,1098,1168,10454,10692,46,3.8,141,11.6,1683,314,1369,2.9,15.7,2159,782,1377,7.3,20.2,-476,-4.5,31.4,0,103,107,620
1991,16,f) 5,1029,1069,8767,9108,42,3.7,162,14.4,1451,246,1205,2.7,15.9,2132,958,1174,10.5,23.4,-681,-7.5,31.8,0,118,118,798
1991,16,g) 6 to 10,3834,4147,38508,39808,197,4.6,402,9.5,5844,1340,4504,3.4,14.7,8444,2970,5474,7.5,21.2,-2600,-6.5,29.4,0,282,282,1775
1991,16,h) 11 to 15,2578,2923,35386,35160,126,4.2,273,9.1,5720,1483,4237,4.2,16.3,5268,1734,3534,4.9,15,452,1.3,30,0,154,159,943
1991,16,l) Left Censored,4884,7796,166871,165287,475,6.1,488,6.3,22413,6330,16083,3.8,13.6,19245,4619,14626,2.8,11.6,3168,2,23.2,0,207,207,1217
1991,17,a) 0,18994,19255,113215,57210,19087,198.3,0,0,112011,112011,0,195.8,195.8,0,0,0,0,0,112011,195.8,0,0,,,
1991,17,b) 1,15729,16024,128204,126486,181,1,3178,18,37951,5437,32514,4.3,30,34515,16041,18474,12.7,27.3,3436,2.7,54.6,0,2192,2192,12369
1991,17,c) 2,13627,13918,109028,116609,449,3,2332,15.7,20781,3265,17516,2.8,17.8,35943,14360,21583,12.3,30.8,-15162,-13,35.6,0,1695,1706,11235
1991,17,d) 3,11876,12190,119548,122518,394,3.1,1803,14,20593,3397,17196,2.8,16.8,26533,10679,15854,8.7,21.7,-5940,-4.9,33.6,0,1370,1370,8601
1991,17,e) 4,11325,11918,156562,160806,414,3.3,1681,13.4,25886,11411,14475,7.1,16.1,34374,12725,21649,7.9,21.4,-8488,-5.3,32.2,0,1201,1236,9106
1991,17,f) 5,9961,10553,110166,111896,328,3,1365,12.4,18797,4574,14223,4.1,16.8,22256,7982,14274,7.1,19.9,-3459,-3.1,33.6,0,1002,1007,6215
1991,17,g) 6 to 10,38237,41419,516629,530362,1356,3.2,3898,9.1,68182,15840,52342,3,12.9,95648,32642,63006,6.2,18,-27466,-5.1,25.8,0,2693,2716,21192
1991,17,h) 11 to 15,23220,27453,377115,381872,1086,3.9,2207,7.9,50559,12140,38419,3.2,13.2,60072,17406,42666,4.6,15.7,-9513,-2.5,26.4,0,1338,1355,10526
1991,17,l) Left Censored,58437,92189,2941544,2969430,4936,5.3,6822,7.3,317340,104681,212659,3.5,10.7,373111,99524,273587,3.4,12.6,-55771,-1.9,21.4,0,2988,3058,29977
1991,18,a) 0,9066,9234,54870,27581,9158,198.4,0,0,54578,54578,0,197.9,197.9,0,0,0,0,0,54578,197.9,0,0,,,
1991,18,b) 1,7515,7678,59176,57838,102,1.2,1498,17.8,18032,4242,13790,7.3,31.2,15355,7861,7494,13.6,26.5,2677,4.7,53,0,1059,1059,5752
1991,18,c) 2,6382,6597,58701,61338,216,3.1,1103,15.6,11527,1461,10066,2.4,18.8,16800,8064,8736,13.1,27.4,-5273,-8.6,37.6,0,854,857,6403
1991,18,d) 3,5256,5416,54351,56795,152,2.6,857,14.9,9655,2139,7516,3.8,17,14543,7004,7539,12.3,25.6,-4888,-8.6,34,0,669,669,5937
1991,18,e) 4,5084,5398,62863,63892,176,3.1,791,13.9,9762,2954,6808,4.6,15.3,11819,5138,6681,8,18.5,-2057,-3.2,30.6,0,592,602,4101
1991,18,f) 5,4682,5014,52141,54239,160,3.1,627,12,7108,1531,5577,2.8,13.1,11304,3907,7397,7.2,20.8,-4196,-7.7,26.2,0,491,491,3335
1991,18,g) 6 to 10,17638,19212,212495,218071,630,3.2,1772,9,28122,6919,21203,3.2,12.9,39273,13359,25914,6.1,18,-11151,-5.1,25.8,0,1276,1290,9455
1991,18,h) 11 to 15,10800,13088,172685,175707,526,3.9,1027,7.7,21367,4173,17194,2.4,12.2,27410,8604,18806,4.9,15.6,-6043,-3.4,24.4,0,637,644,4592
1991,18,l) Left Censored,27346,45815,1380534,1402569,2423,5.3,2981,6.5,137551,43957,93594,3.1,9.8,181620,41059,140561,2.9,12.9,-44069,-3.1,19.6,0,1349,1396,13406
1991,19,a) 0,4548,4596,24837,12466,4556,198.3,0,0,24742,24742,0,198.5,198.5,0,0,0,0,0,24742,198.5,0,0,,,
1991,19,b) 1,3823,3875,25545,25304,31,0.7,619,14.8,6037,448,5589,1.8,23.9,5555,2667,2888,10.5,22,482,1.9,44,0,427,429,2038
1991,19,c) 2,3281,3388,23963,25096,127,3.6,452,12.7,4392,654,3738,2.6,17.5,6657,2957,3700,11.8,26.5,-2265,-9,35,0,344,346,2433
1991,19,d) 3,2756,2831,22131,22523,101,3.4,343,11.6,3700,358,3342,1.6,16.4,4483,1973,2510,8.8,19.9,-783,-3.5,32.8,0,261,266,1615
1991,19,e) 4,2649,2879,51629,52106,121,4,351,11.7,4137,911,3226,1.7,7.9,5090,2083,3007,4,9.8,-953,-1.9,15.8,0,261,261,1457
1991,19,f) 5,2321,2423,19643,20235,87,3.5,265,10.6,3301,674,2627,3.3,16.3,4485,1812,2673,9,22.2,-1184,-5.9,32.6,0,201,201,1415
1991,19,g) 6 to 10,10132,11064,109268,110571,336,3,969,8.5,13663,2746,10917,2.5,12.4,16269,5759,10510,5.2,14.7,-2606,-2.3,24.8,0,693,697,3992
1991,19,h) 11 to 15,7109,8744,86497,87805,382,4.3,665,7.5,11554,2343,9211,2.7,13.2,14170,4427,9743,5,16.1,-2616,-2.9,26.4,0,396,404,2196
1991,19,l) Left Censored,18155,27437,664384,661515,1231,4.5,1648,6,75280,17226,58054,2.6,11.4,69542,15847,53695,2.4,10.5,5738,0.9,21,0,836,851,5670
1991,20,a) 0,4588,4651,24598,12353,4616,198.5,0,0,24491,24491,0,198.3,198.3,0,0,0,0,0,24491,198.3,0,0,,,
1991,20,b) 1,3590,3661,26331,26541,51,1.3,790,19.4,7216,1859,5357,7,27.2,7635,3948,3687,14.9,28.8,-419,-1.6,54.4,0,578,578,3179
1991,20,c) 2,3124,3193,23891,25368,96,2.8,564,16.4,4667,916,3751,3.6,18.4,7621,3601,4020,14.2,30,-2954,-11.6,36.8,0,419,420,2807
1991,20,d) 3,2648,2765,22790,23647,106,3.6,447,15.2,3827,836,2991,3.5,16.2,5541,2798,2743,11.8,23.4,-1714,-7.2,32.4,0,324,324,2325
1991,20,e) 4,2497,2608,33832,35064,85,3.1,416,15,3393,623,2770,1.8,9.7,5856,2706,3150,7.7,16.7,-2463,-7,19.4,0,309,315,2098
1991,20,f) 5,2350,2482,23471,24001,100,3.8,380,14.5,4048,1420,2628,5.9,16.9,5107,2323,2784,9.7,21.3,-1059,-4.4,33.8,0,285,289,1933
1991,20,g) 6 to 10,9535,10230,97379,98405,412,3.9,1202,11.3,16918,5721,11197,5.8,17.2,18969,7080,11889,7.2,19.3,-2051,-2.1,34.4,0,883,887,5232
1991,20,h) 11 to 15,5793,7052,79635,80953,327,4.5,632,8.8,11565,2812,8753,3.5,14.3,14200,5122,9078,6.3,17.5,-2635,-3.2,28.6,0,363,369,2138
1991,20,l) Left Censored,14752,22641,548216,552674,1219,5.3,1685,7.4,61167,21415,39752,3.9,11.1,70082,18436,51646,3.3,12.7,-8915,-1.6,22.2,0,702,733,5978
1991,21,a) 0,5757,5804,34384,17305,5768,198.8,0,0,34159,34159,0,197.4,197.4,0,0,0,0,0,34159,197.4,0,0,,,
1991,21,b) 1,4902,4986,37365,37536,57,1,1074,19.4,10837,1089,9748,2.9,28.9,11178,5700,5478,15.2,29.8,-341,-0.9,57.8,0,815,815,4642
1991,21,c) 2,4216,4333,35338,37900,138,3,694,15,6442,918,5524,2.4,17,11566,5318,6248,14,30.5,-5124,-13.5,34,0,544,544,4576
1991,21,d) 3,3486,3610,30871,32444,115,3,541,14.2,5049,666,4383,2.1,15.6,8195,3760,4435,11.6,25.3,-3146,-9.7,31.2,0,418,418,2436
1991,21,e) 4,3247,3395,41901,44746,130,3.6,544,15.1,5599,782,4817,1.7,12.5,11288,6883,4405,15.4,25.2,-5689,-12.7,25,0,412,424,6164
1991,21,f) 5,2994,3189,34264,35252,114,3.4,394,11.9,4717,1110,3607,3.1,13.4,6692,2210,4482,6.3,19,-1975,-5.6,26.8,0,312,312,1799
1991,21,g) 6 to 10,11257,12042,139290,142349,421,3.4,1241,10,20806,5553,15253,3.9,14.6,26924,8913,18011,6.3,18.9,-6118,-4.3,29.2,0,901,904,6406
1991,21,h) 11 to 15,6400,7685,103872,104645,364,4.7,584,7.5,15532,4755,10777,4.5,14.8,17078,4030,13048,3.9,16.3,-1546,-1.5,29.6,0,361,366,2085
1991,21,l) Left Censored,16406,26976,725293,727057,1632,6,1907,7,85632,31135,54497,4.3,11.8,89160,22746,66414,3.1,12.3,-3528,-0.5,23.6,0,920,936,7156
1991,22,a) 0,6336,6454,45602,22990,6394,198.1,0,0,45224,45224,0,196.7,196.7,0,0,0,0,0,45224,196.7,0,0,,,
1991,22,b) 1,4910,4994,39828,40496,66,1.2,1060,19.2,11487,954,10533,2.4,28.4,12823,6555,6268,16.2,31.7,-1336,-3.3,56.8,0,770,771,5451
1991,22,c) 2,3890,3979,33964,36506,142,3.3,692,16.3,7176,731,6445,2,19.7,12259,6531,5728,17.9,33.6,-5083,-13.9,39.4,0,525,528,5012
1991,22,d) 3,3453,3687,37634,39281,183,4.7,582,15,8595,2180,6415,5.5,21.9,11888,5883,6005,15,30.3,-3293,-8.4,43.8,0,455,455,5113
1991,22,e) 4,3234,3442,42280,43082,180,5,523,14.5,6596,1396,5200,3.2,15.3,8199,3669,4530,8.5,19,-1603,-3.7,30.6,0,393,406,2848
1991,22,f) 5,3235,3395,33849,34915,119,3.3,452,12.7,6072,1378,4694,3.9,17.4,8204,3302,4902,9.5,23.5,-2132,-6.1,34.8,0,363,363,2505
1991,22,g) 6 to 10,13906,15027,166830,166774,580,3.8,1487,9.6,28111,5220,22891,3.1,16.9,27999,9550,18449,5.7,16.8,112,0.1,33.6,0,1024,1036,6633
1991,22,h) 11 to 15,8245,9658,124453,124687,378,3.8,827,8.4,19054,3557,15497,2.9,15.3,19522,5907,13615,4.7,15.7,-468,-0.4,30.6,0,562,570,4147
1991,22,l) Left Censored,17793,30254,749826,753453,1642,5.4,2282,7.5,96590,25666,70924,3.4,12.8,103843,33881,69962,4.5,13.8,-7253,-1,25.6,0,977,988,7472
1991,23,a) 0,2319,2354,10609,5345,2334,198.3,0,0,10529,10529,0,197,197,0,0,0,0,0,10529,197,0,0,,,
1991,23,b) 1,2047,2068,12584,12894,15,0.6,512,21.9,3135,244,2891,1.9,24.3,3755,1939,1816,15,29.1,-620,-4.8,48.6,0,350,351,1429
1991,23,c) 2,2052,2085,13009,14060,65,2.9,402,17.7,2130,308,1822,2.2,15.1,4231,1909,2322,13.6,30.1,-2101,-15,30.2,0,274,274,1385
1991,23,d) 3,1816,1849,11854,13403,66,3.3,342,17.2,1421,267,1154,2,10.6,4519,1772,2747,13.2,33.7,-3098,-23.1,21.2,0,251,251,1282
1991,23,e) 4,1693,1783,16170,17151,54,2.8,318,16.6,1691,246,1445,1.4,9.9,3652,1225,2427,7.1,21.3,-1961,-11.4,19.8,0,240,240,950
1991,23,f) 5,1471,1552,11313,11769,56,3.4,223,13.6,2021,430,1591,3.7,17.2,2932,1095,1837,9.3,24.9,-911,-7.7,34.4,0,156,158,702
1991,23,g) 6 to 10,4688,5016,48632,51201,152,2.9,514,9.9,5310,1137,4173,2.2,10.4,10448,3002,7446,5.9,20.4,-5138,-10,20.8,0,361,364,2275
1991,23,h) 11 to 15,2796,3328,37369,38826,139,4.1,278,8.2,3605,881,2724,2.3,9.3,6519,1746,4773,4.5,16.8,-2914,-7.5,18.6,0,166,166,1046
1991,23,l) Left Censored,6291,9513,234402,240311,487,5.1,722,7.5,21669,7058,14611,2.9,9,33488,7745,25743,3.2,13.9,-11819,-4.9,18,0,304,305,2418
1991,24,a) 0,8381,8487,46609,23402,8431,198.7,0,0,46415,46415,0,198.3,198.3,0,0,0,0,0,46415,198.3,0,0,,,
1991,24,b) 1,7196,7300,51187,53339,96,1.2,1791,21.8,14226,2496,11730,4.7,26.7,18529,9715,8814,18.2,34.7,-4303,-8,53.4,0,1258,1258,6579
1991,24,c) 2,6283,6413,47960,52397,206,3,1263,18.2,8318,1470,6848,2.8,15.9,17191,6656,10535,12.7,32.8,-8873,-16.9,31.8,0,922,922,5278
1991,24,d) 3,5571,5748,51333,55622,199,3.2,967,15.7,7359,1333,6026,2.4,13.2,15936,6737,9199,12.1,28.7,-8577,-15.5,26.4,0,744,745,5517
1991,24,e) 4,5068,5323,61462,65503,203,3.6,848,15,7269,1522,5747,2.3,11.1,15351,6773,8578,10.3,23.4,-8082,-12.3,22.2,0,616,631,4066
1991,24,f) 5,4649,4901,48789,51363,222,4.3,687,13.4,8208,2604,5604,5.1,16,13355,4802,8553,9.3,26,-5147,-10,32,0,495,497,3392
1991,24,g) 6 to 10,15517,17030,203074,211550,604,3.4,1814,10.3,31371,8140,23231,3.8,14.8,48323,15670,32653,7.4,22.8,-16952,-8,29.6,0,1222,1234,9768
1991,24,h) 11 to 15,8578,10402,141405,148324,443,4.2,938,8.8,18669,5058,13611,3.4,12.6,32507,9692,22815,6.5,21.9,-13838,-9.3,25.2,0,568,574,5964
1991,24,l) Left Censored,20970,36305,1084869,1109575,2249,6.1,2887,7.9,127090,47362,79728,4.3,11.5,176503,49894,126609,4.5,15.9,-49413,-4.4,23,0,999,1049,11028
1991,25,a) 0,8936,9081,51864,26077,9003,198.3,0,0,51575,51575,0,197.8,197.8,0,0,0,0,0,51575,197.8,0,0,,,
1991,25,b) 1,8067,8222,63062,65538,90,1,1929,20.9,15711,2161,13550,3.3,24,20663,9530,11133,14.5,31.5,-4952,-7.5,48,0,1329,1329,6193
1991,25,c) 2,7925,8187,59854,66269,243,2.7,1715,19.2,11781,1354,10427,2,17.8,24610,12804,11806,19.3,37.1,-12829,-19.3,35.6,0,1269,1290,10234
1991,25,d) 3,7303,7512,76532,81604,233,2.9,1521,18.6,9615,1467,8148,1.8,11.8,19758,8051,11707,9.9,24.2,-10143,-12.4,23.6,0,1148,1149,6782
1991,25,e) 4,6926,7289,79505,85274,248,3.1,1439,18.2,9003,2177,6826,2.6,10.6,20541,9711,10830,11.4,24.1,-11538,-13.5,21.2,0,1030,1035,7348
1991,25,f) 5,6142,6476,62827,67813,214,3.1,1070,15.5,8212,1424,6788,2.1,12.1,18184,7539,10645,11.1,26.8,-9972,-14.7,24.2,0,748,750,5998
1991,25,g) 6 to 10,21523,23292,285987,301521,750,3.1,2929,12,36563,7124,29439,2.4,12.1,67632,23658,43974,7.8,22.4,-31069,-10.3,24.2,0,1987,1998,15568
1991,25,h) 11 to 15,12179,14763,242056,251594,650,4.3,1618,10.6,27374,8709,18665,3.5,10.9,46449,14755,31694,5.9,18.5,-19075,-7.6,21.8,0,902,927,7569
1991,25,l) Left Censored,35169,52728,1652523,1709477,2738,5.1,4400,8.2,163907,52951,110956,3.1,9.6,277816,71811,206005,4.2,16.3,-113909,-6.7,19.2,0,1755,1833,17425
1991,26,a) 0,14285,14483,80985,40863,14376,198.5,0,0,80244,80244,0,196.4,196.4,0,0,0,0,0,80244,196.4,0,0,,,
1991,26,b) 1,12229,12467,89787,87512,137,1,2382,17.4,27427,3627,23800,4.1,31.3,22876,10187,12689,11.6,26.1,4551,5.2,52.2,0,1686,1689,7861
1991,26,c) 2,10534,10885,84995,92402,344,3,1831,15.7,15275,2264,13011,2.5,16.5,30088,14777,15311,16,32.6,-14813,-16.1,33,0,1427,1430,13139
1991,26,d) 3,9240,9554,86100,91141,281,2.8,1493,14.7,13060,2152,10908,2.4,14.3,23142,9685,13457,10.6,25.4,-10082,-11.1,28.6,0,1147,1150,7863
1991,26,e) 4,9175,9630,103877,110026,283,2.8,1476,14.5,12058,1674,10384,1.5,11,24356,11561,12795,10.5,22.1,-12298,-11.1,22,0,1119,1142,9461
1991,26,f) 5,7780,8255,82621,86836,258,3,1074,12.4,10946,1926,9020,2.2,12.6,19375,7341,12034,8.5,22.3,-8429,-9.7,25.2,0,783,783,5474
1991,26,g) 6 to 10,28555,31263,348351,360156,1075,3.3,3022,9.4,47907,12492,35415,3.5,13.3,71516,24571,46945,6.8,19.9,-23609,-6.6,26.6,0,2090,2144,16012
1991,26,h) 11 to 15,17462,21255,265279,273571,859,4,1726,8,34125,9406,24719,3.4,12.5,50709,15467,35242,5.7,18.5,-16584,-6,25,0,1043,1060,9246
1991,26,l) Left Censored,41493,68830,2134468,2181407,3375,4.9,4812,6.9,220793,78120,142673,3.6,10.1,314671,70082,244589,3.2,14.4,-93878,-4.3,20.2,0,2003,2074,18267
1991,27,a) 0,8111,8236,46673,23494,8174,198.5,0,0,46358,46358,0,197.3,197.3,0,0,0,0,0,46358,197.3,0,0,,,
1991,27,b) 1,6623,6786,49832,49410,93,1.3,1257,17,15140,2862,12278,5.8,30.6,14295,6681,7614,13.5,28.9,845,1.7,57.8,0,853,855,5216
1991,27,c) 2,5683,5834,44156,49596,202,3.3,855,13.8,9431,2008,7423,4,19,20310,13594,6716,27.4,41,-10879,-22,38,0,636,637,12699
1991,27,d) 3,4891,5067,45191,46996,184,3.5,686,12.9,7164,1183,5981,2.5,15.2,10773,4339,6434,9.2,22.9,-3609,-7.7,30.4,0,542,542,3593
1991,27,e) 4,4463,4744,62226,65597,165,3.3,673,13.5,7531,1473,6058,2.2,11.5,14273,5056,9217,7.7,21.8,-6742,-10.3,23,0,472,478,3811
1991,27,f) 5,4101,4419,46072,47565,163,3.5,571,12.4,6775,1016,5759,2.1,14.2,9761,3987,5774,8.4,20.5,-2986,-6.3,28.4,0,395,398,2891
1991,27,g) 6 to 10,15415,16943,214944,219307,630,3.6,1658,9.5,32699,9949,22750,4.5,14.9,41425,13812,27613,6.3,18.9,-8726,-4,29.8,0,1130,1163,9179
1991,27,h) 11 to 15,9842,11908,154064,155283,495,4.1,948,7.8,20603,5457,15146,3.5,13.3,23041,6628,16413,4.3,14.8,-2438,-1.5,26.6,0,561,579,3714
1991,27,l) Left Censored,23674,36802,1141778,1157621,2028,5.5,2452,6.6,122329,41881,80448,3.6,10.6,154014,43754,110260,3.8,13.3,-31685,-2.7,21.2,0,1044,1062,11717
1991,28,a) 0,3911,3972,22661,11464,3930,197.9,0,0,22394,22394,0,195.3,195.3,0,0,0,0,0,22394,195.3,0,0,,,
1991,28,b) 1,3184,3222,21995,21726,41,1.1,713,19.9,6602,1398,5204,6.4,30.4,6063,3521,2542,16.2,27.9,539,2.5,55.8,0,506,506,2359
1991,28,c) 2,2506,2535,19039,20690,80,2.9,506,18.4,3982,368,3614,1.8,19.2,7284,4283,3001,20.7,35.2,-3302,-16,38.4,0,372,372,3589
1991,28,d) 3,2150,2261,21268,22109,88,3.7,390,16.3,3436,849,2587,3.8,15.5,5117,2151,2966,9.7,23.1,-1681,-7.6,31,0,285,285,1662
1991,28,e) 4,2022,2158,28328,28786,91,4,367,16,3633,762,2871,2.6,12.6,4548,2178,2370,7.6,15.8,-915,-3.2,25.2,0,268,269,1772
1991,28,f) 5,1811,1875,15585,16378,76,3.9,283,14.4,2423,395,2028,2.4,14.8,4009,1703,2306,10.4,24.5,-1586,-9.7,29.6,0,208,208,1249
1991,28,g) 6 to 10,7693,8233,80134,81688,298,3.5,859,10.1,12188,3192,8996,3.9,14.9,15296,6121,9175,7.5,18.7,-3108,-3.8,29.8,0,609,611,4265
1991,28,h) 11 to 15,4797,5668,64434,64499,263,4.6,513,8.9,9793,2414,7379,3.7,15.2,9922,2499,7423,3.9,15.4,-129,-0.2,30.4,0,308,310,1487
1991,28,l) Left Censored,11042,18005,460590,462014,1007,5.6,1290,7.1,51834,16735,35099,3.6,11.2,54682,13157,41525,2.8,11.8,-2848,-0.6,22.4,0,562,579,4245
1991,29,a) 0,9580,9726,52963,26674,9649,198.4,0,0,52578,52578,0,197.1,197.1,0,0,0,0,0,52578,197.1,0,0,,,
1991,29,b) 1,7761,7889,55937,57469,93,1.1,1846,20.9,15107,1928,13179,3.4,26.3,18170,9115,9055,15.9,31.6,-3063,-5.3,52.6,0,1323,1323,7246
1991,29,c) 2,6751,6947,49214,52802,221,2.9,1310,17.5,10017,1697,8320,3.2,19,17193,8067,9126,15.3,32.6,-7176,-13.6,38,0,979,988,6378
1991,29,d) 3,5644,5859,56462,55738,223,3.6,1015,16.2,14576,2879,11697,5.2,26.2,13127,6278,6849,11.3,23.6,1449,2.6,47.2,0,764,764,4817
1991,29,e) 4,5516,5804,65353,68144,221,3.6,871,14.2,8195,1422,6773,2.1,12,13777,6228,7549,9.1,20.2,-5582,-8.2,24,0,651,656,4707
1991,29,f) 5,4802,5072,48032,49610,193,3.6,667,12.6,7511,1486,6025,3,15.1,10667,4109,6558,8.3,21.5,-3156,-6.4,30.2,0,486,488,2898
1991,29,g) 6 to 10,18226,19952,211969,218559,760,3.7,2009,9.8,28086,6910,21176,3.2,12.9,41265,14556,26709,6.7,18.9,-13179,-6,25.8,0,1380,1396,10140
1991,29,h) 11 to 15,10860,13092,159097,165065,502,3.7,1233,9.2,18967,4664,14303,2.8,11.5,30903,11946,18957,7.2,18.7,-11936,-7.2,23,0,681,710,5416
1991,29,l) Left Censored,26373,42910,1286013,1281850,2278,5.3,3133,7.2,173509,45945,127564,3.6,13.5,165183,45250,119933,3.5,12.9,8326,0.6,25.8,0,1280,1322,13040
1991,30,a) 0,1941,1952,8767,4402,1925,197.2,0,0,8731,8731,0,198.3,198.3,0,0,0,0,0,8731,198.3,0,0,,,
1991,30,b) 1,1516,1527,8213,8360,10,0.6,305,18.1,1821,109,1712,1.3,21.8,2115,989,1126,11.8,25.3,-294,-3.5,43.6,0,202,202,726
1991,30,c) 2,1288,1340,7960,8471,41,2.9,192,13.5,1264,117,1147,1.4,14.9,2285,1042,1243,12.3,27,-1021,-12.1,29.8,0,141,141,844
1991,30,d) 3,1134,1162,7830,8122,54,4.4,172,14.1,1436,240,1196,3,17.7,2020,848,1172,10.4,24.9,-584,-7.2,35.4,0,136,136,732
1991,30,e) 4,1070,1121,9359,9515,52,4.4,159,13.5,1309,276,1033,2.9,13.8,1621,798,823,8.4,17,-312,-3.2,27.6,0,120,120,603
1991,30,f) 5,996,1039,7503,7499,46,4.2,153,14,1425,296,1129,3.9,19,1417,631,786,8.4,18.9,8,0.1,37.8,0,111,111,503
1991,30,g) 6 to 10,3864,4138,31756,32348,187,4.4,431,10.1,5229,1433,3796,4.4,16.2,6413,2223,4190,6.9,19.8,-1184,-3.6,32.4,0,297,299,1522
1991,30,h) 11 to 15,2667,3087,27973,28110,151,4.8,240,7.7,4221,1101,3120,3.9,15,4494,1072,3422,3.8,16,-273,-1,30,0,164,164,718
1991,30,l) Left Censored,4823,6972,112264,113175,342,4.9,453,6.4,11711,3560,8151,3.1,10.3,13532,3592,9940,3.2,12,-1821,-1.7,20.6,0,226,235,1544
1991,31,a) 0,2813,2862,13592,6832,2840,198.5,0,0,13520,13520,0,197.9,197.9,0,0,0,0,0,13520,197.9,0,0,,,
1991,31,b) 1,2343,2398,17515,16708,33,1.3,441,16.9,5071,518,4553,3.1,30.4,3457,1562,1895,9.3,20.7,1614,9.7,41.4,0,315,315,1203
1991,31,c) 2,2084,2136,14568,15373,75,3.3,292,13,2861,433,2428,2.8,18.6,4470,1608,2862,10.5,29.1,-1609,-10.5,37.2,0,217,219,1348
1991,31,d) 3,1792,1902,16719,17193,83,4.2,271,13.6,2426,582,1844,3.4,14.1,3373,1346,2027,7.8,19.6,-947,-5.5,28.2,0,197,197,1112
1991,31,e) 4,1592,1651,19233,19695,57,3.3,215,12.4,2249,285,1964,1.4,11.4,3172,1783,1389,9.1,16.1,-923,-4.7,22.8,0,173,173,1636
1991,31,f) 5,1448,1518,16067,15519,47,3,180,11.4,3590,1102,2488,7.1,23.1,2494,1196,1298,7.7,16.1,1096,7,32.2,0,139,139,915
1991,31,g) 6 to 10,6497,7088,70431,71188,285,3.9,620,8.6,9880,2299,7581,3.2,13.9,11393,4446,6947,6.2,16,-1513,-2.1,27.8,0,462,466,3393
1991,31,h) 11 to 15,4293,5058,51692,52055,247,4.8,378,7.4,6881,2000,4881,3.8,13.2,7607,2732,4875,5.2,14.6,-726,-1.4,26.4,0,251,256,1317
1991,31,l) Left Censored,10538,15464,372947,371165,797,5.1,1032,6.6,41441,14342,27099,3.9,11.2,37877,9122,28755,2.5,10.2,3564,1,20.4,0,477,499,3579
1991,32,a) 0,3155,3182,20152,10197,3153,198.2,0,0,19910,19910,0,195.3,195.3,0,0,0,0,0,19910,195.3,0,0,,,
1991,32,b) 1,2406,2446,21464,21332,34,1.2,618,22.4,6546,725,5821,3.4,30.7,6282,3205,3077,15,29.4,264,1.3,58.8,0,451,453,2414
1991,32,c) 2,1987,2029,24485,25016,83,3.8,406,18.5,5747,606,5141,2.4,23,6809,2826,3983,11.3,27.2,-1062,-4.2,46,0,316,316,2403
1991,32,d) 3,1547,1597,19716,21988,65,3.9,252,14.9,2908,750,2158,3.4,13.2,7451,2017,5434,9.2,33.9,-4543,-20.7,26.4,0,179,179,1364
1991,32,e) 4,1404,1510,18336,19269,69,4.3,235,14.8,3045,716,2329,3.7,15.8,4910,1930,2980,10,25.5,-1865,-9.7,31.6,0,172,180,1610
1991,32,f) 5,1219,1293,19708,20785,63,4.7,162,12.1,3362,924,2438,4.4,16.2,5516,2468,3048,11.9,26.5,-2154,-10.3,32.4,0,118,119,2125
1991,32,g) 6 to 10,4221,4740,71175,75027,276,5.7,526,10.8,9903,2377,7526,3.2,13.2,17606,4413,13193,5.9,23.5,-7703,-10.3,26.4,0,344,344,2908
1991,32,h) 11 to 15,2669,3158,64473,66360,195,6.1,261,8.2,7847,2094,5753,3.2,11.8,11620,3172,8448,4.8,17.5,-3773,-5.7,23.6,0,166,169,2085
1991,32,l) Left Censored,4326,7271,286969,282384,589,8.1,532,7.3,41944,11611,30333,4.1,14.9,32773,7355,25418,2.6,11.6,9171,3.3,23.2,0,190,193,2831
1991,33,a) 0,2353,2375,11476,5775,2357,198.5,0,0,11403,11403,0,197.5,197.5,0,0,0,0,0,11403,197.5,0,0,,,
1991,33,b) 1,1989,2014,12928,13200,16,0.7,523,22.8,3931,1026,2905,7.8,29.8,4474,2267,2207,17.2,33.9,-543,-4.1,59.6,0,377,377,1876
1991,33,c) 2,1933,1971,16185,18150,52,2.4,453,20.8,3276,186,3090,1,18,7205,4316,2889,23.8,39.7,-3929,-21.7,36,0,350,350,3925
1991,33,d) 3,1796,1838,13090,14508,53,2.6,432,21.3,1660,328,1332,2.3,11.4,4495,1853,2642,12.8,31,-2835,-19.6,22.8,0,338,338,1498
1991,33,e) 4,1718,1765,14347,15423,47,2.4,410,21,1834,507,1327,3.3,11.9,3985,1742,2243,11.3,25.8,-2151,-13.9,23.8,0,302,303,1432
1991,33,f) 5,1487,1583,13628,14882,64,3.7,309,18,1507,329,1178,2.2,10.1,4014,1505,2509,10.1,27,-2507,-16.9,20.2,0,239,239,1260
1991,33,g) 6 to 10,4726,5043,48740,51753,180,3.4,671,12.7,6596,1917,4679,3.7,12.7,12621,4554,8067,8.8,24.4,-6025,-11.7,25.4,0,454,459,3504
1991,33,h) 11 to 15,2557,3011,37448,38992,119,3.8,323,10.4,3916,1280,2636,3.3,10,7004,1770,5234,4.5,18,-3088,-8,20,0,190,197,1003
1991,33,l) Left Censored,5887,8872,242857,250725,551,6.2,720,8,22619,8257,14362,3.3,9,38355,10578,27777,4.2,15.3,-15736,-6.3,18,0,243,254,2576
1991,34,a) 0,14486,14602,75022,37768,14453,198,0,0,74509,74509,0,197.3,197.3,0,0,0,0,0,74509,197.3,0,0,,,
1991,34,b) 1,12102,12285,88631,92913,121,0.9,3127,22.5,21267,2737,18530,2.9,22.9,29831,12878,16953,13.9,32.1,-8564,-9.2,45.8,0,2090,2094,9618
1991,34,c) 2,11219,11369,83320,87067,419,3.4,2269,18.4,19846,3040,16806,3.5,22.8,27340,12198,15142,14,31.4,-7494,-8.6,45.6,0,1671,1671,9239
1991,34,d) 3,10459,10678,87303,93461,403,3.5,2079,18,14874,3205,11669,3.4,15.9,27190,12329,14861,13.2,29.1,-12316,-13.2,31.8,0,1512,1516,9971
1991,34,e) 4,9576,9829,99853,106305,322,3,1775,16.8,11303,2235,9068,2.1,10.6,24206,10001,14205,9.4,22.8,-12903,-12.2,21.2,0,1268,1286,7829
1991,34,f) 5,8441,8784,82987,88082,281,3,1427,15.3,11472,2695,8777,3.1,13,21662,8166,13496,9.3,24.6,-10190,-11.6,26,0,1021,1023,4846
1991,34,g) 6 to 10,29854,31431,335656,353891,925,2.8,3724,11.3,42255,7713,34542,2.2,11.9,78725,24680,54045,7,22.2,-36470,-10.3,23.8,0,2544,2560,16697
1991,34,h) 11 to 15,17690,19707,233517,242338,688,3.4,1991,9.8,31509,7214,24295,3,13,49152,13125,36027,5.4,20.3,-17643,-7.3,26,0,1236,1250,7509
1991,34,l) Left Censored,44178,65740,1973091,2022930,3305,4.9,5394,8.1,223769,71673,152096,3.5,11.1,323447,85396,238051,4.2,16,-99678,-4.9,22.2,0,2270,2322,21379
1991,35,a) 0,3052,3104,17718,8936,3077,198.3,0,0,17565,17565,0,196.6,196.6,0,0,0,0,0,17565,196.6,0,0,,,
1991,35,b) 1,2349,2369,16312,16287,26,1,497,18.9,5117,1061,4056,6.5,31.4,5066,2733,2333,16.8,31.1,51,0.3,62.2,0,338,338,1727
1991,35,c) 2,1984,2044,14897,15886,60,2.7,355,16.1,2513,198,2315,1.2,15.8,4491,1843,2648,11.6,28.3,-1978,-12.5,31.6,0,266,267,1505
1991,35,d) 3,1617,1700,16011,15155,75,4.2,281,15.6,5120,2051,3069,13.5,33.8,3407,1534,1873,10.1,22.5,1713,11.3,45,0,207,208,1165
1991,35,e) 4,1484,1572,18253,18887,82,5,258,15.6,2343,448,1895,2.4,12.4,3610,2057,1553,10.9,19.1,-1267,-6.7,24.8,0,191,193,1492
1991,35,f) 5,1406,1459,13142,13462,69,4.5,237,15.4,2428,657,1771,4.9,18,3067,1443,1624,10.7,22.8,-639,-4.8,36,0,170,172,1049
1991,35,g) 6 to 10,5484,5998,56095,57714,319,5.2,677,11,9489,2976,6513,5.2,16.4,12726,5385,7341,9.3,22.1,-3237,-5.7,32.8,0,441,443,3500
1991,35,h) 11 to 15,3532,4158,42591,42815,229,5.4,339,8.1,7067,1994,5073,4.7,16.5,7514,2263,5251,5.3,17.5,-447,-1,33,0,200,201,1127
1991,35,l) Left Censored,6186,9927,229856,228383,636,6.4,815,8.1,32263,11990,20273,5.2,14.1,29317,9671,19646,4.2,12.8,2946,1.3,25.6,0,303,307,3052
1991,36,a) 0,34132,34336,173394,87202,34015,198.1,0,0,172385,172385,0,197.7,197.7,0,0,0,0,0,172385,197.7,0,0,,,
1991,36,b) 1,28007,28294,183851,186617,227,0.7,6732,21.2,53559,8338,45221,4.5,28.7,59091,28619,30472,15.3,31.7,-5532,-3,57.4,0,4746,4746,21362
1991,36,c) 2,25549,25933,178699,192406,793,2.8,4980,17.8,32244,4837,27407,2.5,16.8,59658,26844,32814,14,31,-27414,-14.2,33.6,0,3702,3706,21313
1991,36,d) 3,22288,22672,186786,197280,710,2.9,4138,17,28910,5299,23611,2.7,14.7,49897,22211,27686,11.3,25.3,-20987,-10.6,29.4,0,3203,3205,18093
1991,36,e) 4,20654,21311,275502,288103,644,2.8,3617,15.9,24340,4475,19865,1.6,8.4,49542,21997,27545,7.6,17.2,-25202,-8.8,16.8,0,2745,2758,16666
1991,36,f) 5,18258,18901,152804,161006,575,2.9,2980,14.8,24057,5980,18077,3.7,14.9,40461,16227,24234,10.1,25.1,-16404,-10.2,29.8,0,2269,2271,12830
1991,36,g) 6 to 10,65720,69397,712806,754598,2129,2.9,8208,11.3,88217,20632,67585,2.7,11.7,171801,56848,114953,7.5,22.8,-83584,-11.1,23.4,0,5862,5896,40484
1991,36,h) 11 to 15,36816,42586,582256,601661,1493,3.4,4225,9.6,71902,17292,54610,2.9,12,110712,35182,75530,5.8,18.4,-38810,-6.4,24,0,2734,2778,19715
1991,36,l) Left Censored,99093,143802,4276967,4390817,6611,4.5,11452,7.8,445054,133153,311901,3,10.1,672756,161292,511464,3.7,15.3,-227702,-5.2,20.2,0,5787,5855,52455
1991,37,a) 0,12158,12329,65132,32801,12246,198.7,0,0,64663,64663,0,197.1,197.1,0,0,0,0,0,64663,197.1,0,0,,,
1991,37,b) 1,10185,10350,67747,69237,111,1,2522,21.7,19440,2402,17038,3.5,28.1,22419,11800,10619,17,32.4,-2979,-4.3,56.2,0,1851,1851,9092
1991,37,c) 2,8602,8862,65553,71039,333,3.5,1622,17,12148,2325,9823,3.3,17.1,23119,11249,11870,15.8,32.5,-10971,-15.4,34.2,0,1255,1257,8946
1991,37,d) 3,7452,7768,68522,73395,307,3.7,1318,15.9,10361,2203,8158,3,14.1,20107,9430,10677,12.8,27.4,-9746,-13.3,28.2,0,1008,1009,7264
1991,37,e) 4,6906,7455,77393,83370,305,3.9,1235,15.6,10174,2206,7968,2.6,12.2,22128,10594,11534,12.7,26.5,-11954,-14.3,24.4,0,914,931,9106
1991,37,f) 5,6304,6730,60403,63644,279,3.9,990,14,9556,2178,7378,3.4,15,16037,5962,10075,9.4,25.2,-6481,-10.2,30,0,709,722,3986
1991,37,g) 6 to 10,24074,26224,289651,302489,969,3.6,2606,9.6,39139,10671,28468,3.5,12.9,64814,22939,41875,7.6,21.4,-25675,-8.5,25.8,0,1756,1793,14252
1991,37,h) 11 to 15,12820,15267,195177,201749,657,4.2,1314,8.4,22851,6626,16225,3.3,11.3,35995,10599,25396,5.3,17.8,-13144,-6.5,22.6,0,767,779,5821
1991,37,l) Left Censored,29820,53660,1679417,1716600,2905,5.4,3798,7,171975,59368,112607,3.5,10,246343,60450,185893,3.5,14.4,-74368,-4.4,20,0,1435,1487,11313
1991,38,a) 0,1188,1194,5601,2810,1183,198.2,0,0,5583,5583,0,198.7,198.7,0,0,0,0,0,5583,198.7,0,0,,,
1991,38,b) 1,970,991,5594,5648,20,1.8,184,17,1756,614,1142,10.9,31.1,1863,970,893,17.2,33,-107,-1.9,62.2,0,114,114,729
1991,38,c) 2,816,825,5139,5488,22,2.5,133,15.1,922,54,868,1,16.8,1619,914,705,16.7,29.5,-697,-12.7,33.6,0,107,107,857
1991,38,d) 3,784,812,6189,6210,26,3.1,101,11.9,1009,89,920,1.4,16.2,1051,371,680,6,16.9,-42,-0.7,32.4,0,81,81,337
1991,38,e) 4,736,763,6429,6574,26,3.3,101,12.6,841,172,669,2.6,12.8,1130,623,507,9.5,17.2,-289,-4.4,25.6,0,81,81,545
1991,38,f) 5,653,693,5269,5382,25,3.4,92,12.7,827,216,611,4,15.4,1053,436,617,8.1,19.6,-226,-4.2,30.8,0,74,74,388
1991,38,g) 6 to 10,2815,3097,25175,25091,108,3.4,288,9,3996,680,3316,2.7,15.9,3828,1348,2480,5.4,15.3,168,0.6,30.6,0,192,192,859
1991,38,h) 11 to 15,1935,2171,19974,19920,95,4.3,194,8.7,3278,1513,1765,7.6,16.5,3169,793,2376,4,15.9,109,0.6,31.8,0,119,119,441
1991,38,l) Left Censored,4623,6545,120757,120114,306,4.6,443,6.7,13716,4551,9165,3.8,11.4,12429,3393,9036,2.8,10.3,1287,1.1,20.6,0,209,213,1459
1991,39,a) 0,15851,16097,94644,47586,15993,198.7,0,0,94116,94116,0,197.8,197.8,0,0,0,0,0,94116,197.8,0,0,,,
1991,39,b) 1,13222,13598,111509,107181,266,1.8,2669,17.9,36300,6057,30243,5.7,33.9,27644,13382,14262,12.5,25.8,8656,8.1,51.6,0,1864,1864,10699
1991,39,c) 2,11613,12005,101485,108361,414,3.2,2053,16,20038,3529,16509,3.3,18.5,33789,16328,17461,15.1,31.2,-13751,-12.7,37,0,1572,1575,12909
1991,39,d) 3,10121,10548,102827,106850,334,3,1658,14.8,17317,3263,14054,3.1,16.2,25362,10540,14822,9.9,23.7,-8045,-7.5,32.4,0,1248,1248,8866
1991,39,e) 4,9782,10407,117112,121182,360,3.3,1405,12.9,15744,2775,12969,2.3,13,23883,9633,14250,7.9,19.7,-8139,-6.7,26,0,1036,1048,7224
1991,39,f) 5,8574,9165,92900,96063,313,3.3,1173,12.2,14671,3247,11424,3.4,15.3,20996,8273,12723,8.6,21.9,-6325,-6.6,30.6,0,869,871,5966
1991,39,g) 6 to 10,32140,35576,425217,437871,1129,3.1,3327,9.1,54177,11329,42848,2.6,12.4,79485,27145,52340,6.2,18.2,-25308,-5.8,24.8,0,2360,2382,19743
1991,39,h) 11 to 15,20593,25242,338269,343835,994,3.9,1870,7.3,41780,10453,31327,3,12.2,52912,14204,38708,4.1,15.4,-11132,-3.2,24.4,0,1130,1145,7895
1991,39,l) Left Censored,54415,93246,2779542,2827157,4346,4.6,6225,6.6,273556,87437,186119,3.1,9.7,368786,97766,271020,3.5,13,-95230,-3.3,19.4,0,2552,2627,29977
1991,40,a) 0,5861,5923,32758,16455,5871,198.2,0,0,32606,32606,0,198.2,198.2,0,0,0,0,0,32606,198.2,0,0,,,
1991,40,b) 1,4538,4596,29890,29754,39,0.8,986,19.3,8614,817,7797,2.7,29,8341,4400,3941,14.8,28,273,1,56,0,705,705,3330
1991,40,c) 2,3750,3813,30987,31709,126,3.1,639,15.7,7103,1464,5639,4.6,22.4,8546,3906,4640,12.3,27,-1443,-4.6,44.8,0,502,502,3261
1991,40,d) 3,3105,3215,27035,28089,138,4.1,488,14.4,4556,724,3832,2.6,16.2,6663,3079,3584,11,23.7,-2107,-7.5,32.4,0,387,387,2623
1991,40,e) 4,2757,2946,39570,39485,143,4.6,446,14.4,6319,1070,5249,2.7,16,6149,2799,3350,7.1,15.6,170,0.4,31.2,0,342,351,2226
1991,40,f) 5,2745,2888,27063,27553,112,3.7,361,12,4500,899,3601,3.3,16.3,5479,2773,2706,10.1,19.9,-979,-3.6,32.6,0,276,276,2354
1991,40,g) 6 to 10,11905,12931,121168,127154,617,4.7,1277,9.6,21240,7024,14216,5.5,16.7,33212,8664,24548,6.8,26.1,-11972,-9.4,33.4,0,914,931,6502
1991,40,h) 11 to 15,6905,8128,93988,93401,424,5.1,714,8.6,13746,3713,10033,4,14.7,12572,4449,8123,4.8,13.5,1174,1.2,27,0,472,472,2469
1991,40,l) Left Censored,14367,23385,547210,550704,1225,5.2,1808,7.6,59596,18083,41513,3.3,10.8,66583,20572,46011,3.7,12.1,-6987,-1.3,21.6,0,718,727,5914
1991,41,a) 0,6934,7002,35463,17801,6942,198.3,0,0,35325,35325,0,198.4,198.4,0,0,0,0,0,35325,198.4,0,0,,,
1991,41,b) 1,5983,6060,40595,41026,57,0.8,1291,19.2,10859,1067,9792,2.6,26.5,11721,5555,6166,13.5,28.6,-862,-2.1,53,0,896,896,4318
1991,41,c) 2,3849,3916,29289,31194,144,3.4,755,17.9,6290,785,5505,2.5,20.2,10099,5156,4943,16.5,32.4,-3809,-12.2,40.4,0,583,583,3657
1991,41,d) 3,3922,4009,31526,33004,138,3.2,660,15.4,5379,731,4648,2.2,16.3,8335,3698,4637,11.2,25.3,-2956,-9,32.6,0,504,504,3087
1991,41,e) 4,3667,3848,43032,43690,154,3.8,572,14.1,6921,1304,5617,3,15.8,8236,3404,4832,7.8,18.9,-1315,-3.1,31.6,0,421,426,2842
1991,41,f) 5,3220,3373,29273,30428,154,4.4,486,13.7,4956,1018,3938,3.3,16.3,7265,3215,4050,10.6,23.9,-2309,-7.6,32.6,0,373,374,2569
1991,41,g) 6 to 10,11531,12622,137678,139944,558,4.3,1376,10.6,22085,6536,15549,4.7,15.8,26616,8532,18084,6.1,19,-4531,-3.2,31.6,0,948,959,5827
1991,41,h) 11 to 15,7517,8907,102339,103873,501,5.5,798,8.8,16094,5395,10699,5.2,15.5,19162,5664,13498,5.5,18.4,-3068,-2.9,31,0,474,487,3305
1991,41,l) Left Censored,14041,22947,573644,570487,1526,6.6,1771,7.7,82021,26505,55516,4.6,14.4,75706,24448,51258,4.3,13.3,6315,1.1,26.6,0,669,726,5387
1991,42,a) 0,17847,18099,106287,53451,17968,198.6,0,0,105672,105672,0,197.7,197.7,0,0,0,0,0,105672,197.7,0,0,,,
1991,42,b) 1,15469,15749,109306,109405,182,1.1,3123,18,28629,3919,24710,3.6,26.2,28826,13761,15065,12.6,26.3,-197,-0.1,52.4,0,2253,2254,10772
1991,42,c) 2,14287,14632,113907,119676,449,2.9,2227,14.3,21961,2890,19071,2.4,18.4,33499,14857,18642,12.4,28,-11538,-9.6,36.8,0,1638,1644,11444
1991,42,d) 3,12541,12952,109347,114690,407,3,1855,13.6,16932,2620,14312,2.3,14.8,27618,12222,15396,10.7,24.1,-10686,-9.3,29.6,0,1404,1418,9808
1991,42,e) 4,11967,12520,133499,138343,369,2.8,1697,12.9,16160,2461,13699,1.8,11.7,25848,11094,14754,8,18.7,-9688,-7,23.4,0,1235,1251,7917
1991,42,f) 5,10692,11250,108402,113643,388,3.3,1376,11.7,15438,2559,12879,2.3,13.6,25920,10263,15657,9,22.8,-10482,-9.2,27.2,0,1001,1001,7461
1991,42,g) 6 to 10,37692,40901,487245,504361,1348,3.2,3962,9.4,58629,12027,46602,2.4,11.6,92861,31204,61657,6.2,18.4,-34232,-6.8,23.2,0,2773,2805,19890
1991,42,h) 11 to 15,22974,27391,364611,370433,1050,3.8,2113,7.6,46264,14139,32125,3.8,12.5,57908,16674,41234,4.5,15.6,-11644,-3.1,25,0,1248,1268,8963
1991,42,l) Left Censored,62281,100152,2976577,3014973,4611,4.6,6951,6.9,314771,97006,217765,3.2,10.4,391564,113044,278520,3.7,13,-76793,-2.6,20.8,0,3201,3344,31420
1991,44,a) 0,1784,1792,9344,4710,1770,197.5,0,0,9268,9268,0,196.8,196.8,0,0,0,0,0,9268,196.8,0,0,,,
1991,44,b) 1,1546,1559,10401,10494,13,0.7,457,25.5,3622,1112,2510,10.6,34.5,3807,1792,2015,17.1,36.3,-185,-1.8,69,0,315,315,1413
1991,44,c) 2,1496,1525,12416,13358,32,1.9,332,19.8,2270,204,2066,1.5,17,4153,1828,2325,13.7,31.1,-1883,-14.1,34,0,220,220,1427
1991,44,d) 3,1353,1393,9440,10241,56,3.7,294,19.4,1795,719,1076,7,17.5,3397,1382,2015,13.5,33.2,-1602,-15.7,35,0,210,210,1023
1991,44,e) 4,1251,1286,11451,12191,42,3,250,18,1234,216,1018,1.8,10.1,2713,1058,1655,8.7,22.3,-1479,-12.2,20.2,0,172,173,799
1991,44,f) 5,1058,1097,8108,8786,28,2.4,158,13.6,1023,226,797,2.6,11.6,2378,866,1512,9.9,27.1,-1355,-15.5,23.2,0,113,113,642
1991,44,g) 6 to 10,3715,3899,38966,41789,107,2.6,451,11.1,4300,725,3575,1.7,10.3,9946,2946,7000,7,23.8,-5646,-13.5,20.6,0,325,325,1933
1991,44,h) 11 to 15,2257,2509,29486,31216,84,3.2,260,10,3490,907,2583,2.9,11.2,6950,2281,4669,7.3,22.3,-3460,-11.1,22.4,0,161,163,1577
1991,44,l) Left Censored,6644,8682,245323,250823,307,3.5,694,7.8,23467,8119,15348,3.2,9.4,34469,7579,26890,3,13.7,-11002,-4.3,18.8,0,320,337,2989
1991,45,a) 0,6299,6404,36668,18454,6348,198.3,0,0,36428,36428,0,197.4,197.4,0,0,0,0,0,36428,197.4,0,0,,,
1991,45,b) 1,5064,5126,36724,37368,65,1.1,1069,18.8,10792,1276,9516,3.4,28.9,12079,6229,5850,16.7,32.3,-1287,-3.4,57.8,0,732,732,4568
1991,45,c) 2,4155,4328,34810,36719,150,3.3,716,15.5,6991,1333,5658,3.6,19,10809,4626,6183,12.6,29.4,-3818,-10.4,38,0,540,540,4016
1991,45,d) 3,3768,3982,54988,58759,202,4.8,637,15.2,5406,1115,4291,1.9,9.2,12947,3974,8973,6.8,22,-7541,-12.8,18.4,0,498,501,3143
1991,45,e) 4,3466,3740,46408,48041,182,4.6,601,15.2,6747,2193,4554,4.6,14,10012,3681,6331,7.7,20.8,-3265,-6.8,28,0,442,445,2790
1991,45,f) 5,3072,3277,27569,29187,135,3.9,435,12.7,4593,1353,3240,4.6,15.7,7828,3377,4451,11.6,26.8,-3235,-11.1,31.4,0,324,325,2305
1991,45,g) 6 to 10,11547,12674,138117,143062,517,4,1296,9.9,18216,4247,13969,3,12.7,28106,9636,18470,6.7,19.6,-9890,-6.9,25.4,0,897,903,6027
1991,45,h) 11 to 15,6283,7532,92200,94822,386,5,634,8.3,13604,4615,8989,4.9,14.3,18847,4725,14122,5,19.9,-5243,-5.6,28.6,0,355,356,2081
1991,45,l) Left Censored,14368,25405,761251,770554,1572,6.2,1877,7.3,87713,36997,50716,4.8,11.4,106320,29754,76566,3.9,13.8,-18607,-2.4,22.8,0,694,729,7203
1991,46,a) 0,1481,1496,8376,4212,1479,197.7,0,0,8329,8329,0,197.7,197.7,0,0,0,0,0,8329,197.7,0,0,,,
1991,46,b) 1,1296,1307,8862,8501,9,0.6,232,16.2,2578,200,2378,2.4,30.3,1855,746,1109,8.8,21.8,723,8.5,43.6,0,146,146,475
1991,46,c) 2,946,965,6043,6212,40,3.9,141,13.8,1221,184,1037,3,19.7,1559,608,951,9.8,25.1,-338,-5.4,39.4,0,104,104,498
1991,46,d) 3,860,897,5987,6271,27,2.9,105,11.2,860,92,768,1.5,13.7,1428,555,873,8.9,22.8,-568,-9.1,27.4,0,76,76,476
1991,46,e) 4,774,799,10161,10253,37,4.5,105,12.6,1076,167,909,1.6,10.5,1260,442,818,4.3,12.3,-184,-1.8,21,0,77,77,336
1991,46,f) 5,686,716,5991,5870,33,4.4,84,11.3,1306,235,1071,4,22.2,1064,316,748,5.4,18.1,242,4.1,36.2,0,63,63,236
1991,46,g) 6 to 10,2965,3242,24896,25386,128,3.9,281,8.5,3254,549,2705,2.2,12.8,4233,1432,2801,5.6,16.7,-979,-3.9,25.6,0,191,191,920
1991,46,h) 11 to 15,1969,2239,22752,22547,100,4.4,162,7.1,3389,596,2793,2.6,15,2978,1027,1951,4.6,13.2,411,1.8,26.4,0,97,98,465
1991,46,l) Left Censored,4950,6769,131473,129368,355,5.2,416,6.1,16881,5682,11199,4.4,13,12670,3492,9178,2.7,9.8,4211,3.2,19.6,0,234,234,1858
1991,47,a) 0,8471,8652,59461,29861,8581,198.4,0,0,59201,59201,0,198.3,198.3,0,0,0,0,0,59201,198.3,0,0,,,
1991,47,b) 1,6800,6941,54252,55450,79,1,1654,21.3,15838,2192,13646,4,28.6,18234,9004,9230,16.2,32.9,-2396,-4.3,57.2,0,1230,1230,6800
1991,47,c) 2,5750,5971,48485,53901,208,3.2,1223,18.9,9807,1364,8443,2.5,18.2,20639,11252,9387,20.9,38.3,-10832,-20.1,36.4,0,977,979,9533
1991,47,d) 3,4996,5210,46854,50169,209,3.8,854,15.4,8778,1536,7242,3.1,17.5,15408,6971,8437,13.9,30.7,-6630,-13.2,35,0,650,651,4913
1991,47,e) 4,4699,5093,61628,63058,244,4.6,754,14.1,8519,2548,5971,4,13.5,11378,4324,7054,6.9,18,-2859,-4.5,27,0,561,562,2994
1991,47,f) 5,4242,4532,43882,47223,143,3,639,13.4,6096,969,5127,2.1,12.9,12778,5773,7005,12.2,27.1,-6682,-14.2,25.8,0,458,465,4754
1991,47,g) 6 to 10,15897,17392,193105,200939,622,3.5,1694,9.5,25044,6148,18896,3.1,12.5,40711,14874,25837,7.4,20.3,-15667,-7.8,25,0,1173,1178,10201
1991,47,h) 11 to 15,9226,11471,170840,170889,537,4.6,966,8.3,25557,6422,19135,3.8,15,25655,6895,18760,4,15,-98,0,30,0,555,581,4432
1991,47,l) Left Censored,21591,37811,1168806,1182038,2324,6.1,2808,7.4,137703,50570,87133,4.3,11.6,164168,41701,122467,3.5,13.9,-26465,-2.3,23.2,0,1104,1139,9426
1991,48,a) 0,33791,34268,227853,114590,34024,198.6,0,0,226527,226527,0,197.7,197.7,0,0,0,0,0,226527,197.7,0,0,,,
1991,48,b) 1,25844,26534,235348,230114,420,1.4,5765,19.6,82635,9386,73249,4.1,35.9,72166,35513,36653,15.4,31.4,10469,4.5,62.8,0,4204,4205,27339
1991,48,c) 2,20583,21286,188713,202613,807,3.5,4033,17.6,43849,5928,37921,2.9,21.6,71648,35812,35836,17.7,35.4,-27799,-13.8,43.2,0,3092,3098,29954
1991,48,d) 3,17209,18551,188508,190996,1008,5.1,3153,16.1,45636,9415,36221,4.9,23.9,50613,24465,26148,12.8,26.5,-4977,-2.6,47.8,0,2402,2410,19434
1991,48,e) 4,15568,16785,212187,215844,772,4.4,2761,15.6,38884,5924,32960,2.7,18,46198,25489,20709,11.8,21.4,-7314,-3.4,36,0,1972,2035,19024
1991,48,f) 5,14670,15934,155634,170035,722,4.3,2317,13.9,29680,7269,22411,4.3,17.5,58482,36942,21540,21.7,34.4,-28802,-16.9,35,0,1704,1709,32092
1991,48,g) 6 to 10,63391,70183,759180,773709,3089,4.3,7896,10.9,131144,30223,100921,3.9,17,160202,60415,99787,7.8,20.7,-29058,-3.7,34,0,5368,5409,38393
1991,48,h) 11 to 15,28432,36183,450661,455723,1917,5.2,3379,9.2,74746,23369,51377,5.1,16.4,84869,30606,54263,6.7,18.6,-10123,-2.2,32.8,0,1942,2009,15184
1991,48,l) Left Censored,57839,117656,3501734,3504145,7294,6.1,9681,8.1,471369,149737,321632,4.3,13.5,476192,143861,332331,4.1,13.6,-4823,-0.1,27,0,3426,3617,32954
1991,49,a) 0,3211,3250,21742,10920,3229,198.7,0,0,21645,21645,0,198.2,198.2,0,0,0,0,0,21645,198.2,0,0,,,
1991,49,b) 1,2377,2427,20425,20028,26,1,513,19.1,6309,396,5913,2,31.5,5515,2868,2647,14.3,27.5,794,4,55,0,367,367,2394
1991,49,c) 2,2031,2090,22714,23234,69,3.1,343,15.4,4991,751,4240,3.2,21.5,6031,3001,3030,12.9,26,-1040,-4.5,43,0,268,268,2610
1991,49,d) 3,1712,1818,20546,22401,68,3.6,267,13.9,3725,473,3252,2.1,16.6,7434,3480,3954,15.5,33.2,-3709,-16.6,33.2,0,200,200,3053
1991,49,e) 4,1492,1585,18153,18293,94,5.7,233,14.1,3340,670,2670,3.7,18.3,3619,1769,1850,9.7,19.8,-279,-1.5,36.6,0,183,183,1463
1991,49,f) 5,1314,1383,22902,21322,60,4.2,194,13.5,6210,507,5703,2.4,29.1,3049,1278,1771,6,14.3,3161,14.8,28.6,0,157,157,1000
1991,49,g) 6 to 10,5153,5787,76515,78040,290,4.9,602,10.1,12411,2764,9647,3.5,15.9,15461,6058,9403,7.8,19.8,-3050,-3.9,31.8,0,413,422,4059
1991,49,h) 11 to 15,3304,3891,54557,54583,212,5.4,324,8.2,9150,3167,5983,5.8,16.8,9201,2530,6671,4.6,16.9,-51,-0.1,33.6,0,207,209,1687
1991,49,l) Left Censored,6639,10994,336907,330807,691,6.2,831,7.5,49215,14077,35138,4.3,14.9,37015,9329,27686,2.8,11.2,12200,3.7,22.4,0,270,276,2551
1991,50,a) 0,1359,1369,6363,3205,1351,197.4,0,0,6316,6316,0,197.1,197.1,0,0,0,0,0,6316,197.1,0,0,,,
1991,50,b) 1,1304,1322,6978,7002,12,0.8,256,17.6,1878,81,1797,1.2,26.8,1925,753,1172,10.8,27.5,-47,-0.7,53.6,0,172,172,548
1991,50,c) 2,1295,1314,7694,8392,40,2.8,259,18.2,1220,175,1045,2.1,14.5,2616,1426,1190,17,31.2,-1396,-16.7,29,0,188,188,1069
1991,50,d) 3,1059,1069,6497,7198,35,3,226,19.3,994,185,809,2.6,13.8,2395,1190,1205,16.5,33.3,-1401,-19.5,27.6,0,147,147,675
1991,50,e) 4,986,1012,8171,8644,29,2.6,192,17.5,943,326,617,3.8,10.9,1888,857,1031,9.9,21.8,-945,-10.9,21.8,0,151,151,695
1991,50,f) 5,925,948,6852,7244,26,2.6,134,13.4,866,123,743,1.7,12,1649,521,1128,7.2,22.8,-783,-10.8,24,0,90,90,361
1991,50,g) 6 to 10,3021,3212,25543,27081,94,2.8,290,8.8,2637,503,2134,1.9,9.7,5712,1629,4083,6,21.1,-3075,-11.4,19.4,0,192,193,1278
1991,50,h) 11 to 15,1622,1832,20026,20951,51,2.7,162,8.6,2140,495,1645,2.4,10.2,3989,1029,2960,4.9,19,-1849,-8.8,20.4,0,100,100,597
1991,50,l) Left Censored,3661,5129,117487,120878,220,4.3,313,6.1,9624,3009,6615,2.5,8,16405,3757,12648,3.1,13.6,-6781,-5.6,16,0,152,156,1671
1991,51,a) 0,11024,11136,58866,29678,11069,198.8,0,0,58376,58376,0,196.7,196.7,0,0,0,0,0,58376,196.7,0,0,,,
1991,51,b) 1,9376,9535,62291,63634,110,1,2401,22.3,18447,3243,15204,5.1,29,21132,10954,10178,17.2,33.2,-2685,-4.2,58,0,1687,1689,8067
1991,51,c) 2,7902,8125,63723,68998,274,3.1,1772,19.9,10841,1316,9525,1.9,15.7,21390,10723,10667,15.5,31,-10549,-15.3,31.4,0,1293,1294,7729
1991,51,d) 3,7069,7361,62527,67827,305,3.9,1401,17.7,9749,2221,7528,3.3,14.4,20348,9479,10869,14,30,-10599,-15.6,28.8,0,1043,1044,7861
1991,51,e) 4,6355,6727,67549,72457,263,3.7,1210,16.8,8313,1533,6780,2.1,11.5,18128,8237,9891,11.4,25,-9815,-13.5,23,0,883,893,6031
1991,51,f) 5,5982,6355,60809,63962,236,3.5,939,14,9957,2046,7911,3.2,15.6,16262,5923,10339,9.3,25.4,-6305,-9.8,31.2,0,673,681,4268
1991,51,g) 6 to 10,20376,22496,265669,278921,968,4.2,2443,10.5,36980,11004,25976,3.9,13.3,63483,18681,44802,6.7,22.8,-26503,-9.5,26.6,0,1562,1582,12444
1991,51,h) 11 to 15,11232,14018,186852,194699,700,4.9,1221,8.5,23897,7800,16097,4,12.3,39590,10053,29537,5.2,20.3,-15693,-8,24.6,0,664,673,4065
1991,51,l) Left Censored,25460,48344,1394363,1426141,2915,6,3643,7.5,154772,57859,96913,4.1,10.9,218328,59928,158400,4.2,15.3,-63556,-4.4,21.8,0,1221,1285,12246
1991,53,a) 0,11918,12055,61308,30762,11951,198.3,0,0,61093,61093,0,198.6,198.6,0,0,0,0,0,61093,198.6,0,0,,,
1991,53,b) 1,10611,10798,73761,72445,96,0.8,2461,20.3,22530,1737,20793,2.4,31.1,19898,9899,9999,13.7,27.5,2632,3.6,55,0,1636,1636,7165
1991,53,c) 2,6222,6397,51781,54997,240,3.5,1089,15.9,10793,1295,9498,2.4,19.6,17225,7310,9915,13.3,31.3,-6432,-11.7,39.2,0,784,787,5398
1991,53,d) 3,6425,6640,56677,58452,318,4.6,980,14.1,10938,1685,9253,2.9,18.7,14488,6184,8304,10.6,24.8,-3550,-6.1,37.4,0,724,724,5176
1991,53,e) 4,5830,6159,68073,71127,261,4,898,13.9,9242,1777,7465,2.5,13,15350,5293,10057,7.4,21.6,-6108,-8.6,26,0,617,632,3814
1991,53,f) 5,5272,5601,49762,51939,241,4.1,766,13.1,8600,1798,6802,3.5,16.6,12953,4873,8080,9.4,24.9,-4353,-8.3,33.2,0,560,563,3560
1991,53,g) 6 to 10,19321,21279,240904,244423,1031,4.7,2180,10,41229,9866,31363,4,16.9,48266,15699,32567,6.4,19.7,-7037,-2.8,33.8,0,1461,1474,10640
1991,53,h) 11 to 15,11704,13848,166784,169581,758,5.4,1170,8.3,25087,6816,18271,4,14.8,30680,7832,22848,4.6,18.1,-5593,-3.3,29.6,0,653,673,4197
1991,53,l) Left Censored,21039,35658,969400,973890,2351,6.6,2566,7.2,130226,35107,95119,3.6,13.4,139206,47229,91977,4.8,14.3,-8980,-0.9,26.8,0,1006,1026,8639
1991,54,a) 0,2607,2663,16362,8206,2642,198.4,0,0,16312,16312,0,198.8,198.8,0,0,0,0,0,16312,198.8,0,0,,,
1991,54,b) 1,2169,2183,15164,15048,18,0.7,487,20,4590,552,4038,3.7,30.5,4357,2099,2258,13.9,29,233,1.5,58,0,360,360,1563
1991,54,c) 2,1825,1872,16148,17465,61,3,310,15.5,2250,425,1825,2.4,12.9,4883,2204,2679,12.6,28,-2633,-15.1,25.8,0,237,239,1912
1991,54,d) 3,1589,1628,13053,13734,66,3.8,255,14.8,1921,338,1583,2.5,14,3282,1455,1827,10.6,23.9,-1361,-9.9,28,0,184,189,1219
1991,54,e) 4,1500,1567,15562,16408,54,3.3,230,13.9,2025,330,1695,2,12.3,3717,1884,1833,11.5,22.7,-1692,-10.4,24.6,0,170,171,1417
1991,54,f) 5,1341,1438,13558,13860,45,3,167,11.1,1997,241,1756,1.7,14.4,2600,1022,1578,7.4,18.8,-603,-4.4,28.8,0,126,126,852
1991,54,g) 6 to 10,5278,5739,64303,65970,210,3.6,529,9,7116,1910,5206,2.9,10.8,10449,3018,7431,4.6,15.8,-3333,-5,21.6,0,383,384,2344
1991,54,h) 11 to 15,3199,3849,40787,41187,200,5.1,292,7.5,5513,1481,4032,3.6,13.4,6312,1763,4549,4.3,15.3,-799,-1.9,26.8,0,169,169,990
1991,54,l) Left Censored,8813,13535,287779,289556,689,5,987,7.2,31759,11716,20043,4,11,35313,8603,26710,3,12.2,-3554,-1.2,22,0,423,435,3226
1991,55,a) 0,8200,8347,47297,23764,8279,198.4,0,0,47067,47067,0,198.1,198.1,0,0,0,0,0,47067,198.1,0,0,,,
1991,55,b) 1,6816,6997,49202,48580,107,1.4,1249,16.4,13524,2123,11401,4.4,27.8,12279,5271,7008,10.9,25.3,1245,2.5,50.6,0,865,865,4227
1991,55,c) 2,6069,6203,44840,47044,170,2.6,911,13.9,8120,1107,7013,2.4,17.3,12528,5325,7203,11.3,26.6,-4408,-9.3,34.6,0,686,694,4272
1991,55,d) 3,5297,5420,44551,46680,155,2.7,655,11.6,7031,1411,5620,3,15.1,11289,5085,6204,10.9,24.2,-4258,-9.1,30.2,0,520,520,4348
1991,55,e) 4,5296,5745,66899,68197,229,3.8,684,11.5,8274,1555,6719,2.3,12.1,10870,4390,6480,6.4,15.9,-2596,-3.8,24.2,0,513,521,3349
1991,55,f) 5,4459,4663,49765,51936,129,2.7,481,9.9,6919,1496,5423,2.9,13.3,11260,5338,5922,10.3,21.7,-4341,-8.4,26.6,0,379,384,3471
1991,55,g) 6 to 10,16840,18552,204600,208381,696,3.7,1592,8.4,27578,6812,20766,3.3,13.2,35140,13005,22135,6.2,16.9,-7562,-3.7,26.4,0,1129,1143,7317
1991,55,h) 11 to 15,10786,12848,166203,164905,588,4.5,1029,7.9,24460,4686,19774,2.8,14.8,21863,6149,15714,3.7,13.3,2597,1.5,26.6,0,636,660,3816
1991,55,l) Left Censored,28287,42617,1263865,1271784,2076,4.8,2636,6.1,120885,37090,83795,2.9,9.5,136723,31650,105073,2.5,10.8,-15838,-1.3,19,0,1294,1326,12464
1991,56,a) 0,1110,1114,4870,2447,1103,198,0,0,4846,,,,198,0,0,0,0,0,4846,198,0,1,,,
1991,56,b) 1,844,850,4752,4602,7,0.7,168,17.8,1356,,,,29.5,1055,536,519,11.6,22.9,301,6.6,45.8,1,111,111,421
1991,56,c) 2,678,702,4895,5085,29,3.9,109,14.7,1059,146,913,2.9,20.8,1438,498,940,9.8,28.3,-379,-7.5,41.6,0,86,86,442
1991,56,d) 3,608,618,4394,4515,21,3.2,92,14.1,783,178,605,3.9,17.3,1025,437,588,9.7,22.7,-242,-5.4,34.6,0,63,63,303
1991,56,e) 4,552,580,5566,5517,28,4.7,70,11.6,962,187,775,3.4,17.4,864,322,542,5.8,15.7,98,1.7,31.4,0,52,52,226
1991,56,f) 5,544,557,3568,3653,26,4.5,74,12.8,694,168,526,4.6,19,863,455,408,12.5,23.6,-169,-4.6,38,0,57,57,376
1991,56,g) 6 to 10,2422,2639,21436,21385,119,4.4,278,10.3,3518,671,2847,3.1,16.5,3415,1110,2305,5.2,16,103,0.5,32,0,199,199,874
1991,56,h) 11 to 15,1603,1841,17088,17481,101,5.4,137,7.4,2622,593,2029,3.4,15,3407,806,2601,4.6,19.5,-785,-4.5,30,0,79,82,505
1991,56,l) Left Censored,2866,4113,68206,67354,247,6,251,6.1,8688,2367,6321,3.5,12.9,6983,1587,5396,2.4,10.4,1705,2.5,20.8,0,112,112,719
1992,01,a) 0,6720,6863,41391,21609,6845,199.5,0,0,39565,39565,0,183.1,183.1,0,0,0,0,0,39565,183.1,0,0,,,
1992,01,b) 1,4990,5125,37427,37472,63,1.1,1368,23.4,11791,1166,10625,3.1,31.5,11880,6811,5069,18.2,31.7,-89,-0.2,63,0,1112,1112,5683
1992,01,c) 2,4463,4618,37174,38242,236,4.7,911,18.3,8049,1553,6496,4.1,21,10184,5157,5027,13.5,26.6,-2135,-5.6,42,0,766,766,4444
1992,01,d) 3,3885,4055,34828,35992,189,4.4,651,15.1,6938,1313,5625,3.6,19.3,9266,4177,5089,11.6,25.7,-2328,-6.4,38.6,0,546,546,3364
1992,01,e) 4,3454,3637,39505,38964,168,4.4,523,13.6,8034,989,7045,2.5,20.6,6952,3244,3708,8.3,17.8,1082,2.8,35.6,0,407,407,2554
1992,01,f) 5,3338,3605,47030,47173,157,4.1,517,13.6,7762,2311,5451,4.9,16.5,8047,3115,4932,6.6,17.1,-285,-0.6,33,0,381,414,2171
1992,01,g) 6 to 10,12552,13650,148322,149635,564,4,1387,9.8,25473,4719,20754,3.2,17,28099,9994,18105,6.7,18.8,-2626,-1.8,34,0,987,995,6828
1992,01,h) 11 to 15,8774,11004,171926,175130,517,4.6,886,7.9,22826,4611,18215,2.6,13,29233,6621,22612,3.8,16.7,-6407,-3.7,26,0,536,552,3364
1992,01,l) Left Censored,15742,27726,800230,802187,1324,4.7,1972,7,90181,20200,69981,2.5,11.2,94095,27974,66121,3.5,11.7,-3914,-0.5,22.4,0,759,782,9026
1992,02,a) 0,1189,1225,5048,2527,1222,199.5,0,0,5043,5043,0,199.6,199.6,0,0,0,0,0,5043,199.6,0,0,,,
1992,02,b) 1,993,1016,5685,5498,12,1,269,23.2,2126,348,1778,6.3,38.7,1752,847,905,15.4,31.9,374,6.8,63.8,0,200,200,675
1992,02,c) 2,889,907,5771,5820,55,5.6,188,19.2,1913,502,1411,8.6,32.9,2010,1089,921,18.7,34.5,-97,-1.6,65.8,0,141,141,912
1992,02,d) 3,576,590,4661,4769,27,4.3,100,15.9,1090,122,968,2.6,22.9,1305,631,674,13.2,27.4,-215,-4.5,45.8,0,68,68,463
1992,02,e) 4,593,642,6165,6469,30,4.4,84,12.5,1383,126,1257,1.9,21.4,1991,452,1539,7,30.8,-608,-9.4,42.8,0,67,67,387
1992,02,f) 5,585,623,8077,8104,36,5.5,94,14.4,2056,142,1914,1.8,25.4,2109,621,1488,7.7,26,-53,-0.6,50.8,0,57,61,468
1992,02,g) 6 to 10,2525,2812,24250,24814,175,6.1,297,10.3,4916,1284,3632,5.2,19.8,6043,2398,3645,9.7,24.4,-1127,-4.6,39.6,0,188,191,1565
1992,02,h) 11 to 15,1548,1926,22263,22129,140,7.2,144,7.4,4305,1213,3092,5.5,19.5,4037,1040,2997,4.7,18.2,268,1.3,36.4,0,69,73,309
1992,02,l) Left Censored,1981,3490,82496,81922,271,7.8,243,7,13176,3621,9555,4.4,16.1,12028,2421,9607,3,14.7,1148,1.4,29.4,0,56,59,684
1992,04,a) 0,7873,8020,49955,25004,8001,199.5,0,0,49903,49903,0,199.6,199.6,0,0,0,0,0,49903,199.6,0,0,,,
1992,04,b) 1,6008,6152,48962,48228,83,1.2,1811,25.5,17428,3807,13621,7.9,36.1,15960,9837,6123,20.4,33.1,1468,3,66.2,0,1432,1432,8385
1992,04,c) 2,5087,5222,43830,53792,253,4.4,1177,20.5,12193,1429,10764,2.7,22.7,32116,26447,5669,49.2,59.7,-19923,-37,45.4,0,983,984,5413
1992,04,d) 3,4425,4621,44264,46216,227,4.6,898,18,9116,2097,7019,4.5,19.7,13021,7151,5870,15.5,28.2,-3905,-8.5,39.4,0,693,703,5624
1992,04,e) 4,3803,4036,36274,38344,209,4.9,662,15.4,6970,1045,5925,2.7,18.2,11109,5467,5642,14.3,29,-4139,-10.8,36.4,0,524,527,4457
1992,04,f) 5,3674,4013,55538,54501,175,4.1,615,14.5,11246,1168,10078,2.1,20.6,9172,3809,5363,7,16.8,2074,3.8,33.6,0,448,459,3186
1992,04,g) 6 to 10,13401,15129,186545,189675,777,5,1814,11.6,30047,6048,23999,3.2,15.8,36307,11952,24355,6.3,19.1,-6260,-3.3,31.6,0,1188,1220,7786
1992,04,h) 11 to 15,8306,10250,146278,145916,541,5.2,994,9.5,24207,4669,19538,3.2,16.6,23483,6865,16618,4.7,16.1,724,0.5,32.2,0,499,512,3285
1992,04,l) Left Censored,10552,21416,638183,646376,1419,6.5,2069,9.5,85468,29360,56108,4.5,13.2,101855,27198,74657,4.2,15.8,-16387,-2.6,26.4,0,490,597,4888
1992,05,a) 0,4398,4477,25641,13028,4458,199.2,0,0,25226,25226,0,193.6,193.6,0,0,0,0,0,25226,193.6,0,0,,,
1992,05,b) 1,3170,3256,22998,22849,42,1.1,944,25.2,7445,784,6661,3.4,32.6,7146,3898,3248,17.1,31.3,299,1.3,62.6,0,764,764,2998
1992,05,c) 2,2806,2902,21231,23351,127,4,598,18.9,4974,929,4045,4,21.3,9213,3398,5815,14.6,39.5,-4239,-18.2,42.6,0,504,505,3046
1992,05,d) 3,2302,2355,20607,22128,92,3.6,418,16.6,4573,699,3874,3.2,20.7,7615,5075,2540,22.9,34.4,-3042,-13.7,41.4,0,327,327,2258
1992,05,e) 4,1970,2045,20811,20310,78,3.6,332,15.2,4859,541,4318,2.7,23.9,3856,1844,2012,9.1,19,1003,4.9,38,0,266,266,1404
1992,05,f) 5,2043,2204,21890,23580,106,4.6,276,12,3461,626,2835,2.7,14.7,6840,2028,4812,8.6,29,-3379,-14.3,29.4,0,200,201,1295
1992,05,g) 6 to 10,8044,8647,81778,82789,348,3.9,862,9.7,12796,2272,10524,2.7,15.5,14817,5143,9674,6.2,17.9,-2021,-2.4,31,0,630,638,3768
1992,05,h) 11 to 15,6211,7221,89446,88902,293,4,608,8.2,14249,1964,12285,2.2,16,13160,4164,8996,4.7,14.8,1089,1.2,29.6,0,382,394,2371
1992,05,l) Left Censored,10216,16381,479088,476133,810,4.9,1162,7,55510,11645,43865,2.4,11.7,49600,12556,37044,2.6,10.4,5910,1.3,20.8,0,485,519,4158
1992,06,a) 0,57973,59132,413240,206910,58945,199.4,0,0,412660,412660,0,199.4,199.4,0,0,0,0,0,412660,199.4,0,0,,,
1992,06,b) 1,46192,47511,352966,361779,625,1.1,14961,26.9,110457,11481,98976,3.2,30.5,128083,70597,57486,19.5,35.4,-17626,-4.9,61,0,11813,11827,58438
1992,06,c) 2,41412,42746,342496,364401,2169,4.6,10122,21.4,82772,12438,70334,3.4,22.7,126582,64898,61684,17.8,34.7,-43810,-12,45.4,0,7939,7951,53940
1992,06,d) 3,35676,37106,330138,342204,1760,4.4,7084,17.7,75306,12848,62458,3.8,22,99437,48954,50483,14.3,29.1,-24131,-7.1,44,0,5541,5582,39794
1992,06,e) 4,31540,33292,314941,330126,1559,4.4,5788,16.2,61043,9798,51245,3,18.5,91412,42533,48879,12.9,27.7,-30369,-9.2,37,0,4336,4357,32692
1992,06,f) 5,30186,32270,437981,440437,1500,4.4,5139,15,90344,30464,59880,6.9,20.5,95255,36510,58745,8.3,21.6,-4911,-1.1,41,0,3607,3649,27207
1992,06,g) 6 to 10,109302,121356,1486750,1538607,5628,4.4,14947,11.8,241181,48239,192942,3.1,15.7,344894,124658,220236,8.1,22.4,-103713,-6.7,31.4,0,9926,10127,85540
1992,06,h) 11 to 15,78878,96289,1319643,1381017,4905,4.9,10096,10.2,204628,57748,146880,4.2,14.8,327376,129758,197618,9.4,23.7,-122748,-8.9,29.6,0,5706,5892,85475
1992,06,l) Left Censored,98521,186830,5602454,5766623,10312,5.4,17028,8.9,702245,217587,484658,3.8,12.2,1030584,279196,751388,4.8,17.9,-328339,-5.7,24.4,0,5813,6286,53719
1992,08,a) 0,9062,9152,49306,24685,9126,199.4,0,0,49242,49242,0,199.5,199.5,0,0,0,0,0,49242,199.5,0,0,,,
1992,08,b) 1,6965,7122,46142,46034,103,1.3,1833,22.7,14504,2671,11833,5.8,31.5,14288,8586,5702,18.7,31,216,0.5,62,0,1403,1403,7184
1992,08,c) 2,5529,5678,41075,43836,248,4,1269,20.4,10192,1519,8673,3.5,23.3,15713,9664,6049,22,35.8,-5521,-12.5,46.6,0,998,1006,8720
1992,08,d) 3,4827,5004,42927,44310,234,4.4,874,16.3,9128,1725,7403,3.9,20.6,11893,5984,5909,13.5,26.8,-2765,-6.2,41.2,0,669,678,4794
1992,08,e) 4,4236,4427,41016,40590,201,4.3,647,13.9,9111,2394,6717,5.9,22.4,8258,4202,4056,10.4,20.3,853,2.1,40.6,0,484,485,3449
1992,08,f) 5,3939,4208,47476,48001,208,4.7,548,12.5,8413,1548,6865,3.2,17.5,9463,4087,5376,8.5,19.7,-1050,-2.2,35,0,400,412,3091
1992,08,g) 6 to 10,14875,16393,196365,196812,756,4.5,1794,10.6,36645,9711,26934,4.9,18.6,37539,17811,19728,9,19.1,-894,-0.5,37.2,0,1232,1250,8999
1992,08,h) 11 to 15,10547,12555,150153,149286,665,5.2,1182,9.2,25195,5737,19458,3.8,16.9,23460,7724,15736,5.2,15.7,1735,1.2,31.4,0,647,664,4004
1992,08,l) Left Censored,14114,24626,701047,699364,1442,5.8,2164,8.6,92109,26005,66104,3.7,13.2,88743,26625,62118,3.8,12.7,3366,0.5,25.4,0,666,714,4762
1992,09,a) 0,5389,5485,30913,15539,5467,199.3,0,0,30748,30748,0,197.9,197.9,0,0,0,0,0,30748,197.9,0,0,,,
1992,09,b) 1,4361,4450,31683,32504,53,1.1,1141,22.6,8168,665,7503,2,25.1,9809,5466,4343,16.8,30.2,-1641,-5.1,50.2,0,880,880,4332
1992,09,c) 2,4227,4320,28774,30420,187,4,903,19.1,5823,933,4890,3.1,19.1,9115,4099,5016,13.5,30,-3292,-10.9,38.2,0,714,714,3295
1992,09,d) 3,4227,4376,30089,31862,199,4.2,802,17.1,5706,769,4937,2.4,17.9,9251,5077,4174,15.9,29,-3545,-11.1,35.8,0,630,633,4357
1992,09,e) 4,3878,4020,39237,39239,179,4.2,678,15.8,7859,1186,6673,3,20,7862,3596,4266,9.2,20,-3,0,40,0,534,535,2677
1992,09,f) 5,3672,3821,40072,43319,147,3.6,596,14.6,4989,647,4342,1.5,11.5,11483,4037,7446,9.3,26.5,-6494,-15,23,0,435,435,2855
1992,09,g) 6 to 10,12994,13780,130697,133964,554,3.9,1627,11.3,21337,5945,15392,4.4,15.9,27871,11480,16391,8.6,20.8,-6534,-4.9,31.8,0,1102,1115,8104
1992,09,h) 11 to 15,9028,10408,120913,124210,377,3.5,1017,9.4,15081,2948,12133,2.4,12.1,21674,6402,15272,5.2,17.4,-6593,-5.3,24.2,0,611,614,3159
1992,09,l) Left Censored,19577,28973,953364,972651,1269,4.3,2383,8.1,97860,24190,73670,2.5,10.1,136433,32157,104276,3.3,14,-38573,-3.9,20.2,0,931,990,7861
1992,10,a) 0,1385,1408,7081,3545,1406,199.7,0,0,7072,7072,0,199.5,199.5,0,0,0,0,0,7072,199.5,0,0,,,
1992,10,b) 1,1126,1159,7465,7294,51,4,268,20.8,2437,828,1609,11.4,33.4,2094,1125,969,15.4,28.7,343,4.7,57.4,0,196,196,869
1992,10,c) 2,970,993,6356,6544,51,4.7,204,19,1409,210,1199,3.2,21.5,1785,974,811,14.9,27.3,-376,-5.8,43,0,154,154,744
1992,10,d) 3,912,928,7064,7500,36,3.6,149,15.1,1111,151,960,2,14.8,1982,943,1039,12.6,26.4,-871,-11.6,29.6,0,108,108,764
1992,10,e) 4,726,740,6993,7268,28,3.5,123,15.5,1293,325,968,4.5,17.8,1843,672,1171,9.2,25.4,-550,-7.6,35.6,0,95,95,491
1992,10,f) 5,736,771,7893,8233,36,4.5,98,12.2,1233,208,1025,2.5,15,1912,731,1181,8.9,23.2,-679,-8.2,30,0,76,76,599
1992,10,g) 6 to 10,2523,2714,27331,28224,138,4.9,275,9.8,3708,809,2899,2.9,13.1,5493,2046,3447,7.2,19.5,-1785,-6.4,26.2,0,184,185,1034
1992,10,h) 11 to 15,1739,2049,36032,37428,92,4.4,185,8.8,6858,1236,5622,3.3,18.3,9650,5732,3918,15.3,25.8,-2792,-7.5,36.6,0,106,111,724
1992,10,l) Left Censored,3918,6121,195373,200331,447,7.2,570,9.2,19414,6005,13409,3,9.7,29330,8517,20813,4.3,14.6,-9916,-4.9,19.4,0,159,159,980
1992,11,a) 0,1111,1146,27481,13744,1143,199.5,0,0,27475,27475,0,199.9,199.9,0,0,0,0,0,27475,199.9,0,0,,,
1992,11,b) 1,879,888,6391,6639,13,1.3,184,18.7,1699,127,1572,1.9,25.6,2194,947,1247,14.3,33,-495,-7.4,51.2,0,138,138,670
1992,11,c) 2,789,821,7618,7624,37,4.2,132,15,1704,282,1422,3.7,22.4,1716,890,826,11.7,22.5,-12,-0.1,44.8,0,101,101,677
1992,11,d) 3,747,783,8887,8776,37,4.5,122,14.7,2238,131,2107,1.5,25.5,2015,791,1224,9,23,223,2.5,46,0,93,94,676
1992,11,e) 4,700,740,11369,11212,50,6.5,99,12.9,1683,266,1417,2.4,15,1369,532,837,4.7,12.2,314,2.8,24.4,0,76,76,413
1992,11,f) 5,631,663,6170,6318,35,5,106,15.1,1291,182,1109,2.9,20.4,1586,740,846,11.7,25.1,-295,-4.7,40.8,0,80,80,634
1992,11,g) 6 to 10,2830,3005,38176,39341,127,4.1,326,10.5,4984,871,4113,2.2,12.7,7314,2410,4904,6.1,18.6,-2330,-5.9,25.4,0,210,213,1740
1992,11,h) 11 to 15,2043,2393,68416,69081,115,4.7,210,8.6,5999,1126,4873,1.6,8.7,7328,1916,5412,2.8,10.6,-1329,-1.9,17.4,0,111,112,840
1992,11,l) Left Censored,4909,7273,227683,232224,428,5.8,605,8.2,25633,5711,19922,2.5,11,34714,8416,26298,3.6,14.9,-9081,-3.9,22,0,192,201,2468
1992,12,a) 0,36357,36862,198146,100098,36761,199.5,0,0,196097,196097,0,195.9,195.9,0,0,0,0,0,196097,195.9,0,0,,,
1992,12,b) 1,26251,26854,179383,185739,289,0.9,7793,25.2,54127,6809,47318,3.7,29.1,66838,41120,25718,22.1,36,-12711,-6.9,58.2,0,6355,6361,34407
1992,12,c) 2,22807,23280,171126,180881,1126,4.4,5451,21.3,40695,6401,34294,3.5,22.5,60205,33205,27000,18.4,33.3,-19510,-10.8,45,0,4429,4439,28214
1992,12,d) 3,19091,19761,154721,159744,949,4.4,3910,18.3,33310,6771,26539,4.2,20.9,43355,21341,22014,13.4,27.1,-10045,-6.2,41.8,0,3170,3203,18161
1992,12,e) 4,16871,17989,155069,163343,752,3.9,3201,16.6,28478,4326,24152,2.6,17.4,45026,20478,24548,12.5,27.6,-16548,-10.2,34.8,0,2475,2487,15956
1992,12,f) 5,15101,16096,182889,189694,718,4.2,2456,14.4,32175,5225,26950,2.8,17,45785,22403,23382,11.8,24.1,-13610,-7.1,34,0,1805,1848,18837
1992,12,g) 6 to 10,52581,57504,620371,628968,2620,4.4,7160,11.9,111643,29503,82140,4.7,17.8,128837,52513,76324,8.3,20.5,-17194,-2.7,35.6,0,5093,5187,34427
1992,12,h) 11 to 15,32347,39596,499759,509427,2090,5.1,3939,9.7,78600,23133,55467,4.5,15.4,97937,33056,64881,6.5,19.2,-19337,-3.8,30.8,0,2319,2402,17412
1992,12,l) Left Censored,41734,86680,2394642,2423881,5104,5.8,8481,9.6,328900,105434,223466,4.3,13.6,387379,137409,249970,5.7,16,-58479,-2.4,27.2,0,2373,2618,19400
1992,13,a) 0,13463,13661,88125,44107,13620,199.4,0,0,88037,88037,0,199.6,199.6,0,0,0,0,0,88037,199.6,0,0,,,
1992,13,b) 1,9793,10037,81961,79410,159,1.4,2635,23.1,29562,5083,24479,6.4,37.2,24459,14665,9794,18.5,30.8,5103,6.4,61.6,0,2061,2061,12506
1992,13,c) 2,8260,8447,68831,71324,415,4.5,1901,20.5,16243,3140,13103,4.4,22.8,21228,13046,8182,18.3,29.8,-4985,-7,45.6,0,1577,1578,11432
1992,13,d) 3,7414,7733,63839,65669,384,4.6,1352,16.4,13142,2238,10904,3.4,20,16802,8603,8199,13.1,25.6,-3660,-5.6,40,0,1063,1075,7149
1992,13,e) 4,6287,6719,63713,67777,351,4.9,1163,16.2,13304,2490,10814,3.7,19.6,21432,13814,7618,20.4,31.6,-8128,-12,39.2,0,855,863,9012
1992,13,f) 5,5949,6380,87049,84405,298,4.4,985,14.6,19644,2219,17425,2.6,23.3,14356,6369,7987,7.5,17,5288,6.3,34,0,674,729,4294
1992,13,g) 6 to 10,22590,24716,266853,269741,1159,4.5,2848,11.1,44654,8998,35656,3.3,16.6,50429,18955,31474,7,18.7,-5775,-2.1,33.2,0,1917,1954,12706
1992,13,h) 11 to 15,14592,17781,245128,248370,1014,5.6,1574,8.7,40897,12275,28622,4.9,16.5,47381,18059,29322,7.3,19.1,-6484,-2.6,33,0,835,869,11516
1992,13,l) Left Censored,24700,48392,1538580,1545305,2713,5.5,4208,8.6,202829,55890,146939,3.6,13.1,216279,75952,140327,4.9,14,-13450,-0.9,26.2,0,1251,1337,10355
1992,15,a) 0,2031,2088,13428,6720,2081,199.3,0,0,13417,13417,0,199.7,199.7,0,0,0,0,0,13417,199.7,0,0,,,
1992,15,b) 1,1779,1824,16309,16028,30,1.5,472,22.9,5041,470,4571,2.9,31.5,4478,2550,1928,15.9,27.9,563,3.6,55.8,0,371,371,1866
1992,15,c) 2,1544,1617,14150,14426,61,3.5,300,17.2,3386,192,3194,1.3,23.5,3938,1818,2120,12.6,27.3,-552,-3.8,47,0,242,242,1493
1992,15,d) 3,1269,1341,14590,15909,65,4.5,250,17.3,2268,362,1906,2.3,14.3,4905,1521,3384,9.6,30.8,-2637,-16.5,28.6,0,205,210,1281
1992,15,e) 4,1228,1383,14860,14862,60,4.1,191,13.1,2992,1371,1621,9.2,20.1,2995,954,2041,6.4,20.2,-3,-0.1,40.2,0,133,133,703
1992,15,f) 5,1053,1161,16948,17762,50,4.1,148,12.2,2790,408,2382,2.3,15.7,4418,832,3586,4.7,24.9,-1628,-9.2,31.4,0,100,103,534
1992,15,g) 6 to 10,4017,4459,49052,49410,204,4.4,472,10.2,8389,1847,6542,3.7,17,9105,3849,5256,7.8,18.4,-716,-1.4,34,0,313,316,1958
1992,15,h) 11 to 15,3278,4270,59970,60674,174,4,346,7.9,7918,1168,6750,1.9,13.1,9325,2119,7206,3.5,15.4,-1407,-2.3,26.2,0,187,196,1171
1992,15,l) Left Censored,5265,9024,247706,246049,415,4.5,615,6.7,30662,6192,24470,2.5,12.5,27347,6839,20508,2.8,11.1,3315,1.4,22.2,0,205,217,1268
1992,16,a) 0,2504,2529,11814,5921,2519,199.2,0,0,11786,11786,0,199.1,199.1,0,0,0,0,0,11786,199.1,0,0,,,
1992,16,b) 1,1756,1782,11188,10962,28,1.4,430,21.4,3482,239,3243,2.2,31.8,3030,1848,1182,16.9,27.6,452,4.2,55.2,0,319,319,1298
1992,16,c) 2,1636,1672,11032,11627,80,4.4,325,17.9,2540,380,2160,3.3,21.8,3729,1894,1835,16.3,32.1,-1189,-10.3,43.6,0,241,241,1564
1992,16,d) 3,1224,1272,10012,10166,48,3.5,210,15.4,2351,433,1918,4.3,23.1,2658,1431,1227,14.1,26.1,-307,-3,46.2,0,164,164,1115
1992,16,e) 4,1090,1115,11403,11693,54,4.7,140,12.1,2274,623,1651,5.3,19.4,2854,1030,1824,8.8,24.4,-580,-5,38.8,0,110,110,875
1992,16,f) 5,993,1067,10515,10607,37,3.3,133,11.9,1887,181,1706,1.7,17.8,2070,857,1213,8.1,19.5,-183,-1.7,35.6,0,94,95,655
1992,16,g) 6 to 10,3988,4344,41833,41120,227,5.1,401,9,7787,1393,6394,3.4,18.9,6361,2447,3914,6,15.5,1426,3.4,31,0,288,288,1902
1992,16,h) 11 to 15,3110,3520,47320,44951,183,5.1,273,7.6,10914,5528,5386,12.3,24.3,6175,1597,4578,3.6,13.7,4739,10.6,27.4,0,161,173,904
1992,16,l) Left Censored,4715,7654,169714,168699,376,4.8,573,7.4,22175,6159,16016,3.7,13.1,20144,4873,15271,2.9,11.9,2031,1.2,23.8,0,214,221,1235
1992,17,a) 0,18799,19137,136874,68548,19076,199.4,0,0,136652,136652,0,199.4,199.4,0,0,0,0,0,136652,199.4,0,0,,,
1992,17,b) 1,14952,15374,122088,115382,243,1.4,3683,21.3,44949,6358,38591,5.5,39,31536,16347,15189,14.2,27.3,13413,11.7,54.6,0,2797,2797,12712
1992,17,c) 2,13521,13903,120596,123307,571,3.8,2406,16.1,27341,3205,24136,2.6,22.2,32762,16321,16441,13.2,26.6,-5421,-4.4,44.4,0,1899,1903,13036
1992,17,d) 3,11901,12321,98843,102487,526,4,1926,14.7,19225,3105,16120,3,18.8,26513,11842,14671,11.6,25.9,-7288,-7.1,37.6,0,1509,1512,9385
1992,17,e) 4,10617,11004,112375,113045,487,4.2,1462,12.7,27545,10971,16574,9.7,24.4,28885,10426,18459,9.2,25.6,-1340,-1.2,48.8,0,1121,1128,8589
1992,17,f) 5,10316,10936,144955,150479,396,3.5,1301,11.4,19708,1821,17887,1.2,13.1,30756,13197,17559,8.8,20.4,-11048,-7.3,26.2,0,901,915,9645
1992,17,g) 6 to 10,39006,42311,514965,518747,1569,3.6,4128,9.4,76143,13434,62709,2.6,14.7,83707,28417,55290,5.5,16.1,-7564,-1.4,29.4,0,2736,2792,18059
1992,17,h) 11 to 15,27888,32999,469631,477751,1330,3.9,2674,7.9,65781,13621,52160,2.9,13.8,82021,21361,60660,4.5,17.2,-16240,-3.4,27.6,0,1501,1540,12344
1992,17,l) Left Censored,55758,89920,2884861,2909539,4385,4.8,6963,7.6,338610,85371,253239,2.9,11.6,387965,107609,280356,3.7,13.3,-49355,-1.7,23.2,0,2678,2809,25200
1992,18,a) 0,8962,9143,52510,26285,9118,199.5,0,0,52450,52450,0,199.5,199.5,0,0,0,0,0,52450,199.5,0,0,,,
1992,18,b) 1,7213,7477,54067,54011,138,1.7,1670,20,16139,2739,13400,5.1,29.9,16027,8368,7659,15.5,29.7,112,0.2,59.4,0,1308,1309,6769
1992,18,c) 2,6318,6557,51269,54695,273,3.8,1259,17.7,10980,2376,8604,4.3,20.1,17831,10326,7505,18.9,32.6,-6851,-12.5,40.2,0,1004,1006,8435
1992,18,d) 3,5597,5904,56829,57835,273,4.4,902,14.5,11562,2309,9253,4,20,13573,6386,7187,11,23.5,-2011,-3.5,40,0,730,730,5130
1992,18,e) 4,4669,4885,54511,53948,210,4.1,694,13.5,11375,1220,10155,2.3,21.1,10249,4749,5500,8.8,19,1126,2.1,38,0,549,552,4023
1992,18,f) 5,4608,4944,58345,59347,204,4,601,11.6,8870,1674,7196,2.8,14.9,10874,3848,7026,6.5,18.3,-2004,-3.4,29.8,0,439,443,2947
1992,18,g) 6 to 10,18338,19992,217597,220478,685,3.3,1846,8.9,31868,5739,26129,2.6,14.5,37629,14803,22826,6.7,17.1,-5761,-2.6,29,0,1326,1341,10054
1992,18,h) 11 to 15,12773,15560,215820,217143,673,4.2,1184,7.5,28920,6608,22312,3,13.3,31565,8832,22733,4.1,14.5,-2645,-1.2,26.6,0,713,734,4497
1992,18,l) Left Censored,26250,45069,1393591,1386716,2069,4.5,3083,6.8,173081,53952,119129,3.9,12.5,159332,41364,117968,3,11.5,13749,1,23,0,1213,1293,10118
1992,19,a) 0,4697,4765,29694,14864,4747,199.2,0,0,29660,29660,0,199.5,199.5,0,0,0,0,0,29660,199.5,0,0,,,
1992,19,b) 1,3640,3723,26656,25359,50,1.2,818,19.7,9146,1804,7342,7.1,36.1,6552,3556,2996,14,25.8,2594,10.3,51.6,0,627,627,2882
1992,19,c) 2,3265,3342,22345,23851,118,3.3,584,16.2,4409,645,3764,2.7,18.5,7421,4644,2777,19.5,31.1,-3012,-12.6,37,0,473,473,4123
1992,19,d) 3,2868,3007,22805,23342,110,3.5,430,13.5,4424,1164,3260,5,19,5498,2350,3148,10.1,23.6,-1074,-4.6,38,0,335,337,1827
1992,19,e) 4,2460,2528,22183,21822,85,3.2,326,12.2,4877,1173,3704,5.4,22.3,4155,1827,2328,8.4,19,722,3.3,38,0,249,251,1386
1992,19,f) 5,2423,2669,37805,38518,101,3.6,291,10.5,4217,766,3451,2,10.9,5642,1454,4188,3.8,14.6,-1425,-3.7,21.8,0,223,225,1137
1992,19,g) 6 to 10,10006,10909,106519,108134,382,3.4,958,8.5,14748,2724,12024,2.5,13.6,17978,6155,11823,5.7,16.6,-3230,-3,27.2,0,689,700,4445
1992,19,h) 11 to 15,8421,10346,109513,110497,402,3.8,806,7.6,13391,2378,11013,2.2,12.1,15358,5343,10015,4.8,13.9,-1967,-1.8,24.2,0,486,499,3595
1992,19,l) Left Censored,17426,26895,649269,656897,1064,3.9,1719,6.3,71142,16952,54190,2.6,10.8,86398,22136,64262,3.4,13.2,-15256,-2.4,21.6,0,739,763,5146
1992,20,a) 0,4666,4753,26076,13064,4734,199.2,0,0,26025,26025,0,199.2,199.2,0,0,0,0,0,26025,199.2,0,0,,,
1992,20,b) 1,3554,3646,23779,24048,54,1.3,949,22.9,7090,1145,5945,4.8,29.5,7627,4391,3236,18.3,31.7,-537,-2.2,59,0,763,764,3677
1992,20,c) 2,3035,3120,22413,23957,129,3.8,594,17.6,4864,826,4038,3.4,20.3,7951,4164,3787,17.4,33.2,-3087,-12.9,40.6,0,490,490,3433
1992,20,d) 3,2750,2855,22638,23099,133,4.4,423,14,4437,722,3715,3.1,19.2,5358,2626,2732,11.4,23.2,-921,-4,38.4,0,354,355,2246
1992,20,e) 4,2346,2479,21857,22124,101,3.9,350,13.4,3753,658,3095,3,17,4286,2122,2164,9.6,19.4,-533,-2.4,34,0,268,268,1732
1992,20,f) 5,2286,2401,32418,32390,109,4.4,304,12.1,4745,943,3802,2.9,14.6,4689,2438,2251,7.5,14.5,56,0.1,29,0,223,223,1963
1992,20,g) 6 to 10,9537,10227,90689,93891,392,3.7,974,9.2,13624,2938,10686,3.1,14.5,20027,7970,12057,8.5,21.3,-6403,-6.8,29,0,686,701,6351
1992,20,h) 11 to 15,7098,8601,104249,104474,406,4.6,709,8.1,16619,4133,12486,4,15.9,17068,5983,11085,5.7,16.3,-449,-0.4,31.8,0,381,397,2292
1992,20,l) Left Censored,14121,22151,543001,546251,1051,4.7,1636,7.3,58946,15649,43297,2.9,10.8,65445,16444,49001,3,12,-6499,-1.2,21.6,0,666,695,5025
1992,21,a) 0,5999,6104,33364,16700,6087,199.4,0,0,33329,33329,0,199.6,199.6,0,0,0,0,0,33329,199.6,0,0,,,
1992,21,b) 1,4413,4487,33129,33231,51,1,1235,24,9805,1395,8410,4.2,29.5,10008,6142,3866,18.5,30.1,-203,-0.6,59,0,1028,1031,5451
1992,21,c) 2,4127,4246,34154,35417,177,3.8,823,17.9,7514,1368,6146,3.9,21.2,10040,5058,4982,14.3,28.3,-2526,-7.1,42.4,0,694,694,4373
1992,21,d) 3,3647,3814,31715,33188,152,3.7,625,15.4,5615,902,4713,2.7,16.9,8560,4042,4518,12.2,25.8,-2945,-8.9,33.8,0,519,519,3244
1992,21,e) 4,3112,3270,29625,30177,136,4,442,12.9,5153,1164,3989,3.9,17.1,6257,2385,3872,7.9,20.7,-1104,-3.6,34.2,0,354,354,1986
1992,21,f) 5,2896,3046,42768,42926,107,3.3,426,13.3,7113,711,6402,1.7,16.6,7428,2700,4728,6.3,17.3,-315,-0.7,33.2,0,339,339,2268
1992,21,g) 6 to 10,11607,12536,136659,138189,435,3.4,1228,9.5,20849,3956,16893,2.9,15.1,23908,9740,14168,7,17.3,-3059,-2.2,30.2,0,891,900,7027
1992,21,h) 11 to 15,7628,9123,138339,138644,346,3.7,823,8.8,18283,3452,14831,2.5,13.2,18893,4744,14149,3.4,13.6,-610,-0.4,26.4,0,494,505,2754
1992,21,l) Left Censored,15610,26317,716923,721509,1213,4.5,1923,7.2,74070,17011,57059,2.4,10.3,83241,23821,59420,3.3,11.5,-9171,-1.2,20.6,0,795,832,6698
1992,22,a) 0,6474,6568,39294,19716,6549,199.4,0,0,39157,39157,0,198.6,198.6,0,0,0,0,0,39157,198.6,0,0,,,
1992,22,b) 1,4989,5147,44945,44688,72,1.2,1205,20.8,14452,943,13509,2.1,32.3,13938,7073,6865,15.8,31.2,514,1.1,62.4,0,971,971,5979
1992,22,c) 2,4163,4272,35698,37285,182,3.9,801,17.3,7952,980,6972,2.6,21.3,11125,5339,5786,14.3,29.8,-3173,-8.5,42.6,0,666,668,4687
1992,22,d) 3,3402,3499,31424,32166,142,3.8,543,14.6,7096,1163,5933,3.6,22.1,8579,3771,4808,11.7,26.7,-1483,-4.6,44.2,0,448,449,3229
1992,22,e) 4,3053,3305,34435,35857,141,4,469,13.4,5971,1287,4684,3.6,16.7,8814,4739,4075,13.2,24.6,-2843,-7.9,33.4,0,355,357,3591
1992,22,f) 5,2929,3158,43745,42688,138,4.2,414,12.5,10654,1015,9639,2.4,25,8540,3143,5397,7.4,20,2114,5,40,0,313,319,2430
1992,22,g) 6 to 10,13680,14863,161620,161856,595,3.9,1435,9.4,28850,6008,22842,3.7,17.8,29321,9761,19560,6,18.1,-471,-0.3,35.6,0,1042,1055,7686
1992,22,h) 11 to 15,10137,11928,164046,163078,523,4.3,989,8.1,28900,6736,22164,4.1,17.7,26963,7014,19949,4.3,16.5,1937,1.2,33,0,637,657,4795
1992,22,l) Left Censored,16988,29399,740681,747007,1512,5.1,2452,8.2,95226,23706,71520,3.2,12.7,107878,33464,74414,4.5,14.4,-12652,-1.7,25.4,0,860,945,7819
1992,23,a) 0,2273,2340,10680,5373,2328,199,0,0,10614,10614,0,197.5,197.5,0,0,0,0,0,10614,197.5,0,0,,,
1992,23,b) 1,1792,1844,10658,10550,25,1.2,477,22.8,3417,535,2882,5.1,32.4,3200,1710,1490,16.2,30.3,217,2.1,60.6,0,362,362,1372
1992,23,c) 2,1727,1754,11179,11785,61,3.2,333,17.5,2205,248,1957,2.1,18.7,3417,1568,1849,13.3,29,-1212,-10.3,37.4,0,250,250,1344
1992,23,d) 3,1780,1814,11439,12000,88,4.5,318,16.3,1920,312,1608,2.6,16,3041,1501,1540,12.5,25.3,-1121,-9.3,32,0,237,238,1215
1992,23,e) 4,1591,1620,10812,11250,63,3.6,261,15.1,1624,281,1343,2.5,14.4,2499,918,1581,8.2,22.2,-875,-7.8,28.8,0,177,177,632
1992,23,f) 5,1524,1607,14880,15261,64,3.8,210,12.4,2057,177,1880,1.2,13.5,2818,1210,1608,7.9,18.5,-761,-5,27,0,147,147,905
1992,23,g) 6 to 10,5015,5348,47859,49133,186,3.3,581,10.4,6411,972,5439,2,13,8958,3215,5743,6.5,18.2,-2547,-5.2,26,0,391,403,2142
1992,23,h) 11 to 15,3321,3984,44650,45344,182,4.5,302,7.4,5385,1020,4365,2.2,11.9,6773,1702,5071,3.8,14.9,-1388,-3,23.8,0,184,190,1037
1992,23,l) Left Censored,5954,9159,225270,230452,378,4,756,8.1,22446,6740,15706,2.9,9.7,32809,10872,21937,4.7,14.2,-10363,-4.5,19.4,0,306,326,2322
1992,24,a) 0,8207,8363,47453,23976,8343,199.5,0,0,46954,46954,0,195.8,195.8,0,0,0,0,0,46954,195.8,0,0,,,
1992,24,b) 1,6503,6648,47469,46540,87,1.2,1732,22.9,15033,1792,13241,3.9,32.3,13174,7632,5542,16.4,28.3,1859,4,56.6,0,1284,1284,6193
1992,24,c) 2,6092,6249,46480,48237,291,4.3,1207,17.9,10740,2326,8414,4.8,22.3,14253,7166,7087,14.9,29.5,-3513,-7.2,44.6,0,909,911,5401
1992,24,d) 3,5514,5667,44063,45615,274,4.6,923,15.3,8496,1391,7105,3,18.6,11599,5563,6036,12.2,25.4,-3103,-6.8,37.2,0,714,718,4591
1992,24,e) 4,4929,5120,46759,48466,222,4.1,769,14.2,7532,1719,5813,3.5,15.5,10946,4518,6428,9.3,22.6,-3414,-7.1,31,0,562,569,3607
1992,24,f) 5,4506,4795,56562,58370,205,4.1,668,13.2,8644,1494,7150,2.6,14.8,12259,4651,7608,8,21,-3615,-6.2,29.6,0,489,499,3686
1992,24,g) 6 to 10,16552,18116,198087,207318,745,4,1858,9.9,28313,5221,23092,2.5,13.7,46775,15636,31139,7.5,22.6,-18462,-8.9,27.4,0,1174,1188,10025
1992,24,h) 11 to 15,10368,12625,176398,178748,577,4.5,1098,8.5,25463,6233,19230,3.5,14.2,30163,9087,21076,5.1,16.9,-4700,-2.7,28.4,0,581,605,4409
1992,24,l) Left Censored,20115,35564,1048814,1066523,1957,5.4,2877,8,134336,40473,93863,3.8,12.6,169754,43116,126638,4,15.9,-35418,-3.3,25.2,0,896,981,8661
1992,25,a) 0,8993,9239,55074,27745,9215,199.5,0,0,54659,54659,0,197,197,0,0,0,0,0,54659,197,0,0,,,
1992,25,b) 1,7058,7246,53108,53060,76,0.9,1698,20.8,15506,1927,13579,3.6,29.2,15409,7446,7963,14,29,97,0.2,58,0,1295,1295,5758
1992,25,c) 2,6754,6953,56801,58904,325,4.3,1417,18.7,12901,2334,10567,4,21.9,17106,8879,8227,15.1,29,-4205,-7.1,43.8,0,1104,1107,7085
1992,25,d) 3,6816,7091,56600,57442,317,4.2,1256,16.5,11241,2031,9210,3.5,19.6,12924,6024,6900,10.5,22.5,-1683,-2.9,39.2,0,994,996,4862
1992,25,e) 4,6384,6686,72466,73690,299,4.2,1048,14.7,13110,2178,10932,3,17.8,15558,8758,6800,11.9,21.1,-2448,-3.3,35.6,0,803,805,6836
1992,25,f) 5,6102,6479,75129,77563,280,4.1,1008,14.7,10559,1508,9051,1.9,13.6,15427,7012,8415,9,19.9,-4868,-6.3,27.2,0,722,724,5330
1992,25,g) 6 to 10,22215,23797,271417,278433,993,4,2708,10.9,39568,7965,31603,2.9,14.2,53599,18519,35080,6.7,19.3,-14031,-5.1,28.4,0,1817,1835,13002
1992,25,h) 11 to 15,14703,17891,289792,291076,827,4.5,1679,9.1,41514,9484,32030,3.3,14.3,44081,15296,28785,5.3,15.1,-2567,-0.8,28.6,0,884,914,7063
1992,25,l) Left Censored,33459,51200,1615340,1641090,2373,4.5,4156,8,184426,53483,130943,3.3,11.2,235927,63579,172348,3.9,14.4,-51501,-3.2,22.4,0,1652,1750,16331
1992,26,a) 0,14261,14470,77675,38903,14432,199.5,0,0,77545,77545,0,199.3,199.3,0,0,0,0,0,77545,199.3,0,0,,,
1992,26,b) 1,11602,11908,84130,81186,154,1.2,2333,17.7,26193,4051,22142,5,32.3,20305,10061,10244,12.4,25,5888,7.3,50,0,1714,1714,8116
1992,26,c) 2,10730,11065,85267,86794,398,3.4,1579,13.4,18399,2246,16153,2.6,21.2,21452,10216,11236,11.8,24.7,-3053,-3.5,42.4,0,1162,1162,8545
1992,26,d) 3,9366,9691,77865,79295,327,3.2,1349,13.1,15267,2002,13265,2.5,19.3,18126,8154,9972,10.3,22.9,-2859,-3.6,38.6,0,986,988,6366
1992,26,e) 4,8249,8611,79116,82039,330,3.6,1181,13,13589,2212,11377,2.7,16.6,19434,10034,9400,12.2,23.7,-5845,-7.1,33.2,0,855,856,6297
1992,26,f) 5,8286,8789,99797,101053,317,3.4,1086,11.8,15599,1753,13846,1.7,15.4,18110,7833,10277,7.8,17.9,-2511,-2.5,30.8,0,792,798,6162
1992,26,g) 6 to 10,29305,32089,356140,359232,1155,3.5,3228,9.7,58839,10456,48383,2.9,16.4,65022,24758,40264,6.9,18.1,-6183,-1.7,32.8,0,2193,2233,18181
1992,26,h) 11 to 15,20841,25336,333956,333344,1004,3.9,2045,7.9,51044,11924,39120,3.6,15.3,49819,15192,34627,4.6,14.9,1225,0.4,29.8,0,1186,1231,7303
1992,26,l) Left Censored,39642,67438,2132936,2139176,3060,4.5,4851,7.1,243788,55096,188692,2.6,11.4,256267,64154,192113,3,12,-12479,-0.6,22.8,0,1790,1852,15039
1992,27,a) 0,8002,8134,43477,21754,8117,199.6,0,0,43447,43447,0,199.7,199.7,0,0,0,0,0,43447,199.7,0,0,,,
1992,27,b) 1,6438,6642,46146,45663,104,1.4,1501,20.2,13283,1750,11533,3.8,29.1,12316,6841,5475,15,27,967,2.1,54,0,1117,1117,5708
1992,27,c) 2,5649,5849,43175,45552,221,3.5,1020,16.2,8499,1095,7404,2.4,18.7,13253,7428,5825,16.3,29.1,-4754,-10.4,37.4,0,821,822,6334
1992,27,d) 3,4958,5123,40711,41682,171,3.1,768,14.1,7767,1083,6684,2.6,18.6,9709,4628,5081,11.1,23.3,-1942,-4.7,37.2,0,588,588,3556
1992,27,e) 4,4335,4529,38961,39497,149,3.1,642,13.4,7411,838,6573,2.1,18.8,8482,3878,4604,9.8,21.5,-1071,-2.7,37.6,0,490,500,3139
1992,27,f) 5,4057,4371,63016,62137,194,4.3,522,11.5,11506,1783,9723,2.9,18.5,9748,4317,5431,6.9,15.7,1758,2.8,31.4,0,385,390,3360
1992,27,g) 6 to 10,15888,17534,215691,214786,732,4.1,1689,9.4,34230,7849,26381,3.7,15.9,32419,11208,21211,5.2,15.1,1811,0.8,30.2,0,1149,1178,7905
1992,27,h) 11 to 15,11716,14205,199786,200111,601,4.1,1151,7.9,28551,5275,23276,2.6,14.3,29201,10149,19052,5.1,14.6,-650,-0.3,28.6,0,657,686,4585
1992,27,l) Left Censored,22708,36087,1152223,1151533,1776,4.9,2677,7.3,136337,34826,101511,3,11.8,134956,39127,95829,3.4,11.7,1381,0.1,23.4,0,997,1043,9470
1992,28,a) 0,3913,3981,19705,9878,3967,199.3,0,0,19655,19655,0,199,199,0,0,0,0,0,19655,199,0,0,,,
1992,28,b) 1,2972,3053,21994,22278,31,0.9,836,23.8,7006,1033,5973,4.6,31.4,7573,4556,3017,20.5,34,-567,-2.6,62.8,0,671,671,3796
1992,28,c) 2,2688,2758,20038,20626,141,4.7,544,18.2,4917,1089,3828,5.3,23.8,6092,2703,3389,13.1,29.5,-1175,-5.7,47.6,0,435,435,2264
1992,28,d) 3,2132,2173,17092,17830,99,4.2,424,18.1,3293,636,2657,3.6,18.5,4768,2592,2176,14.5,26.7,-1475,-8.2,37,0,346,346,1934
1992,28,e) 4,1903,2042,20507,20782,115,5.4,309,14.4,3614,845,2769,4.1,17.4,4163,2016,2147,9.7,20,-549,-2.6,34.8,0,238,238,1752
1992,28,f) 5,1833,1957,24542,24883,82,4,254,12.4,5762,346,5416,1.4,23.2,6443,1574,4869,6.3,25.9,-681,-2.7,46.4,0,181,184,1244
1992,28,g) 6 to 10,7720,8198,77944,78461,317,3.7,844,10,11273,1818,9455,2.3,14.4,12307,4306,8001,5.5,15.7,-1034,-1.3,28.8,0,595,611,3079
1992,28,h) 11 to 15,5708,6703,78442,79725,283,4.1,589,8.6,10804,1588,9216,2,13.6,13369,4772,8597,6,16.8,-2565,-3.2,27.2,0,359,370,2672
1992,28,l) Left Censored,10554,17551,459295,460011,763,4.3,1275,7.2,50894,10532,40362,2.3,11.1,52326,12916,39410,2.8,11.4,-1432,-0.3,22.2,0,489,499,3242
1992,29,a) 0,9716,9873,55317,27687,9849,199.5,0,0,55261,55261,0,199.6,199.6,0,0,0,0,0,55261,199.6,0,0,,,
1992,29,b) 1,7320,7534,51256,51322,120,1.4,2027,23.6,16264,2582,13682,5,31.7,16395,9598,6797,18.7,31.9,-131,-0.2,63.4,0,1631,1631,8289
1992,29,c) 2,6452,6623,50954,52945,285,3.9,1404,19.4,11941,1829,10112,3.5,22.6,15922,9021,6901,17,30.1,-3981,-7.5,45.2,0,1101,1101,7123
1992,29,d) 3,5897,6144,47049,47295,275,4.2,962,14.7,10227,1852,8375,3.9,21.6,10718,4741,5977,10,22.7,-491,-1.1,43.2,0,756,759,3899
1992,29,e) 4,5025,5244,48511,51971,206,3.7,751,13.5,8313,1142,7171,2.2,16,15232,4228,11004,8.1,29.3,-6919,-13.3,32,0,581,581,3283
1992,29,f) 5,4976,5267,66531,65252,213,3.9,724,13.1,13391,3281,10110,5,20.5,10833,4749,6084,7.3,16.6,2558,3.9,33.2,0,528,533,3624
1992,29,g) 6 to 10,18673,20260,212158,215117,821,3.9,2100,10,32565,6217,26348,2.9,15.1,38482,14710,23772,6.8,17.9,-5917,-2.8,30.2,0,1410,1446,9151
1992,29,h) 11 to 15,12992,15849,204380,205404,637,3.9,1293,8,28619,6674,21945,3.2,13.9,30667,9625,21042,4.7,14.9,-2048,-1,27.8,0,765,791,5214
1992,29,l) Left Censored,25285,41839,1257161,1270314,1840,4.3,3143,7.4,134261,29482,104779,2.3,10.6,160569,41168,119401,3.2,12.6,-26308,-2,21.2,0,1141,1198,8314
1992,30,a) 0,2137,2151,9446,4729,2143,199.3,0,0,9435,9435,0,199.5,199.5,0,0,0,0,0,9435,199.5,0,0,,,
1992,30,b) 1,1512,1528,9059,8855,15,0.9,387,22.3,2493,138,2355,1.6,28.2,2084,1216,868,13.7,23.5,409,4.7,47,0,293,293,1020
1992,30,c) 2,1293,1303,7842,7827,53,3.8,242,17.2,1754,136,1618,1.7,22.4,1723,968,755,12.4,22,31,0.4,44,0,181,181,739
1992,30,d) 3,1135,1192,7911,7891,45,3.6,183,14.4,1586,140,1446,1.8,20.1,1545,705,840,8.9,19.6,41,0.5,39.2,0,130,130,496
1992,30,e) 4,1013,1042,7303,7511,42,3.8,149,13.5,1402,145,1257,1.9,18.7,1817,952,865,12.7,24.2,-415,-5.5,37.4,0,116,116,813
1992,30,f) 5,965,1014,9301,9334,48,4.5,155,14.5,1627,192,1435,2.1,17.4,1692,867,825,9.3,18.1,-65,-0.7,34.8,0,107,110,622
1992,30,g) 6 to 10,3938,4250,33142,33056,193,4.4,420,9.6,5519,978,4541,3,16.7,5347,2115,3232,6.4,16.2,172,0.5,32.4,0,294,295,1595
1992,30,h) 11 to 15,3137,3611,34397,34224,158,4.3,291,7.9,5340,785,4555,2.3,15.6,4994,1463,3531,4.3,14.6,346,1,29.2,0,197,201,962
1992,30,l) Left Censored,4650,6970,117159,114958,372,5.3,475,6.8,16227,3142,13085,2.7,14.1,11825,3864,7961,3.4,10.3,4402,3.8,20.6,0,215,222,1665
1992,31,a) 0,2966,3006,16349,8223,2990,198.9,0,0,16252,16252,0,197.6,197.6,0,0,0,0,0,16252,197.6,0,0,,,
1992,31,b) 1,2288,2351,13345,13314,34,1.3,491,18.9,3500,328,3172,2.5,26.3,3437,1842,1595,13.8,25.8,63,0.5,51.6,0,388,388,1546
1992,31,c) 2,2028,2098,16214,16684,99,4.4,357,15.9,3368,628,2740,3.8,20.2,4308,2112,2196,12.7,25.8,-940,-5.6,40.4,0,295,295,1787
1992,31,d) 3,1835,1909,18921,19951,59,2.9,265,13.1,2242,216,2026,1.1,11.2,4301,1263,3038,6.3,21.6,-2059,-10.4,22.4,0,211,211,1040
1992,31,e) 4,1604,1727,14639,15504,73,4,215,11.9,2041,413,1628,2.7,13.2,3770,1964,1806,12.7,24.3,-1729,-11.1,26.4,0,162,162,1675
1992,31,f) 5,1460,1548,20810,19990,66,4.1,171,10.7,3797,199,3598,1,19,2156,871,1285,4.4,10.8,1641,8.2,21.6,0,125,128,666
1992,31,g) 6 to 10,6466,7053,73011,73429,279,3.8,657,9,10259,2007,8252,2.7,14,11095,3531,7564,4.8,15.1,-836,-1.1,28,0,461,470,2541
1992,31,h) 11 to 15,5102,5955,63090,63781,227,3.7,459,7.5,7803,1391,6412,2.2,12.2,9185,2649,6536,4.2,14.4,-1382,-2.2,24.4,0,268,281,1574
1992,31,l) Left Censored,10082,15019,363210,363253,615,4,1077,7.1,40480,8871,31609,2.4,11.1,40566,11162,29404,3.1,11.2,-86,-0.1,22.2,0,456,476,3211
1992,32,a) 0,3057,3098,20371,10278,3094,199.7,0,0,20187,20187,0,196.4,196.4,0,0,0,0,0,20187,196.4,0,0,,,
1992,32,b) 1,2285,2333,18631,18891,38,1.4,785,28.6,6239,452,5787,2.4,33,6758,3581,3177,19,35.8,-519,-2.8,66,0,636,636,3088
1992,32,c) 2,1981,2034,18865,19901,117,5.2,469,21,4405,710,3695,3.6,22.1,6476,3302,3174,16.6,32.5,-2071,-10.4,44.2,0,378,379,2385
1992,32,d) 3,1709,1769,19633,21581,77,4.1,317,16.7,3216,475,2741,2.2,14.9,7111,2895,4216,13.4,33,-3895,-18.1,29.8,0,256,258,2492
1992,32,e) 4,1339,1392,17069,18477,70,4.7,256,17.2,2518,355,2163,1.9,13.6,5334,2001,3333,10.8,28.9,-2816,-15.3,27.2,0,192,197,1654
1992,32,f) 5,1248,1357,16692,17414,65,4.5,204,14.2,2520,483,2037,2.8,14.5,3963,1459,2504,8.4,22.8,-1443,-8.3,29,0,144,147,1054
1992,32,g) 6 to 10,4312,4901,75369,77570,322,6.4,550,10.9,11295,3903,7392,5,14.6,15698,4665,11033,6,20.2,-4403,-5.6,29.2,0,364,369,2721
1992,32,h) 11 to 15,3203,3886,72893,74171,230,5.8,371,9.3,8152,2053,6099,2.8,11,10707,3162,7545,4.3,14.4,-2555,-3.4,22,0,207,210,1469
1992,32,l) Left Censored,4282,7309,287251,288456,576,7.8,640,8.7,33844,10746,23098,3.7,11.7,36253,9412,26841,3.3,12.6,-2409,-0.9,23.4,0,166,171,1281
1992,33,a) 0,2245,2317,11575,5807,2307,199.1,0,0,11536,11536,0,198.7,198.7,0,0,0,0,0,11536,198.7,0,0,,,
1992,33,b) 1,1758,1790,10730,10993,14,0.7,534,25.7,3021,165,2856,1.5,27.5,3547,2191,1356,19.9,32.3,-526,-4.8,55,0,430,430,1796
1992,33,c) 2,1629,1660,10283,11379,71,3.9,382,20.9,2097,221,1876,1.9,18.4,4288,2757,1531,24.2,37.7,-2191,-19.3,36.8,0,307,308,2087
1992,33,d) 3,1654,1706,17037,16384,79,4.3,300,16.4,4009,251,3758,1.5,24.5,2702,1269,1433,7.7,16.5,1307,8,33,0,240,242,1082
1992,33,e) 4,1570,1625,11894,12305,80,4.6,263,15.2,2283,541,1742,4.4,18.6,3104,1606,1498,13.1,25.2,-821,-6.6,37.2,0,206,206,1445
1992,33,f) 5,1530,1568,13492,13990,82,4.9,246,14.8,1861,274,1587,2,13.3,2857,883,1974,6.3,20.4,-996,-7.1,26.6,0,184,187,694
1992,33,g) 6 to 10,5034,5386,51438,52227,224,4,631,11.2,7637,1099,6538,2.1,14.6,9215,3411,5804,6.5,17.6,-1578,-3,29.2,0,448,452,2618
1992,33,h) 11 to 15,3065,3612,43296,43856,166,4.5,324,8.7,6037,1726,4311,3.9,13.8,7156,1968,5188,4.5,16.3,-1119,-2.5,27.6,0,190,200,1039
1992,33,l) Left Censored,5726,8926,243407,244700,593,6.6,652,7.3,29625,9843,19782,4,12.1,32210,8453,23757,3.5,13.2,-2585,-1.1,24.2,0,245,267,3164
1992,34,a) 0,14125,14308,76840,39057,14268,199.4,0,0,75566,75566,0,193.5,193.5,0,0,0,0,0,75566,193.5,0,0,,,
1992,34,b) 1,11377,11562,80726,77479,113,0.9,2790,21.3,30745,2095,28650,2.7,39.7,24250,11346,12904,14.6,31.3,6495,8.4,62.6,0,2070,2071,8822
1992,34,c) 2,10301,10504,71902,75415,467,4.1,1990,17.5,15973,1957,14016,2.6,21.2,22998,12845,10153,17,30.5,-7025,-9.3,42.4,0,1528,1528,8041
1992,34,d) 3,9762,9975,80121,81071,449,4.2,1669,15.7,16780,2334,14446,2.9,20.7,18680,8606,10074,10.6,23,-1900,-2.3,41.4,0,1275,1278,6337
1992,34,e) 4,9184,9425,84881,85787,406,4,1527,15.2,17178,2047,15131,2.4,20,18989,8812,10177,10.3,22.1,-1811,-2.1,40,0,1124,1140,6314
1992,34,f) 5,8556,8833,91472,95004,380,4.1,1284,13.8,13321,1500,11821,1.6,14,20384,6489,13895,6.8,21.5,-7063,-7.5,28,0,943,948,4901
1992,34,g) 6 to 10,30685,32325,347967,352623,1277,3.8,3639,10.8,51506,8324,43182,2.4,14.6,60817,21049,39768,6,17.2,-9311,-2.6,29.2,0,2517,2529,13859
1992,34,h) 11 to 15,21186,23714,299490,298799,902,3.7,2166,8.9,50069,9008,41061,3,16.8,48686,14500,34186,4.9,16.3,1383,0.5,32.6,0,1317,1335,7795
1992,34,l) Left Censored,41927,63275,1907389,1938969,2842,4.4,5338,8.3,231224,56647,174577,2.9,11.9,294386,80291,214095,4.1,15.2,-63162,-3.3,23.8,0,2068,2149,17052
1992,35,a) 0,2981,3039,16668,8482,3024,199,0,0,16372,16372,0,193,193,0,0,0,0,0,16372,193,0,0,,,
1992,35,b) 1,2358,2471,17197,17798,84,3,605,21.8,4851,997,3854,5.6,27.3,6052,2618,3434,14.7,34,-1201,-6.7,54.6,0,446,446,1983
1992,35,c) 2,1979,2013,14753,15178,96,4.4,393,18,4105,1136,2969,7.5,27,4954,2714,2240,17.9,32.6,-849,-5.6,54,0,299,299,2352
1992,35,d) 3,1715,1790,12357,12881,106,5.6,314,16.5,2489,463,2026,3.6,19.3,3537,1763,1774,13.7,27.5,-1048,-8.2,38.6,0,247,247,1359
1992,35,e) 4,1401,1485,13883,14166,64,4,254,16,2882,400,2482,2.8,20.3,3448,1725,1723,12.2,24.3,-566,-4,40.6,0,183,183,1063
1992,35,f) 5,1347,1432,18779,18328,67,4.5,181,12.1,3653,522,3131,2.8,19.9,2751,1150,1601,6.3,15,902,4.9,30,0,125,126,839
1992,35,g) 6 to 10,5506,6051,57912,58336,324,5.2,676,10.8,10643,2336,8307,4,18.2,11490,4598,6892,7.9,19.7,-847,-1.5,36.4,0,466,474,3125
1992,35,h) 11 to 15,4206,5011,53637,53722,250,4.9,419,8.2,8953,2262,6691,4.2,16.7,9123,2703,6420,5,17,-170,-0.3,33.4,0,249,251,1531
1992,35,l) Left Censored,5975,9731,230397,229971,584,5.9,835,8.5,35887,10126,25761,4.4,15.6,35035,10016,25019,4.4,15.2,852,0.4,30.4,0,263,296,1737
1992,36,a) 0,32540,32927,184237,92240,32845,199.5,0,0,183995,183995,0,199.5,199.5,0,0,0,0,0,183995,199.5,0,0,,,
1992,36,b) 1,26046,26391,177717,174605,209,0.7,7399,24.4,57734,8894,48840,5.1,33.1,51510,30127,21383,17.3,29.5,6224,3.6,59,0,5734,5735,23488
1992,36,c) 2,23356,23726,157068,167388,1005,3.9,5026,19.4,32692,4761,27931,2.8,19.5,53332,27883,25449,16.7,31.9,-20640,-12.4,39,0,4014,4016,22972
1992,36,d) 3,21793,22251,159218,164949,907,3.8,4192,17.4,31922,5665,26257,3.4,19.4,43383,20000,23383,12.1,26.3,-11461,-6.9,38.8,0,3382,3384,16910
1992,36,e) 4,19460,19953,178509,181858,764,3.6,3220,15.1,34454,7995,26459,4.4,18.9,41151,17551,23600,9.7,22.6,-6697,-3.7,37.8,0,2568,2568,14184
1992,36,f) 5,18244,18906,259456,266086,678,3.4,2849,14.2,34607,7062,27545,2.7,13,47866,14783,33083,5.6,18,-13259,-5,26,0,2190,2214,11748
1992,36,g) 6 to 10,66875,70692,706305,711949,2461,3.3,8496,11.5,125027,15524,109503,2.2,17.6,136315,47964,88351,6.7,19.1,-11288,-1.5,35.2,0,6207,6275,35381
1992,36,h) 11 to 15,43743,50617,706610,719535,1907,3.7,4776,9.1,100249,20284,79965,2.8,13.9,126099,38014,88085,5.3,17.5,-25850,-3.6,27.8,0,3094,3168,24308
1992,36,l) Left Censored,93427,137901,4139324,4198365,5345,3.8,11445,8.1,475301,127473,347828,3,11.3,593383,172312,421071,4.1,14.1,-118082,-2.8,22.6,0,5328,5641,48197
1992,37,a) 0,11773,11966,66058,33079,11930,199.4,0,0,65958,65958,0,199.4,199.4,0,0,0,0,0,65958,199.4,0,0,,,
1992,37,b) 1,9420,9685,66130,64667,157,1.4,2499,22.8,22520,3049,19471,4.7,34.8,19593,12031,7562,18.6,30.3,2927,4.5,60.6,0,2001,2002,9772
1992,37,c) 2,8522,8751,61699,63796,394,4.1,1763,18.5,12967,2032,10935,3.2,20.3,17161,8766,8395,13.7,26.9,-4194,-6.6,40.6,0,1449,1450,7370
1992,37,d) 3,7401,7678,62308,64124,303,3.7,1325,16.1,11569,1580,9989,2.5,18,15201,8131,7070,12.7,23.7,-3632,-5.7,36,0,1041,1041,6775
1992,37,e) 4,6622,6998,68874,69270,298,4,991,13.4,12310,2076,10234,3,17.8,13101,5828,7273,8.4,18.9,-791,-1.1,35.6,0,778,780,4877
1992,37,f) 5,6217,6791,76215,74797,301,4.2,902,12.7,14666,1746,12920,2.3,19.6,11830,5022,6808,6.7,15.8,2836,3.8,31.6,0,650,663,3730
1992,37,g) 6 to 10,25168,27408,273809,276303,1130,4,2615,9.3,45995,10486,35509,3.8,16.6,50982,19854,31128,7.2,18.5,-4987,-1.9,33.2,0,1762,1792,13426
1992,37,h) 11 to 15,15354,18604,270959,268203,810,4.3,1457,7.7,39669,8111,31558,3,14.8,34157,10059,24098,3.8,12.7,5512,2.1,25.4,0,847,879,5444
1992,37,l) Left Censored,28619,52668,1681529,1682552,2616,4.9,3800,7.1,199650,54110,145540,3.2,11.9,201697,62120,139577,3.7,12,-2047,-0.1,23.8,0,1285,1354,9131
1992,38,a) 0,1179,1186,5303,2704,1177,198.5,0,0,5198,5198,0,192.2,192.2,0,0,0,0,0,5198,192.2,0,0,,,
1992,38,b) 1,954,967,5576,5604,13,1.2,211,19.5,1369,321,1048,5.7,24.4,1424,747,677,13.3,25.4,-55,-1,48.8,0,171,171,610
1992,38,c) 2,856,885,5134,5331,39,4.2,136,14.5,1084,163,921,3.1,20.3,1478,883,595,16.6,27.7,-394,-7.4,40.6,0,106,106,802
1992,38,d) 3,711,723,4752,4872,31,4,112,14.6,852,188,664,3.9,17.5,1092,581,511,11.9,22.4,-240,-4.9,35,0,88,88,471
1992,38,e) 4,690,715,6094,6116,26,3.4,110,14.4,1031,90,941,1.5,16.9,1074,431,643,7,17.6,-43,-0.7,33.8,0,82,82,318
1992,38,f) 5,682,713,6235,6390,34,4.6,84,11.4,924,76,848,1.2,14.5,1234,406,828,6.4,19.3,-310,-4.8,29,0,60,60,335
1992,38,g) 6 to 10,2752,3043,25136,25284,106,3.4,284,9,3134,351,2783,1.4,12.4,3429,1086,2343,4.3,13.6,-295,-1.2,24.8,0,183,188,658
1992,38,h) 11 to 15,2297,2602,25768,25519,106,4,217,8.1,3702,493,3209,1.9,14.5,3203,784,2419,3.1,12.6,499,1.9,25.2,0,145,147,548
1992,38,l) Left Censored,4393,6392,121034,120500,293,4.5,458,7.1,14209,4051,10158,3.4,11.8,13141,4031,9110,3.3,10.9,1068,0.9,21.8,0,212,218,1400
1992,39,a) 0,15385,15648,88799,44592,15602,199.4,0,0,88414,88414,0,198.3,198.3,0,0,0,0,0,88414,198.3,0,0,,,
1992,39,b) 1,12517,12873,93939,92259,208,1.4,3042,21.1,29432,4597,24835,5,31.9,26071,14271,11800,15.5,28.3,3361,3.6,56.6,0,2381,2381,11608
1992,39,c) 2,11261,11653,91250,96273,463,3.7,2084,16.6,18897,2598,16299,2.7,19.6,28942,14130,14812,14.7,30.1,-10045,-10.5,39.2,0,1673,1676,11704
1992,39,d) 3,10172,10738,103649,101757,480,4.2,1595,14,25813,6414,19399,6.3,25.4,22028,8833,13195,8.7,21.6,3785,3.8,43.2,0,1275,1275,7300
1992,39,e) 4,9029,9520,95613,97620,369,3.7,1277,12.8,16643,2577,14066,2.6,17,20656,7922,12734,8.1,21.2,-4013,-4.2,34,0,979,979,5810
1992,39,f) 5,8849,9537,111764,114420,361,3.6,1181,11.8,17497,3919,13578,3.4,15.3,22809,8510,14299,7.4,19.9,-5312,-4.6,30.6,0,868,876,6047
1992,39,g) 6 to 10,32833,36375,421454,429993,1296,3.5,3491,9.3,57146,10221,46925,2.4,13.3,74224,25318,48906,5.9,17.3,-17078,-4,26.6,0,2342,2392,15016
1992,39,h) 11 to 15,24651,30320,435012,434222,1175,3.8,2376,7.7,63260,11914,51346,2.7,14.6,61679,17254,44425,4,14.2,1581,0.4,28.4,0,1347,1390,9794
1992,39,l) Left Censored,51997,91018,2723248,2750307,3959,4.3,6509,7,276171,64091,212080,2.3,10,330289,85308,244981,3.1,12,-54118,-2,20,0,2354,2494,18856
1992,40,a) 0,5963,6039,31721,15879,6024,199.5,0,0,31684,31684,0,199.5,199.5,0,0,0,0,0,31684,199.5,0,0,,,
1992,40,b) 1,4435,4542,30879,31512,60,1.1,1297,24.8,10028,1090,8938,3.5,31.8,11293,7573,3720,24,35.8,-1265,-4,63.6,0,1065,1065,6565
1992,40,c) 2,3790,3857,25779,27307,164,3.9,798,19,5429,637,4792,2.3,19.9,8485,4332,4153,15.9,31.1,-3056,-11.2,39.8,0,669,669,3862
1992,40,d) 3,3174,3250,28658,29900,126,3.6,637,18.1,5669,738,4931,2.5,19,8152,4627,3525,15.5,27.3,-2483,-8.3,38,0,521,522,4049
1992,40,e) 4,2736,2859,24915,25921,115,3.8,430,14.2,3778,684,3094,2.6,14.6,5789,2541,3248,9.8,22.3,-2011,-7.7,29.2,0,347,348,2030
1992,40,f) 5,2492,2703,37505,38546,124,4.4,356,12.6,6991,640,6351,1.7,18.1,9073,4938,4135,12.8,23.5,-2082,-5.4,36.2,0,274,276,1850
1992,40,g) 6 to 10,11894,12946,121475,121964,591,4.4,1271,9.5,19323,4045,15278,3.3,15.8,20301,6709,13592,5.5,16.6,-978,-0.8,31.6,0,905,929,4884
1992,40,h) 11 to 15,8366,9936,118233,119579,426,4.2,820,8.1,15424,3208,12216,2.7,12.9,18116,5472,12644,4.6,15.1,-2692,-2.2,25.8,0,520,529,2446
1992,40,l) Left Censored,13660,22817,534017,539977,1159,5,1781,7.7,61924,17149,44775,3.2,11.5,73844,22787,51057,4.2,13.7,-11920,-2.2,23,0,739,792,5907
1992,41,a) 0,6976,7083,37485,18755,7068,199.6,0,0,37461,37461,0,199.7,199.7,0,0,0,0,0,37461,199.7,0,0,,,
1992,41,b) 1,5286,5407,32933,33780,73,1.2,1494,24.1,9812,1018,8794,3,29,11506,7636,3870,22.6,34.1,-1694,-5.1,58,0,1133,1133,6052
1992,41,c) 2,5044,5160,33273,36026,243,4.4,991,17.7,7101,1383,5718,3.8,19.7,12606,6926,5680,19.2,35,-5505,-15.3,39.4,0,768,769,5546
1992,41,d) 3,3394,3497,27333,28124,176,4.8,536,14.5,5506,1056,4450,3.8,19.6,7088,3659,3429,13,25.2,-1582,-5.6,39.2,0,413,413,3151
1992,41,e) 4,3458,3554,29671,29948,139,3.7,538,14.3,5997,1094,4903,3.7,20,6551,2813,3738,9.4,21.9,-554,-1.9,40,0,397,401,2216
1992,41,f) 5,3284,3481,40237,41001,169,4.6,503,13.8,6539,947,5592,2.3,15.9,8067,2955,5112,7.2,19.7,-1528,-3.8,31.8,0,355,361,2183
1992,41,g) 6 to 10,11850,12959,137133,139196,587,4.4,1334,10,21454,4884,16570,3.5,15.4,25580,9136,16444,6.6,18.4,-4126,-3,30.8,0,910,922,5502
1992,41,h) 11 to 15,9123,10777,124665,126062,516,4.7,897,8.2,19115,3809,15306,3,15.2,21908,7105,14803,5.6,17.4,-2793,-2.2,30.4,0,513,528,3705
1992,41,l) Left Censored,13537,22547,561689,569245,1195,5.2,1750,7.7,65439,16738,48701,2.9,11.5,80551,19102,61449,3.4,14.2,-15112,-2.7,23,0,642,669,4520
1992,42,a) 0,16734,17043,104259,52176,17009,199.6,0,0,104167,104167,0,199.6,199.6,0,0,0,0,0,104167,199.6,0,0,,,
1992,42,b) 1,14068,14399,102496,104734,161,1,3420,21.1,27588,3519,24069,3.4,26.3,32064,16611,15453,15.9,30.6,-4476,-4.3,52.6,0,2661,2663,13439
1992,42,c) 2,13150,13484,98008,101827,463,3.2,2426,16.6,19896,3393,16503,3.3,19.5,27534,13346,14188,13.1,27,-7638,-7.5,39,0,1948,1961,11280
1992,42,d) 3,12424,12843,108087,109530,427,3.1,1991,14.5,22809,2517,20292,2.3,20.8,25694,11593,14101,10.6,23.5,-2885,-2.7,41.6,0,1583,1585,9764
1992,42,e) 4,11113,11603,100509,104280,399,3.3,1598,13,16248,2275,13973,2.2,15.6,23790,10008,13782,9.6,22.8,-7542,-7.2,31.2,0,1276,1280,8122
1992,42,f) 5,10912,11449,128856,130445,398,3.3,1350,11.3,19378,2645,16733,2,14.9,22555,9055,13500,6.9,17.3,-3177,-2.4,29.8,0,1001,1023,6325
1992,42,g) 6 to 10,39388,42614,487043,496978,1495,3.4,4310,9.8,68007,11802,56205,2.4,13.7,87876,33529,54347,6.7,17.7,-19869,-4,27.4,0,2951,2989,21547
1992,42,h) 11 to 15,27190,32557,448753,452072,1203,3.6,2637,7.9,59450,11786,47664,2.6,13.2,66087,18881,47206,4.2,14.6,-6637,-1.4,26.4,0,1616,1644,11102
1992,42,l) Left Censored,59389,97704,2895798,2936345,4046,4.1,7006,7.1,298618,85137,213481,2.9,10.2,379712,101780,277932,3.5,12.9,-81094,-2.7,20.4,0,2837,2970,21623
1992,44,a) 0,1727,1744,9294,4652,1737,199.2,0,0,9284,9284,0,199.6,199.6,0,0,0,0,0,9284,199.6,0,0,,,
1992,44,b) 1,1328,1340,8726,9071,7,0.4,400,25.6,2397,126,2271,1.4,26.4,3086,1973,1113,21.8,34,-689,-7.6,52.8,0,312,312,1465
1992,44,c) 2,1277,1299,7894,9053,71,5,294,20.6,1878,500,1378,5.5,20.7,4196,2236,1960,24.7,46.3,-2318,-25.6,41.4,0,239,239,1775
1992,44,d) 3,1315,1346,10992,11461,68,4.7,215,15,1990,587,1403,5.1,17.4,2928,1201,1727,10.5,25.5,-938,-8.1,34.8,0,168,168,1037
1992,44,e) 4,1197,1234,9428,9469,55,4.2,200,15.2,2260,224,2036,2.4,23.9,2342,1308,1034,13.8,24.7,-82,-0.8,47.8,0,145,145,1018
1992,44,f) 5,1121,1157,10663,11140,65,5.3,186,15.2,1593,233,1360,2.1,14.3,2547,1016,1531,9.1,22.9,-954,-8.6,28.6,0,128,129,669
1992,44,g) 6 to 10,3804,3973,36201,38039,153,3.7,455,10.9,5032,720,4312,1.9,13.2,8707,3106,5601,8.2,22.9,-3675,-9.7,26.4,0,315,318,1670
1992,44,h) 11 to 15,2658,2956,34258,35221,107,3.5,291,9.5,4309,1166,3143,3.3,12.2,6234,1803,4431,5.1,17.7,-1925,-5.5,24.4,0,168,172,1132
1992,44,l) Left Censored,6274,8305,235205,239759,327,3.8,693,8.1,23110,5253,17857,2.2,9.6,32218,9586,22632,4,13.4,-9108,-3.8,19.2,0,300,320,3541
1992,45,a) 0,6233,6315,37030,18549,6296,199.4,0,0,36963,36963,0,199.3,199.3,0,0,0,0,0,36963,199.3,0,0,,,
1992,45,b) 1,4864,5022,34084,34760,84,1.5,1279,22.5,8952,795,8157,2.3,25.8,10304,5717,4587,16.4,29.6,-1352,-3.8,51.6,0,1009,1010,4848
1992,45,c) 2,4178,4277,31973,33311,203,4.3,936,19.9,7050,1350,5700,4.1,21.2,9726,5221,4505,15.7,29.2,-2676,-8,42.4,0,770,770,4566
1992,45,d) 3,3549,3759,32132,32168,167,4.1,658,16.3,6961,1216,5745,3.8,21.6,7032,3190,3842,9.9,21.9,-71,-0.3,43.2,0,516,516,2674
1992,45,e) 4,3290,3523,35845,34171,120,3.2,494,13.2,10223,806,9417,2.4,29.9,6874,3055,3819,8.9,20.1,3349,9.8,40.2,0,404,404,2439
1992,45,f) 5,3115,3406,48926,47567,145,4.1,445,12.5,10777,1913,8864,4,22.7,8059,3037,5022,6.4,16.9,2718,5.8,33.8,0,341,349,2484
1992,45,g) 6 to 10,12008,13168,129779,133353,522,3.8,1386,10.2,17839,4294,13545,3.2,13.4,24987,8900,16087,6.7,18.7,-7148,-5.3,26.8,0,966,979,5747
1992,45,h) 11 to 15,7558,9099,117943,119908,436,4.7,792,8.5,16368,4904,11464,4.1,13.7,20298,5426,14872,4.5,16.9,-3930,-3.2,27.4,0,438,453,2733
1992,45,l) Left Censored,13806,24880,783256,787385,1265,5,1892,7.5,83551,23513,60038,3,10.6,91809,24197,67612,3.1,11.7,-8258,-1.1,21.2,0,611,641,6357
1992,46,a) 0,1464,1492,7058,3534,1484,198.9,0,0,7048,7048,0,199.4,199.4,0,0,0,0,0,7048,199.4,0,0,,,
1992,46,b) 1,1172,1190,7793,7991,20,1.5,294,21.9,2482,211,2271,2.6,31.1,2878,1358,1520,17,36,-396,-4.9,62.2,0,211,211,1089
1992,46,c) 2,1097,1115,7647,8252,39,3.2,209,17.3,1443,199,1244,2.4,17.5,2652,1439,1213,17.4,32.1,-1209,-14.6,35,0,162,162,1297
1992,46,d) 3,827,856,5815,6002,30,3.3,125,13.7,1071,187,884,3.1,17.8,1444,797,647,13.3,24.1,-373,-6.3,35.6,0,97,97,643
1992,46,e) 4,771,805,5866,5892,27,3.2,108,12.7,1056,173,883,2.9,17.9,1108,540,568,9.2,18.8,-52,-0.9,35.8,0,75,76,378
1992,46,f) 5,712,730,11123,10650,34,4.5,88,11.6,2148,101,2047,0.9,20.2,1202,484,718,4.5,11.3,946,8.9,22.6,0,66,67,363
1992,46,g) 6 to 10,3010,3298,28135,27622,142,4.2,278,8.2,5007,646,4361,2.3,18.1,3981,1436,2545,5.2,14.4,1026,3.7,28.8,0,174,176,1062
1992,46,h) 11 to 15,2299,2612,29582,29600,94,3.5,248,9.2,3738,462,3276,1.6,12.6,3773,1512,2261,5.1,12.7,-35,-0.1,25.2,0,156,159,678
1992,46,l) Left Censored,4741,6666,131079,129865,331,4.9,465,6.9,15967,4550,11417,3.5,12.3,13539,3951,9588,3,10.4,2428,1.9,20.8,0,244,248,1438
1992,47,a) 0,8547,8701,52052,26054,8677,199.4,0,0,51996,51996,0,199.6,199.6,0,0,0,0,0,51996,199.6,0,0,,,
1992,47,b) 1,6421,6670,61467,59482,114,1.5,1877,24.6,22675,3370,19305,5.7,38.1,18704,10421,8283,17.5,31.4,3971,6.7,62.8,0,1531,1535,9227
1992,47,c) 2,5665,5822,46145,49202,249,3.9,1209,19,10601,1842,8759,3.7,21.5,16714,8966,7748,18.2,34,-6113,-12.5,43,0,987,988,8045
1992,47,d) 3,4931,5172,44512,45870,227,4.1,912,16.4,9131,1532,7599,3.3,19.9,11846,5722,6124,12.5,25.8,-2715,-5.9,39.8,0,745,746,4793
1992,47,e) 4,4434,4688,48439,47613,217,4.4,696,14.1,11627,1466,10161,3.1,24.4,9974,4503,5471,9.5,20.9,1653,3.5,41.8,0,529,531,3615
1992,47,f) 5,4202,4604,64488,63099,222,4.6,638,13.2,13020,2437,10583,3.9,20.6,10241,3875,6366,6.1,16.2,2779,4.4,32.4,0,466,470,2987
1992,47,g) 6 to 10,16643,18133,194628,196060,794,4.3,1763,9.4,29814,5699,24115,2.9,15.2,32678,12858,19820,6.6,16.7,-2864,-1.5,30.4,0,1252,1269,8189
1992,47,h) 11 to 15,10952,13589,218024,215376,634,4.5,1332,9.5,40510,7696,32814,3.6,18.8,35213,15035,20178,7,16.3,5297,2.5,32.6,0,677,713,4488
1992,47,l) Left Censored,20739,37092,1163204,1165690,1910,5.1,2801,7.5,132165,33113,99052,2.8,11.3,137137,38502,98635,3.3,11.8,-4972,-0.5,22.6,0,945,994,7780
1992,48,a) 0,34163,34912,241231,120877,34809,199.4,0,0,240709,240709,0,199.1,199.1,0,0,0,0,0,240709,199.1,0,0,,,
1992,48,b) 1,25972,26870,226634,222887,539,1.8,7121,23.3,79899,14427,65472,6.5,35.8,72405,42136,30269,18.9,32.5,7494,3.3,65,0,5733,5736,35651
1992,48,c) 2,21416,22286,188364,205054,1046,4.3,4721,19.4,43822,7892,35930,3.8,21.4,77202,44240,32962,21.6,37.6,-33380,-16.2,42.8,0,3872,3892,38550
1992,48,d) 3,17517,18471,168195,176630,939,4.7,3394,17.1,36387,6054,30333,3.4,20.6,53257,28163,25094,15.9,30.2,-16870,-9.6,41.2,0,2703,2750,22951
1992,48,e) 4,15121,16388,160617,171009,810,4.7,2628,15.1,31707,5968,25739,3.5,18.5,52490,26935,25555,15.8,30.7,-20783,-12.2,37,0,1930,1944,18561
1992,48,f) 5,13852,15144,205599,208018,749,4.7,2240,14.1,44739,6686,38053,3.2,21.5,49579,15616,33963,7.5,23.8,-4840,-2.3,43,0,1624,1646,10367
1992,48,g) 6 to 10,58836,65623,706656,716159,3351,4.9,7400,10.9,130238,25932,104306,3.6,18.2,149244,55660,93584,7.8,20.8,-19006,-2.6,36.4,0,4948,5096,36778
1992,48,h) 11 to 15,40533,50407,627768,637232,2563,5,4534,8.8,99524,26563,72961,4.2,15.6,118452,37385,81067,5.9,18.6,-18928,-3,31.2,0,2641,2769,17857
1992,48,l) Left Censored,55188,115213,3468671,3492193,6695,5.7,10089,8.6,449101,135897,313204,3.9,12.9,496146,148120,348026,4.2,14.2,-47045,-1.3,25.8,0,3105,3368,25835
1992,49,a) 0,3485,3542,21040,10536,3533,199.5,0,0,21008,21008,0,199.4,199.4,0,0,0,0,0,21008,199.4,0,0,,,
1992,49,b) 1,2480,2545,21137,21128,43,1.5,673,23.3,7191,684,6507,3.2,34,7173,4509,2664,21.3,34,18,0,68,0,535,535,3806
1992,49,c) 2,2008,2089,19525,19734,108,4.8,397,17.6,4849,913,3936,4.6,24.6,5268,2602,2666,13.2,26.7,-419,-2.1,49.2,0,324,324,2151
1992,49,d) 3,1761,1816,22330,22062,85,4.4,316,16.3,5890,585,5305,2.7,26.7,5353,3414,1939,15.5,24.3,537,2.4,48.6,0,256,256,2730
1992,49,e) 4,1505,1620,20089,20698,73,4.2,261,15.2,3801,383,3418,1.9,18.4,5018,2597,2421,12.5,24.2,-1217,-5.8,36.8,0,205,207,2111
1992,49,f) 5,1349,1447,16893,17089,73,4.8,195,12.9,3188,640,2548,3.7,18.7,3580,1531,2049,9,20.9,-392,-2.2,37.4,0,148,153,940
1992,49,g) 6 to 10,5138,5678,77230,79287,259,4.4,589,10.1,13472,1869,11603,2.4,17,17586,9911,7675,12.5,22.2,-4114,-5.2,34,0,398,405,8323
1992,49,h) 11 to 15,4060,4828,74054,72593,242,4.9,398,8.1,13277,2735,10542,3.8,18.3,10355,2943,7412,4.1,14.3,2922,4,28.6,0,235,239,1625
1992,49,l) Left Censored,6395,10778,340472,340438,583,5.3,960,8.7,45595,14655,30940,4.3,13.4,45527,13675,31852,4,13.4,68,0,26.8,0,313,330,1897
1992,50,a) 0,1309,1321,6391,3197,1320,199.8,0,0,6388,6388,0,199.8,199.8,0,0,0,0,0,6388,199.8,0,0,,,
1992,50,b) 1,1102,1124,6251,6186,14,1.1,222,17.8,1766,217,1549,3.5,28.5,1636,733,903,11.8,26.4,130,2.1,52.8,0,180,180,598
1992,50,c) 2,1109,1136,5517,5969,46,3.8,198,16.1,976,126,850,2.1,16.4,1880,913,967,15.3,31.5,-904,-15.1,32.8,0,153,153,716
1992,50,d) 3,1104,1125,7480,7532,40,3.3,209,17.2,1524,234,1290,3.1,20.2,1628,737,891,9.8,21.6,-104,-1.4,40.4,0,162,165,617
1992,50,e) 4,949,962,5718,6049,46,4.5,137,13.5,1030,246,784,4.1,17,1692,867,825,14.3,28,-662,-11,34,0,103,103,684
1992,50,f) 5,875,905,6225,7192,34,3.5,134,14,803,168,635,2.3,11.2,2736,476,2260,6.6,38,-1933,-26.8,22.4,0,97,97,349
1992,50,g) 6 to 10,3229,3405,27196,27522,111,3.1,357,10.1,3861,681,3180,2.5,14,4512,1845,2667,6.7,16.4,-651,-2.4,28,0,252,253,1472
1992,50,h) 11 to 15,1955,2202,24980,24860,87,3.8,188,8.3,3260,399,2861,1.6,13.1,3019,708,2311,2.8,12.1,241,1,24.2,0,110,111,445
1992,50,l) Left Censored,3531,5015,116960,117285,205,4,331,6.5,11639,2878,8761,2.5,9.9,12288,2856,9432,2.4,10.5,-649,-0.6,19.8,0,137,138,1201
1992,51,a) 0,10937,11213,62683,31367,11186,199.5,0,0,62632,62632,0,199.7,199.7,0,0,0,0,0,62632,199.7,0,0,,,
1992,51,b) 1,8433,8628,56800,57429,111,1.1,2367,24,18035,1296,16739,2.3,31.4,19293,11376,7917,19.8,33.6,-1258,-2.2,62.8,0,1852,1852,9294
1992,51,c) 2,7851,8070,54327,57211,400,4.6,1680,19.1,12194,2057,10137,3.6,21.3,17962,9830,8132,17.2,31.4,-5768,-10.1,42.6,0,1376,1378,8741
1992,51,d) 3,6850,7115,54605,58697,336,4.4,1219,16.1,10536,1653,8883,2.8,17.9,18719,10940,7779,18.6,31.9,-8183,-14,35.8,0,962,966,9793
1992,51,e) 4,6241,6599,61063,61659,305,4.4,999,14.3,11567,1931,9636,3.1,18.8,12758,5685,7073,9.2,20.7,-1191,-1.9,37.6,0,748,749,4365
1992,51,f) 5,5736,6105,69151,67825,302,4.7,860,13.4,16429,2107,14322,3.1,24.2,13777,6256,7521,9.2,20.3,2652,3.9,40.6,0,596,608,3598
1992,51,g) 6 to 10,21640,23849,256126,261630,1054,4.3,2396,9.7,40548,10109,30439,3.9,15.5,51556,18191,33365,7,19.7,-11008,-4.2,31,0,1583,1614,12651
1992,51,h) 11 to 15,13526,16769,247175,246647,745,4.3,1475,8.6,39695,8146,31549,3.3,16.1,38638,10641,27997,4.3,15.7,1057,0.4,31.4,0,773,812,5225
1992,51,l) Left Censored,24581,47455,1376693,1388838,2658,5.5,3829,8,162658,51157,111501,3.7,11.7,186948,52871,134077,3.8,13.5,-24290,-1.8,23.4,0,1079,1218,9322
1992,53,a) 0,12601,12813,64237,32645,12759,199.2,0,0,63184,63184,0,193.5,193.5,0,0,0,0,0,63184,193.5,0,0,,,
1992,53,b) 1,9130,9336,60375,59546,110,1,2511,23.5,19323,1743,17580,2.9,32.5,17665,9952,7713,16.7,29.7,1658,2.8,59.4,0,1900,1900,7816
1992,53,c) 2,8955,9233,66627,68982,487,4.9,1821,18.2,15430,2365,13065,3.4,22.4,20139,10195,9944,14.8,29.2,-4709,-6.8,44.8,0,1392,1392,8172
1992,53,d) 3,5497,5714,51557,52120,286,4.7,854,14.1,11097,1762,9335,3.4,21.3,12222,5137,7085,9.9,23.4,-1125,-2.1,42.6,0,663,665,4280
1992,53,e) 4,5705,5937,53279,53873,300,4.8,863,13.8,11446,3532,7914,6.6,21.2,12634,5539,7095,10.3,23.5,-1188,-2.3,42.4,0,665,673,4539
1992,53,f) 5,5262,5609,70397,68968,280,4.8,780,13.3,14525,1182,13343,1.7,21.1,11667,4906,6761,7.1,16.9,2858,4.2,33.8,0,569,572,3420
1992,53,g) 6 to 10,19971,21925,246800,246579,1054,4.7,2252,10,44428,8079,36349,3.3,18,43986,14573,29413,5.9,17.8,442,0.2,35.6,0,1493,1514,9840
1992,53,h) 11 to 15,14110,16855,208079,209058,903,5.3,1428,8.3,32537,7218,25319,3.5,15.6,34495,10390,24105,5,16.5,-1958,-0.9,31.2,0,822,841,4869
1992,53,l) Left Censored,20280,35209,967003,969775,2061,5.8,2770,7.8,140671,30686,109985,3.2,14.5,146215,48635,97580,5,15.1,-5544,-0.6,29,0,954,997,7807
1992,54,a) 0,2539,2562,12836,6434,2548,198.9,0,0,12804,12804,0,199,199,0,0,0,0,0,12804,199,0,0,,,
1992,54,b) 1,2037,2095,13873,15125,18,0.8,510,21.5,3491,221,3270,1.5,23.1,5994,2747,3247,18.2,39.6,-2503,-16.5,46.2,0,393,393,2257
1992,54,c) 2,1837,1858,12999,13683,71,3.5,345,17.1,2489,419,2070,3.1,18.2,3857,2175,1682,15.9,28.2,-1368,-10,36.4,0,290,290,1847
1992,54,d) 3,1580,1624,14149,15038,49,2.8,277,15.9,2266,157,2109,1,15.1,4044,2614,1430,17.4,26.9,-1778,-11.8,30.2,0,215,215,1414
1992,54,e) 4,1414,1459,11346,11567,52,3.4,182,11.9,1836,202,1634,1.7,15.9,2278,891,1387,7.7,19.7,-442,-3.8,31.8,0,148,148,798
1992,54,f) 5,1367,1430,15445,15411,59,3.9,173,11.6,2872,317,2555,2.1,18.6,2803,1135,1668,7.4,18.2,69,0.4,36.4,0,129,130,937
1992,54,g) 6 to 10,5442,6007,66805,67630,229,3.7,529,8.6,7762,1496,6266,2.2,11.5,9412,2977,6435,4.4,13.9,-1650,-2.4,23,0,353,353,1884
1992,54,h) 11 to 15,3803,4536,52429,52414,181,3.9,353,7.6,7038,1541,5497,2.9,13.4,7007,2392,4615,4.6,13.4,31,0,26.8,0,208,210,1120
1992,54,l) Left Censored,8466,13172,280423,284050,621,4.6,1013,7.6,32191,8121,24070,2.9,11.3,39444,11957,27487,4.2,13.9,-7253,-2.6,22.6,0,368,382,2042
1992,55,a) 0,8066,8137,44916,22473,8119,199.6,0,0,44886,44886,0,199.7,199.7,0,0,0,0,0,44886,199.7,0,0,,,
1992,55,b) 1,6593,6785,46654,45959,101,1.3,1467,19.4,13472,1984,11488,4.3,29.3,12081,6399,5682,13.9,26.3,1391,3,52.6,0,1090,1090,5219
1992,55,c) 2,5849,6093,47046,47613,232,3.6,997,15.3,10250,2479,7771,5.2,21.5,11383,5482,5901,11.5,23.9,-1133,-2.4,43,0,780,780,4605
1992,55,d) 3,5337,5493,41644,42808,176,3,787,13.5,7161,1000,6161,2.3,16.7,9489,4570,4919,10.7,22.2,-2328,-5.5,33.4,0,599,605,3569
1992,55,e) 4,4746,4890,42802,43577,151,2.9,605,11.8,6498,820,5678,1.9,14.9,8047,3645,4402,8.4,18.5,-1549,-3.6,29.8,0,465,465,2604
1992,55,f) 5,4876,5347,66424,66663,211,3.8,563,10.2,9308,1800,7508,2.7,14,9785,3576,6209,5.4,14.7,-477,-0.7,28,0,388,397,2551
1992,55,g) 6 to 10,17283,18924,213412,213807,662,3.4,1736,8.9,31657,5415,26242,2.5,14.8,32447,11508,20939,5.4,15.2,-790,-0.4,29.6,0,1206,1220,7256
1992,55,h) 11 to 15,12833,15347,201612,202474,585,3.7,1207,7.7,25872,4453,21419,2.2,12.8,27596,7985,19611,3.9,13.6,-1724,-0.8,25.6,0,689,705,4441
1992,55,l) Left Censored,27158,41788,1266120,1269416,1646,3.9,2739,6.5,123975,23378,100597,1.8,9.8,130567,35965,94602,2.8,10.3,-6592,-0.5,19.6,0,1189,1218,8727
1992,56,a) 0,1146,1148,4796,2463,1143,199.1,0,0,4666,4666,0,189.4,189.4,0,0,0,0,0,4666,189.4,0,0,,,
1992,56,b) 1,884,891,5324,5062,9,0.9,198,19.8,1881,194,1687,3.8,37.2,1357,643,714,12.7,26.8,524,10.4,53.6,0,141,141,454
1992,56,c) 2,738,746,4076,4399,29,3.6,115,14.4,784,161,623,3.7,17.8,1429,610,819,13.9,32.5,-645,-14.7,35.6,0,89,89,495
1992,56,d) 3,604,634,4455,4688,27,4,86,12.9,859,84,775,1.8,18.3,1324,762,562,16.3,28.2,-465,-9.9,36.6,0,57,57,655
1992,56,e) 4,562,580,4124,4232,34,5.7,69,11.5,692,117,575,2.8,16.4,908,404,504,9.5,21.5,-216,-5.1,32.8,0,56,56,377
1992,56,f) 5,502,537,5076,5217,34,6.1,67,12.1,904,234,670,4.5,17.3,1185,351,834,6.7,22.7,-281,-5.4,34.6,0,45,45,247
1992,56,g) 6 to 10,2376,2582,21099,21292,117,4.4,237,8.9,3345,478,2867,2.2,15.7,3730,1188,2542,5.6,17.5,-385,-1.8,31.4,0,166,167,950
1992,56,h) 11 to 15,1919,2196,20563,20743,90,4,196,8.7,3288,569,2719,2.7,15.9,3648,929,2719,4.5,17.6,-360,-1.7,31.8,0,113,117,605
1992,56,l) Left Censored,2782,4024,67595,67780,227,5.6,333,8.2,8492,2169,6323,3.2,12.5,8861,2522,6339,3.7,13.1,-369,-0.6,25,0,90,92,588
1993,01,a) 0,7135,7157,39107,19620,7097,198.3,0,0,38974,38974,0,198.6,198.6,0,0,0,0,0,38974,198.6,0,0,,,
1993,01,b) 1,5142,5285,43783,42167,27,0.4,1451,23.9,13065,1087,11978,2.6,31,9832,5645,4187,13.4,23.3,3233,7.7,46.6,0,1193,1193,4807
1993,01,c) 2,4240,4415,36350,36857,158,3.3,825,17.3,8535,1197,7338,3.2,23.2,9548,4852,4696,13.2,25.9,-1013,-2.7,46.4,0,688,688,4275
1993,01,d) 3,3951,4104,34075,35465,129,3,628,14.4,5878,485,5393,1.4,16.6,8657,3581,5076,10.1,24.4,-2779,-7.8,33.2,0,526,526,3017
1993,01,e) 4,3494,3665,34446,34406,112,2.9,482,12.5,6611,744,5867,2.2,19.2,6531,2491,4040,7.2,19,80,0.2,38,0,391,391,2085
1993,01,f) 5,3149,3317,36832,37611,112,3.2,400,11.5,5316,803,4513,2.1,14.1,6874,2566,4308,6.8,18.3,-1558,-4.2,28.2,0,315,315,1952
1993,01,g) 6 to 10,13306,14498,174406,173902,446,3,1295,8.7,26029,2766,23263,1.6,15,25020,8393,16627,4.8,14.4,1009,0.6,28.8,0,950,952,5912
1993,01,h) 11 to 15,8103,9529,147145,147024,314,3.2,748,7.7,19245,2845,16400,1.9,13.1,19003,5222,13781,3.6,12.9,242,0.2,25.8,0,509,513,2987
1993,01,i) 16 to 20,1861,2864,49741,49409,106,3.7,169,5.8,6003,791,5212,1.6,12.1,5338,1586,3752,3.2,10.8,665,1.3,21.6,0,88,88,549
1993,01,l) Left Censored,15013,26855,806487,806725,981,3.6,1839,6.7,88029,15257,72772,1.9,10.9,88505,26862,61643,3.3,11,-476,-0.1,21.8,0,683,694,5432
1993,02,a) 0,1292,1298,5860,2979,1280,197.2,0,0,5762,5762,0,193.4,193.4,0,0,0,0,0,5762,193.4,0,0,,,
1993,02,b) 1,881,914,5609,5313,4,0.4,292,27.3,2213,98,2115,1.8,41.7,1621,1000,621,18.8,30.5,592,11.2,61,0,188,188,679
1993,02,c) 2,843,868,5711,5679,28,3,166,17.6,1417,94,1323,1.7,25,1353,654,699,11.5,23.8,64,1.2,47.6,0,120,120,505
1993,02,d) 3,798,813,5323,5352,44,5.1,132,15.4,1339,133,1206,2.5,25,1396,684,712,12.8,26.1,-57,-1.1,50,0,104,104,443
1993,02,e) 4,523,533,5001,4830,29,5.2,85,15.1,1327,194,1133,4,27.5,984,431,553,8.9,20.4,343,7.1,40.8,0,57,57,294
1993,02,f) 5,538,587,5875,6007,20,3.3,66,10.7,940,59,881,1,15.6,1203,366,837,6.1,20,-263,-4.4,31.2,0,52,52,322
1993,02,g) 6 to 10,2551,2825,27676,27961,91,3.1,268,9.2,4523,627,3896,2.2,16.2,5093,1671,3422,6,18.2,-570,-2,32.4,0,175,175,1358
1993,02,h) 11 to 15,1519,1726,17875,18200,63,3.5,162,9.1,2617,303,2314,1.7,14.4,3266,1119,2147,6.1,17.9,-649,-3.5,28.8,0,79,86,583
1993,02,i) 16 to 20,328,496,7606,7601,23,4.6,38,7.5,1155,103,1052,1.4,15.2,1145,287,858,3.8,15.1,10,0.1,30.2,0,7,7,24
1993,02,l) Left Censored,1911,3421,80570,81717,155,4.5,242,7,10345,2091,8254,2.6,12.7,12638,2936,9702,3.6,15.5,-2293,-2.8,25.4,0,58,59,378
1993,04,a) 0,8158,8198,46222,23269,8148,198.8,0,0,45907,45907,0,197.3,197.3,0,0,0,0,0,45907,197.3,0,0,,,
1993,04,b) 1,5956,6108,50831,50660,31,0.4,1777,25.1,15956,963,14993,1.9,31.5,15613,8952,6661,17.7,30.8,343,0.7,61.6,0,1470,1470,7119
1993,04,c) 2,5123,5264,45092,46821,208,3.6,1032,18.1,10619,989,9630,2.1,22.7,14076,6050,8026,12.9,30.1,-3457,-7.4,45.4,0,868,868,5181
1993,04,d) 3,4434,4573,40079,41910,159,3.2,782,16,8437,1192,7245,2.8,20.1,12099,5197,6902,12.4,28.9,-3662,-8.8,40.2,0,659,659,4375
1993,04,e) 4,3979,4169,44174,43982,183,4.2,632,14.4,9866,2019,7847,4.6,22.4,9482,4692,4790,10.7,21.6,384,0.8,43.2,0,495,508,3904
1993,04,f) 5,3488,3717,35756,35680,138,3.6,455,11.7,6682,847,5835,2.4,18.7,6530,2919,3611,8.2,18.3,152,0.4,36.6,0,354,354,1959
1993,04,g) 6 to 10,13876,15562,200584,201917,612,3.8,1656,10.3,32105,6341,25764,3.1,15.9,34772,13785,20987,6.8,17.2,-2667,-1.3,31.8,0,1114,1130,7543
1993,04,h) 11 to 15,8538,9902,140593,140771,378,3.7,877,8.6,19448,2877,16571,2,13.8,19803,6092,13711,4.3,14.1,-355,-0.3,27.6,0,528,530,3110
1993,04,i) 16 to 20,1435,2274,46445,46199,119,5.2,151,6.6,6967,1429,5538,3.1,15.1,6474,2135,4339,4.6,14,493,1.1,28,0,69,70,898
1993,04,l) Left Censored,10125,20749,648774,643548,1218,5.8,1913,9.1,93862,28419,65443,4.4,14.6,83410,28361,55049,4.4,13,10452,1.6,26,0,430,439,3300
1993,05,a) 0,4701,4718,23355,11736,4688,198.7,0,0,23239,23239,0,198,198,0,0,0,0,0,23239,198,0,0,,,
1993,05,b) 1,3365,3456,28535,27351,20,0.5,954,24,9696,1201,8495,4.4,35.5,7328,4221,3107,15.4,26.8,2368,8.7,53.6,0,789,789,3624
1993,05,c) 2,2727,2834,20998,21996,99,3.3,515,16.9,4882,843,4039,3.8,22.2,6877,3989,2888,18.1,31.3,-1995,-9.1,44.4,0,428,428,2951
1993,05,d) 3,2510,2617,20584,20802,94,3.4,370,13.4,3792,647,3145,3.1,18.2,4227,1649,2578,7.9,20.3,-435,-2.1,36.4,0,307,307,1390
1993,05,e) 4,2045,2101,19694,19905,79,3.5,319,14.3,3441,451,2990,2.3,17.3,3863,1809,2054,9.1,19.4,-422,-2.1,34.6,0,267,267,1508
1993,05,f) 5,1817,1891,19058,19873,61,3.1,221,11.2,2603,310,2293,1.6,13.1,4232,1574,2658,7.9,21.3,-1629,-8.2,26.2,0,187,187,1274
1993,05,g) 6 to 10,8332,8940,90073,89533,310,3.4,828,9,14492,1998,12494,2.2,16.2,13411,5217,8194,5.8,15,1081,1.2,30,0,631,637,3609
1993,05,h) 11 to 15,5813,6517,78507,77903,217,3.3,535,8,12553,2507,10046,3.2,16.1,11345,3370,7975,4.3,14.6,1208,1.5,29.2,0,373,387,2057
1993,05,i) 16 to 20,1228,1699,27245,27328,47,2.7,101,5.9,3920,547,3373,2,14.3,4085,792,3293,2.9,14.9,-165,-0.6,28.6,0,67,68,274
1993,05,l) Left Censored,9849,15855,483950,480615,549,3.4,1027,6.4,51799,10399,41400,2.2,10.8,45129,13127,32002,2.7,9.4,6670,1.4,18.8,0,396,419,2292
1993,06,a) 0,54484,54699,336859,169781,54156,198,0,0,334157,334157,0,196.8,196.8,0,0,0,0,0,334157,196.8,0,0,,,
1993,06,b) 1,42450,43709,444226,426321,183,0.4,14061,27.3,154105,23957,130148,5.6,36.1,118295,62311,55984,14.6,27.7,35810,8.4,55.4,0,11317,11329,52793
1993,06,c) 2,38141,39469,305923,325995,1518,3.5,8936,20.6,71229,9556,61673,2.9,21.8,111372,56849,54523,17.4,34.2,-40143,-12.4,43.6,0,7083,7102,43210
1993,06,d) 3,35367,36672,317236,327198,1527,3.9,7042,17.8,71567,10724,60843,3.3,21.9,91491,42233,49258,12.9,28,-19924,-6.1,43.8,0,5588,5594,34596
1993,06,e) 4,31085,32523,309321,318679,1239,3.6,5515,15.8,60427,8399,52028,2.6,19,79143,33079,46064,10.4,24.8,-18716,-5.8,38,0,4308,4318,26866
1993,06,f) 5,27914,29611,293479,303239,1177,3.7,4615,14.7,53806,9920,43886,3.3,17.7,73326,28866,44460,9.5,24.2,-19520,-6.5,35.4,0,3444,3458,21264
1993,06,g) 6 to 10,111061,122943,1568265,1612503,4528,3.5,14497,11.3,238602,40978,197624,2.5,14.8,327080,104320,222760,6.5,20.3,-88478,-5.5,29.6,0,10098,10209,67965
1993,06,h) 11 to 15,76036,88132,1156423,1180927,2862,3.1,8456,9.3,162388,26529,135859,2.2,13.8,211395,66063,145332,5.6,17.9,-49007,-4.1,27.6,0,5343,5485,39322
1993,06,i) 16 to 20,14172,21663,378431,382126,782,3.5,1857,8.4,50045,9614,40431,2.5,13.1,57434,15401,42033,4,15,-7389,-1.9,26.2,0,905,948,5042
1993,06,l) Left Censored,92664,176176,5413539,5500924,7631,4.2,17383,9.6,716400,196068,520332,3.6,13,891169,308828,582341,5.6,16.2,-174769,-3.2,26,0,5257,5656,46268
1993,08,a) 0,10087,10100,50849,25510,10035,198.7,0,0,50678,50678,0,198.7,198.7,0,0,0,0,0,50678,198.7,0,0,,,
1993,08,b) 1,7023,7128,53487,51502,32,0.4,1931,23.7,18192,836,17356,1.6,35.3,14222,8366,5856,16.2,27.6,3970,7.7,55.2,0,1510,1511,6552
1993,08,c) 2,5983,6145,43226,44392,225,3.4,1148,17.3,9971,1056,8915,2.4,22.5,12303,7217,5086,16.3,27.7,-2332,-5.2,45,0,915,915,5933
1993,08,d) 3,4967,5111,40832,40895,200,3.7,746,13.8,8906,1014,7892,2.5,21.8,9032,4525,4507,11.1,22.1,-126,-0.3,43.6,0,581,581,3645
1993,08,e) 4,4415,4586,40680,41156,155,3.2,569,11.9,7975,772,7203,1.9,19.4,8927,3829,5098,9.3,21.7,-952,-2.3,38.8,0,458,458,3231
1993,08,f) 5,3900,4086,43476,42168,145,3.4,486,11.4,9383,937,8446,2.2,22.3,6767,2840,3927,6.7,16,2616,6.3,32,0,371,371,2209
1993,08,g) 6 to 10,15483,16955,210157,209469,647,3.7,1589,9.1,32414,4559,27855,2.2,15.5,31037,12178,18859,5.8,14.8,1377,0.7,29.6,0,1075,1079,6497
1993,08,h) 11 to 15,10576,11831,140724,138916,456,3.8,907,7.5,23780,3605,20175,2.6,17.1,20163,7054,13109,5.1,14.5,3617,2.6,29,0,564,584,3851
1993,08,i) 16 to 20,1874,2800,43896,42666,121,4.3,198,7,7964,2431,5533,5.7,18.7,5504,2119,3385,5,12.9,2460,5.8,25.8,0,77,77,389
1993,08,l) Left Censored,13599,23914,709600,708327,1157,4.8,1916,7.9,87967,21082,66885,3,12.4,85422,24951,60471,3.5,12.1,2545,0.3,24.2,0,542,551,3353
1993,09,a) 0,5563,5581,28788,14437,5536,198.4,0,0,28703,28703,0,198.8,198.8,0,0,0,0,0,28703,198.8,0,0,,,
1993,09,b) 1,4298,4408,33310,31764,29,0.6,1022,20.6,10562,1230,9332,3.9,33.3,7470,3980,3490,12.5,23.5,3092,9.8,47,0,791,791,2923
1993,09,c) 2,3728,3821,36004,33745,130,3.1,714,17.3,15500,716,14784,2.1,45.9,10982,7682,3300,22.8,32.5,4518,13.4,65,0,569,571,7187
1993,09,d) 3,3752,3840,28425,28741,135,3.3,590,14.5,5438,839,4599,2.9,18.9,6069,2696,3373,9.4,21.1,-631,-2.2,37.8,0,470,471,2239
1993,09,e) 4,3814,3969,29516,29748,142,3.4,537,12.9,5197,659,4538,2.2,17.5,5660,2113,3547,7.1,19,-463,-1.5,35,0,420,420,1704
1993,09,f) 5,3506,3659,38492,38783,126,3.3,488,12.7,6439,1138,5301,2.9,16.6,7020,2562,4458,6.6,18.1,-581,-1.5,33.2,0,359,360,1949
1993,09,g) 6 to 10,13649,14380,144231,145987,461,3.1,1432,9.6,21340,3342,17998,2.3,14.6,24852,8399,16453,5.8,17,-3512,-2.4,29.2,0,1046,1055,5660
1993,09,h) 11 to 15,8685,9618,104370,106134,261,2.6,746,7.6,12755,2123,10632,2,12,16282,4184,12098,3.9,15.3,-3527,-3.3,24,0,500,505,2459
1993,09,i) 16 to 20,1785,2416,40422,39151,71,2.8,218,8.7,7185,1031,6154,2.6,18.4,4642,1167,3475,3,11.9,2543,6.5,23.8,0,105,106,418
1993,09,l) Left Censored,18759,27887,917541,934301,917,3.2,1949,6.9,93475,19940,73535,2.1,10,126995,27348,99647,2.9,13.6,-33520,-3.6,20,0,763,775,4561
1993,10,a) 0,1448,1450,6633,3333,1442,198.9,0,0,6600,6600,0,198,198,0,0,0,0,0,6600,198,0,0,,,
1993,10,b) 1,1107,1134,7306,7180,6,0.5,263,20.7,2027,,,,28.2,1775,1050,725,14.6,24.7,252,3.5,49.4,1,218,218,954
1993,10,c) 2,953,976,6399,6855,40,3.8,211,19.8,1379,264,1115,3.9,20.1,2291,1370,921,20,33.4,-912,-13.3,40.2,0,172,172,1278
1993,10,d) 3,877,904,5839,5946,47,5,127,13.4,1243,188,1055,3.2,20.9,1456,783,673,13.2,24.5,-213,-3.6,41.8,0,100,100,688
1993,10,e) 4,835,848,6626,6831,34,3.8,113,12.7,923,124,799,1.8,13.5,1333,488,845,7.1,19.5,-410,-6,27,0,86,86,349
1993,10,f) 5,656,671,6634,6586,22,3.1,88,12.5,1186,413,773,6.3,18,1090,613,477,9.3,16.6,96,1.4,33.2,0,63,63,526
1993,10,g) 6 to 10,2697,2899,29631,30186,81,2.7,265,8.9,3932,378,3554,1.3,13,5041,1750,3291,5.8,16.7,-1109,-3.7,26,0,191,191,1140
1993,10,h) 11 to 15,1584,1757,22929,23245,36,2,154,8.5,3310,497,2813,2.1,14.2,3942,978,2964,4.2,17,-632,-2.8,28.4,0,105,107,682
1993,10,i) 16 to 20,396,543,16527,16584,18,3.3,35,6.3,3124,,,,18.8,3238,371,2867,2.2,19.5,-114,-0.7,37.6,1,16,16,105
1993,10,l) Left Censored,3790,5918,195077,195656,300,5,489,8.1,23735,6115,17620,3.1,12.1,24894,8052,16842,4.1,12.7,-1159,-0.6,24.2,0,94,94,835
1993,11,a) 0,1039,1043,7872,3946,1032,197.9,0,0,7853,7853,0,199,199,0,0,0,0,0,7853,199,0,0,,,
1993,11,b) 1,883,917,28383,28471,9,0.9,220,21.2,2199,221,1978,0.8,7.7,2374,717,1657,2.5,8.3,-175,-0.6,15.4,0,161,161,485
1993,11,c) 2,772,780,6727,6528,25,3,126,15.1,1855,385,1470,5.9,28.4,1456,693,763,10.6,22.3,399,6.1,44.6,0,100,100,547
1993,11,d) 3,706,739,6922,7273,22,2.8,108,13.8,1536,73,1463,1,21.1,2237,1372,865,18.9,30.8,-701,-9.7,42.2,0,85,85,521
1993,11,e) 4,674,706,8462,8638,23,3.1,98,13.2,1655,86,1569,1,19.2,2006,780,1226,9,23.2,-351,-4,38.4,0,79,79,723
1993,11,f) 5,627,664,11547,11661,19,2.7,89,12.7,1142,84,1058,0.7,9.8,1369,705,664,6,11.7,-227,-1.9,19.6,0,53,53,378
1993,11,g) 6 to 10,2810,2961,35876,36301,91,3,261,8.6,5174,647,4527,1.8,14.3,6023,1672,4351,4.6,16.6,-849,-2.3,28.6,0,167,167,900
1993,11,h) 11 to 15,1918,2113,33919,34919,52,2.4,177,8.1,4028,426,3602,1.2,11.5,6028,2028,4000,5.8,17.3,-2000,-5.8,23,0,93,94,828
1993,11,i) 16 to 20,461,652,35853,36300,24,3.6,52,7.8,1869,599,1270,1.7,5.1,2762,299,2463,0.8,7.6,-893,-2.5,10.2,0,19,21,97
1993,11,l) Left Censored,4695,6916,251726,240776,321,4.5,682,9.6,51060,5676,45384,2.4,21.2,29161,9796,19365,4.1,12.1,21899,9.1,24.2,0,170,171,1627
1993,12,a) 0,37704,37838,208138,104777,37540,198.4,0,0,206723,206723,0,197.3,197.3,0,0,0,0,0,206723,197.3,0,0,,,
1993,12,b) 1,27368,27905,198817,198110,86,0.3,8398,25.9,62452,4950,57502,2.5,31.5,61038,39227,21811,19.8,30.8,1414,0.7,61.6,0,7049,7049,34126
1993,12,c) 2,22122,22750,163705,170631,800,3.2,4776,19.3,38366,4337,34029,2.5,22.5,52217,28109,24108,16.5,30.6,-13851,-8.1,45,0,3976,3984,23121
1993,12,d) 3,19954,20424,168339,169537,835,3.8,3603,16.5,42035,4832,37203,2.9,24.8,44430,19458,24972,11.5,26.2,-2395,-1.4,49.6,0,3044,3048,16884
1993,12,e) 4,16955,17710,148067,151036,720,3.8,2778,14.8,29471,5092,24379,3.4,19.5,35409,16606,18803,11,23.4,-5938,-3.9,39,0,2291,2295,13493
1993,12,f) 5,15270,16331,152683,153672,685,4,2329,13.6,32938,4485,28453,2.9,21.4,34915,17943,16972,11.7,22.7,-1977,-1.3,42.8,0,1785,1814,14907
1993,12,g) 6 to 10,54889,59778,677243,685121,2210,3.6,6594,10.6,115277,18982,96295,2.8,16.8,131034,47163,83871,6.9,19.1,-15757,-2.3,33.6,0,4925,4962,33495
1993,12,h) 11 to 15,32653,37328,459032,462027,1224,3.2,3295,8.6,67875,10765,57110,2.3,14.7,73864,26369,47495,5.7,16,-5989,-1.3,29.4,0,2249,2277,15178
1993,12,i) 16 to 20,5769,9113,144012,145803,360,3.9,741,8,22043,4064,17979,2.8,15.1,25625,9738,15887,6.7,17.6,-3582,-2.5,30.2,0,322,383,3169
1993,12,l) Left Censored,39494,83173,2410663,2403657,4084,4.8,7483,8.8,340397,103917,236480,4.3,14.2,326385,107782,218603,4.5,13.6,14012,0.6,27.2,0,2137,2293,20750
1993,13,a) 0,14141,14184,82816,41594,14086,198.6,0,0,82445,82445,0,198.2,198.2,0,0,0,0,0,82445,198.2,0,0,,,
1993,13,b) 1,10341,10565,87843,89770,95,0.8,2949,24.3,29539,4779,24760,5.3,32.9,33393,14566,18827,16.2,37.2,-3854,-4.3,65.8,0,2479,2479,13161
1993,13,c) 2,8439,8701,72026,76040,332,3.5,1595,17,15298,1989,13309,2.6,20.1,23325,11768,11557,15.5,30.7,-8027,-10.6,40.2,0,1323,1323,8527
1993,13,d) 3,7318,7504,64748,66336,284,3.6,1174,14.7,12747,1269,11478,1.9,19.2,15922,7731,8191,11.7,24,-3175,-4.8,38.4,0,968,970,6458
1993,13,e) 4,6677,7008,63831,63613,276,3.8,985,13.4,14044,2334,11710,3.7,22.1,13608,6632,6976,10.4,21.4,436,0.7,42.8,0,799,799,5012
1993,13,f) 5,5723,6111,59936,61500,224,3.5,805,12.6,10679,1209,9470,2,17.4,13807,6786,7021,11,22.5,-3128,-5.1,34.8,0,630,634,5466
1993,13,g) 6 to 10,23638,25658,305313,305926,923,3.5,2580,9.7,47009,9662,37347,3.2,15.4,48234,19106,29128,6.2,15.8,-1225,-0.4,30.8,0,1813,1825,12465
1993,13,h) 11 to 15,14108,16541,227695,225712,541,3.2,1203,7.1,36124,6790,29334,3,16,32157,9326,22831,4.1,14.2,3967,1.8,28.4,0,784,795,5922
1993,13,i) 16 to 20,2984,4243,72437,71487,179,4.2,278,6.5,11169,2963,8206,4.1,15.6,9268,2214,7054,3.1,13,1901,2.6,26,0,113,113,487
1993,13,l) Left Censored,23653,46995,1540993,1538514,2291,4.8,3693,7.7,189663,49149,140514,3.2,12.3,184706,57540,127166,3.7,12,4957,0.3,24,0,1046,1065,8734
1993,15,a) 0,1994,2017,11727,5902,2002,198.5,0,0,11650,11650,0,197.4,197.4,0,0,0,0,0,11650,197.4,0,0,,,
1993,15,b) 1,1508,1571,13762,13750,10,0.5,478,26.1,3619,265,3354,1.9,26.3,3594,2057,1537,15,26.1,25,0.2,52.2,0,393,393,1686
1993,15,c) 2,1495,1541,15340,15635,57,3.4,327,19.5,2936,780,2156,5,18.8,3526,1474,2052,9.4,22.6,-590,-3.8,37.6,0,266,266,1156
1993,15,d) 3,1302,1384,12403,13260,43,2.9,265,17.6,2311,216,2095,1.6,17.4,4025,1676,2349,12.6,30.4,-1714,-13,34.8,0,211,212,1282
1993,15,e) 4,1124,1192,13091,13766,34,2.7,162,12.8,2492,206,2286,1.5,18.1,3842,1398,2444,10.2,27.9,-1350,-9.8,36.2,0,137,137,1260
1993,15,f) 5,1108,1248,12984,13864,43,3.3,173,13.2,2249,418,1831,3,16.2,4009,793,3216,5.7,28.9,-1760,-12.7,32.4,0,126,128,609
1993,15,g) 6 to 10,4073,4557,53715,55436,158,3.4,405,8.6,5796,944,4852,1.7,10.5,9237,2393,6844,4.3,16.7,-3441,-6.2,21,0,308,308,1859
1993,15,h) 11 to 15,3211,3804,45403,47584,113,2.9,312,8,4396,500,3896,1.1,9.2,8757,1697,7060,3.6,18.4,-4361,-9.2,18.4,0,171,172,781
1993,15,i) 16 to 20,602,1010,17847,18155,31,3,75,7.3,1865,211,1654,1.2,10.3,2480,624,1856,3.4,13.7,-615,-3.4,20.6,0,23,23,103
1993,15,l) Left Censored,5047,8740,234984,241314,333,3.7,609,6.9,21707,6143,15564,2.5,9,34366,9975,24391,4.1,14.2,-12659,-5.2,18,0,205,209,1546
1993,16,a) 0,2617,2621,12401,6234,2591,197.7,0,0,12334,12334,0,197.9,197.9,0,0,0,0,0,12334,197.9,0,0,,,
1993,16,b) 1,1950,1976,12092,11962,11,0.5,509,22.6,3581,183,3398,1.5,29.9,3321,1862,1459,15.6,27.8,260,2.1,55.6,0,367,367,1411
1993,16,c) 2,1490,1517,10143,10552,57,3.5,305,18.5,2384,455,1929,4.3,22.6,3202,1779,1423,16.9,30.3,-818,-7.7,45.2,0,238,238,1329
1993,16,d) 3,1477,1512,10685,10823,68,4.3,211,13.3,2323,422,1901,3.9,21.5,2598,1241,1357,11.5,24,-275,-2.5,43,0,147,147,867
1993,16,e) 4,1129,1177,9279,9651,51,4.2,149,12.2,1883,250,1633,2.6,19.5,2626,1129,1497,11.7,27.2,-743,-7.7,39,0,112,112,777
1993,16,f) 5,1016,1044,11531,11385,34,3.1,97,9,2504,304,2200,2.7,22,2212,631,1581,5.5,19.4,292,2.6,38.8,0,75,75,516
1993,16,g) 6 to 10,4136,4466,45067,45246,145,3.1,399,8.7,6965,872,6093,1.9,15.4,7323,2812,4511,6.2,16.2,-358,-0.8,30.8,0,280,280,1646
1993,16,h) 11 to 15,2928,3203,38262,40265,113,3.4,255,7.8,5815,1199,4616,3,14.4,9820,1964,7856,4.9,24.4,-4005,-10,28.8,0,173,173,1492
1993,16,i) 16 to 20,582,787,13728,13179,32,4,73,9.1,2542,287,2255,2.2,19.3,1443,479,964,3.6,10.9,1099,8.4,21.8,0,38,40,187
1993,16,l) Left Censored,4516,7458,170769,169790,325,4.3,520,6.9,18669,4513,14156,2.7,11,16711,4356,12355,2.6,9.8,1958,1.2,19.6,0,214,214,1143
1993,17,a) 0,19315,19382,108740,54606,19247,198.6,0,0,108269,108269,0,198.3,198.3,0,0,0,0,0,108269,198.3,0,0,,,
1993,17,b) 1,14888,15266,125685,131216,77,0.4,3602,20.9,42005,6315,35690,4.8,32,53067,15498,37569,11.8,40.4,-11062,-8.4,64,0,2823,2823,12396
1993,17,c) 2,13066,13554,108660,112025,473,3.3,2168,15,24944,3868,21076,3.5,22.3,31673,17761,13912,15.9,28.3,-6729,-6,44.6,0,1746,1746,11836
1993,17,d) 3,12081,12450,120085,118724,390,3,1751,13.3,26559,2442,24117,2.1,22.4,23837,9842,13995,8.3,20.1,2722,2.3,40.2,0,1396,1396,7757
1993,17,e) 4,10825,11233,96998,97414,376,3.2,1413,12,16883,2453,14430,2.5,17.3,17714,7216,10498,7.4,18.2,-831,-0.9,34.6,0,1075,1076,5487
1993,17,f) 5,9718,10115,112699,111623,307,2.9,1159,11,22665,9701,12964,8.7,20.3,20513,7160,13353,6.4,18.4,2152,1.9,36.8,0,882,884,5611
1993,17,g) 6 to 10,40261,43622,561591,565151,1207,2.7,3846,8.6,71681,10147,61534,1.8,12.7,78800,25031,53769,4.4,13.9,-7119,-1.2,25.4,0,2785,2795,17325
1993,17,h) 11 to 15,26880,29962,406692,409681,870,2.8,2198,7.2,51662,8104,43558,2,12.6,57639,17297,40342,4.2,14.1,-5977,-1.5,25.2,0,1432,1440,9460
1993,17,i) 16 to 20,5760,8283,147598,146917,266,3.2,541,6.4,19819,2703,17116,1.8,13.5,18456,4684,13772,3.2,12.6,1363,0.9,25.2,0,257,263,1635
1993,17,l) Left Censored,53280,86868,2832942,2862187,3196,3.6,6233,7.1,310544,79012,231532,2.8,10.8,369035,100661,268374,3.5,12.9,-58491,-2.1,21.6,0,2385,2466,18356
1993,18,a) 0,9309,9326,47521,23949,9236,198.1,0,0,47145,47145,0,196.9,196.9,0,0,0,0,0,47145,196.9,0,0,,,
1993,18,b) 1,7158,7366,55497,53847,49,0.6,1686,20.4,15960,1075,14885,2,29.6,12659,7173,5486,13.3,23.5,3301,6.1,47,0,1390,1390,6191
1993,18,c) 2,6310,6596,52767,53081,222,3.2,1061,15.1,11947,2299,9648,4.3,22.5,12574,6663,5911,12.6,23.7,-627,-1.2,45,0,856,857,5632
1993,18,d) 3,5726,5944,50007,50551,218,3.5,825,13.2,9609,1056,8553,2.1,19,10696,5766,4930,11.4,21.2,-1087,-2.2,38,0,655,655,4057
1993,18,e) 4,5061,5402,55589,56132,188,3.3,678,12,10104,1527,8577,2.7,18,11190,4035,7155,7.2,19.9,-1086,-1.9,36,0,540,540,3247
1993,18,f) 5,4312,4540,52485,53302,152,3.2,501,10.6,6999,1204,5795,2.3,13.1,8632,3455,5177,6.5,16.2,-1633,-3.1,26.2,0,416,416,2792
1993,18,g) 6 to 10,19110,20803,239314,240518,585,2.7,1799,8.4,33242,4596,28646,1.9,13.8,35649,12074,23575,5,14.8,-2407,-1,27.6,0,1377,1381,8315
1993,18,h) 11 to 15,12026,13568,172511,171937,339,2.4,953,6.9,23519,2595,20924,1.5,13.7,22371,6208,16163,3.6,13,1148,0.7,26,0,672,680,3778
1993,18,i) 16 to 20,2638,4069,78918,78118,128,3.1,276,6.7,10106,1490,8616,1.9,12.9,8505,2759,5746,3.5,10.9,1601,2,21.8,0,125,136,888
1993,18,l) Left Censored,25167,43804,1402263,1398905,1474,3.3,2704,6.1,155701,31290,124411,2.2,11.1,148985,38807,110178,2.8,10.7,6716,0.4,21.4,0,1058,1080,8390
1993,19,a) 0,4546,4553,22918,11489,4525,198.8,0,0,22858,22858,0,199,199,0,0,0,0,0,22858,199,0,0,,,
1993,19,b) 1,3699,3775,29538,29581,17,0.4,923,21.6,7015,312,6703,1.1,23.7,7101,3457,3644,11.7,24,-86,-0.3,47.4,0,745,745,2971
1993,19,c) 2,3216,3310,24229,25510,105,3,502,14.3,4802,660,4142,2.6,18.8,7363,3312,4051,13,28.9,-2561,-10.1,37.6,0,402,402,2958
1993,19,d) 3,2926,3006,21770,21868,93,2.9,399,12.6,4215,516,3699,2.4,19.3,4411,1951,2460,8.9,20.2,-196,-0.9,38.6,0,326,326,1548
1993,19,e) 4,2617,2759,22383,22619,63,2.2,309,10.7,3850,592,3258,2.6,17,4322,1847,2475,8.2,19.1,-472,-2.1,34,0,230,230,1525
1993,19,f) 5,2250,2315,22326,22209,62,2.6,271,11.2,3280,510,2770,2.3,14.8,3045,1280,1765,5.8,13.7,235,1.1,27.4,0,218,218,980
1993,19,g) 6 to 10,10194,11222,129709,129844,294,2.5,901,7.8,16332,1925,14407,1.5,12.6,16601,4833,11768,3.7,12.8,-269,-0.2,25.2,0,651,657,3495
1993,19,h) 11 to 15,7809,8996,91172,92080,250,2.7,619,6.7,9764,1413,8351,1.5,10.6,11580,2569,9011,2.8,12.6,-1816,-2,21.2,0,442,443,1777
1993,19,i) 16 to 20,1796,2661,33999,33549,88,3.3,149,5.5,4269,1003,3266,3,12.7,3368,662,2706,2,10,901,2.7,20,0,84,85,328
1993,19,l) Left Censored,16730,26042,647116,646989,729,2.8,1544,5.8,61430,11224,50206,1.7,9.5,61178,15850,45328,2.4,9.5,252,0,19,0,670,681,3708
1993,20,a) 0,4768,4784,25587,12845,4746,198.4,0,0,25485,25485,0,198.4,198.4,0,0,0,0,0,25485,198.4,0,0,,,
1993,20,b) 1,3646,3733,24710,25262,17,0.4,954,22.5,6481,678,5803,2.7,25.7,7585,4414,3171,17.5,30,-1104,-4.3,51.4,0,758,758,3786
1993,20,c) 2,2989,3093,20598,21770,119,3.5,641,19,4525,642,3883,2.9,20.8,6869,3859,3010,17.7,31.6,-2344,-10.8,41.6,0,521,521,3366
1993,20,d) 3,2647,2743,21376,21886,77,2.6,442,15.1,3983,434,3549,2,18.2,5003,2767,2236,12.6,22.9,-1020,-4.7,36.4,0,355,356,2413
1993,20,e) 4,2498,2598,22193,22377,64,2.3,322,11.8,3877,371,3506,1.7,17.3,4245,1788,2457,8,19,-368,-1.7,34.6,0,249,249,1472
1993,20,f) 5,2158,2285,19518,20719,82,3.4,276,11.6,2504,319,2185,1.5,12.1,4905,1595,3310,7.7,23.7,-2401,-11.6,24.2,0,212,213,1197
1993,20,g) 6 to 10,9672,10340,104901,105951,304,2.9,914,8.6,13295,2193,11102,2.1,12.5,15395,5663,9732,5.3,14.5,-2100,-2,25,0,666,672,3790
1993,20,h) 11 to 15,6779,7593,81671,82165,227,2.9,529,6.8,10968,1297,9671,1.6,13.3,11955,3743,8212,4.6,14.5,-987,-1.2,26.6,0,353,357,2206
1993,20,i) 16 to 20,1494,2292,38801,38230,75,3.2,132,5.7,5599,1001,4598,2.6,14.6,4456,1236,3220,3.2,11.7,1143,2.9,23.4,0,65,65,321
1993,20,l) Left Censored,13530,21464,537312,540309,710,3.3,1389,6.4,52340,9369,42971,1.7,9.7,58334,14388,43946,2.7,10.8,-5994,-1.1,19.4,0,543,562,3393
1993,21,a) 0,6102,6125,34973,17558,6083,198.6,0,0,34830,34830,0,198.4,198.4,0,0,0,0,0,34830,198.4,0,0,,,
1993,21,b) 1,4614,4727,33444,33247,20,0.4,1292,23.9,9682,1272,8410,3.8,29.1,9287,5489,3798,16.5,27.9,395,1.2,55.8,0,1120,1121,4946
1993,21,c) 2,3809,3906,31540,32555,106,2.5,678,16.1,6497,420,6077,1.3,20,8527,4130,4397,12.7,26.2,-2030,-6.2,40,0,574,574,3573
1993,21,d) 3,3635,3761,31125,32530,118,2.9,579,14.5,5477,728,4749,2.2,16.8,8286,4262,4024,13.1,25.5,-2809,-8.7,33.6,0,488,489,3549
1993,21,e) 4,3281,3446,30823,31114,102,2.8,448,12.3,5721,771,4950,2.5,18.4,6303,2643,3660,8.5,20.3,-582,-1.9,36.8,0,358,358,2194
1993,21,f) 5,2852,3015,29306,29632,92,2.9,348,11.1,4468,555,3913,1.9,15.1,5120,2070,3050,7,17.3,-652,-2.2,30.2,0,286,286,1774
1993,21,g) 6 to 10,11915,12847,154682,155138,360,2.7,1224,9.2,21072,2775,18297,1.8,13.6,21984,7741,14243,5,14.2,-912,-0.6,27.2,0,908,913,4966
1993,21,h) 11 to 15,7307,8162,126266,124507,217,2.6,577,6.9,16908,3311,13597,2.7,13.6,13389,4208,9181,3.4,10.8,3519,2.8,21.6,0,397,403,2672
1993,21,i) 16 to 20,1618,2357,36747,36720,96,4,160,6.7,4491,857,3634,2.3,12.2,4436,1122,3314,3.1,12.1,55,0.1,24.2,0,73,73,287
1993,21,l) Left Censored,14982,25588,727977,723363,1140,4.4,1867,7.2,86842,21166,65676,2.9,12,77613,24439,53174,3.4,10.7,9229,1.3,21.4,0,657,668,4106
1993,22,a) 0,6784,6817,46288,23229,6766,198.5,0,0,46118,46118,0,198.5,198.5,0,0,0,0,0,46118,198.5,0,0,,,
1993,22,b) 1,5074,5196,40897,40031,35,0.6,1295,22,13242,1451,11791,3.6,33.1,11510,6241,5269,15.6,28.8,1732,4.3,57.6,0,1088,1088,5589
1993,22,c) 2,4332,4493,40135,42160,144,3,770,16,8245,892,7353,2.1,19.6,12295,4333,7962,10.3,29.2,-4050,-9.6,39.2,0,616,616,3771
1993,22,d) 3,3703,3810,32746,34156,120,3,576,14.3,6102,473,5629,1.4,17.9,8922,4552,4370,13.3,26.1,-2820,-8.2,35.8,0,469,469,3929
1993,22,e) 4,3095,3193,28290,29501,99,3,401,12,4942,351,4591,1.2,16.8,7364,2902,4462,9.8,25,-2422,-8.2,33.6,0,344,347,2451
1993,22,f) 5,2819,3043,34310,34151,97,3.1,360,11.4,6145,730,5415,2.1,18,5827,2334,3493,6.8,17.1,318,0.9,34.2,0,262,262,1809
1993,22,g) 6 to 10,13258,14377,164651,169524,416,2.8,1344,9.1,24457,4297,20160,2.5,14.4,34202,13410,20792,7.9,20.2,-9745,-5.8,28.8,0,1015,1019,10009
1993,22,h) 11 to 15,10145,11499,151177,152401,327,2.8,815,6.9,21990,3105,18885,2,14.4,24438,6338,18100,4.2,16,-2448,-1.6,28.8,0,552,553,4052
1993,22,i) 16 to 20,1853,2626,42290,42186,97,3.6,189,7.1,6342,799,5543,1.9,15,6133,2240,3893,5.3,14.5,209,0.5,29,0,100,112,1164
1993,22,l) Left Censored,16238,28353,726920,733810,984,3.4,1979,6.9,82830,15236,67594,2.1,11.3,96612,25095,71517,3.4,13.2,-13782,-1.9,22.6,0,790,794,5272
1993,23,a) 0,2398,2407,11559,5817,2387,198.3,0,0,11485,11485,0,197.4,197.4,0,0,0,0,0,11485,197.4,0,0,,,
1993,23,b) 1,1754,1813,12291,11563,17,0.8,470,22.7,4319,156,4163,1.3,37.4,2863,1858,1005,16.1,24.8,1456,12.6,49.6,0,370,370,1480
1993,23,c) 2,1534,1588,13276,13554,45,2.6,287,16.7,2322,335,1987,2.5,17.1,2877,1553,1324,11.5,21.2,-555,-4.1,34.2,0,219,219,1315
1993,23,d) 3,1533,1561,10649,10753,63,3.8,244,14.7,2137,186,1951,1.7,19.9,2344,1054,1290,9.8,21.8,-207,-1.9,39.8,0,204,204,836
1993,23,e) 4,1592,1629,10762,10872,69,4,234,13.6,1836,206,1630,1.9,16.9,2055,1069,986,9.8,18.9,-219,-2,33.8,0,175,175,942
1993,23,f) 5,1459,1493,11034,10942,66,4.2,183,11.7,1888,208,1680,1.9,17.3,1703,715,988,6.5,15.6,185,1.7,31.2,0,143,143,629
1993,23,g) 6 to 10,5445,5779,53382,53213,180,3,562,9.4,7861,832,7029,1.6,14.8,7522,2870,4652,5.4,14.1,339,0.7,28.2,0,397,397,1973
1993,23,h) 11 to 15,3145,3511,41864,41751,95,2.6,264,7.3,5601,800,4801,1.9,13.4,5375,1623,3752,3.9,12.9,226,0.5,25.8,0,168,168,879
1993,23,i) 16 to 20,667,1034,13381,13205,42,4,58,5.6,1781,283,1498,2.1,13.5,1429,446,983,3.4,10.8,352,2.7,21.6,0,24,28,165
1993,23,l) Left Censored,5726,8875,225593,223685,300,3.3,604,6.7,27423,9729,17694,4.3,12.3,23607,6752,16855,3,10.6,3816,1.7,21.2,0,217,236,1289
1993,24,a) 0,8645,8700,47945,24094,8631,198.4,0,0,47703,47703,0,198,198,0,0,0,0,0,47703,198,0,0,,,
1993,24,b) 1,6408,6573,48562,48054,35,0.5,1683,22.5,13408,1043,12365,2.2,27.9,12391,6714,5677,14,25.8,1017,2.1,51.6,0,1314,1314,5643
1993,24,c) 2,5654,5801,43614,45700,231,3.7,1037,16.7,9235,1051,8184,2.3,20.2,13407,7109,6298,15.6,29.3,-4172,-9.1,40.4,0,820,826,5056
1993,24,d) 3,5365,5495,43102,44476,204,3.5,906,15.5,8291,1018,7273,2.3,18.6,11038,5240,5798,11.8,24.8,-2747,-6.2,37.2,0,704,704,4386
1993,24,e) 4,5045,5215,44136,44118,204,3.7,657,12.1,9141,1434,7707,3.3,20.7,9104,3369,5735,7.6,20.6,37,0.1,41.2,0,501,501,2658
1993,24,f) 5,4484,4661,44176,44917,149,3.1,596,12.2,7076,803,6273,1.8,15.8,8558,3418,5140,7.6,19.1,-1482,-3.3,31.6,0,447,447,2415
1993,24,g) 6 to 10,17347,18831,217705,220089,617,3.2,1876,9.6,33205,6379,26826,2.9,15.1,37972,14215,23757,6.5,17.3,-4767,-2.2,30.2,0,1293,1295,10632
1993,24,h) 11 to 15,10002,11401,148824,152130,345,3,883,7.6,18594,2712,15882,1.8,12.2,25206,8818,16388,5.8,16.6,-6612,-4.4,24.4,0,544,566,6151
1993,24,i) 16 to 20,2171,3384,57053,55267,128,3.7,214,6.2,10406,3474,6932,6.3,18.8,6834,1548,5286,2.8,12.4,3572,6.4,24.8,0,98,100,739
1993,24,l) Left Censored,19186,33814,1011501,1029508,1388,4,3083,8.9,112356,29677,82679,2.9,10.9,148370,40746,107624,4,14.4,-36014,-3.5,21.8,0,801,830,8049
1993,25,a) 0,9468,9496,52209,26198,9426,198.5,0,0,52023,52023,0,198.6,198.6,0,0,0,0,0,52023,198.6,0,0,,,
1993,25,b) 1,7267,7539,63617,59122,58,0.7,1607,19.1,20683,2520,18163,4.3,35,11693,5989,5704,10.1,19.8,8990,15.2,39.6,0,1263,1263,5017
1993,25,c) 2,6149,6351,51629,52189,225,3.3,1075,15.8,12874,1957,10917,3.7,24.7,13994,7056,6938,13.5,26.8,-1120,-2.1,49.4,0,829,850,5920
1993,25,d) 3,6007,6218,51790,53268,231,3.5,924,14,10052,952,9100,1.8,18.9,13008,5474,7534,10.3,24.4,-2956,-5.5,37.8,0,737,745,4465
1993,25,e) 4,6188,6463,54431,55437,225,3.3,854,12.6,9783,1098,8685,2,17.6,11795,5566,6229,10,21.3,-2012,-3.7,35.2,0,678,679,4540
1993,25,f) 5,5828,6122,73110,72482,206,3.2,746,11.7,11378,2021,9357,2.8,15.7,10122,3356,6766,4.6,14,1256,1.7,28,0,587,588,2712
1993,25,g) 6 to 10,23255,24821,292561,292061,875,3.4,2483,9.7,43359,4985,38374,1.7,14.8,42358,15554,26804,5.3,14.5,1001,0.3,29,0,1795,1805,10438
1993,25,h) 11 to 15,14328,16424,241267,239970,520,3.1,1357,8.1,36315,6698,29617,2.8,15.1,33720,10476,23244,4.4,14.1,2595,1,28.2,0,882,895,5279
1993,25,i) 16 to 20,2956,4403,112988,111783,159,3.6,288,6.5,16880,5417,11463,4.8,15.1,14470,5457,9013,4.9,12.9,2410,2.2,25.8,0,113,120,525
1993,25,l) Left Censored,31884,49145,1596114,1604547,1792,3.6,3743,7.5,188662,48260,140402,3,11.8,205528,57696,147832,3.6,12.8,-16866,-1,23.6,0,1527,1574,12289
1993,26,a) 0,14284,14344,82359,41292,14234,198.5,0,0,82135,82135,0,198.9,198.9,0,0,0,0,0,82135,198.9,0,0,,,
1993,26,b) 1,11336,11563,85343,82395,54,0.4,2691,20.7,26683,4066,22617,4.9,32.4,20787,10780,10007,13.1,25.2,5896,7.2,50.4,0,2093,2093,8691
1993,26,c) 2,10179,10506,81067,82535,335,3,1676,15,18620,2535,16085,3.1,22.6,21556,10982,10574,13.3,26.1,-2936,-3.5,45.2,0,1351,1352,9388
1993,26,d) 3,9611,9892,84915,84055,324,3.1,1438,13.7,19659,1551,18108,1.8,23.4,17939,7803,10136,9.3,21.3,1720,2.1,42.6,0,1099,1099,6078
1993,26,e) 4,8449,8770,75431,76173,263,2.9,1144,12.4,13971,1513,12458,2,18.3,15454,6374,9080,8.4,20.3,-1483,-2,36.6,0,897,897,4690
1993,26,f) 5,7549,7913,77254,77895,229,2.8,913,11.1,11849,1520,10329,2,15.2,13130,5091,8039,6.5,16.9,-1281,-1.7,30.4,0,709,711,3896
1993,26,g) 6 to 10,31229,34006,385528,390447,1029,2.9,3112,8.9,53869,9023,44846,2.3,13.8,63707,21676,42031,5.6,16.3,-9838,-2.5,27.6,0,2222,2242,13891
1993,26,h) 11 to 15,19750,22603,281945,284199,618,2.7,1611,7,37306,6169,31137,2.2,13.1,41814,11520,30294,4.1,14.7,-4508,-1.6,26.2,0,1079,1084,6639
1993,26,i) 16 to 20,4141,6219,108445,107702,187,3,403,6.4,15248,2628,12620,2.4,14.2,13762,3750,10012,3.5,12.8,1486,1.4,25.6,0,199,213,1617
1993,26,l) Left Censored,38021,65454,2137221,2135285,2254,3.4,4223,6.4,228069,43346,184723,2,10.7,224198,56990,167208,2.7,10.5,3871,0.2,21,0,1625,1666,12802
1993,27,a) 0,8324,8373,48793,24465,8325,198.9,0,0,48656,48656,0,198.9,198.9,0,0,0,0,0,48656,198.9,0,0,,,
1993,27,b) 1,6466,6621,48131,45759,47,0.6,1405,19,15446,3212,12234,7,33.8,10702,5877,4825,12.8,23.4,4744,10.4,46.8,0,1098,1098,4902
1993,27,c) 2,5708,5924,47052,46522,193,3.1,862,13.7,10505,947,9558,2,22.6,9444,4042,5402,8.7,20.3,1061,2.3,40.6,0,691,692,3441
1993,27,d) 3,5072,5258,43557,43482,152,2.7,708,12.8,8551,976,7575,2.2,19.7,8400,3707,4693,8.5,19.3,151,0.4,38.6,0,549,549,3047
1993,27,e) 4,4574,4740,40599,40571,161,3.3,522,10.6,7270,1010,6260,2.5,17.9,7214,3341,3873,8.2,17.8,56,0.1,35.6,0,414,414,2697
1993,27,f) 5,4041,4225,38566,38543,123,2.8,416,9.5,7208,596,6612,1.5,18.7,7161,2963,4198,7.7,18.6,47,0.1,37.2,0,320,320,2385
1993,27,g) 6 to 10,16649,18314,240730,242580,522,2.8,1488,7.9,31420,4424,26996,1.8,13,35120,12835,22285,5.3,14.5,-3700,-1.5,26,0,1052,1062,8523
1993,27,h) 11 to 15,11046,12675,169819,169763,379,2.9,805,6.2,24054,5412,18642,3.2,14.2,23941,7123,16818,4.2,14.1,113,0.1,28.2,0,536,541,3785
1993,27,i) 16 to 20,2510,3624,63948,62937,129,3.5,218,6,8123,1867,6256,3,12.9,6100,1787,4313,2.8,9.7,2023,3.2,19.4,0,102,106,968
1993,27,l) Left Censored,21826,35113,1164689,1160109,1321,3.7,2288,6.4,130756,31880,98876,2.7,11.3,121596,33810,87786,2.9,10.5,9160,0.8,21,0,865,911,6637
1993,28,a) 0,4343,4368,27559,13841,4316,197.6,0,0,27436,27436,0,198.2,198.2,0,0,0,0,0,27436,198.2,0,0,,,
1993,28,b) 1,2967,3049,21485,20770,21,0.6,900,25.6,7180,2361,4819,11.4,34.6,5749,3458,2291,16.6,27.7,1431,6.9,55.4,0,771,771,2971
1993,28,c) 2,2557,2650,20326,21009,91,3.2,483,16.9,4392,407,3985,1.9,20.9,5757,3326,2431,15.8,27.4,-1365,-6.5,41.8,0,405,405,3027
1993,28,d) 3,2373,2425,18857,19409,91,3.5,392,15.2,3502,338,3164,1.7,18,4606,2071,2535,10.7,23.7,-1104,-5.7,36,0,320,320,1483
1993,28,e) 4,1904,1950,17805,17479,77,3.7,285,13.8,4720,507,4213,2.9,27,4067,2175,1892,12.4,23.3,653,3.7,46.6,0,246,246,1610
1993,28,f) 5,1723,1862,18741,19574,67,3.4,243,12.5,3294,230,3064,1.2,16.8,4960,2704,2256,13.8,25.3,-1666,-8.5,33.6,0,189,189,1364
1993,28,g) 6 to 10,7889,8370,88376,88122,282,3.3,774,9,12524,1526,10998,1.7,14.2,12015,4216,7799,4.8,13.6,509,0.6,27.2,0,612,613,2889
1993,28,h) 11 to 15,5385,6073,73699,73075,214,3.5,439,7.1,10199,1765,8434,2.4,14,8950,2527,6423,3.5,12.2,1249,1.8,24.4,0,314,315,1419
1993,28,i) 16 to 20,1187,1622,20144,19781,60,3.6,118,7.2,2632,509,2123,2.6,13.3,1906,632,1274,3.2,9.6,726,3.7,19.2,0,63,64,252
1993,28,l) Left Censored,10090,17081,461603,461218,633,3.7,1118,6.5,50786,10384,40402,2.3,11,50015,16891,33124,3.7,10.8,771,0.2,21.6,0,490,495,5631
1993,29,a) 0,10202,10283,54505,27569,10204,198.5,0,0,53872,53872,0,195.4,195.4,0,0,0,0,0,53872,195.4,0,0,,,
1993,29,b) 1,7473,7633,54957,54762,40,0.5,2114,24.2,17340,1867,15473,3.4,31.7,16949,10277,6672,18.8,31,391,0.7,62,0,1739,1739,9164
1993,29,c) 2,6294,6545,47270,48975,214,3,1181,16.8,10268,1373,8895,2.8,21,13678,6736,6942,13.8,27.9,-3410,-6.9,42,0,978,980,5950
1993,29,d) 3,5677,5842,50936,51639,217,3.5,962,15.4,9869,1259,8610,2.4,19.1,11274,5303,5971,10.3,21.8,-1405,-2.7,38.2,0,802,802,4576
1993,29,e) 4,5306,5546,44719,45833,168,2.9,754,12.9,8045,757,7288,1.7,17.6,10273,4889,5384,10.7,22.4,-2228,-4.8,35.2,0,598,607,3978
1993,29,f) 5,4573,4797,45878,46639,156,3.1,595,11.9,7470,1669,5801,3.6,16,8991,3766,5225,8.1,19.3,-1521,-3.3,32,0,456,456,2426
1993,29,g) 6 to 10,19598,21171,233009,237951,597,2.7,1960,9,30133,4509,25624,1.9,12.7,40017,12003,28014,5,16.8,-9884,-4.1,25.4,0,1429,1432,8122
1993,29,h) 11 to 15,12234,13948,170223,172764,375,2.6,1050,7.3,21039,2820,18219,1.6,12.2,26120,9011,17109,5.2,15.1,-5081,-2.9,24.4,0,686,699,5651
1993,29,i) 16 to 20,2669,4058,67893,66858,125,3,268,6.5,9725,1355,8370,2,14.5,7655,2288,5367,3.4,11.4,2070,3.1,22.8,0,136,137,1015
1993,29,l) Left Censored,24206,40434,1237448,1246841,1415,3.4,2813,6.8,126540,26101,100439,2.1,10.1,145327,42658,102669,3.4,11.7,-18787,-1.6,20.2,0,1057,1097,8611
1993,30,a) 0,2168,2174,9041,4532,2158,198.5,0,0,9019,9019,0,199,199,0,0,0,0,0,9019,199,0,0,,,
1993,30,b) 1,1664,1681,9535,9514,6,0.3,427,22.3,2564,68,2496,0.7,26.9,2522,1409,1113,14.8,26.5,42,0.4,53,0,329,329,1124
1993,30,c) 2,1319,1339,8330,8696,47,3.3,227,15.8,1559,139,1420,1.6,17.9,2291,1097,1194,12.6,26.3,-732,-8.4,35.8,0,169,169,875
1993,30,d) 3,1156,1166,7932,7772,41,3.3,167,13.5,1737,248,1489,3.2,22.3,1417,605,812,7.8,18.2,320,4.1,36.4,0,137,137,531
1993,30,e) 4,988,1041,7497,7686,30,2.7,168,15.1,1180,141,1039,1.8,15.4,1558,863,695,11.2,20.3,-378,-4.9,30.8,0,139,139,757
1993,30,f) 5,927,959,7255,7406,32,3.2,121,12.1,1134,163,971,2.2,15.3,1436,493,943,6.7,19.4,-302,-4.1,30.6,0,91,91,333
1993,30,g) 6 to 10,4028,4351,38222,37874,159,3.5,424,9.4,7418,2696,4722,7.1,19.6,6721,2318,4403,6.1,17.7,697,1.9,35.4,0,300,300,1547
1993,30,h) 11 to 15,2948,3247,29740,29733,88,2.6,258,7.7,4219,372,3847,1.3,14.2,4204,1256,2948,4.2,14.1,15,0.1,28.2,0,179,181,934
1993,30,i) 16 to 20,611,792,9097,9156,24,3,52,6.5,1228,150,1078,1.6,13.4,1345,572,773,6.2,14.7,-117,-1.3,26.8,0,25,25,322
1993,30,l) Left Censored,4435,6717,115562,115835,222,3.2,475,6.9,13004,2735,10269,2.4,11.2,13550,3222,10328,2.8,11.7,-546,-0.5,22.4,0,217,225,1461
1993,31,a) 0,2900,2908,16191,8126,2881,198.1,0,0,16130,16130,0,198.5,198.5,0,0,0,0,0,16130,198.5,0,0,,,
1993,31,b) 1,2358,2402,16473,16310,12,0.4,556,20.6,4475,308,4167,1.9,27.4,4150,2065,2085,12.7,25.4,325,2,50.8,0,449,449,1800
1993,31,c) 2,1978,2045,12894,13139,57,2.6,345,15.7,2596,290,2306,2.2,19.8,3085,1585,1500,12.1,23.5,-489,-3.7,39.6,0,283,283,1287
1993,31,d) 3,1822,1894,15768,16051,52,2.6,254,12.7,2972,300,2672,1.9,18.5,3538,1405,2133,8.8,22,-566,-3.5,37,0,192,192,961
1993,31,e) 4,1663,1736,17553,17787,46,2.5,212,11.6,2408,239,2169,1.3,13.5,2876,1174,1702,6.6,16.2,-468,-2.7,27,0,177,177,937
1993,31,f) 5,1479,1608,14445,14543,56,3.4,174,10.4,2045,213,1832,1.5,14.1,2241,941,1300,6.5,15.4,-196,-1.3,28.2,0,138,138,674
1993,31,g) 6 to 10,6526,7093,83187,82732,188,2.6,581,8,11723,1377,10346,1.7,14.2,10813,3635,7178,4.4,13.1,910,1.1,26.2,0,427,430,2749
1993,31,h) 11 to 15,4711,5221,56233,56251,148,2.8,392,7.3,6678,1038,5640,1.8,11.9,6714,1902,4812,3.4,11.9,-36,0,23.8,0,290,291,1317
1993,31,i) 16 to 20,1069,1525,18276,18010,63,4.1,120,7.7,2531,559,1972,3.1,14.1,1999,650,1349,3.6,11.1,532,3,22.2,0,74,75,304
1993,31,l) Left Censored,9712,14591,362494,363534,500,3.4,919,6.2,35296,6076,29220,1.7,9.7,37376,8169,29207,2.2,10.3,-2080,-0.6,19.4,0,368,374,1966
1993,32,a) 0,3245,3256,21770,10919,3237,198.8,0,0,21703,21703,0,198.8,198.8,0,0,0,0,0,21703,198.8,0,0,,,
1993,32,b) 1,2238,2283,19999,19838,18,0.7,747,27.8,6636,335,6301,1.7,33.5,6314,3343,2971,16.9,31.8,322,1.7,63.6,0,622,623,2924
1993,32,c) 2,1873,1924,18368,18425,75,3.5,463,21.8,5902,389,5513,2.1,32,6016,3427,2589,18.6,32.7,-114,-0.7,64,0,363,363,3010
1993,32,d) 3,1691,1747,18132,18408,74,3.9,337,17.8,3602,443,3159,2.4,19.6,4154,1975,2179,10.7,22.6,-552,-3,39.2,0,269,269,1468
1993,32,e) 4,1480,1538,17507,18551,44,2.7,261,15.8,3446,254,3192,1.4,18.6,5533,3209,2324,17.3,29.8,-2087,-11.2,37.2,0,203,203,2997
1993,32,f) 5,1213,1270,16318,16664,58,4.4,165,12.4,2609,612,1997,3.7,15.7,3300,1137,2163,6.8,19.8,-691,-4.1,31.4,0,130,131,871
1993,32,g) 6 to 10,4545,5095,74157,75151,209,4,517,9.9,11847,2099,9748,2.8,15.8,13834,5520,8314,7.3,18.4,-1987,-2.6,31.6,0,363,364,3875
1993,32,h) 11 to 15,3146,3631,68473,68039,127,3.4,280,7.5,7187,849,6338,1.2,10.6,6318,1753,4565,2.6,9.3,869,1.3,18.6,0,183,183,1129
1993,32,i) 16 to 20,582,897,21942,21298,42,4.7,53,5.9,3326,1655,1671,7.8,15.6,2037,360,1677,1.7,9.6,1289,6,19.2,0,26,27,177
1993,32,l) Left Censored,4167,7147,292709,290275,520,7.2,709,9.8,35612,12229,23383,4.2,12.3,30744,8897,21847,3.1,10.6,4868,1.7,21.2,0,130,159,992
1993,33,a) 0,2338,2341,11018,5541,2316,197.9,0,0,10955,10955,0,197.7,197.7,0,0,0,0,0,10955,197.7,0,0,,,
1993,33,b) 1,1726,1786,11959,11701,10,0.5,475,23.3,3550,87,3463,0.7,30.3,3034,1762,1272,15.1,25.9,516,4.4,51.8,0,366,366,1454
1993,33,c) 2,1517,1553,11017,10873,56,3.4,285,17.1,2733,247,2486,2.3,25.1,2444,1402,1042,12.9,22.5,289,2.6,45,0,235,237,1228
1993,33,d) 3,1443,1474,10066,10168,46,2.9,226,14.4,2078,298,1780,2.9,20.4,2281,1169,1112,11.5,22.4,-203,-2,40.8,0,186,186,1006
1993,33,e) 4,1482,1535,16588,16949,55,3.4,228,14,1814,172,1642,1,10.7,2537,820,1717,4.8,15,-723,-4.3,21.4,0,178,178,697
1993,33,f) 5,1433,1491,11850,11908,55,3.5,199,12.8,2049,180,1869,1.5,17.2,2164,961,1203,8.1,18.2,-115,-1,34.4,0,166,166,848
1993,33,g) 6 to 10,5475,5775,56487,57179,192,3.2,623,10.4,8839,1409,7430,2.5,15.5,10222,3814,6408,6.7,17.9,-1383,-2.4,31,0,426,429,1940
1993,33,h) 11 to 15,2885,3161,35383,35545,92,2.8,272,8.4,4664,646,4018,1.8,13.1,4987,1539,3448,4.3,14,-323,-0.9,26.2,0,175,176,830
1993,33,i) 16 to 20,635,968,15839,15786,57,5.8,79,8.1,2170,723,1447,4.6,13.7,2063,783,1280,5,13.1,107,0.6,26.2,0,38,39,126
1993,33,l) Left Censored,5468,8661,239419,240557,365,4.1,619,7,25232,6737,18495,2.8,10.5,27507,7640,19867,3.2,11.4,-2275,-0.9,21,0,206,207,1224
1993,34,a) 0,15038,15054,74774,37707,14930,198.4,0,0,74134,74134,0,196.6,196.6,0,0,0,0,0,74134,196.6,0,0,,,
1993,34,b) 1,11103,11270,79102,76603,39,0.3,2800,21.9,25387,3567,21820,4.7,33.1,20388,10459,9929,13.7,26.6,4999,6.5,53.2,0,2129,2131,8408
1993,34,c) 2,9854,10045,67101,73443,323,3,1755,16.3,15039,1420,13619,1.9,20.5,27723,9104,18619,12.4,37.7,-12684,-17.2,41,0,1416,1416,7467
1993,34,d) 3,9231,9415,68281,70066,370,3.7,1411,14.2,14470,1366,13104,1.9,20.7,18039,6542,11497,9.3,25.7,-3569,-5,41.4,0,1086,1086,4906
1993,34,e) 4,8839,9057,76861,78333,341,3.6,1222,12.8,14067,1232,12835,1.6,18,17011,6904,10107,8.8,21.7,-2944,-3.7,36,0,951,951,5437
1993,34,f) 5,8502,8745,83397,83980,347,3.8,1031,11.4,13770,1857,11913,2.2,16.4,14935,5063,9872,6,17.8,-1165,-1.4,32.8,0,783,785,3797
1993,34,g) 6 to 10,32315,33996,374786,378726,1152,3.3,3259,9.3,54144,7090,47054,1.9,14.3,62024,20274,41750,5.4,16.4,-7880,-2.1,28.6,0,2376,2379,14595
1993,34,h) 11 to 15,20453,22173,262199,267107,603,2.7,1712,7.5,36418,5915,30503,2.2,13.6,46233,13871,32362,5.2,17.3,-9815,-3.7,27.2,0,1152,1158,6421
1993,34,i) 16 to 20,4243,5353,92446,93369,170,3.1,397,7.3,13451,1639,11812,1.8,14.4,15297,3454,11843,3.7,16.4,-1846,-2,28.8,0,208,212,1002
1993,34,l) Left Censored,39965,60906,1879709,1891924,2221,3.6,4445,7.2,232440,55773,176667,2.9,12.3,256870,73810,183060,3.9,13.6,-24430,-1.3,24.6,0,1882,1911,12447
1993,35,a) 0,3101,3106,16692,8392,3076,198.1,0,0,16601,16601,0,197.8,197.8,0,0,0,0,0,16601,197.8,0,0,,,
1993,35,b) 1,2301,2366,17221,16867,16,0.6,626,23.2,5164,802,4362,4.8,30.6,4455,2376,2079,14.1,26.4,709,4.2,52.8,0,507,507,1904
1993,35,c) 2,2075,2186,15950,16524,83,3.6,362,15.5,3423,526,2897,3.2,20.7,4571,2013,2558,12.2,27.7,-1148,-7,41.4,0,289,289,1636
1993,35,d) 3,1763,1790,13631,14171,68,3.6,289,15.2,2894,414,2480,2.9,20.4,3974,1651,2323,11.7,28,-1080,-7.6,40.8,0,227,227,1237
1993,35,e) 4,1577,1639,12518,12449,68,4,225,13.1,2584,407,2177,3.3,20.8,2445,1178,1267,9.5,19.6,139,1.2,39.2,0,172,172,847
1993,35,f) 5,1291,1380,13103,13494,58,4,169,11.8,2144,405,1739,3,15.9,2925,776,2149,5.8,21.7,-781,-5.8,31.8,0,135,135,666
1993,35,g) 6 to 10,5678,6218,69158,68797,253,4,598,9.4,10540,1729,8811,2.5,15.3,9818,3393,6425,4.9,14.3,722,1,28.6,0,425,425,2639
1993,35,h) 11 to 15,4060,4555,47682,47711,179,3.9,350,7.5,7110,1133,5977,2.4,14.9,7168,2361,4807,4.9,15,-58,-0.1,29.8,0,239,239,1295
1993,35,i) 16 to 20,818,1192,14209,14338,48,4,67,5.6,1909,255,1654,1.8,13.3,2167,410,1757,2.9,15.1,-258,-1.8,26.6,0,38,38,274
1993,35,l) Left Censored,5765,9436,230403,230153,403,4.2,709,7.4,30475,6435,24040,2.8,13.2,29975,9193,20782,4,13,500,0.2,26,0,223,226,1334
1993,36,a) 0,33309,33406,170572,85681,33157,198.5,0,0,169782,169782,0,198.2,198.2,0,0,0,0,0,169782,198.2,0,0,,,
1993,36,b) 1,25066,25465,188015,186209,84,0.3,6959,23.8,67916,14310,53606,7.7,36.5,64303,27394,36909,14.7,34.5,3613,2,69,0,5567,5568,22845
1993,36,c) 2,22227,22595,158954,165884,773,3.2,4384,17.9,34532,3969,30563,2.4,20.8,48392,23373,25019,14.1,29.2,-13860,-8.4,41.6,0,3610,3611,20389
1993,36,d) 3,20400,20754,147048,150944,736,3.3,3534,15.9,29778,3001,26777,2,19.7,37569,17518,20051,11.6,24.9,-7791,-5.2,39.4,0,2861,2863,14510
1993,36,e) 4,19319,19778,147843,153337,631,3,3019,14.4,25425,3067,22358,2,16.6,36412,16111,20301,10.5,23.7,-10987,-7.1,33.2,0,2406,2406,13158
1993,36,f) 5,17524,18015,162259,170022,543,2.9,2456,12.9,23673,4608,19065,2.7,13.9,39199,16459,22740,9.7,23.1,-15526,-9.2,27.8,0,1970,1975,13937
1993,36,g) 6 to 10,69181,72776,781192,806277,2196,2.9,7888,10.4,97769,12907,84862,1.6,12.1,147938,42278,105660,5.2,18.3,-50169,-6.2,24.2,0,5916,5943,30703
1993,36,h) 11 to 15,42264,46595,585622,592138,1242,2.6,3874,8.1,75593,10096,65497,1.7,12.8,88625,22795,65830,3.8,15,-13032,-2.2,25.6,0,2822,2843,15046
1993,36,i) 16 to 20,8461,11925,236180,234703,390,3.2,881,7.3,39702,14376,25326,6.1,16.9,36748,10691,26057,4.6,15.7,2954,1.2,31.4,0,469,481,2710
1993,36,l) Left Censored,88288,132050,4009800,4072941,4766,3.5,10526,7.8,442616,103703,338913,2.5,10.9,568899,144346,424553,3.5,14,-126283,-3.1,21.8,0,4777,4892,31765
1993,37,a) 0,12228,12275,63754,32047,12163,198.2,0,0,63415,63415,0,197.9,197.9,0,0,0,0,0,63415,197.9,0,0,,,
1993,37,b) 1,9140,9382,73371,69851,56,0.5,2451,22.9,24166,2859,21307,4.1,34.6,17125,9960,7165,14.3,24.5,7041,10.1,49,0,2006,2006,8517
1993,37,c) 2,8096,8384,62110,64242,268,3,1485,16.4,14532,1844,12688,2.9,22.6,18796,8491,10305,13.2,29.3,-4264,-6.7,45.2,0,1238,1240,7490
1993,37,d) 3,7532,7760,63001,62005,270,3.3,1204,14.6,14253,1389,12864,2.2,23,12260,6112,6148,9.9,19.8,1993,3.2,39.6,0,939,940,4803
1993,37,e) 4,6719,7004,61754,61883,257,3.5,907,12.4,11576,1780,9796,2.9,18.7,11833,5040,6793,8.1,19.1,-257,-0.4,37.4,0,734,735,4201
1993,37,f) 5,6020,6317,67115,67486,206,3.1,785,11.8,10524,955,9569,1.4,15.6,11265,4725,6540,7,16.7,-741,-1.1,31.2,0,594,594,3369
1993,37,g) 6 to 10,26300,28722,300679,301718,863,2.9,2511,8.5,42608,5554,37054,1.8,14.1,44685,14862,29823,4.9,14.8,-2077,-0.7,28.2,0,1832,1843,10327
1993,37,h) 11 to 15,14881,17118,235659,238428,520,3,1163,6.7,30680,5767,24913,2.4,12.9,36218,10427,25791,4.4,15.2,-5538,-2.3,25.8,0,792,805,7041
1993,37,i) 16 to 20,3044,4491,79263,78359,158,3.5,332,7.3,10420,1560,8860,2,13.3,8611,2961,5650,3.8,11,1809,2.3,22,0,139,147,746
1993,37,l) Left Censored,27404,51328,1694591,1689570,1955,3.8,3250,6.3,183879,39258,144621,2.3,10.9,173837,47960,125877,2.8,10.3,10042,0.6,20.6,0,1191,1226,9730
1993,38,a) 0,1237,1239,6050,3039,1227,198.1,0,0,6023,6023,0,198.2,198.2,0,0,0,0,0,6023,198.2,0,0,,,
1993,38,b) 1,927,937,5401,5335,5,0.5,227,21.4,1460,49,1411,0.9,27.4,1328,658,670,12.3,24.9,132,2.5,49.8,0,176,176,529
1993,38,c) 2,825,845,5258,5424,26,2.9,150,16.5,934,129,805,2.4,17.2,1266,627,639,11.6,23.3,-332,-6.1,34.4,0,126,126,546
1993,38,d) 3,761,791,5076,5100,28,3.3,114,13.6,1002,212,790,4.2,19.6,1050,423,627,8.3,20.6,-48,-1,39.2,0,92,92,276
1993,38,e) 4,652,665,4511,4642,19,2.7,81,11.7,703,95,608,2,15.1,964,617,347,13.3,20.8,-261,-5.7,30.2,0,65,65,551
1993,38,f) 5,611,636,5815,5944,17,2.5,91,13.5,719,54,665,0.9,12.1,976,396,580,6.7,16.4,-257,-4.3,24.2,0,71,71,340
1993,38,g) 6 to 10,2818,3076,26614,26516,102,3.2,247,7.8,3664,443,3221,1.7,13.8,3468,1253,2215,4.7,13.1,196,0.7,26.2,0,174,175,950
1993,38,h) 11 to 15,2191,2400,23560,23339,67,2.7,154,6.3,3245,474,2771,2,13.9,2803,759,2044,3.3,12,442,1.9,24,0,110,110,413
1993,38,i) 16 to 20,468,627,7601,7556,18,2.9,29,4.6,989,95,894,1.3,13.1,899,131,768,1.7,11.9,90,1.2,23.8,0,18,18,43
1993,38,l) Left Censored,4245,6235,122126,121628,187,3,338,5.4,11587,2305,9282,1.9,9.5,10591,2780,7811,2.3,8.7,996,0.8,17.4,0,144,145,887
1993,39,a) 0,15868,15941,91649,46083,15796,198.2,0,0,91133,91133,0,197.8,197.8,0,0,0,0,0,91133,197.8,0,0,,,
1993,39,b) 1,12214,12521,89205,88690,57,0.4,2929,20.8,25142,1586,23556,1.8,28.3,24112,14109,10003,15.9,27.2,1030,1.1,54.4,0,2357,2357,12090
1993,39,c) 2,10858,11228,85325,88823,323,2.7,1866,15.5,17554,1782,15772,2,19.8,24550,12784,11766,14.4,27.6,-6996,-7.8,39.6,0,1523,1525,10728
1993,39,d) 3,10080,10469,87714,89009,323,2.9,1452,13.1,16265,1810,14455,2,18.3,18854,8018,10836,9,21.2,-2589,-2.9,36.6,0,1169,1169,6636
1993,39,e) 4,9238,9815,97901,98746,335,3.3,1237,12,18506,3605,14901,3.7,18.7,20196,8721,11475,8.8,20.5,-1690,-1.8,37.4,0,978,982,6178
1993,39,f) 5,8274,8774,96823,96113,285,3.1,1011,11.1,17448,2474,14974,2.6,18.2,16027,6345,9682,6.6,16.7,1421,1.5,33.4,0,793,793,5081
1993,39,g) 6 to 10,34406,37877,466286,465709,1103,2.8,3269,8.4,67325,10371,56954,2.2,14.5,66171,20959,45212,4.5,14.2,1154,0.3,28.4,0,2332,2377,13716
1993,39,h) 11 to 15,23390,26911,371350,366300,674,2.5,1832,6.7,55754,11595,44159,3.2,15.2,45653,12218,33435,3.3,12.5,10101,2.7,25,0,1195,1205,7401
1993,39,i) 16 to 20,5079,7802,142618,142891,243,3.1,539,6.8,18303,4613,13690,3.2,12.8,18849,5554,13295,3.9,13.2,-546,-0.4,25.6,0,210,228,1292
1993,39,l) Left Censored,49826,87522,2719222,2723742,2984,3.3,6423,7.2,300578,62100,238478,2.3,11,309618,92678,216940,3.4,11.4,-9040,-0.4,22,0,2097,2148,14306
1993,40,a) 0,6126,6137,30776,15508,6081,198.2,0,0,30537,30537,0,196.9,196.9,0,0,0,0,0,30537,196.9,0,0,,,
1993,40,b) 1,4536,4619,30206,31021,14,0.3,1343,25.2,8690,976,7714,3.1,28,10319,5717,4602,18.4,33.3,-1629,-5.3,56,0,1107,1107,4946
1993,40,c) 2,3754,3865,27240,29138,130,3.1,782,18.6,5522,638,4884,2.2,19,9317,5703,3614,19.6,32,-3795,-13,38,0,624,624,3964
1993,40,d) 3,3380,3461,25788,25672,127,3.5,505,13.8,5924,1008,4916,3.9,23.1,5692,2488,3204,9.7,22.2,232,0.9,44.4,0,416,416,2199
1993,40,e) 4,2870,2942,26819,27492,95,3.1,389,12.6,4413,866,3547,3.2,16.1,5758,2049,3709,7.5,20.9,-1345,-4.8,32.2,0,321,321,1734
1993,40,f) 5,2468,2591,23647,24145,78,2.9,350,12.8,4965,570,4395,2.4,20.6,5960,3616,2344,15,24.7,-995,-4.1,41.2,0,281,282,1972
1993,40,g) 6 to 10,11550,12502,132006,132473,373,2.9,1130,8.8,17810,2788,15022,2.1,13.4,18743,6195,12548,4.7,14.1,-933,-0.7,26.8,0,824,828,4343
1993,40,h) 11 to 15,8471,9515,107986,108535,319,3.3,716,7.4,14556,3001,11555,2.8,13.4,15653,4318,11335,4,14.4,-1097,-1,26.8,0,463,477,2476
1993,40,i) 16 to 20,1534,2310,34036,33611,79,3.4,139,5.9,4342,634,3708,1.9,12.9,3492,828,2664,2.5,10.4,850,2.5,20.8,0,69,69,288
1993,40,l) Left Censored,13108,22013,537686,536871,772,3.4,1567,7,62420,15329,47091,2.9,11.6,60789,17427,43362,3.2,11.3,1631,0.3,22.6,0,547,550,2902
1993,41,a) 0,7099,7132,32376,16267,7065,198.1,0,0,32218,32218,0,198.1,198.1,0,0,0,0,0,32218,198.1,0,0,,,
1993,41,b) 1,5267,5393,36871,37110,24,0.4,1565,25.1,10320,952,9368,2.6,27.8,10798,5913,4885,15.9,29.1,-478,-1.3,55.6,0,1200,1200,4774
1993,41,c) 2,4594,4714,30782,31760,203,4,853,16.9,6648,1035,5613,3.3,20.9,8604,3952,4652,12.4,27.1,-1956,-6.2,41.8,0,658,658,3083
1993,41,d) 3,4474,4596,31952,32256,158,3.2,691,14.2,6652,805,5847,2.5,20.6,7260,3166,4094,9.8,22.5,-608,-1.9,41.2,0,538,538,2655
1993,41,e) 4,3099,3208,27316,27403,111,3.3,401,12,5283,843,4440,3.1,19.3,5456,2114,3342,7.7,19.9,-173,-0.6,38.6,0,308,308,1379
1993,41,f) 5,3198,3298,29295,29757,148,4.3,413,12,5053,678,4375,2.3,17,5977,2425,3552,8.1,20.1,-924,-3.1,34,0,334,335,1995
1993,41,g) 6 to 10,12387,13458,146924,148163,504,3.6,1320,9.5,21926,3751,18175,2.5,14.8,24404,8066,16338,5.4,16.5,-2478,-1.7,29.6,0,939,946,4812
1993,41,h) 11 to 15,8831,9896,109553,109719,312,3.1,681,6.7,15471,2400,13071,2.2,14.1,15802,5042,10760,4.6,14.4,-331,-0.3,28.2,0,458,464,3035
1993,41,i) 16 to 20,1735,2490,42394,41543,82,3.2,161,6.4,6206,820,5386,2,14.9,4503,889,3614,2.1,10.8,1703,4.1,21.6,0,67,74,357
1993,41,l) Left Censored,12940,21659,566098,564899,838,3.8,1721,7.8,70640,15518,55122,2.7,12.5,68241,20381,47860,3.6,12.1,2399,0.4,24.2,0,554,561,3457
1993,42,a) 0,16249,16319,93502,46925,16201,198.6,0,0,93154,93154,0,198.5,198.5,0,0,0,0,0,93154,198.5,0,0,,,
1993,42,b) 1,13330,13664,107131,106599,73,0.5,3162,20.6,28712,2026,26686,1.9,26.9,27648,14050,13598,13.2,25.9,1064,1,51.8,0,2534,2534,11427
1993,42,c) 2,12264,12632,94742,97790,372,2.8,2031,15,19285,1861,17424,1.9,19.7,25380,12206,13174,12.5,26,-6095,-6.3,39.4,0,1677,1678,10281
1993,42,d) 3,11696,12014,92528,94723,380,3,1742,13.7,16538,1978,14560,2.1,17.5,20928,9049,11879,9.6,22.1,-4390,-4.6,35,0,1448,1452,7119
1993,42,e) 4,11240,11683,99815,103684,340,2.8,1449,11.8,15145,2065,13080,2,14.6,22883,8202,14681,7.9,22.1,-7738,-7.5,29.2,0,1172,1178,6848
1993,42,f) 5,10133,10632,95709,97837,269,2.4,1204,10.8,14519,1689,12830,1.7,14.8,18774,7040,11734,7.2,19.2,-4255,-4.4,29.6,0,968,970,5974
1993,42,g) 6 to 10,41577,44703,513646,520527,1260,2.7,3919,8.5,64407,9110,55297,1.8,12.4,78169,25638,52531,4.9,15,-13762,-2.6,24.8,0,2944,2967,19463
1993,42,h) 11 to 15,25790,29128,368381,373935,702,2.4,2079,7,44604,6358,38246,1.7,11.9,55712,15882,39830,4.2,14.9,-11108,-3,23.8,0,1389,1405,9878
1993,42,i) 16 to 20,5720,8256,160712,161581,207,2.5,595,7.1,16769,2453,14316,1.5,10.4,18506,4557,13949,2.8,11.5,-1737,-1.1,20.8,0,273,280,1378
1993,42,l) Left Censored,56518,93996,2872225,2882981,3067,3.2,6636,6.9,308972,78721,230251,2.7,10.7,330484,89826,240658,3.1,11.5,-21512,-0.8,21.4,0,2634,2692,19403
1993,44,a) 0,1819,1819,8446,4241,1806,198.6,0,0,8410,8410,0,198.3,198.3,0,0,0,0,0,8410,198.3,0,0,,,
1993,44,b) 1,1366,1378,15115,12196,3,0.2,345,22.1,8244,,,,67.6,2405,1430,975,11.7,19.7,5839,47.9,39.4,1,259,259,1094
1993,44,c) 2,1165,1176,8860,8785,48,3.8,211,16.8,1977,158,1819,1.8,22.5,1826,1017,809,11.6,20.8,151,1.7,41.6,0,171,171,719
1993,44,d) 3,1154,1177,7744,7762,45,3.6,173,14,1520,264,1256,3.4,19.6,1556,778,778,10,20,-36,-0.4,39.2,0,138,138,648
1993,44,e) 4,1197,1227,11104,11182,51,4,170,13.2,1997,369,1628,3.3,17.9,2153,1232,921,11,19.3,-156,-1.4,35.8,0,130,130,1117
1993,44,f) 5,1093,1132,9447,9359,49,4.1,148,12.5,1767,221,1546,2.4,18.9,1590,678,912,7.2,17,177,1.9,34,0,104,104,531
1993,44,g) 6 to 10,4124,4279,38978,39346,148,3.4,402,9.1,5319,655,4664,1.7,13.5,6054,2068,3986,5.3,15.4,-735,-1.9,27,0,287,287,1557
1993,44,h) 11 to 15,2478,2670,30756,30219,95,3.5,225,8.2,4861,614,4247,2,16.1,3787,1436,2351,4.8,12.5,1074,3.6,25,0,130,130,643
1993,44,i) 16 to 20,587,725,12784,12606,20,2.7,44,6,1824,,,,14.5,1468,267,1201,2.1,11.6,356,2.9,23.2,1,19,19,62
1993,44,l) Left Censored,6071,8105,228848,231697,316,3.9,516,6.3,21555,6482,15073,2.8,9.3,27252,8122,19130,3.5,11.8,-5697,-2.5,18.6,0,225,230,1544
1993,45,a) 0,6362,6393,33617,16904,6328,198,0,0,33426,33426,0,197.7,197.7,0,0,0,0,0,33426,197.7,0,0,,,
1993,45,b) 1,4740,4839,38440,38115,21,0.4,1366,24.5,11107,704,10403,1.8,29.1,10456,6081,4375,16,27.4,651,1.7,54.8,0,1140,1140,5136
1993,45,c) 2,4149,4314,32260,32988,146,3.1,820,17.6,6170,699,5471,2.1,18.7,7625,3746,3879,11.4,23.1,-1455,-4.4,37.4,0,689,689,3111
1993,45,d) 3,3705,3799,29194,30410,134,3.3,609,15.1,5274,554,4720,1.8,17.3,7706,4028,3678,13.2,25.3,-2432,-8,34.6,0,479,481,3237
1993,45,e) 4,3232,3453,30644,31103,152,4.2,444,12.3,5798,753,5045,2.4,18.6,6716,2704,4012,8.7,21.6,-918,-3,37.2,0,357,357,2246
1993,45,f) 5,2960,3155,33065,34178,96,2.9,423,12.7,4191,782,3409,2.3,12.3,6417,2613,3804,7.6,18.8,-2226,-6.5,24.6,0,335,337,1718
1993,45,g) 6 to 10,12598,13805,152629,154866,427,3,1233,8.7,21516,3368,18148,2.2,13.9,25990,7559,18431,4.9,16.8,-4474,-2.9,27.8,0,881,889,4764
1993,45,h) 11 to 15,7339,8556,111073,111008,268,3.1,595,6.8,14744,1980,12764,1.8,13.3,14614,4609,10005,4.2,13.2,130,0.1,26.4,0,393,395,2159
1993,45,i) 16 to 20,1514,2119,29190,29047,111,5.2,175,8.1,4826,1272,3554,4.4,16.6,4539,1592,2947,5.5,15.6,287,1,31.2,0,80,82,357
1993,45,l) Left Censored,13264,24318,785766,785659,1076,4.4,1618,6.6,79364,20073,59291,2.6,10.1,79149,22673,56476,2.9,10.1,215,0,20.2,0,532,540,2824
1993,46,a) 0,1510,1513,7625,3826,1505,198.9,0,0,7598,7598,0,198.6,198.6,0,0,0,0,0,7598,198.6,0,0,,,
1993,46,b) 1,1159,1187,7639,7309,7,0.5,278,20.7,2452,,,,33.5,1791,962,829,13.2,24.5,661,9,49,1,216,216,745
1993,46,c) 2,1027,1048,7861,7825,33,2.9,177,15.8,1609,147,1462,1.9,20.6,1537,836,701,10.7,19.6,72,1,39.2,0,144,144,766
1993,46,d) 3,997,1016,7663,7768,34,3.2,134,12.6,1427,119,1308,1.5,18.4,1637,819,818,10.5,21.1,-210,-2.7,36.8,0,103,103,738
1993,46,e) 4,757,785,6084,5936,23,2.8,93,11.3,1200,270,930,4.5,20.2,904,446,458,7.5,15.2,296,5,30.4,0,74,74,397
1993,46,f) 5,710,742,5799,5808,26,3.4,83,10.7,819,151,668,2.6,14.1,837,422,415,7.3,14.4,-18,-0.3,28.2,0,61,61,259
1993,46,g) 6 to 10,3129,3374,34119,34449,107,3.1,285,8.2,4321,649,3672,1.9,12.5,4980,1501,3479,4.4,14.5,-659,-2,25,0,204,204,1000
1993,46,h) 11 to 15,2154,2360,28763,28169,82,3.4,160,6.7,4147,428,3719,1.5,14.7,2958,729,2229,2.6,10.5,1189,4.2,21,0,115,116,489
1993,46,i) 16 to 20,485,655,6515,6629,25,3.8,35,5.3,723,,,,10.9,951,200,751,3,14.3,-228,-3.4,21.8,1,21,21,143
1993,46,l) Left Censored,4532,6429,132298,131468,187,2.9,405,6.2,15122,4286,10836,3.3,11.5,13462,4761,8701,3.6,10.2,1660,1.3,20.4,0,177,186,1014
1993,47,a) 0,9092,9147,53710,26941,9082,198.6,0,0,53539,53539,0,198.7,198.7,0,0,0,0,0,53539,198.7,0,0,,,
1993,47,b) 1,6535,6713,55351,53668,49,0.6,1870,24.3,19039,2940,16099,5.5,35.5,15673,8432,7241,15.7,29.2,3366,6.3,58.4,0,1581,1581,7169
1993,47,c) 2,5489,5730,53012,57047,214,3.5,1112,17.9,11013,1257,9756,2.2,19.3,19082,9915,9167,17.4,33.4,-8069,-14.1,38.6,0,893,905,8434
1993,47,d) 3,4958,5116,43655,44770,186,3.4,864,15.8,9760,1559,8201,3.5,21.8,11990,5363,6627,12,26.8,-2230,-5,43.6,0,712,712,4592
1993,47,e) 4,4451,4700,42605,43215,150,3,600,12.2,7773,1183,6590,2.7,18,8993,3752,5241,8.7,20.8,-1220,-2.8,36,0,470,471,3234
1993,47,f) 5,4040,4280,46472,47163,130,2.9,499,11.2,8050,695,7355,1.5,17.1,9431,3388,6043,7.2,20,-1381,-2.9,34.2,0,397,401,2818
1993,47,g) 6 to 10,17432,18957,229153,228678,571,2.9,1621,8.3,32978,4995,27983,2.2,14.4,32028,11365,20663,5,14,950,0.4,28,0,1156,1172,7178
1993,47,h) 11 to 15,10395,11969,160581,161883,383,3.1,833,6.8,20659,3424,17235,2.1,12.8,23263,6160,17103,3.8,14.4,-2604,-1.6,25.6,0,559,572,3224
1993,47,i) 16 to 20,2358,3936,87964,88558,316,8.1,233,6,17815,8876,8939,10,20.1,19003,2086,16917,2.4,21.5,-1188,-1.4,40.2,0,107,113,813
1993,47,l) Left Censored,19919,35952,1172673,1166719,1346,3.7,2496,6.8,134286,24169,110117,2.1,11.5,122378,34678,87700,3,10.5,11908,1,21,0,830,860,5371
1993,48,a) 0,34879,35090,215253,108126,34811,198.4,0,0,214254,214254,0,198.2,198.2,0,0,0,0,0,214254,198.2,0,0,,,
1993,48,b) 1,26047,26806,241288,240319,144,0.5,7507,24.3,73005,7057,65948,2.9,30.4,71067,41259,29808,17.2,29.6,1938,0.8,59.2,0,6214,6221,34565
1993,48,c) 2,21937,22894,196594,210312,812,3.3,4547,18.3,47414,5232,42182,2.5,22.5,74849,41900,32949,19.9,35.6,-27435,-13.1,45,0,3741,3749,37588
1993,48,d) 3,18786,19638,183064,185228,671,3.2,3196,15.3,40413,6414,33999,3.5,21.8,44741,21202,23539,11.4,24.2,-4328,-2.4,43.6,0,2590,2620,17260
1993,48,e) 4,15705,16688,160414,164332,629,3.6,2391,13.6,32311,7041,25270,4.3,19.7,40147,18214,21933,11.1,24.4,-7836,-4.7,39.4,0,1884,1892,14938
1993,48,f) 5,13564,14708,154883,157296,475,3.1,2105,13.5,29807,4699,25108,3,18.9,34632,15920,18712,10.1,22,-4825,-3.1,37.8,0,1547,1552,10820
1993,48,g) 6 to 10,58456,65276,765991,771039,2395,3.6,6502,9.7,127725,22243,105482,2.9,16.6,137821,48886,88935,6.3,17.9,-10096,-1.3,33.2,0,4670,4760,32434
1993,48,h) 11 to 15,41083,47801,598180,596316,1609,3.3,3929,8,94373,17328,77045,2.9,15.8,90645,28514,62131,4.8,15.2,3728,0.6,30.4,0,2567,2615,16320
1993,48,i) 16 to 20,7019,11251,180242,177874,379,3.3,797,7,28821,6804,22017,3.8,16.2,24084,8513,15571,4.8,13.5,4737,2.7,27,0,355,363,2301
1993,48,l) Left Censored,52575,111178,3471622,3467920,5663,5,9559,8.4,496141,119442,376699,3.4,14.3,488737,149414,339323,4.3,14.1,7404,0.2,28.2,0,2618,2662,15918
1993,49,a) 0,3730,3749,23447,11750,3730,199,0,0,23395,23395,0,199.1,199.1,0,0,0,0,0,23395,199.1,0,0,,,
1993,49,b) 1,2712,2758,23716,22182,12,0.4,730,23.2,8682,1143,7539,5.2,39.1,5614,3396,2218,15.3,25.3,3068,13.8,50.6,0,577,577,2897
1993,49,c) 2,2157,2231,20489,20670,81,3.4,374,15.6,5474,598,4876,2.9,26.5,5835,3106,2729,15,28.2,-361,-1.7,53,0,308,310,2626
1993,49,d) 3,1760,1841,19425,19399,57,2.9,288,14.7,4329,335,3994,1.7,22.3,4277,2304,1973,11.9,22,52,0.3,44,0,220,220,1859
1993,49,e) 4,1578,1635,23146,22613,47,2.7,215,12.5,4884,653,4231,2.9,21.6,3818,1444,2374,6.4,16.9,1066,4.7,33.8,0,162,162,1093
1993,49,f) 5,1362,1481,20401,20182,63,4.1,191,12.3,4363,672,3691,3.3,21.6,3924,1997,1927,9.9,19.4,439,2.2,38.8,0,149,150,1740
1993,49,g) 6 to 10,5257,5799,82689,81499,220,3.7,560,9.4,14133,1912,12221,2.3,17.3,11753,4084,7669,5,14.4,2380,2.9,28.8,0,410,411,3077
1993,49,h) 11 to 15,3924,4432,68540,68042,170,3.7,390,8.6,10128,1013,9115,1.5,14.9,9131,4062,5069,6,13.4,997,1.5,26.8,0,240,244,2322
1993,49,i) 16 to 20,790,1080,19258,19026,39,3.6,73,6.7,2640,324,2316,1.7,13.9,2176,869,1307,4.6,11.4,464,2.5,22.8,0,36,36,255
1993,49,l) Left Censored,6152,10523,346826,344897,522,4.9,796,7.5,38774,8655,30119,2.5,11.2,34915,12499,22416,3.6,10.1,3859,1.1,20.2,0,281,287,2244
1993,50,a) 0,1474,1476,6073,3046,1465,198.5,0,0,6054,6054,0,198.8,198.8,0,0,0,0,0,6054,198.8,0,0,,,
1993,50,b) 1,1034,1045,6455,6423,4,0.3,261,22.1,1594,43,1551,0.7,24.8,1530,978,552,15.2,23.8,64,1,47.6,0,203,203,847
1993,50,c) 2,942,964,5234,5478,16,1.5,170,16.3,907,110,797,2,16.6,1394,747,647,13.6,25.4,-487,-8.8,33.2,0,131,131,676
1993,50,d) 3,997,1023,5556,5530,34,3.1,156,14.4,1189,184,1005,3.3,21.5,1137,587,550,10.6,20.6,52,0.9,41.2,0,131,131,485
1993,50,e) 4,1023,1046,7386,7442,35,3.2,122,11.2,1196,150,1046,2,16.1,1307,502,805,6.7,17.6,-111,-1.5,32.2,0,94,94,421
1993,50,f) 5,866,879,5357,5528,33,3.6,110,12,923,65,858,1.2,16.7,1265,443,822,8,22.9,-342,-6.2,33.4,0,83,83,354
1993,50,g) 6 to 10,3426,3589,29746,29481,108,2.9,328,8.9,4561,593,3968,2,15.5,4031,1411,2620,4.8,13.7,530,1.8,27.4,0,235,236,949
1993,50,h) 11 to 15,1873,2038,19689,19684,57,2.7,164,7.8,2623,290,2333,1.5,13.3,2612,894,1718,4.5,13.3,11,0,26.6,0,121,121,674
1993,50,i) 16 to 20,401,537,9818,9629,21,3.8,40,7.3,1269,217,1052,2.3,13.2,891,195,696,2,9.3,378,3.9,18.6,0,20,20,87
1993,50,l) Left Censored,3398,4863,118502,118408,159,3.2,309,6.3,11117,2673,8444,2.3,9.4,10928,3734,7194,3.2,9.2,189,0.2,18.4,0,124,125,912
1993,51,a) 0,11334,11370,61284,30754,11287,198.5,0,0,61060,61060,0,198.5,198.5,0,0,0,0,0,61060,198.5,0,0,,,
1993,51,b) 1,8527,8804,64303,63348,51,0.5,2264,22.6,18766,1018,17748,1.6,29.6,16855,9880,6975,15.6,26.6,1911,3,53.2,0,1825,1825,8467
1993,51,c) 2,7359,7567,56623,57352,253,3.1,1288,15.9,12978,1461,11517,2.5,22.6,14436,6970,7466,12.2,25.2,-1458,-2.6,45.2,0,1030,1031,5369
1993,51,d) 3,6976,7200,53852,53945,275,3.6,1121,14.7,11282,1365,9917,2.5,20.9,11467,5648,5819,10.5,21.3,-185,-0.4,41.8,0,883,883,4671
1993,51,e) 4,6152,6432,53525,53787,207,3.1,856,12.6,9588,1046,8542,1.9,17.8,10112,4373,5739,8.1,18.8,-524,-1,35.6,0,677,677,3767
1993,51,f) 5,5733,6040,58825,59552,220,3.5,724,11.5,9096,1734,7362,2.9,15.3,10549,4407,6142,7.4,17.7,-1453,-2.4,30.6,0,540,540,3201
1993,51,g) 6 to 10,22749,24902,279866,279869,839,3.3,2293,8.9,43180,6520,36660,2.3,15.4,43185,16020,27165,5.7,15.4,-5,0,30.8,0,1605,1612,10088
1993,51,h) 11 to 15,13116,15172,212289,215443,460,3,1178,7.6,28579,6043,22536,2.8,13.3,34887,9334,25553,4.3,16.2,-6308,-2.9,26.6,0,765,778,5070
1993,51,i) 16 to 20,2733,4363,74063,73420,154,3.5,274,6.2,10287,2343,7944,3.2,14,9000,2091,6909,2.8,12.3,1287,1.7,24.6,0,108,112,528
1993,51,l) Left Censored,23550,46053,1470155,1423108,1972,4.2,3296,7.1,262629,44858,217771,3.2,18.5,168534,45523,123011,3.2,11.8,94095,6.7,23.6,0,970,1000,6874
1993,53,a) 0,12592,12629,59951,30318,12517,198.2,0,0,59266,59266,0,195.5,195.5,0,0,0,0,0,59266,195.5,0,0,,,
1993,53,b) 1,9480,9727,63723,64218,49,0.4,2851,25.3,18263,1243,17020,1.9,28.4,19252,11179,8073,17.4,30,-989,-1.6,56.8,0,2191,2191,8989
1993,53,c) 2,7840,8049,57846,58222,319,3.7,1486,17.1,14377,2333,12044,4,24.7,15129,7434,7695,12.8,26,-752,-1.3,49.4,0,1150,1156,6262
1993,53,d) 3,7937,8205,62929,64192,341,3.9,1280,14.7,13384,1943,11441,3,20.8,15910,6648,9262,10.4,24.8,-2526,-4,41.6,0,975,976,5323
1993,53,e) 4,4924,5131,47341,49416,171,3.2,728,13.4,8391,790,7601,1.6,17,12541,4647,7894,9.4,25.4,-4150,-8.4,34,0,574,576,3257
1993,53,f) 5,5140,5369,50346,51385,195,3.5,737,13,8247,951,7296,1.9,16,10325,4698,5627,9.1,20.1,-2078,-4.1,32,0,559,560,3593
1993,53,g) 6 to 10,20882,22815,264937,267830,835,3.6,2162,9.2,37780,6021,31759,2.2,14.1,43566,13693,29873,5.1,16.3,-5786,-2.2,28.2,0,1485,1487,9181
1993,53,h) 11 to 15,13633,15485,191378,191404,542,3.4,1156,7.3,28081,5707,22374,3,14.7,28133,7607,20526,4,14.7,-52,0,29.4,0,739,760,4524
1993,53,i) 16 to 20,2732,3950,62636,62004,181,4.5,271,6.8,8830,1687,7143,2.7,14.2,7565,2164,5401,3.5,12.2,1265,2,24.4,0,133,136,720
1993,53,l) Left Censored,19483,34168,968674,978681,1534,4.4,2580,7.4,107741,26209,81532,2.7,11,127756,38613,89143,3.9,13.1,-20015,-2.1,22,0,812,845,6990
1993,54,a) 0,2541,2544,11883,5975,2517,197.9,0,0,11817,11817,0,197.8,197.8,0,0,0,0,0,11817,197.8,0,0,,,
1993,54,b) 1,1984,2010,12042,12354,6,0.3,499,21.8,3081,101,2980,0.8,24.9,3704,1969,1735,15.9,30,-623,-5.1,49.8,0,412,412,1719
1993,54,c) 2,1755,1875,17770,17834,65,3.2,314,15.6,3513,512,3001,2.9,19.7,3641,1685,1956,9.4,20.4,-128,-0.7,39.4,0,261,261,1322
1993,54,d) 3,1628,1647,11707,12266,39,2.2,238,13.6,2050,223,1827,1.8,16.7,3168,1618,1550,13.2,25.8,-1118,-9.1,33.4,0,209,209,1483
1993,54,e) 4,1432,1475,13710,13929,47,3,194,12.5,2209,431,1778,3.1,15.9,2647,1238,1409,8.9,19,-438,-3.1,31.8,0,153,153,992
1993,54,f) 5,1292,1334,10586,10905,40,2.9,158,11.3,1521,154,1367,1.4,13.9,2158,897,1261,8.2,19.8,-637,-5.9,27.8,0,127,127,734
1993,54,g) 6 to 10,5644,6088,67851,68274,181,2.9,497,8,8140,1372,6768,2,11.9,8986,2623,6363,3.8,13.2,-846,-1.3,23.8,0,347,357,1702
1993,54,h) 11 to 15,3624,4100,45822,46107,128,3.1,283,6.8,5621,850,4771,1.8,12.2,6190,1281,4909,2.8,13.4,-569,-1.2,24.4,0,193,196,939
1993,54,i) 16 to 20,845,1210,18232,17874,36,2.9,77,6.3,2388,375,2013,2.1,13.4,1672,506,1166,2.8,9.4,716,4,18.8,0,33,33,141
1993,54,l) Left Censored,8065,12729,277154,277812,428,3.3,883,6.8,30666,5396,25270,1.9,11,31981,9515,22466,3.4,11.5,-1315,-0.5,22,0,356,359,2216
1993,55,a) 0,8611,8652,45161,22692,8589,198.5,0,0,44938,44938,0,198,198,0,0,0,0,0,44938,198,0,0,,,
1993,55,b) 1,6486,6570,46873,45798,41,0.6,1478,20.1,12474,905,11569,2,27.2,10324,6075,4249,13.3,22.5,2150,4.7,45,0,1161,1161,4616
1993,55,c) 2,5816,6026,45892,46551,187,2.9,914,14.3,9094,1101,7993,2.4,19.5,10411,4808,5603,10.3,22.4,-1317,-2.9,39,0,755,755,4026
1993,55,d) 3,5288,5553,45380,46084,208,3.6,719,12.4,8125,1453,6672,3.2,17.6,9533,3725,5808,8.1,20.7,-1408,-3.1,35.2,0,564,564,2777
1993,55,e) 4,4894,5055,43870,42646,183,3.5,605,11.5,10005,1023,8982,2.4,23.5,7557,3490,4067,8.2,17.7,2448,5.8,35.4,0,491,492,2900
1993,55,f) 5,4367,4506,41199,41924,113,2.4,495,10.5,5649,606,5043,1.4,13.5,7098,2400,4698,5.7,16.9,-1449,-3.4,27,0,386,389,1857
1993,55,g) 6 to 10,18534,20240,244403,244868,576,2.8,1654,8,31999,4020,27979,1.6,13.1,32929,11488,21441,4.7,13.4,-930,-0.3,26.2,0,1202,1213,7869
1993,55,h) 11 to 15,12079,13578,174753,174145,378,2.7,937,6.8,22058,3281,18777,1.9,12.7,20842,6097,14745,3.5,12,1216,0.7,24,0,662,669,4272
1993,55,i) 16 to 20,2652,4028,66226,66457,143,3.5,258,6.3,9116,2133,6983,3.2,13.7,9577,2069,7508,3.1,14.4,-461,-0.7,27.4,0,122,123,539
1993,55,l) Left Censored,26044,40670,1273539,1267892,1353,3.3,2441,5.9,134175,29639,104536,2.3,10.6,122882,37608,85274,3,9.7,11293,0.9,19.4,0,1077,1131,10293
1993,56,a) 0,1260,1263,6197,3109,1256,198.9,0,0,6177,6177,0,198.7,198.7,0,0,0,0,0,6177,198.7,0,0,,,
1993,56,b) 1,888,891,4833,4778,2,0.2,236,23.1,1363,,,,28.5,1253,684,569,14.3,26.2,110,2.3,52.4,1,182,182,571
1993,56,c) 2,764,771,4441,4837,30,3.6,144,17.3,976,151,825,3.1,20.2,1768,687,1081,14.2,36.6,-792,-16.4,40.4,0,109,109,583
1993,56,d) 3,660,668,3800,3937,19,2.7,95,13.4,668,71,597,1.8,17,942,320,622,8.1,23.9,-274,-6.9,34,0,72,72,245
1993,56,e) 4,554,582,4187,4315,24,3.9,74,12.2,660,59,601,1.4,15.3,916,280,636,6.5,21.2,-256,-5.9,30.6,0,50,50,177
1993,56,f) 5,517,536,3798,3958,18,3.2,65,11.6,535,56,479,1.4,13.5,854,323,531,8.2,21.6,-319,-8.1,27,0,52,52,281
1993,56,g) 6 to 10,2269,2449,20937,21896,87,3.4,262,10.3,2618,370,2248,1.7,12,4535,1961,2574,9,20.7,-1917,-8.7,24,0,182,184,1367
1993,56,h) 11 to 15,1948,2113,18254,18356,80,3.7,149,6.9,2596,340,2256,1.9,14.1,2799,820,1979,4.5,15.2,-203,-1.1,28.2,0,102,106,650
1993,56,i) 16 to 20,349,489,6664,6523,17,3.5,26,5.3,1085,,,,16.6,802,89,713,1.4,12.3,283,4.3,24.6,1,12,12,42
1993,56,l) Left Censored,2659,4060,67745,67649,322,8,286,7.1,8742,3300,5442,4.9,12.9,8550,2470,6080,3.7,12.6,192,0.3,25.2,0,115,118,778
1994,01,a) 0,7735,7793,47574,23847,7737,198.6,0,0,47455,47455,0,199,199,0,0,0,0,0,47455,199,0,0,,,
1994,01,b) 1,5455,5491,37642,38218,20,0.3,1539,24.3,11247,443,10804,1.2,29.4,12398,6929,5469,18.1,32.4,-1151,-3,58.8,0,1301,1301,6065
1994,01,c) 2,4367,4455,37515,40224,135,2.8,873,18,6869,1055,5814,2.6,17.1,12287,5706,6581,14.2,30.5,-5418,-13.4,34.2,0,716,716,5072
1994,01,d) 3,3733,3913,32008,33740,136,3.3,604,14.5,5862,642,5220,1.9,17.4,9326,4478,4848,13.3,27.6,-3464,-10.2,34.8,0,477,477,3337
1994,01,e) 4,3535,3664,30939,32055,116,3,519,13.4,5659,471,5188,1.5,17.7,7891,3380,4511,10.5,24.6,-2232,-6.9,35.4,0,403,404,2190
1994,01,f) 5,3139,3318,32959,33132,130,3.7,439,12.6,6109,840,5269,2.5,18.4,6454,2647,3807,8,19.5,-345,-1.1,36.8,0,346,346,2094
1994,01,g) 6 to 10,13655,14964,185360,187787,492,3.2,1391,9,23771,4622,19149,2.5,12.7,28624,8619,20005,4.6,15.2,-4853,-2.5,25.4,0,1032,1036,5795
1994,01,h) 11 to 15,7828,8831,130973,131138,261,2.9,695,7.7,17032,3039,13993,2.3,13,17362,5292,12070,4,13.2,-330,-0.2,26,0,436,442,3181
1994,01,i) 16 to 20,3351,4910,76095,75381,160,3.2,302,6.1,9885,2587,7298,3.4,13.1,8456,2524,5932,3.3,11.2,1429,1.9,22.4,0,153,153,1572
1994,01,l) Left Censored,14406,26412,820049,819489,1202,4.5,1708,6.4,87779,23152,64627,2.8,10.7,86659,24084,62575,2.9,10.6,1120,0.1,21.2,0,628,643,6781
1994,02,a) 0,1308,1309,6540,3290,1290,197.1,0,0,6501,6501,0,197.6,197.6,0,0,0,0,0,6501,197.6,0,0,,,
1994,02,b) 1,987,996,5788,5782,6,0.5,276,24.1,1879,36,1843,0.6,32.5,1867,952,915,16.5,32.3,12,0.2,64.6,0,190,190,675
1994,02,c) 2,753,789,4606,5135,43,5,159,18.7,1244,216,1028,4.2,24.2,2301,901,1400,17.5,44.8,-1057,-20.6,48.4,0,116,116,596
1994,02,d) 3,748,767,5496,5579,34,4.2,129,15.8,1255,79,1176,1.4,22.5,1420,438,982,7.9,25.5,-165,-3,45,0,91,91,315
1994,02,e) 4,696,710,4684,4993,23,3,117,15.4,879,119,760,2.4,17.6,1496,465,1031,9.3,30,-617,-12.4,35.2,0,81,81,319
1994,02,f) 5,490,500,3810,4451,22,4.2,58,11.2,573,55,518,1.2,12.9,1854,342,1512,7.7,41.7,-1281,-28.8,25.8,0,44,44,206
1994,02,g) 6 to 10,2490,2756,28862,29132,107,3.8,286,10,4569,774,3795,2.7,15.7,5108,1643,3465,5.6,17.5,-539,-1.8,31.4,0,184,186,1004
1994,02,h) 11 to 15,1582,1781,17483,17551,79,4.4,140,7.7,2666,334,2332,1.9,15.2,2802,740,2062,4.2,16,-136,-0.8,30.4,0,74,76,458
1994,02,i) 16 to 20,601,821,11371,11519,36,4.4,46,5.6,1475,156,1319,1.4,12.8,1771,354,1417,3.1,15.4,-296,-2.6,25.6,0,11,11,50
1994,02,l) Left Censored,1856,3367,82860,81776,174,5.1,226,6.7,12974,4428,8546,5.4,15.9,10806,3418,7388,4.2,13.2,2168,2.7,26.4,0,50,52,285
1994,04,a) 0,9103,9185,56270,28192,9138,199,0,0,56157,56157,0,199.2,199.2,0,0,0,0,0,56157,199.2,0,0,,,
1994,04,b) 1,6171,6238,46449,46412,41,0.6,1826,25.3,14487,610,13877,1.3,31.2,14413,8501,5912,18.3,31.1,74,0.1,62.2,0,1506,1506,7579
1994,04,c) 2,5046,5202,47865,49088,187,3.3,1053,18.6,11442,1585,9857,3.2,23.3,13888,6851,7037,14,28.3,-2446,-5,46.6,0,865,865,5884
1994,04,d) 3,4427,4574,40539,42746,154,3.1,810,16.5,8725,896,7829,2.1,20.4,13139,4753,8386,11.1,30.7,-4414,-10.3,40.8,0,660,660,3713
1994,04,e) 4,3931,4064,39790,40019,142,3.3,650,15,8637,1383,7254,3.5,21.6,9095,4646,4449,11.6,22.7,-458,-1.1,43.2,0,502,502,3914
1994,04,f) 5,3557,3771,42042,42404,165,4.2,568,14.3,8257,1203,7054,2.8,19.5,8981,4115,4866,9.7,21.2,-724,-1.7,39,0,440,443,2987
1994,04,g) 6 to 10,14285,15753,197424,196670,678,4.2,1687,10.4,33462,5508,27954,2.8,17,31954,11979,19975,6.1,16.2,1508,0.8,32.4,0,1181,1188,8131
1994,04,h) 11 to 15,8765,10437,165775,162351,479,4.5,785,7.4,25973,5052,20921,3.1,16,19125,5766,13359,3.6,11.8,6848,4.2,23.6,0,497,501,3535
1994,04,i) 16 to 20,2658,3704,69112,66876,178,4.7,282,7.5,11914,2675,9239,4,17.8,7442,2064,5378,3.1,11.1,4472,6.7,22.2,0,149,149,936
1994,04,l) Left Censored,9742,20820,680957,666703,1477,7.1,1461,7,113129,38495,74634,5.8,17,84621,29213,55408,4.4,12.7,28508,4.3,25.4,0,385,390,2431
1994,05,a) 0,4944,4975,29237,14653,4942,198.7,0,0,29169,29169,0,199.1,199.1,0,0,0,0,0,29169,199.1,0,0,,,
1994,05,b) 1,3602,3626,21608,22382,10,0.2,1012,24.2,5842,116,5726,0.5,26.1,7390,4374,3016,19.5,33,-1548,-6.9,52.2,0,842,842,3729
1994,05,c) 2,2868,2963,24272,26365,84,2.6,546,17,5624,773,4851,2.9,21.3,9809,6284,3525,23.8,37.2,-4185,-15.9,42.6,0,433,433,5697
1994,05,d) 3,2411,2522,19322,20036,77,2.9,373,13.9,3383,366,3017,1.8,16.9,4810,1887,2923,9.4,24,-1427,-7.1,33.8,0,311,311,1610
1994,05,e) 4,2252,2360,17811,19133,66,2.6,317,12.7,3114,529,2585,2.8,16.3,5757,3401,2356,17.8,30.1,-2643,-13.8,32.6,0,262,262,1642
1994,05,f) 5,1855,1912,21209,20293,64,3.2,241,12,5504,839,4665,4.1,27.1,3671,1623,2048,8,18.1,1833,9,36.2,0,201,201,876
1994,05,g) 6 to 10,8230,8795,91861,92185,285,3.1,925,10.1,13805,2385,11420,2.6,15,14452,6331,8121,6.9,15.7,-647,-0.7,30,0,702,702,4643
1994,05,h) 11 to 15,5591,6302,78305,78640,215,3.3,489,7.6,10859,2116,8743,2.7,13.8,11528,2972,8556,3.8,14.7,-669,-0.9,27.6,0,330,331,1721
1994,05,i) 16 to 20,2272,2828,41235,41557,103,3.6,206,7.2,4677,954,3723,2.3,11.3,5320,1568,3752,3.8,12.8,-643,-1.5,22.6,0,123,130,925
1994,05,l) Left Censored,9442,15738,486711,485834,776,4.9,937,5.9,51774,14976,36798,3.1,10.7,50020,16895,33125,3.5,10.3,1754,0.4,20.6,0,412,416,3688
1994,06,a) 0,56333,56822,366568,184075,56339,198.3,0,0,364987,364987,0,198.3,198.3,0,0,0,0,0,364987,198.3,0,0,,,
1994,06,b) 1,40703,41144,322948,330556,209,0.4,12471,26,94404,6401,88003,1.9,28.6,109620,64373,45247,19.5,33.2,-15216,-4.6,57.2,0,10010,10015,54016
1994,06,c) 2,35114,36424,380109,408944,1432,3.6,8138,20.3,74397,9884,64513,2.4,18.2,132066,65626,66440,16,32.3,-57669,-14.1,36.4,0,6472,6474,56250
1994,06,d) 3,32741,34016,288684,296507,1395,3.8,6513,17.7,66280,8498,57782,2.9,22.4,81925,39313,42612,13.3,27.6,-15645,-5.2,44.8,0,5081,5088,31243
1994,06,e) 4,31052,32393,288306,302248,1408,4.1,5515,16,57269,9291,47978,3.1,18.9,85153,41558,43595,13.7,28.2,-27884,-9.3,37.8,0,4165,4186,33448
1994,06,f) 5,27641,29114,280196,292854,1185,3.8,4410,14.3,48952,7015,41937,2.4,16.7,74267,29844,44423,10.2,25.4,-25315,-8.7,33.4,0,3360,3372,22733
1994,06,g) 6 to 10,111911,122673,1507397,1538711,4802,3.7,15080,11.8,229506,39902,189604,2.6,14.9,292133,110725,181408,7.2,19,-62627,-4.1,29.8,0,10446,10521,79003
1994,06,h) 11 to 15,73777,85847,1198160,1214579,3178,3.6,8334,9.4,163852,32481,131371,2.7,13.5,196689,64954,131735,5.3,16.2,-32837,-2.7,27,0,5070,5115,37853
1994,06,i) 16 to 20,25580,35105,580192,580176,1318,3.6,3229,8.9,82019,16419,65600,2.8,14.1,81986,27024,54962,4.7,14.1,33,0,28.2,0,1615,1662,10094
1994,06,l) Left Censored,87478,170105,5250711,5335204,9187,5.3,15389,8.9,620129,205164,414965,3.8,11.6,789115,239553,549562,4.5,14.8,-168986,-3.2,23.2,0,4876,5067,36370
1994,08,a) 0,11084,11152,58666,29463,11083,198.8,0,0,58407,58407,0,198.2,198.2,0,0,0,0,0,58407,198.2,0,0,,,
1994,08,b) 1,7760,7794,51914,51242,33,0.4,2188,24.5,15804,491,15313,1,30.8,14459,8851,5608,17.3,28.2,1345,2.6,56.4,0,1737,1737,7579
1994,08,c) 2,6022,6125,47400,50111,202,3,1148,17.3,10737,925,9812,1.8,21.4,16158,6912,9246,13.8,32.2,-5421,-10.8,42.8,0,887,887,5780
1994,08,d) 3,5291,5467,41203,42270,207,3.6,851,14.7,8298,1325,6973,3.1,19.6,10431,4406,6025,10.4,24.7,-2133,-5.1,39.2,0,674,674,3497
1994,08,e) 4,4494,4649,39157,39757,169,3.5,608,12.5,7839,1191,6648,3,19.7,9039,3794,5245,9.5,22.7,-1200,-3,39.4,0,474,475,2921
1994,08,f) 5,4017,4223,40375,40537,172,3.9,515,11.7,7726,1660,6066,4.1,19.1,8049,3621,4428,8.9,19.9,-323,-0.8,38.2,0,392,392,2631
1994,08,g) 6 to 10,15900,17065,197216,199288,650,3.7,1709,9.7,30777,4080,26697,2,15.4,34921,14737,20184,7.4,17.5,-4144,-2.1,30.8,0,1219,1224,8160
1994,08,h) 11 to 15,10513,12098,168823,167535,479,3.9,906,7.4,24808,5323,19485,3.2,14.8,22231,7090,15141,4.2,13.3,2577,1.5,26.6,0,583,587,3880
1994,08,i) 16 to 20,3563,4751,70859,70352,191,3.9,354,7.3,10817,1739,9078,2.5,15.4,9803,3033,6770,4.3,13.9,1014,1.5,27.8,0,190,191,1427
1994,08,l) Left Censored,13143,23914,718621,714365,1560,6.5,1601,6.7,91563,28896,62667,4,12.8,83052,27606,55446,3.9,11.6,8511,1.2,23.2,0,486,503,3354
1994,09,a) 0,5670,5692,30703,15383,5655,198.7,0,0,30641,30641,0,199.2,199.2,0,0,0,0,0,30641,199.2,0,0,,,
1994,09,b) 1,4407,4438,31437,29762,24,0.5,1052,21,11528,707,10821,2.4,38.7,8177,4642,3535,15.6,27.5,3351,11.2,55,0,832,832,4063
1994,09,c) 2,3693,3814,29063,30729,125,3,688,16.7,5613,479,5134,1.6,18.3,8945,4510,4435,14.7,29.1,-3332,-10.8,36.6,0,533,533,3623
1994,09,d) 3,3295,3391,26335,31289,108,3,512,14.2,5500,414,5086,1.3,17.6,15407,12448,2959,39.8,49.2,-9907,-31.6,35.2,0,403,403,11976
1994,09,e) 4,3386,3492,26884,27467,147,4,477,13,4632,922,3710,3.4,16.9,5798,2275,3523,8.3,21.1,-1166,-4.2,33.8,0,367,367,1642
1994,09,f) 5,3440,3583,29183,29308,136,3.6,515,13.6,5081,792,4289,2.7,17.3,5331,2519,2812,8.6,18.2,-250,-0.9,34.6,0,376,376,1608
1994,09,g) 6 to 10,14161,14937,157725,159673,512,3.3,1513,9.8,22220,3027,19193,1.9,13.9,26115,8979,17136,5.6,16.4,-3895,-2.5,27.8,0,1081,1091,6127
1994,09,h) 11 to 15,8622,9465,104999,105077,267,2.7,745,7.7,15222,3072,12150,2.9,14.5,15378,4073,11305,3.9,14.6,-156,-0.1,29,0,513,517,2420
1994,09,i) 16 to 20,3193,4056,57714,58923,143,3.5,254,6.2,7497,1665,5832,2.8,12.7,9914,2416,7498,4.1,16.8,-2417,-4.1,25.4,0,145,145,1031
1994,09,l) Left Censored,17921,27059,883539,899300,1012,3.7,1799,6.5,82907,19367,63540,2.2,9.2,114429,27485,86944,3.1,12.7,-31522,-3.5,18.4,0,744,753,5474
1994,10,a) 0,1560,1567,8272,4165,1551,198,0,0,8215,8215,0,197.2,197.2,0,0,0,0,0,8215,197.2,0,0,,,
1994,10,b) 1,1190,1193,31424,18993,6,0.5,229,17.4,26519,33,26486,0.2,139.6,1657,675,982,3.6,8.7,24862,130.9,17.4,0,181,181,530
1994,10,c) 2,932,959,6335,6806,22,2.1,187,17.9,1254,91,1163,1.3,18.4,2195,1203,992,17.7,32.3,-941,-13.9,36.8,0,127,127,954
1994,10,d) 3,823,847,5986,6192,23,2.5,151,16.5,1055,103,952,1.7,17,1467,651,816,10.5,23.7,-412,-6.7,34,0,117,117,483
1994,10,e) 4,787,814,5726,5786,25,2.9,111,12.9,1146,302,844,5.2,19.8,1265,427,838,7.4,21.9,-119,-2.1,39.6,0,85,85,351
1994,10,f) 5,759,779,6316,6502,25,3.1,91,11.2,952,101,851,1.6,14.6,1323,459,864,7.1,20.3,-371,-5.7,29.2,0,69,69,372
1994,10,g) 6 to 10,2793,2973,30330,31127,106,3.5,288,9.4,3694,524,3170,1.7,11.9,5287,2231,3056,7.2,17,-1593,-5.1,23.8,0,206,206,1479
1994,10,h) 11 to 15,1571,1734,23210,23581,44,2.5,143,8,3094,282,2812,1.2,13.1,3835,1113,2722,4.7,16.3,-741,-3.2,26.2,0,88,88,549
1994,10,i) 16 to 20,652,841,20984,20639,27,3.2,60,7,2742,155,2587,0.8,13.3,2052,769,1283,3.7,9.9,690,3.4,19.8,0,26,26,191
1994,10,l) Left Censored,3647,5885,190639,192720,372,6.3,410,6.9,22621,7524,15097,3.9,11.7,26783,4382,22401,2.3,13.9,-4162,-2.2,23.4,0,123,123,527
1994,11,a) 0,1126,1133,10030,5021,1129,199.3,0,0,10019,10019,0,199.5,199.5,0,0,0,0,0,10019,199.5,0,0,,,
1994,11,b) 1,836,841,7183,7269,7,0.7,196,20.8,1717,150,1567,2.1,23.6,1889,1050,839,14.4,26,-172,-2.4,47.2,0,154,154,743
1994,11,c) 2,769,804,27373,27874,31,3.6,137,15.9,1284,127,1157,0.5,4.6,2286,799,1487,2.9,8.2,-1002,-3.6,9.2,0,96,96,424
1994,11,d) 3,684,692,6552,6631,19,2.6,104,14.2,1149,124,1025,1.9,17.3,1306,450,856,6.8,19.7,-157,-2.4,34.6,0,83,83,400
1994,11,e) 4,642,679,6858,6877,28,3.9,82,11.6,1214,280,934,4.1,17.7,1252,474,778,6.9,18.2,-38,-0.5,35.4,0,63,63,276
1994,11,f) 5,629,656,6290,7366,25,3.7,74,10.9,1018,149,869,2,13.8,3169,267,2902,3.6,43,-2151,-29.2,27.6,0,51,51,187
1994,11,g) 6 to 10,2757,2925,40989,40957,96,3.2,260,8.6,5593,703,4890,1.7,13.7,5529,1582,3947,3.9,13.5,64,0.2,27,0,168,168,1036
1994,11,h) 11 to 15,1967,2181,32977,33428,79,3.5,161,7.2,4224,723,3501,2.2,12.6,5126,1242,3884,3.7,15.3,-902,-2.7,25.2,0,100,101,724
1994,11,i) 16 to 20,762,981,45034,43795,58,5.8,98,9.8,4721,746,3975,1.7,10.8,2243,807,1436,1.8,5.1,2478,5.7,10.2,0,33,52,411
1994,11,l) Left Censored,4534,6773,224698,239846,315,4.6,456,6.7,22873,6611,16262,2.8,9.5,53168,8065,45103,3.4,22.2,-30295,-12.7,19,0,155,156,919
1994,12,a) 0,37891,38151,209738,105324,37874,198.5,0,0,208828,208828,0,198.3,198.3,0,0,0,0,0,208828,198.3,0,0,,,
1994,12,b) 1,28202,28424,201724,206593,109,0.3,8857,26.7,56146,3148,52998,1.5,27.2,65883,41114,24769,19.9,31.9,-9737,-4.7,54.4,0,7387,7387,35809
1994,12,c) 2,22579,23061,189357,192571,770,3,5334,21,51667,7635,44032,4,26.8,58094,30989,27105,16.1,30.2,-6427,-3.4,53.6,0,4339,4347,25704
1994,12,d) 3,19062,19655,154569,158883,673,3.2,3632,17.1,33531,3457,30074,2.2,21.1,42158,22266,19892,14,26.5,-8627,-5.4,42.2,0,2940,2942,18013
1994,12,e) 4,17502,18013,151661,159764,552,2.9,2865,14.9,28036,2600,25436,1.6,17.5,44241,17113,27128,10.7,27.7,-16205,-10.2,35,0,2331,2331,14308
1994,12,f) 5,15137,15957,140459,143719,608,3.6,2319,13.8,27961,5228,22733,3.6,19.5,34480,13880,20600,9.7,24,-6519,-4.5,39,0,1836,1839,10591
1994,12,g) 6 to 10,57101,62209,718661,721652,2196,3.4,7097,11,129363,26343,103020,3.7,17.9,135345,53028,82317,7.3,18.8,-5982,-0.9,35.8,0,5195,5248,37853
1994,12,h) 11 to 15,32629,37023,473156,474439,1202,3.1,3515,9.2,68621,12602,56019,2.7,14.5,71187,25352,45835,5.3,15,-2566,-0.5,29,0,2337,2361,15355
1994,12,i) 16 to 20,10670,15070,226216,224134,668,4.4,1202,7.8,32719,8998,23721,4,14.6,28554,7402,21152,3.3,12.7,4165,1.9,25.4,0,653,668,3389
1994,12,l) Left Censored,37519,82391,2449195,2430141,4748,5.7,5802,7,315279,90168,225111,3.7,13,277170,77910,199260,3.2,11.4,38109,1.6,22.8,0,1933,1956,14590
1994,13,a) 0,15083,15198,92061,46156,15111,198.9,0,0,91811,91811,0,198.9,198.9,0,0,0,0,0,91811,198.9,0,0,,,
1994,13,b) 1,10830,10896,87174,86036,53,0.4,3067,24.5,26012,1900,24112,2.2,30.2,23735,14495,9240,16.8,27.6,2277,2.6,55.2,0,2469,2469,12081
1994,13,c) 2,8596,8831,75096,79932,261,2.7,1900,19.6,16293,1217,15076,1.5,20.4,25964,13647,12317,17.1,32.5,-9671,-12.1,40.8,0,1548,1549,11359
1994,13,d) 3,7303,7569,67056,68956,262,3.2,1349,16.6,13496,1639,11857,2.4,19.6,17296,8661,8635,12.6,25.1,-3800,-5.5,39.2,0,1058,1061,6793
1994,13,e) 4,6557,6735,64101,64348,240,3.4,1006,14.1,12793,1219,11574,1.9,19.9,13286,6549,6737,10.2,20.6,-493,-0.7,39.8,0,774,774,4810
1994,13,f) 5,6007,6415,65920,65426,247,3.7,821,12.2,13766,2501,11265,3.8,21,12777,4677,8100,7.1,19.5,989,1.5,39,0,633,634,3445
1994,13,g) 6 to 10,24167,26338,320135,318169,996,3.7,2712,10,51739,9678,42061,3,16.3,47807,18788,29019,5.9,15,3932,1.3,30,0,1969,1973,12199
1994,13,h) 11 to 15,13982,16289,227395,226920,568,3.4,1322,7.9,32772,6596,26176,2.9,14.4,31821,11836,19985,5.2,14,951,0.4,28,0,850,877,6853
1994,13,i) 16 to 20,5290,7126,119735,117467,359,5,561,7.8,18393,4022,14371,3.4,15.7,13857,4751,9106,4,11.8,4536,3.9,23.6,0,319,321,2364
1994,13,l) Left Censored,22580,46326,1564155,1552007,2578,5.5,3315,7.1,199602,61347,138255,4,12.9,175307,57135,118172,3.7,11.3,24295,1.6,22.6,0,1006,1024,6665
1994,15,a) 0,1973,1985,16579,8304,1971,198.6,0,0,16551,16551,0,199.3,199.3,0,0,0,0,0,16551,199.3,0,0,,,
1994,15,b) 1,1518,1545,10596,11136,13,0.7,443,24.8,3103,228,2875,2,27.9,4182,2589,1593,23.2,37.6,-1079,-9.7,55.8,0,363,363,2130
1994,15,c) 2,1288,1341,12476,13100,46,3.2,258,17.7,2234,167,2067,1.3,17.1,3481,1373,2108,10.5,26.6,-1247,-9.5,34.2,0,204,204,1142
1994,15,d) 3,1290,1337,13963,14614,56,3.9,244,17,1998,215,1783,1.5,13.7,3299,1595,1704,10.9,22.6,-1301,-8.9,27.4,0,193,193,1342
1994,15,e) 4,1139,1228,9676,10707,57,4.4,204,15.6,1648,350,1298,3.3,15.4,3710,2077,1633,19.4,34.7,-2062,-19.3,30.8,0,152,154,1801
1994,15,f) 5,1023,1093,9753,11382,36,3.2,130,11.4,1281,173,1108,1.5,11.3,4538,2324,2214,20.4,39.9,-3257,-28.6,22.6,0,107,107,2212
1994,15,g) 6 to 10,4149,4706,56031,57464,151,3.1,489,10,6895,1109,5786,1.9,12,9760,3500,6260,6.1,17,-2865,-5,24,0,332,332,2278
1994,15,h) 11 to 15,3191,3740,45371,46262,91,2.4,271,7.1,5259,649,4610,1.4,11.4,7040,1701,5339,3.7,15.2,-1781,-3.8,22.8,0,152,168,1056
1994,15,i) 16 to 20,1082,1559,22938,23284,42,2.6,113,7.1,2285,204,2081,0.9,9.8,2976,884,2092,3.8,12.8,-691,-3,19.6,0,55,55,210
1994,15,l) Left Censored,4840,8541,224885,230300,331,3.8,522,6,19302,6599,12703,2.9,8.4,30132,9300,20832,4,13.1,-10830,-4.7,16.8,0,188,204,1538
1994,16,a) 0,3047,3068,15047,7550,3044,198.4,0,0,14994,14994,0,198.6,198.6,0,0,0,0,0,14994,198.6,0,0,,,
1994,16,b) 1,2015,2027,12505,12268,13,0.6,549,23.6,3697,174,3523,1.4,30.1,3223,1837,1386,15,26.3,474,3.8,52.6,0,405,405,1397
1994,16,c) 2,1691,1717,11308,11626,71,3.8,301,16.3,2544,410,2134,3.5,21.9,3180,1575,1605,13.5,27.4,-636,-5.5,43.8,0,236,236,1253
1994,16,d) 3,1346,1369,9369,9675,53,3.7,194,13.4,1848,203,1645,2.1,19.1,2460,924,1536,9.6,25.4,-612,-6.3,38.2,0,145,145,629
1994,16,e) 4,1354,1384,10360,10459,57,3.9,179,12.4,2093,161,1932,1.5,20,2290,873,1417,8.3,21.9,-197,-1.9,40,0,139,139,691
1994,16,f) 5,1031,1089,9283,9302,35,3.1,122,10.7,1629,148,1481,1.6,17.5,1667,597,1070,6.4,17.9,-38,-0.4,35,0,98,98,529
1994,16,g) 6 to 10,4272,4542,48522,48470,180,3.9,399,8.6,8899,1442,7457,3,18.4,8794,3782,5012,7.8,18.1,105,0.3,36.2,0,287,291,2942
1994,16,h) 11 to 15,2810,3151,40549,40333,139,4.3,251,7.8,6461,2011,4450,5,16,6029,2095,3934,5.2,14.9,432,1.1,29.8,0,165,165,1065
1994,16,i) 16 to 20,1104,1347,19571,19673,46,3.3,118,8.5,2212,327,1885,1.7,11.2,2415,751,1664,3.8,12.3,-203,-1.1,22.4,0,63,63,418
1994,16,l) Left Censored,4417,7442,179785,175464,393,5.3,406,5.4,24450,5651,18799,3.2,13.9,15808,4367,11441,2.5,9,8642,4.9,18,0,164,171,867
1994,17,a) 0,19923,20053,129747,65100,19915,198.6,0,0,129295,129295,0,198.6,198.6,0,0,0,0,0,129295,198.6,0,0,,,
1994,17,b) 1,15387,15500,109909,109429,85,0.5,3582,20.5,30763,2037,28726,1.9,28.1,29802,15203,14599,13.9,27.2,961,0.9,54.4,0,2823,2823,12839
1994,17,c) 2,12872,13258,116891,120693,406,2.8,2265,15.9,24529,2869,21660,2.4,20.3,32133,13712,18421,11.4,26.6,-7604,-6.3,40.6,0,1772,1772,10834
1994,17,d) 3,11639,12135,101220,104838,351,2.7,1706,13.3,19030,3522,15508,3.4,18.2,26266,11966,14300,11.4,25.1,-7236,-6.9,36.4,0,1334,1334,10224
1994,17,e) 4,10908,11296,123160,121197,314,2.6,1430,12,24065,2149,21916,1.8,19.9,20138,8262,11876,6.8,16.6,3927,3.3,33.2,0,1070,1071,6300
1994,17,f) 5,9933,10372,96098,96864,310,2.9,1166,10.8,16013,2047,13966,2.1,16.5,17544,6938,10606,7.2,18.1,-1531,-1.6,33,0,907,907,5265
1994,17,g) 6 to 10,41230,44284,560767,565928,1293,2.8,4009,8.8,74459,9883,64576,1.7,13.2,84781,27520,57261,4.9,15,-10322,-1.8,26.4,0,2878,2888,18254
1994,17,h) 11 to 15,26441,29619,426050,426465,908,3,2128,7,52172,9250,42922,2.2,12.2,53002,15767,37235,3.7,12.4,-830,-0.2,24.4,0,1397,1399,9866
1994,17,i) 16 to 20,10196,13428,221077,220828,505,3.7,878,6.4,28134,7321,20813,3.3,12.7,27636,7917,19719,3.6,12.5,498,0.2,25,0,467,471,4090
1994,17,l) Left Censored,50853,84992,2848128,2843239,3587,4.2,5595,6.5,313779,76586,237193,2.7,11,304001,89741,214260,3.2,10.7,9778,0.3,21.4,0,2286,2321,18266
1994,18,a) 0,9840,9900,54613,27392,9827,198.5,0,0,54443,54443,0,198.8,198.8,0,0,0,0,0,54443,198.8,0,0,,,
1994,18,b) 1,7369,7404,47724,47520,42,0.5,1784,21.3,13451,925,12526,1.9,28.3,13043,7658,5385,16.1,27.4,408,0.9,54.8,0,1457,1457,6248
1994,18,c) 2,6162,6382,55438,56224,142,2.1,1118,16.2,12453,1096,11357,1.9,22.1,14025,6865,7160,12.2,24.9,-1572,-2.8,44.2,0,894,894,4869
1994,18,d) 3,5576,5850,49148,50487,163,2.6,868,14,8257,988,7269,2,16.4,10934,5084,5850,10.1,21.7,-2677,-5.3,32.8,0,683,683,3755
1994,18,e) 4,5208,5434,50003,49908,181,3.2,665,11.7,10243,2120,8123,4.2,20.5,10053,5476,4577,11,20.1,190,0.4,40.2,0,511,526,3443
1994,18,f) 5,4600,4941,53447,54068,141,2.7,585,11.3,7884,1010,6874,1.9,14.6,9125,3311,5814,6.1,16.9,-1241,-2.3,29.2,0,459,459,2476
1994,18,g) 6 to 10,19294,21078,254693,254868,580,2.7,1778,8.2,34962,5638,29324,2.2,13.7,35311,12143,23168,4.8,13.9,-349,-0.2,27.4,0,1320,1327,8131
1994,18,h) 11 to 15,11893,13359,178720,177730,371,2.7,940,6.9,23824,4153,19671,2.3,13.4,21844,7116,14728,4,12.3,1980,1.1,24.6,0,637,637,4141
1994,18,i) 16 to 20,4728,6568,113427,112747,282,4.2,429,6.5,15034,2951,12083,2.6,13.3,13673,3890,9783,3.5,12.1,1361,1.2,24.2,0,231,233,1863
1994,18,l) Left Censored,24152,43003,1403285,1402916,1734,4,2517,5.8,154798,38892,115906,2.8,11,154060,46092,107968,3.3,11,738,0,22,0,952,974,6775
1994,19,a) 0,4989,5022,25446,12766,4989,198.7,0,0,25361,25361,0,198.7,198.7,0,0,0,0,0,25361,198.7,0,0,,,
1994,19,b) 1,3623,3633,21359,21942,11,0.3,837,20.4,5117,151,4966,0.7,23.3,6282,3602,2680,16.4,28.6,-1165,-5.3,46.6,0,648,648,2845
1994,19,c) 2,3188,3289,26294,27388,106,3,570,16.2,4480,757,3723,2.8,16.4,6668,2860,3808,10.4,24.3,-2188,-7.9,32.8,0,478,480,2388
1994,19,d) 3,2875,2975,21902,22976,81,2.6,400,12.7,3649,429,3220,1.9,15.9,5796,2680,3116,11.7,25.2,-2147,-9.3,31.8,0,310,312,2041
1994,19,e) 4,2612,2693,19959,20822,72,2.5,374,13.1,3057,390,2667,1.9,14.7,4783,1999,2784,9.6,23,-1726,-8.3,29.4,0,291,291,1542
1994,19,f) 5,2394,2532,21404,21933,87,3.3,312,11.8,3160,545,2615,2.5,14.4,4217,1708,2509,7.8,19.2,-1057,-4.8,28.8,0,234,234,948
1994,19,g) 6 to 10,10276,11078,131600,131950,293,2.6,931,8.2,17529,4244,13285,3.2,13.3,18228,6009,12219,4.6,13.8,-699,-0.5,26.6,0,693,698,3722
1994,19,h) 11 to 15,7287,8477,95385,95536,251,2.9,639,7.4,11965,1762,10203,1.8,12.5,12267,4041,8226,4.2,12.8,-302,-0.3,25,0,446,446,2754
1994,19,i) 16 to 20,3191,4416,53163,53335,136,3,250,5.6,6605,1202,5403,2.3,12.4,6948,1660,5288,3.1,13,-343,-0.6,24.8,0,146,146,787
1994,19,l) Left Censored,16022,25427,648573,645540,873,3.4,1439,5.6,65781,14229,51552,2.2,10.2,59716,19876,39840,3.1,9.3,6065,0.9,18.6,0,633,638,3314
1994,20,a) 0,5067,5100,27839,13983,5053,198.2,0,0,27713,27713,0,198.2,198.2,0,0,0,0,0,27713,198.2,0,0,,,
1994,20,b) 1,3723,3750,24992,25345,21,0.5,980,23,6435,279,6156,1.1,25.4,7141,4630,2511,18.3,28.2,-706,-2.8,50.8,0,805,805,3983
1994,20,c) 2,3099,3186,23023,23769,114,3.3,626,18.1,5533,1034,4499,4.4,23.3,7025,3956,3069,16.6,29.6,-1492,-6.3,46.6,0,505,505,2942
1994,20,d) 3,2688,2809,20555,20828,107,3.6,386,13.1,3908,496,3412,2.4,18.8,4453,2007,2446,9.6,21.4,-545,-2.6,37.6,0,311,311,1610
1994,20,e) 4,2384,2486,20896,21004,88,3.4,341,13,4549,643,3906,3.1,21.7,4764,2358,2406,11.2,22.7,-215,-1,43.4,0,253,253,1362
1994,20,f) 5,2234,2344,20309,21133,83,3.4,329,13.3,3131,570,2561,2.7,14.8,4778,2072,2706,9.8,22.6,-1647,-7.8,29.6,0,252,253,1678
1994,20,g) 6 to 10,9659,10287,110543,110656,329,3.1,996,9.4,14477,2241,12236,2,13.1,14702,5421,9281,4.9,13.3,-225,-0.2,26.2,0,702,706,3791
1994,20,h) 11 to 15,6734,7527,81997,81699,209,2.7,530,6.9,10402,1359,9043,1.7,12.7,9805,2489,7316,3,12,597,0.7,24,0,377,377,1531
1994,20,i) 16 to 20,2559,3556,53401,52768,135,3.7,229,6.3,6842,1582,5260,3,13,5575,1809,3766,3.4,10.6,1267,2.4,21.2,0,117,117,568
1994,20,l) Left Censored,13014,21020,542730,540100,916,4.3,1346,6.3,60750,15451,45299,2.9,11.2,55490,15551,39939,2.9,10.3,5260,0.9,20.6,0,553,593,4105
1994,21,a) 0,6152,6193,37348,18730,6154,198.7,0,0,37236,37236,0,198.8,198.8,0,0,0,0,0,37236,198.8,0,0,,,
1994,21,b) 1,4868,4914,35500,35124,35,0.6,1157,21,10348,1230,9118,3.5,29.5,9596,5344,4252,15.2,27.3,752,2.2,54.6,0,1004,1004,4788
1994,21,c) 2,3903,4050,31186,32294,100,2.3,766,17.4,6523,393,6130,1.2,20.2,8738,4343,4395,13.4,27.1,-2215,-6.9,40.4,0,626,626,3728
1994,21,d) 3,3324,3412,29533,30126,103,2.8,559,15.3,6962,572,6390,1.9,23.1,8147,3899,4248,12.9,27,-1185,-3.9,46.2,0,447,447,2686
1994,21,e) 4,3243,3357,28614,29766,76,2.1,466,13.1,4767,491,4276,1.6,16,7071,3400,3671,11.4,23.8,-2304,-7.8,32,0,374,376,2635
1994,21,f) 5,2957,3119,29572,30220,87,2.7,394,12,5102,1096,4006,3.6,16.9,6398,2478,3920,8.2,21.2,-1296,-4.3,33.8,0,318,318,2072
1994,21,g) 6 to 10,12218,13176,161475,163123,391,2.9,1205,8.9,21765,4833,16932,3,13.3,25060,8080,16980,5,15.4,-3295,-2.1,26.6,0,918,923,6083
1994,21,h) 11 to 15,7201,8034,120026,121559,228,2.8,574,7,13222,2202,11020,1.8,10.9,16287,4353,11934,3.6,13.4,-3065,-2.5,21.8,0,395,396,2544
1994,21,i) 16 to 20,2900,3881,59187,58716,219,5.6,258,6.6,7459,2102,5357,3.6,12.7,6516,1403,5113,2.4,11.1,943,1.6,22.2,0,139,140,640
1994,21,l) Left Censored,14354,25133,738168,733672,1191,4.7,1658,6.5,83863,21670,62193,3,11.4,74871,20643,54228,2.8,10.2,8992,1.2,20.4,0,627,632,5302
1994,22,a) 0,7278,7343,50336,25293,7283,198.4,0,0,50086,50086,0,198,198,0,0,0,0,0,50086,198,0,0,,,
1994,22,b) 1,5246,5299,46961,46437,24,0.4,1401,23.1,13494,345,13149,0.7,29.1,12445,6743,5702,14.5,26.8,1049,2.3,53.6,0,1147,1147,5752
1994,22,c) 2,4354,4480,38080,39176,117,2.4,790,16.3,8825,1119,7706,2.9,22.5,11017,4620,6397,11.8,28.1,-2192,-5.6,45,0,642,642,3888
1994,22,d) 3,3751,3922,36326,38097,133,3.2,656,15.6,6901,883,6018,2.3,18.1,10443,4368,6075,11.5,27.4,-3542,-9.3,36.2,0,538,538,3736
1994,22,e) 4,3330,3442,32192,32462,115,3.2,469,12.9,5645,675,4970,2.1,17.4,6185,2495,3690,7.7,19.1,-540,-1.7,34.8,0,365,367,2047
1994,22,f) 5,2814,2938,28640,28519,73,2.4,342,11.1,5730,349,5381,1.2,20.1,5488,1820,3668,6.4,19.2,242,0.9,38.4,0,279,280,1511
1994,22,g) 6 to 10,12902,14082,166965,169255,470,3.2,1331,9.2,23625,4842,18783,2.9,14,28204,9595,18609,5.7,16.7,-4579,-2.7,28,0,950,951,6906
1994,22,h) 11 to 15,10126,11542,147131,149418,397,3.4,954,8.1,19353,3918,15435,2.6,13,23927,6723,17204,4.5,16,-4574,-3,26,0,653,658,3847
1994,22,i) 16 to 20,3347,4284,65266,66067,161,3.7,293,6.7,9187,1312,7875,2,13.9,10788,2364,8424,3.6,16.3,-1601,-2.4,27.8,0,162,174,1012
1994,22,l) Left Censored,15555,27786,731508,729512,1236,4.4,1824,6.5,83274,19493,63781,2.7,11.4,79283,22373,56910,3.1,10.9,3991,0.5,21.8,0,686,695,5685
1994,23,a) 0,2523,2531,11695,5872,2509,198.3,0,0,11647,11647,0,198.3,198.3,0,0,0,0,0,11647,198.3,0,0,,,
1994,23,b) 1,1836,1849,11218,11229,8,0.4,496,23.3,3040,68,2972,0.6,27.1,3062,1835,1227,16.3,27.3,-22,-0.2,54.2,0,388,388,1564
1994,23,c) 2,1504,1579,10171,11192,58,3.4,284,16.7,2417,240,2177,2.1,21.6,4458,2919,1539,26.1,39.8,-2041,-18.2,43.2,0,230,230,2727
1994,23,d) 3,1356,1408,8790,9164,41,2.7,204,13.6,1351,154,1197,1.7,14.7,2099,951,1148,10.4,22.9,-748,-8.2,29.4,0,168,168,833
1994,23,e) 4,1379,1408,9830,10229,44,3,192,12.9,1748,135,1613,1.3,17.1,2546,977,1569,9.6,24.9,-798,-7.8,34.2,0,157,157,850
1994,23,f) 5,1489,1528,9976,10387,57,3.6,151,9.6,1377,145,1232,1.4,13.3,2199,740,1459,7.1,21.2,-822,-7.9,26.6,0,131,131,485
1994,23,g) 6 to 10,5740,6064,56071,56771,207,3.3,657,10.4,7733,1001,6732,1.8,13.6,9133,3593,5540,6.3,16.1,-1400,-2.5,27.2,0,461,461,2178
1994,23,h) 11 to 15,3070,3419,40149,40483,109,3.1,265,7.6,4641,855,3786,2.1,11.5,5308,1320,3988,3.3,13.1,-667,-1.6,23,0,181,181,924
1994,23,i) 16 to 20,1222,1674,21652,21301,68,4,97,5.7,3106,937,2169,4.4,14.6,2404,502,1902,2.4,11.3,702,3.3,22.6,0,59,59,198
1994,23,l) Left Censored,5473,8659,229174,229054,353,4,539,6.2,25365,6129,19236,2.7,11.1,25124,6559,18565,2.9,11,241,0.1,22,0,228,232,1630
1994,24,a) 0,8788,8861,51173,25672,8815,199,0,0,51002,51002,0,198.7,198.7,0,0,0,0,0,51002,198.7,0,0,,,
1994,24,b) 1,6766,6843,49792,48605,37,0.5,1757,22.6,15950,627,15323,1.3,32.8,13575,7467,6108,15.4,27.9,2375,4.9,55.8,0,1363,1363,6104
1994,24,c) 2,5449,5634,42824,44947,200,3.3,1084,17.8,8588,1195,7393,2.7,19.1,12834,5840,6994,13,28.6,-4246,-9.5,38.2,0,843,843,4456
1994,24,d) 3,4968,5124,42126,42774,180,3.3,822,15.1,9243,1204,8039,2.8,21.6,10539,5281,5258,12.3,24.6,-1296,-3,43.2,0,629,629,3865
1994,24,e) 4,4859,4981,40433,41654,177,3.4,673,12.9,7119,738,6381,1.8,17.1,9560,4346,5214,10.4,23,-2441,-5.9,34.2,0,489,491,3496
1994,24,f) 5,4556,4726,41473,42613,143,2.9,604,12.2,6708,1026,5682,2.4,15.7,8987,3974,5013,9.3,21.1,-2279,-5.4,31.4,0,457,457,2891
1994,24,g) 6 to 10,18071,19483,227503,227994,688,3.4,1924,9.6,34676,5918,28758,2.6,15.2,35658,12375,23283,5.4,15.6,-982,-0.4,30.4,0,1312,1331,8067
1994,24,h) 11 to 15,10117,11457,150153,151216,318,2.7,923,7.8,18868,3276,15592,2.2,12.5,20993,6065,14928,4,13.9,-2125,-1.4,25,0,515,534,3149
1994,24,i) 16 to 20,3731,5199,85145,85623,201,3.8,389,7.3,10515,2007,8508,2.3,12.3,11471,2743,8728,3.2,13.4,-956,-1.1,24.6,0,172,186,1080
1994,24,l) Left Censored,18354,33105,997110,1004722,1515,4.5,2271,6.8,121035,33427,87608,3.3,12,136261,40638,95623,4,13.6,-15226,-1.6,24,0,724,741,7075
1994,25,a) 0,10461,10497,58483,29332,10433,198.8,0,0,58302,58302,0,198.8,198.8,0,0,0,0,0,58302,198.8,0,0,,,
1994,25,b) 1,7612,7659,55592,53698,41,0.5,1706,19.9,17903,1640,16263,3.1,33.3,14114,7315,6799,13.6,26.3,3789,7,52.6,0,1342,1342,5894
1994,25,c) 2,6277,6591,58313,60916,212,3,1104,15.6,11404,1494,9910,2.5,18.7,16610,7975,8635,13.1,27.3,-5206,-8.6,37.4,0,886,886,7037
1994,25,d) 3,5522,5699,49141,49801,187,3.1,791,13.2,9580,1101,8479,2.2,19.2,10900,4972,5928,10,21.9,-1320,-2.7,38.4,0,604,604,3888
1994,25,e) 4,5458,5686,51422,51354,214,3.6,725,12.2,9746,1161,8585,2.3,19,9610,4209,5401,8.2,18.7,136,0.3,37.4,0,575,575,3415
1994,25,f) 5,5628,5832,51401,52608,204,3.3,819,13.3,8596,1009,7587,1.9,16.3,11009,4869,6140,9.3,20.9,-2413,-4.6,32.6,0,585,585,3006
1994,25,g) 6 to 10,24050,25609,316355,318436,908,3.4,2511,9.5,43381,5490,37891,1.7,13.6,47542,16520,31022,5.2,14.9,-4161,-1.3,27.2,0,1767,1770,11513
1994,25,h) 11 to 15,14351,16222,234351,237880,510,3.1,1304,7.8,31145,6045,25100,2.5,13.1,38202,9427,28775,4,16.1,-7057,-3,26.2,0,814,820,4404
1994,25,i) 16 to 20,5198,7292,155206,156149,290,3.9,488,6.6,16954,3398,13556,2.2,10.9,18840,6833,12007,4.4,12.1,-1886,-1.2,21.8,0,249,252,4814
1994,25,l) Left Censored,30469,47868,1583046,1590147,1974,4.1,3230,6.7,183678,44603,139075,2.8,11.6,197880,55509,142371,3.5,12.4,-14202,-0.8,23.2,0,1371,1393,12984
1994,26,a) 0,14969,15048,88469,44427,14938,198.5,0,0,88084,88084,0,198.3,198.3,0,0,0,0,0,88084,198.3,0,0,,,
1994,26,b) 1,11595,11702,86734,84829,61,0.5,2441,18.7,25755,3053,22702,3.6,30.4,21945,11544,10401,13.6,25.9,3810,4.5,51.8,0,1850,1850,8525
1994,26,c) 2,9883,10135,79422,82759,310,2.9,1674,15.4,17372,1839,15533,2.2,21,24045,10397,13648,12.6,29.1,-6673,-8.1,42,0,1340,1340,8438
1994,26,d) 3,9105,9444,78115,79897,279,2.8,1324,13.3,14860,1233,13627,1.5,18.6,18424,8473,9951,10.6,23.1,-3564,-4.5,37.2,0,1037,1037,6583
1994,26,e) 4,8729,9040,83287,83816,281,3,1104,11.7,15985,1555,14430,1.9,19.1,17043,6584,10459,7.9,20.3,-1058,-1.2,38.2,0,905,906,5076
1994,26,f) 5,7678,8060,72617,73704,267,3.2,963,11.4,12801,1851,10950,2.5,17.4,14975,5786,9189,7.9,20.3,-2174,-2.9,34.8,0,791,793,4670
1994,26,g) 6 to 10,31945,34674,402174,401536,1054,2.9,3146,8.8,61796,11136,50660,2.8,15.4,60519,23999,36520,6,15.1,1277,0.3,30.2,0,2305,2335,16732
1994,26,h) 11 to 15,19537,22229,287108,287661,644,2.8,1569,6.9,37998,6876,31122,2.4,13.2,39103,13209,25894,4.6,13.6,-1105,-0.4,26.4,0,1032,1035,7655
1994,26,i) 16 to 20,7551,10282,164982,163544,376,3.6,654,6.3,24660,4606,20054,2.8,15.1,21783,5261,16522,3.2,13.3,2877,1.8,26.6,0,354,356,2370
1994,26,l) Left Censored,36363,64175,2145031,2142544,2533,3.9,3904,6,233588,60307,173281,2.8,10.9,228614,78165,150449,3.6,10.7,4974,0.2,21.4,0,1572,1655,13762
1994,27,a) 0,8836,8891,51351,25747,8837,198.8,0,0,51209,51209,0,198.9,198.9,0,0,0,0,0,51209,198.9,0,0,,,
1994,27,b) 1,6701,6778,49814,49618,38,0.5,1490,19.7,13403,872,12531,1.8,27,13010,7688,5322,15.5,26.2,393,0.8,52.4,0,1152,1152,5810
1994,27,c) 2,5617,5788,42159,44948,158,2.5,948,15.3,8297,711,7586,1.6,18.5,13874,7310,6564,16.3,30.9,-5577,-12.4,37,0,751,751,6010
1994,27,d) 3,5107,5330,46372,46502,145,2.6,703,12.5,8561,952,7609,2,18.4,8821,4039,4782,8.7,19,-260,-0.6,36.8,0,538,538,3245
1994,27,e) 4,4654,4845,43974,43660,150,3,542,10.7,8585,1276,7309,2.9,19.7,7956,3097,4859,7.1,18.2,629,1.5,36.4,0,430,432,2445
1994,27,f) 5,4264,4434,39984,40195,121,2.6,429,9.4,6410,777,5633,1.9,15.9,6831,2334,4497,5.8,17,-421,-1.1,31.8,0,334,334,1835
1994,27,g) 6 to 10,17192,18665,235483,236788,510,2.7,1572,8.2,31792,4754,27038,2,13.4,34404,12195,22209,5.2,14.5,-2612,-1.1,26.8,0,1116,1116,8386
1994,27,h) 11 to 15,10745,12342,175535,174694,399,3.2,895,7.1,24530,5177,19353,3,14,22848,7233,15615,4.1,13.1,1682,0.9,26.2,0,551,557,3439
1994,27,i) 16 to 20,4431,6004,97431,96864,246,4,409,6.7,12351,3263,9088,3.4,12.8,11216,3299,7917,3.4,11.6,1135,1.2,23.2,0,204,204,1285
1994,27,l) Left Censored,20980,34676,1174014,1170642,1499,4.3,1954,5.6,120131,25196,94935,2.2,10.3,113387,32444,80943,2.8,9.7,6744,0.6,19.4,0,782,800,7616
1994,28,a) 0,4503,4529,34883,17557,4488,198.2,0,0,34653,34653,0,197.4,197.4,0,0,0,0,0,34653,197.4,0,0,,,
1994,28,b) 1,3248,3285,28499,27029,18,0.5,1010,26.4,9822,763,9059,2.8,36.3,6882,4221,2661,15.6,25.5,2940,10.8,51,0,847,847,3637
1994,28,c) 2,2436,2523,18808,19748,74,2.7,555,19.9,3373,434,2939,2.2,17.1,5253,2651,2602,13.4,26.6,-1880,-9.5,34.2,0,460,460,2308
1994,28,d) 3,2229,2323,19155,19498,75,3,394,15.9,3579,334,3245,1.7,18.4,4265,1746,2519,9,21.9,-686,-3.5,36.8,0,325,325,1302
1994,28,e) 4,2102,2160,16927,17786,75,3.3,342,14.9,2797,326,2471,1.8,15.7,4514,1753,2761,9.9,25.4,-1717,-9.7,31.4,0,282,282,1451
1994,28,f) 5,1738,1782,18485,18033,64,3.4,223,12,4343,844,3499,4.7,24.1,3439,1398,2041,7.8,19.1,904,5,38.2,0,180,184,1154
1994,28,g) 6 to 10,7772,8299,92392,94043,269,3.1,905,10.5,13517,2329,11188,2.5,14.4,16818,6588,10230,7,17.9,-3301,-3.5,28.8,0,688,695,4164
1994,28,h) 11 to 15,5227,5853,72251,71929,156,2.6,474,7.9,9879,1453,8426,2,13.7,9234,3130,6104,4.4,12.8,645,0.9,25.6,0,341,341,1833
1994,28,i) 16 to 20,2084,2716,37707,35926,112,4.1,176,6.4,7589,1228,6361,3.4,21.1,4027,1194,2833,3.3,11.2,3562,9.9,22.4,0,106,106,765
1994,28,l) Left Censored,9654,16661,477015,469853,685,4.1,1094,6.5,59801,20381,39420,4.3,12.7,45476,14182,31294,3,9.7,14325,3,19.4,0,459,464,2863
1994,29,a) 0,10944,11045,59480,29823,10968,198.6,0,0,59315,59315,0,198.9,198.9,0,0,0,0,0,59315,198.9,0,0,,,
1994,29,b) 1,7790,7902,53591,54082,43,0.5,2219,24.4,15287,543,14744,1,28.3,16268,9536,6732,17.6,30.1,-981,-1.8,56.6,0,1818,1818,7950
1994,29,c) 2,6286,6462,51635,53819,226,3.2,1326,18.8,11335,1474,9861,2.7,21.1,15702,7216,8486,13.4,29.2,-4367,-8.1,42.2,0,1076,1078,6149
1994,29,d) 3,5521,5798,46969,47304,207,3.4,911,14.8,9729,1750,7979,3.7,20.6,10400,4610,5790,9.7,22,-671,-1.4,41.2,0,744,744,3830
1994,29,e) 4,5052,5225,46048,48211,168,3,763,13.8,7548,663,6885,1.4,15.7,11873,5973,5900,12.4,24.6,-4325,-8.9,31.4,0,608,610,4441
1994,29,f) 5,4797,5056,41983,43332,191,3.6,673,12.7,7674,1214,6460,2.8,17.7,10372,4828,5544,11.1,23.9,-2698,-6.2,35.4,0,518,519,3828
1994,29,g) 6 to 10,19887,21367,241759,242859,634,2.9,2099,9.5,34530,4151,30379,1.7,14.2,36729,14002,22727,5.8,15.1,-2199,-0.9,28.4,0,1551,1554,9349
1994,29,h) 11 to 15,12041,13735,173395,173459,407,2.9,1057,7.5,23072,4156,18916,2.4,13.3,23199,7373,15826,4.3,13.4,-127,-0.1,26.6,0,722,726,4557
1994,29,i) 16 to 20,4732,6482,100762,99729,247,3.8,424,6.4,14380,3994,10386,4,14.4,12314,3231,9083,3.2,12.3,2066,2.1,24.6,0,244,246,1381
1994,29,l) Left Censored,23172,39642,1249153,1242984,1844,4.6,2630,6.6,136395,32449,103946,2.6,11,124057,35243,88814,2.8,10,12338,1,20,0,1012,1027,7608
1994,30,a) 0,2385,2394,10512,5284,2382,199,0,0,10457,10457,0,197.9,197.9,0,0,0,0,0,10457,197.9,0,0,,,
1994,30,b) 1,1680,1689,8804,8859,6,0.3,450,23.3,2341,56,2285,0.6,26.4,2451,1412,1039,15.9,27.7,-110,-1.3,52.8,0,348,348,1133
1994,30,c) 2,1428,1447,8392,8915,47,3,266,17,1600,304,1296,3.4,17.9,2646,1178,1468,13.2,29.7,-1046,-11.8,35.8,0,215,215,1043
1994,30,d) 3,1192,1215,8073,8223,46,3.6,160,12.5,1415,154,1261,1.9,17.2,1715,793,922,9.6,20.9,-300,-3.7,34.4,0,127,127,526
1994,30,e) 4,1064,1075,7498,7926,31,2.8,130,11.6,1101,118,983,1.5,13.9,1956,564,1392,7.1,24.7,-855,-10.8,27.8,0,90,90,407
1994,30,f) 5,902,951,6607,6863,26,2.6,111,11.1,872,54,818,0.8,12.7,1383,531,852,7.7,20.2,-511,-7.5,25.4,0,81,81,337
1994,30,g) 6 to 10,3996,4259,37492,38738,156,3.5,453,10.3,5290,828,4462,2.1,13.7,7781,2362,5419,6.1,20.1,-2491,-6.4,27.4,0,335,335,1745
1994,30,h) 11 to 15,2892,3243,31185,31459,108,3.2,264,7.9,3880,520,3360,1.7,12.3,4428,1234,3194,3.9,14.1,-548,-1.8,24.6,0,179,179,939
1994,30,i) 16 to 20,1094,1327,12832,13210,46,3.4,79,5.9,1457,178,1279,1.3,11,2212,563,1649,4.3,16.7,-755,-5.7,22,0,52,52,394
1994,30,l) Left Censored,4238,6569,113922,114618,240,3.6,379,5.7,11405,2558,8847,2.2,10,12797,4045,8752,3.5,11.2,-1392,-1.2,20,0,188,188,963
1994,31,a) 0,3123,3155,16445,8248,3129,198.4,0,0,16395,16395,0,198.8,198.8,0,0,0,0,0,16395,198.8,0,0,,,
1994,31,b) 1,2324,2341,15364,15720,14,0.5,536,20.4,3695,65,3630,0.4,23.5,4407,2500,1907,15.9,28,-712,-4.5,47,0,421,421,2166
1994,31,c) 2,2016,2059,13720,15052,45,2,374,16.8,2207,145,2062,1,14.7,4872,2189,2683,14.5,32.4,-2665,-17.7,29.4,0,305,306,1896
1994,31,d) 3,1709,1774,12498,12649,42,2.2,287,15.1,2515,119,2396,0.9,19.9,2817,1365,1452,10.8,22.3,-302,-2.4,39.8,0,217,217,1101
1994,31,e) 4,1656,1735,14646,15132,58,3.2,216,11.9,2515,347,2168,2.3,16.6,3487,1349,2138,8.9,23,-972,-6.4,33.2,0,181,181,1049
1994,31,f) 5,1520,1597,18026,17589,38,2.3,164,9.8,2952,634,2318,3.6,16.8,2078,843,1235,4.8,11.8,874,5,23.6,0,135,135,692
1994,31,g) 6 to 10,6611,7117,80964,82469,187,2.6,573,7.8,10118,1841,8277,2.2,12.3,13128,4588,8540,5.6,15.9,-3010,-3.6,24.6,0,427,428,2722
1994,31,h) 11 to 15,4549,5107,56198,56962,162,3.1,350,6.7,7112,1806,5306,3.2,12.5,8639,2525,6114,4.4,15.2,-1527,-2.7,25,0,233,233,1281
1994,31,i) 16 to 20,1927,2543,33099,32604,100,3.9,148,5.8,4288,989,3299,3,13.2,3297,762,2535,2.3,10.1,991,3.1,20.2,0,94,94,400
1994,31,l) Left Censored,9299,14287,367648,364082,609,4.2,900,6.2,39949,10677,29272,2.9,11,32818,11792,21026,3.2,9,7131,2,18,0,408,414,2237
1994,32,a) 0,3689,3705,28000,14143,3674,198.3,0,0,27714,27714,0,196,196,0,0,0,0,0,27714,196,0,0,,,
1994,32,b) 1,2424,2442,21972,21807,16,0.6,764,26.8,7605,475,7130,2.2,34.9,7274,4377,2897,20.1,33.4,331,1.5,66.8,0,638,639,3723
1994,32,c) 2,1856,1918,18494,19326,79,3.8,425,20.2,4338,470,3868,2.4,22.4,6001,3023,2978,15.6,31.1,-1663,-8.7,44.8,0,335,335,2579
1994,32,d) 3,1647,1704,17265,17717,76,4.2,286,15.8,4290,399,3891,2.3,24.2,5194,2914,2280,16.4,29.3,-904,-5.1,48.4,0,224,224,2504
1994,32,e) 4,1509,1571,17004,17506,68,4.1,250,15.1,3089,299,2790,1.7,17.6,4092,2229,1863,12.7,23.4,-1003,-5.8,35.2,0,194,194,1814
1994,32,f) 5,1355,1417,17175,17361,69,4.7,187,12.7,3182,355,2827,2,18.3,3554,1191,2363,6.9,20.5,-372,-2.2,36.6,0,148,149,990
1994,32,g) 6 to 10,4742,5254,77499,77967,245,4.5,578,10.7,14337,2015,12322,2.6,18.4,15272,7507,7765,9.6,19.6,-935,-1.2,36.8,0,386,387,5949
1994,32,h) 11 to 15,3180,3709,78721,75431,182,4.8,284,7.5,14973,2474,12499,3.3,19.8,8393,3292,5101,4.4,11.1,6580,8.7,22.2,0,178,178,2349
1994,32,i) 16 to 20,1067,1431,29202,29417,67,4.6,96,6.6,3729,544,3185,1.8,12.7,4159,659,3500,2.2,14.1,-430,-1.4,25.4,0,47,47,179
1994,32,l) Left Censored,4081,7170,314822,303863,530,7.4,502,7,49021,12350,36671,4.1,16.1,27103,9003,18100,3,8.9,21918,7.2,17.8,0,148,151,1953
1994,33,a) 0,2563,2573,13078,6555,2556,198.7,0,0,13047,13047,0,199,199,0,0,0,0,0,13047,199,0,0,,,
1994,33,b) 1,1803,1818,10997,10760,14,0.7,483,23.3,3420,128,3292,1.2,31.8,2946,1716,1230,15.9,27.4,474,4.4,54.8,0,392,392,1453
1994,33,c) 2,1502,1565,11161,11544,53,3.2,256,15.3,2467,229,2238,2,21.4,3233,1275,1958,11,28,-766,-6.6,42.8,0,201,201,1014
1994,33,d) 3,1327,1358,9844,10285,36,2.5,216,14.9,1896,175,1721,1.7,18.4,2778,1730,1048,16.8,27,-882,-8.6,36.8,0,168,168,707
1994,33,e) 4,1293,1329,9842,9939,48,3.4,189,13.5,1695,155,1540,1.6,17.1,1889,826,1063,8.3,19,-194,-1.9,34.2,0,150,150,641
1994,33,f) 5,1339,1390,17486,17028,48,3.3,190,13,2661,230,2431,1.4,15.6,1744,793,951,4.7,10.2,917,5.4,20.4,0,153,153,552
1994,33,g) 6 to 10,5802,6120,61273,60992,281,4.5,627,9.9,10582,2474,8108,4.1,17.3,10020,3818,6202,6.3,16.4,562,0.9,32.8,0,444,444,2646
1994,33,h) 11 to 15,2950,3236,36693,36335,125,3.8,245,7.4,5272,1034,4238,2.8,14.5,4556,1571,2985,4.3,12.5,716,2,25,0,160,160,961
1994,33,i) 16 to 20,1106,1526,23581,23406,78,5.1,113,7.3,3187,759,2428,3.2,13.6,2837,659,2178,2.8,12.1,350,1.5,24.2,0,55,55,216
1994,33,l) Left Censored,5245,8459,243859,241616,403,4.7,577,6.7,27906,5997,21909,2.5,11.5,23420,7403,16017,3.1,9.7,4486,1.8,19.4,0,199,200,1454
1994,34,a) 0,15290,15336,80960,40613,15228,198.6,0,0,80694,80694,0,198.7,198.7,0,0,0,0,0,80694,198.7,0,0,,,
1994,34,b) 1,11830,11874,77002,75207,39,0.3,2914,21.6,23950,1424,22526,1.9,31.8,20360,11524,8836,15.3,27.1,3590,4.7,54.2,0,2195,2195,8958
1994,34,c) 2,9603,9807,69960,74455,318,3,1677,15.9,15163,1357,13806,1.8,20.4,24152,13815,10337,18.6,32.4,-8989,-12,40.8,0,1329,1329,12188
1994,34,d) 3,8767,8943,62003,64553,308,3.2,1363,14.4,11401,1233,10168,1.9,17.7,16500,7496,9004,11.6,25.6,-5099,-7.9,35.4,0,1035,1035,5767
1994,34,e) 4,8361,8516,63413,65867,343,3.8,1207,13.5,10893,1485,9408,2.3,16.5,15800,6553,9247,9.9,24,-4907,-7.5,33,0,930,932,4886
1994,34,f) 5,8081,8327,75398,76216,294,3.4,1031,11.9,12650,1644,11006,2.2,16.6,14285,5421,8864,7.1,18.7,-1635,-2.1,33.2,0,786,786,4337
1994,34,g) 6 to 10,33269,34881,396649,403912,1115,3.1,3745,10.3,51316,7343,43973,1.8,12.7,65841,23355,42486,5.8,16.3,-14525,-3.6,25.4,0,2692,2703,17289
1994,34,h) 11 to 15,20511,22184,259359,262359,686,3,1790,7.9,33841,7246,26595,2.8,12.9,39840,10691,29149,4.1,15.2,-5999,-2.3,25.8,0,1182,1199,6656
1994,34,i) 16 to 20,7409,8866,136295,137800,244,2.7,666,7.3,16543,3146,13397,2.3,12,19552,4457,15095,3.2,14.2,-3009,-2.2,24,0,382,411,2939
1994,34,l) Left Censored,38011,59390,1842272,1858193,2783,4.6,4335,7.2,209250,60653,148597,3.3,11.3,241093,75275,165818,4.1,13,-31843,-1.7,22.6,0,1725,1747,14325
1994,35,a) 0,3454,3475,18695,9410,3438,197.9,0,0,18571,18571,0,197.4,197.4,0,0,0,0,0,18571,197.4,0,0,,,
1994,35,b) 1,2359,2373,16294,16409,9,0.3,669,24.4,4761,390,4371,2.4,29,4991,3099,1892,18.9,30.4,-230,-1.4,58,0,530,530,2531
1994,35,c) 2,1926,1995,15784,16374,66,3,416,19.1,3330,335,2995,2,20.3,4509,2486,2023,15.2,27.5,-1179,-7.2,40.6,0,337,337,1930
1994,35,d) 3,1804,1912,14985,15488,70,3.4,333,16.3,2980,342,2638,2.2,19.2,3985,1933,2052,12.5,25.7,-1005,-6.5,38.4,0,257,257,1507
1994,35,e) 4,1558,1587,12384,12994,58,3.4,253,15,2318,276,2042,2.1,17.8,3537,1745,1792,13.4,27.2,-1219,-9.4,35.6,0,196,196,1402
1994,35,f) 5,1430,1496,11774,12184,56,3.6,195,12.4,2272,484,1788,4,18.6,3092,1468,1624,12,25.4,-820,-6.8,37.2,0,145,145,1130
1994,35,g) 6 to 10,5612,6053,67899,68450,244,3.9,647,10.3,9788,1223,8565,1.8,14.3,10889,4017,6872,5.9,15.9,-1101,-1.6,28.6,0,473,475,2771
1994,35,h) 11 to 15,4074,4702,54074,53555,195,4.1,353,7.4,8717,1851,6866,3.5,16.3,7679,2165,5514,4,14.3,1038,2,28.6,0,254,257,1324
1994,35,i) 16 to 20,1455,1919,22085,22004,91,4.7,143,7.4,3219,958,2261,4.4,14.6,3057,1063,1994,4.8,13.9,162,0.7,27.8,0,80,81,516
1994,35,l) Left Censored,5582,9406,235853,232886,531,5.6,572,6.1,32371,9285,23086,4,13.9,26437,7727,18710,3.3,11.4,5934,2.5,22.8,0,217,219,1107
1994,36,a) 0,33809,33864,180972,90776,33628,198.6,0,0,180392,180392,0,198.7,198.7,0,0,0,0,0,180392,198.7,0,0,,,
1994,36,b) 1,25828,26009,169278,170494,103,0.3,6989,23.5,47514,3363,44151,2,27.9,49946,29550,20396,17.3,29.3,-2432,-1.4,55.8,0,5531,5531,24759
1994,36,c) 2,21119,21565,155028,171599,673,2.9,4384,18.6,29832,3696,26136,2.2,17.4,62974,26190,36784,15.3,36.7,-33142,-19.3,34.8,0,3575,3578,20821
1994,36,d) 3,19408,19798,146573,153769,637,3,3308,15.6,25933,3677,22256,2.4,16.9,40324,19663,20661,12.8,26.2,-14391,-9.3,33.8,0,2612,2618,16457
1994,36,e) 4,18108,18503,137618,141827,625,3.2,2803,14.3,24405,2404,22001,1.7,17.2,32822,14090,18732,9.9,23.1,-8417,-5.9,34.4,0,2256,2263,12067
1994,36,f) 5,17209,17635,137316,142870,538,2.9,2605,13.9,21374,2069,19305,1.4,15,32481,14948,17533,10.5,22.7,-11107,-7.7,30,0,2068,2083,11408
1994,36,g) 6 to 10,70015,73395,795847,808565,2226,2.9,8084,10.6,97369,15099,82270,1.9,12,122804,44139,78665,5.5,15.2,-25435,-3.2,24,0,6101,6110,32717
1994,36,h) 11 to 15,42095,46161,585197,593360,1223,2.6,4184,8.8,70660,11190,59470,1.9,11.9,86986,27380,59606,4.6,14.7,-16326,-2.8,23.8,0,2891,2904,17094
1994,36,i) 16 to 20,15062,19320,337281,338791,575,2.9,1571,7.9,39917,7017,32900,2.1,11.8,42937,12748,30189,3.8,12.7,-3020,-0.9,23.6,0,877,918,6660
1994,36,l) Left Censored,83438,128229,3926448,3963633,5667,4.4,9716,7.5,423694,108582,315112,2.7,10.7,498064,130992,367072,3.3,12.6,-74370,-1.9,21.4,0,4490,4561,34269
1994,37,a) 0,13437,13518,76805,38530,13426,198.6,0,0,76551,76551,0,198.7,198.7,0,0,0,0,0,76551,198.7,0,0,,,
1994,37,b) 1,9605,9674,64222,63881,48,0.4,2410,22,19536,1647,17889,2.6,30.6,18854,11547,7307,18.1,29.5,682,1.1,59,0,1959,1959,9707
1994,37,c) 2,7779,8023,68641,70795,237,2.7,1505,17.3,13925,1227,12698,1.7,19.7,18232,9647,8585,13.6,25.8,-4307,-6.1,39.4,0,1203,1203,7606
1994,37,d) 3,7152,7439,59230,60421,233,3,1131,14.3,11793,1696,10097,2.8,19.5,14175,6025,8150,10,23.5,-2382,-4,39,0,907,907,4604
1994,37,e) 4,6826,7073,59231,60958,265,3.6,909,12.3,11177,1809,9368,3,18.3,14631,8062,6569,13.2,24,-3454,-5.7,36.6,0,713,713,6901
1994,37,f) 5,6133,6440,61346,61220,229,3.4,774,11.5,10982,1607,9375,2.6,17.9,10729,3977,6752,6.5,17.5,253,0.4,35,0,617,617,3282
1994,37,g) 6 to 10,27011,29527,325583,325193,1064,3.5,2621,8.6,48282,8934,39348,2.7,14.8,47501,18169,29332,5.6,14.6,781,0.2,29.2,0,1937,1943,12965
1994,37,h) 11 to 15,14705,16965,237295,235807,513,3,1190,6.9,32047,6796,25251,2.9,13.6,29070,8156,20914,3.5,12.3,2977,1.3,24.6,0,790,790,5113
1994,37,i) 16 to 20,5681,7606,120953,119348,313,4.1,456,5.9,15093,3348,11745,2.8,12.6,11883,2892,8991,2.4,10,3210,2.6,20,0,271,272,1347
1994,37,l) Left Censored,26287,50641,1733922,1716640,2224,4.4,2900,5.7,193990,50461,143529,2.9,11.3,159425,41881,117544,2.4,9.3,34565,2,18.6,0,1073,1110,7022
1994,38,a) 0,1290,1291,6191,3103,1283,198.8,0,0,6176,,,,199,0,0,0,0,0,6176,199,0,1,,,
1994,38,b) 1,988,992,6153,6127,3,0.3,239,21.4,1600,,,,26.1,1548,754,794,12.3,25.3,52,0.8,50.6,1,178,178,600
1994,38,c) 2,811,819,5267,5329,23,2.6,138,15.7,1209,176,1033,3.3,22.7,1333,560,773,10.5,25,-124,-2.3,45.4,0,104,105,466
1994,38,d) 3,737,755,5387,5288,21,2.6,101,12.6,1126,192,934,3.6,21.3,927,445,482,8.4,17.5,199,3.8,35,0,85,85,371
1994,38,e) 4,670,699,4431,4731,19,2.6,103,13.8,612,60,552,1.3,12.9,1212,430,782,9.1,25.6,-600,-12.7,25.8,0,81,81,352
1994,38,f) 5,590,605,4400,4438,16,2.5,75,11.8,644,70,574,1.6,14.5,719,233,486,5.3,16.2,-75,-1.7,29,0,57,57,198
1994,38,g) 6 to 10,2843,3022,25665,25949,82,2.6,232,7.5,3383,209,3174,0.8,13,3951,1328,2623,5.1,15.2,-568,-2.2,26,0,176,176,875
1994,38,h) 11 to 15,2127,2403,25655,25923,70,2.9,163,6.6,2948,427,2521,1.6,11.4,3483,924,2559,3.6,13.4,-535,-2,22.8,0,102,102,575
1994,38,i) 16 to 20,840,1022,11455,11268,31,3,67,6.4,1590,301,1289,2.7,14.1,1216,262,954,2.3,10.8,374,3.3,21.6,0,45,45,144
1994,38,l) Left Censored,4103,6131,123529,122843,199,3.2,319,5.2,11332,1750,9582,1.4,9.2,9961,2551,7410,2.1,8.1,1371,1.1,16.2,0,150,151,795
1994,39,a) 0,16644,16822,99062,49637,16727,198.9,0,0,98850,98850,0,199.1,199.1,0,0,0,0,0,98850,199.1,0,0,,,
1994,39,b) 1,12707,12858,99490,97003,82,0.6,2922,20.3,28568,3463,25105,3.6,29.5,23594,12891,10703,13.3,24.3,4974,5.2,48.6,0,2263,2263,10341
1994,39,c) 2,10551,10862,82414,85509,300,2.6,1873,16,16902,2321,14581,2.7,19.8,23092,11495,11597,13.4,27,-6190,-7.2,39.6,0,1517,1520,9770
1994,39,d) 3,9657,10042,83638,84303,300,2.8,1424,13.4,16702,2346,14356,2.8,19.8,18032,7209,10823,8.6,21.4,-1330,-1.6,39.6,0,1116,1116,5474
1994,39,e) 4,9152,9560,85271,86430,274,2.7,1164,11.6,14439,1935,12504,2.2,16.7,16756,6735,10021,7.8,19.4,-2317,-2.7,33.4,0,908,909,4995
1994,39,f) 5,8443,9057,95808,96443,296,3.1,1041,11,16817,2980,13837,3.1,17.4,18086,7411,10675,7.7,18.8,-1269,-1.4,34.8,0,809,810,4681
1994,39,g) 6 to 10,35403,38816,473721,477334,1176,2.9,3320,8.3,64878,10806,54072,2.3,13.6,72104,25064,47040,5.3,15.1,-7226,-1.5,27.2,0,2426,2436,17304
1994,39,h) 11 to 15,22652,26122,367163,367825,744,2.8,1895,7.1,45474,7698,37776,2.1,12.4,46798,15084,31714,4.1,12.7,-1324,-0.3,24.8,0,1261,1300,8797
1994,39,i) 16 to 20,9092,12572,205017,203803,489,3.8,811,6.4,28316,6693,21623,3.3,13.9,25887,7777,18110,3.8,12.7,2429,1.2,25.4,0,418,430,2416
1994,39,l) Left Censored,47810,86051,2733634,2724727,3764,4.3,5311,6.1,308104,85114,222990,3.1,11.3,290290,78131,212159,2.9,10.7,17814,0.6,21.4,0,1955,2021,13714
1994,40,a) 0,6445,6463,35429,17753,6431,199,0,0,35352,35352,0,199.1,199.1,0,0,0,0,0,35352,199.1,0,0,,,
1994,40,b) 1,4631,4664,31409,31103,30,0.6,1374,25.4,9236,468,8768,1.5,29.7,8624,5193,3431,16.7,27.7,612,2,55.4,0,1135,1135,4595
1994,40,c) 2,3755,3842,27217,28715,99,2.3,816,19.3,5911,741,5170,2.6,20.6,8907,5114,3793,17.8,31,-2996,-10.4,41.2,0,671,671,4523
1994,40,d) 3,3308,3418,25621,26310,127,3.5,558,15.3,4788,448,4340,1.7,18.2,6165,3475,2690,13.2,23.4,-1377,-5.2,36.4,0,446,446,3045
1994,40,e) 4,3013,3113,24878,25229,109,3.3,443,13.5,4726,655,4071,2.6,18.7,5428,2330,3098,9.2,21.5,-702,-2.8,37.4,0,363,363,2000
1994,40,f) 5,2617,2708,24617,25570,94,3.3,330,11.7,3416,417,2999,1.6,13.4,5322,1909,3413,7.5,20.8,-1906,-7.4,26.8,0,268,268,1644
1994,40,g) 6 to 10,11420,12298,129804,131653,414,3.3,1068,8.5,16707,2553,14154,1.9,12.7,20404,6558,13846,5,15.5,-3697,-2.8,25.4,0,808,809,4923
1994,40,h) 11 to 15,8508,9654,113328,112804,348,3.5,717,7.3,15116,3096,12020,2.7,13.4,14068,3887,10181,3.4,12.5,1048,0.9,25,0,487,487,2412
1994,40,i) 16 to 20,2807,3707,50160,50241,134,3.5,290,7.7,7073,1541,5532,3.1,14.1,7234,2780,4454,5.5,14.4,-161,-0.3,28.2,0,166,167,1057
1994,40,l) Left Censored,12551,21612,533185,536004,901,4.1,1317,6,56417,12717,43700,2.4,10.5,62055,16656,45399,3.1,11.6,-5638,-1.1,21,0,562,565,3036
1994,41,a) 0,8121,8187,38343,19227,8133,198.7,0,0,38232,38232,0,198.8,198.8,0,0,0,0,0,38232,198.8,0,0,,,
1994,41,b) 1,5530,5572,32527,32304,28,0.4,1460,23,9255,850,8405,2.6,28.6,8809,5161,3648,16,27.3,446,1.3,54.6,0,1144,1145,4067
1994,41,c) 2,4567,4697,35710,36259,187,3.7,844,16.7,8005,1086,6919,3,22.1,9102,4282,4820,11.8,25.1,-1097,-3,44.2,0,657,657,3189
1994,41,d) 3,4080,4190,29173,29705,146,3.3,621,14,5754,630,5124,2.1,19.4,6818,3351,3467,11.3,23,-1064,-3.6,38.8,0,480,480,2756
1994,41,e) 4,4104,4232,33263,32841,166,3.8,521,11.8,6833,1055,5778,3.2,20.8,5989,2493,3496,7.6,18.2,844,2.6,36.4,0,389,389,1961
1994,41,f) 5,2792,2907,26453,26766,107,3.5,386,12.6,4979,1063,3916,4,18.6,5605,2308,3297,8.6,20.9,-626,-2.3,37.2,0,307,307,1721
1994,41,g) 6 to 10,12908,13840,151047,150021,522,3.7,1381,9.7,26071,4195,21876,2.8,17.4,24018,8588,15430,5.7,16,2053,1.4,32,0,964,968,5808
1994,41,h) 11 to 15,8508,9654,119710,119172,335,3.4,780,7.9,17181,3064,14117,2.6,14.4,16105,5673,10432,4.8,13.5,1076,0.9,27,0,493,499,3014
1994,41,i) 16 to 20,3205,4173,60971,60634,170,4,289,6.8,8364,2293,6071,3.8,13.8,7689,2552,5137,4.2,12.7,675,1.1,25.4,0,151,151,919
1994,41,l) Left Censored,12475,21557,580360,573128,1233,5.7,1328,6.1,72998,22252,50746,3.9,12.7,58534,16959,41575,3,10.2,14464,2.5,20.4,0,486,488,2935
1994,42,a) 0,16147,16256,104919,52577,16142,198.6,0,0,104684,104684,0,199.1,199.1,0,0,0,0,0,104684,199.1,0,0,,,
1994,42,b) 1,12946,13050,94280,93413,67,0.5,2994,20.4,26606,1556,25050,1.7,28.5,24871,13101,11770,14,26.6,1735,1.9,53.2,0,2448,2448,11028
1994,42,c) 2,11563,11955,88163,96429,335,2.6,1957,15.3,17128,2533,14595,2.6,17.8,33660,18586,15074,19.3,34.9,-16532,-17.1,35.6,0,1582,1584,16233
1994,42,d) 3,10911,11292,87490,90632,315,2.6,1555,13,16144,1772,14372,2,17.8,22427,10437,11990,11.5,24.7,-6283,-6.9,35.6,0,1240,1243,7502
1994,42,e) 4,10558,10895,86590,89300,289,2.5,1353,11.8,13682,1550,12132,1.7,15.3,19102,8052,11050,9,21.4,-5420,-6.1,30.6,0,1064,1065,6329
1994,42,f) 5,10243,10772,95718,97454,324,2.9,1218,10.8,15427,3204,12223,3.3,15.8,18899,7190,11709,7.4,19.4,-3472,-3.6,31.6,0,970,972,6117
1994,42,g) 6 to 10,42693,45872,519204,527126,1219,2.6,4213,8.9,68363,10505,57858,2,13,84206,31138,53068,5.9,16,-15843,-3,26,0,3094,3113,20243
1994,42,h) 11 to 15,25299,28432,369368,371936,686,2.4,2079,7.1,46244,8102,38142,2.2,12.4,51379,16249,35130,4.4,13.8,-5135,-1.4,24.8,0,1444,1455,9894
1994,42,i) 16 to 20,9946,13248,222318,223521,479,3.5,978,7.2,23246,4479,18767,2,10.4,25651,7901,17750,3.5,11.5,-2405,-1.1,20.8,0,520,529,3532
1994,42,l) Left Censored,53817,91852,2845262,2857701,3887,4.2,6009,6.5,295096,81282,213814,2.8,10.3,319975,94196,225779,3.3,11.2,-24879,-0.9,20.6,0,2521,2586,19345
1994,44,a) 0,1950,1958,13599,6814,1943,198.5,0,0,13571,13571,0,199.2,199.2,0,0,0,0,0,13571,199.2,0,0,,,
1994,44,b) 1,1439,1441,7844,8127,4,0.2,356,21.8,2147,158,1989,1.9,26.4,2712,1814,898,22.3,33.4,-565,-7,52.8,0,272,272,1312
1994,44,c) 2,1175,1188,8829,11974,39,3,229,17.8,1595,98,1497,0.8,13.3,7885,1691,6194,14.1,65.9,-6290,-52.6,26.6,0,178,178,1547
1994,44,d) 3,1035,1050,7785,8363,40,3.6,160,14.4,1669,347,1322,4.1,20,2824,964,1860,11.5,33.8,-1155,-13.8,40,0,130,130,840
1994,44,e) 4,1046,1067,7045,7278,32,2.9,134,12,1068,112,956,1.5,14.7,1533,549,984,7.5,21.1,-465,-6.4,29.4,0,100,100,417
1994,44,f) 5,1092,1110,10169,10719,50,4.3,175,15,1473,203,1270,1.9,13.7,2572,1135,1437,10.6,24,-1099,-10.3,27.4,0,121,121,665
1994,44,g) 6 to 10,4301,4473,39847,41123,174,3.8,491,10.6,5105,1019,4086,2.5,12.4,7656,2316,5340,5.6,18.6,-2551,-6.2,24.8,0,364,364,1795
1994,44,h) 11 to 15,2480,2651,32640,32684,88,3.2,232,8.5,5346,1072,4274,3.3,16.4,5433,2781,2652,8.5,16.6,-87,-0.2,32.8,0,151,154,862
1994,44,i) 16 to 20,988,1176,16711,17000,43,3.6,88,7.3,1808,335,1473,2,10.6,2386,518,1868,3,14,-578,-3.4,21.2,0,43,43,258
1994,44,l) Left Censored,5826,7825,221292,225044,253,3.2,520,6.5,19568,5066,14502,2.3,8.7,27072,7869,19203,3.5,12,-7504,-3.3,17.4,0,242,243,1912
1994,45,a) 0,6678,6719,44294,22213,6671,198.6,0,0,44163,44163,0,198.8,198.8,0,0,0,0,0,44163,198.8,0,0,,,
1994,45,b) 1,4825,4873,33612,33364,25,0.4,1385,24.6,10104,636,9468,1.9,30.3,9607,5646,3961,16.9,28.8,497,1.5,57.6,0,1126,1126,4836
1994,45,c) 2,4006,4097,35739,36936,107,2.4,812,18.2,7863,610,7253,1.7,21.3,10256,4479,5777,12.1,27.8,-2393,-6.5,42.6,0,661,662,3635
1994,45,d) 3,3627,3802,29054,29982,123,3,611,15.1,5216,554,4662,1.8,17.4,7072,3246,3826,10.8,23.6,-1856,-6.2,34.8,0,487,487,2683
1994,45,e) 4,3271,3364,27677,28363,113,3.2,534,14.9,5499,807,4692,2.8,19.4,6871,3823,3048,13.5,24.2,-1372,-4.8,38.8,0,421,422,3181
1994,45,f) 5,2904,3148,29680,30209,118,3.6,431,13,5212,836,4376,2.8,17.3,6270,2492,3778,8.2,20.8,-1058,-3.5,34.6,0,326,326,1841
1994,45,g) 6 to 10,12955,14274,159397,160450,493,3.4,1320,9,23096,4578,18518,2.9,14.4,25201,8661,16540,5.4,15.7,-2105,-1.3,28.8,0,944,948,6695
1994,45,h) 11 to 15,7238,8268,110761,110721,259,3.1,661,7.8,16684,4198,12486,3.8,15.1,16604,6481,10123,5.9,15,80,0.1,30,0,421,423,3013
1994,45,i) 16 to 20,2729,3628,51232,50359,160,4.3,256,7,8520,1852,6668,3.7,16.9,6774,2199,4575,4.4,13.5,1746,3.4,27,0,137,137,767
1994,45,l) Left Censored,12758,24056,795917,792777,1142,4.7,1430,5.9,85638,25782,59856,3.3,10.8,79357,24299,55058,3.1,10,6281,0.8,20,0,519,528,5561
1994,46,a) 0,1692,1704,8957,4514,1690,198.4,0,0,8886,8886,0,196.9,196.9,0,0,0,0,0,8886,196.9,0,0,,,
1994,46,b) 1,1189,1196,7209,7414,5,0.4,291,21.5,1780,31,1749,0.4,24,2190,1288,902,17.4,29.5,-410,-5.5,48,0,218,218,1067
1994,46,c) 2,1015,1044,6626,7430,37,3.3,174,15.6,1154,87,1067,1.2,15.5,2761,1331,1430,17.9,37.2,-1607,-21.7,31,0,137,137,1170
1994,46,d) 3,913,934,7110,7468,22,2.2,129,13,1047,58,989,0.8,14,1763,868,895,11.6,23.6,-716,-9.6,28,0,106,106,753
1994,46,e) 4,890,907,7559,7696,33,3.4,136,14.2,1144,117,1027,1.5,14.9,1418,694,724,9,18.4,-274,-3.5,29.8,0,105,105,491
1994,46,f) 5,699,726,5821,5951,17,2.2,73,9.7,970,95,875,1.6,16.3,1229,360,869,6,20.7,-259,-4.4,32.6,0,55,55,294
1994,46,g) 6 to 10,3175,3362,34495,34523,106,3.1,289,8.4,5099,695,4404,2,14.8,5154,2088,3066,6,14.9,-55,-0.1,29.6,0,216,217,1771
1994,46,h) 11 to 15,2035,2303,27458,27779,73,3.1,170,7.2,3299,661,2638,2.4,11.9,3940,1052,2888,3.8,14.2,-641,-2.3,23.8,0,99,99,510
1994,46,i) 16 to 20,886,1100,11970,11971,31,2.8,82,7.3,1429,181,1248,1.5,11.9,1430,391,1039,3.3,11.9,-1,0,23.8,0,51,51,229
1994,46,l) Left Censored,4366,6346,135079,133291,274,4.3,341,5.3,15199,4605,10594,3.5,11.4,11622,3896,7726,2.9,8.7,3577,2.7,17.4,0,188,190,999
1994,47,a) 0,9412,9466,61065,30658,9396,198.5,0,0,60814,60814,0,198.4,198.4,0,0,0,0,0,60814,198.4,0,0,,,
1994,47,b) 1,6955,7047,52827,53293,48,0.6,1951,24.1,15811,882,14929,1.7,29.7,16743,10293,6450,19.3,31.4,-932,-1.7,59.4,0,1604,1604,8669
1994,47,c) 2,5473,5670,51607,53139,160,2.6,1141,18.4,12245,1379,10866,2.6,23,15309,7483,7826,14.1,28.8,-3064,-5.8,46,0,936,936,5362
1994,47,d) 3,4826,5059,47763,49645,172,3.2,785,14.6,9004,1458,7546,2.9,18.1,12767,5766,7001,11.6,25.7,-3763,-7.6,36.2,0,600,600,4585
1994,47,e) 4,4424,4575,39258,41333,130,2.7,634,13.1,6657,609,6048,1.5,16.1,10806,4792,6014,11.6,26.1,-4149,-10,32.2,0,508,511,3406
1994,47,f) 5,4070,4329,40865,41255,141,3.1,510,11.3,7063,1263,5800,3.1,17.1,7842,3016,4826,7.3,19,-779,-1.9,34.2,0,396,397,2317
1994,47,g) 6 to 10,17932,19459,239487,240985,645,3.2,1693,8.5,33664,5173,28491,2.1,14,36660,14062,22598,5.8,15.2,-2996,-1.2,28,0,1229,1234,9859
1994,47,h) 11 to 15,10195,11675,157328,158807,344,2.9,914,7.6,20009,3955,16054,2.5,12.6,22966,7792,15174,4.9,14.5,-2957,-1.9,25.2,0,597,602,4802
1994,47,i) 16 to 20,4223,6237,123202,123615,247,3.9,371,5.9,14914,3903,11011,3.2,12.1,15739,3087,12652,2.5,12.7,-825,-0.6,24.2,0,205,210,1377
1994,47,l) Left Censored,19057,35422,1192209,1181716,1701,4.8,2232,6.3,140928,42595,98333,3.6,11.9,119941,39783,80158,3.4,10.1,20987,1.8,20.2,0,844,861,5371
1994,48,a) 0,36478,36881,229500,115227,36625,198.6,0,0,228547,228547,0,198.3,198.3,0,0,0,0,0,228547,198.3,0,0,,,
1994,48,b) 1,26421,26802,213291,214757,168,0.5,7741,25,64649,4170,60479,1.9,30.1,67581,40424,27157,18.8,31.5,-2932,-1.4,60.2,0,6401,6401,35057
1994,48,c) 2,21799,22573,212016,225512,666,2.7,4687,19,46551,4668,41883,2.1,20.6,73543,39003,34540,17.3,32.6,-26992,-12,41.2,0,3847,3849,27831
1994,48,d) 3,19116,20066,187232,190785,655,3.1,3316,15.4,39228,4695,34533,2.5,20.6,46334,23100,23234,12.1,24.3,-7106,-3.7,41.2,0,2655,2658,19175
1994,48,e) 4,16649,17551,171437,176770,587,3.2,2594,14,33176,5580,27596,3.2,18.8,43842,18435,25407,10.4,24.8,-10666,-6,37.6,0,2028,2041,14571
1994,48,f) 5,14084,15107,156677,158599,565,3.6,2036,12.8,29565,5565,24000,3.5,18.6,33409,12924,20485,8.1,21.1,-3844,-2.5,37.2,0,1581,1585,9747
1994,48,g) 6 to 10,58107,64788,760565,773570,2487,3.7,6725,10,117834,19882,97952,2.6,15.2,143844,55733,88111,7.2,18.6,-26010,-3.4,30.4,0,4776,4815,32557
1994,48,h) 11 to 15,41696,48360,622592,622081,1744,3.5,3868,7.8,93008,22208,70800,3.6,15,91986,29543,62443,4.7,14.8,1022,0.2,29.6,0,2426,2449,13204
1994,48,i) 16 to 20,12955,18400,280090,279749,875,4.7,1506,8,39972,9732,30240,3.5,14.3,39289,12382,26907,4.4,14,683,0.3,28,0,737,740,4188
1994,48,l) Left Censored,50164,110055,3454051,3464872,6289,5.7,7650,6.9,427742,127058,300684,3.7,12.3,449385,116258,333127,3.4,13,-21643,-0.7,24.6,0,2464,2516,16328
1994,49,a) 0,4349,4411,28608,14333,4391,199.1,0,0,28551,28551,0,199.2,199.2,0,0,0,0,0,28551,199.2,0,0,,,
1994,49,b) 1,2858,2885,22935,23119,16,0.5,819,24.7,6973,402,6571,1.7,30.2,7340,4375,2965,18.9,31.7,-367,-1.5,60.4,0,660,660,3618
1994,49,c) 2,2291,2341,19560,21584,81,3.2,477,18.7,4824,488,4336,2.3,22.3,8871,4335,4536,20.1,41.1,-4047,-18.8,44.6,0,395,395,3529
1994,49,d) 3,1907,1988,19120,19593,57,2.7,290,13.8,4008,671,3337,3.4,20.5,4953,2583,2370,13.2,25.3,-945,-4.8,41,0,229,229,1953
1994,49,e) 4,1612,1692,17823,18462,79,4.5,215,12.2,3499,579,2920,3.1,19,4777,2468,2309,13.4,25.9,-1278,-6.9,38,0,162,164,2024
1994,49,f) 5,1441,1503,20979,22056,52,3.3,182,11.6,3459,310,3149,1.4,15.7,5612,2033,3579,9.2,25.4,-2153,-9.7,31.4,0,154,154,1445
1994,49,g) 6 to 10,5424,5882,92993,90905,224,3.7,587,9.7,16721,2635,14086,2.9,18.4,12544,5421,7123,6,13.8,4177,4.6,27.6,0,413,415,3410
1994,49,h) 11 to 15,3834,4412,69216,68937,157,3.5,359,7.9,9205,1246,7959,1.8,13.4,8647,2482,6165,3.6,12.5,558,0.9,25,0,225,227,1273
1994,49,i) 16 to 20,1431,1821,30765,30691,95,5.1,158,8.5,3985,999,2986,3.3,13,3837,1305,2532,4.3,12.5,148,0.5,25,0,79,82,487
1994,49,l) Left Censored,5863,10484,367038,358428,629,6,715,6.8,46906,11473,35433,3.2,13.1,29686,9329,20357,2.6,8.3,17220,4.8,16.6,0,296,296,1962
1994,50,a) 0,1432,1446,6439,3235,1434,198.3,0,0,6408,6408,0,198.1,198.1,0,0,0,0,0,6408,198.1,0,0,,,
1994,50,b) 1,1171,1174,6034,6032,5,0.4,285,21.5,1444,35,1409,0.6,23.9,1439,719,720,11.9,23.9,5,0,47.8,0,217,217,574
1994,50,c) 2,917,931,6087,6250,34,3.4,142,14.4,1055,93,962,1.5,16.9,1381,485,896,7.8,22.1,-326,-5.2,33.8,0,115,115,427
1994,50,d) 3,848,868,5313,5266,24,2.6,114,12.4,1043,79,964,1.5,19.8,949,485,464,9.2,18,94,1.8,36,0,87,87,413
1994,50,e) 4,907,931,5653,5600,30,3.1,116,11.9,1012,161,851,2.9,18.1,906,364,542,6.5,16.2,106,1.9,32.4,0,81,81,272
1994,50,f) 5,927,953,7494,7408,32,3.2,116,11.6,1323,226,1097,3.1,17.9,1150,533,617,7.2,15.5,173,2.4,31,0,91,91,450
1994,50,g) 6 to 10,3596,3757,30823,30918,120,3.1,312,8.1,4181,668,3513,2.2,13.5,4370,1316,3054,4.3,14.1,-189,-0.6,27,0,232,233,1021
1994,50,h) 11 to 15,1885,2039,20064,20101,59,2.8,143,6.9,2464,348,2116,1.7,12.3,2538,614,1924,3.1,12.6,-74,-0.3,24.6,0,106,106,418
1994,50,i) 16 to 20,713,885,13093,13267,27,3,70,7.7,1270,197,1073,1.5,9.6,1618,481,1137,3.6,12.2,-348,-2.6,19.2,0,37,37,128
1994,50,l) Left Censored,3275,4741,116439,117418,157,3.3,285,5.9,9894,1781,8113,1.5,8.4,11851,4181,7670,3.6,10.1,-1957,-1.7,16.8,0,116,120,1267
1994,51,a) 0,11764,11840,60813,30506,11762,198.7,0,0,60615,60615,0,198.7,198.7,0,0,0,0,0,60615,198.7,0,0,,,
1994,51,b) 1,8931,9000,62517,61200,51,0.5,2231,21.9,18440,1282,17158,2.1,30.1,15805,8857,6948,14.5,25.8,2635,4.3,51.6,0,1787,1787,7415
1994,51,c) 2,7318,7591,62507,64093,268,3.3,1418,17.3,13872,2080,11792,3.2,21.6,17043,8226,8817,12.8,26.6,-3171,-5,43.2,0,1103,1103,6348
1994,51,d) 3,6498,6721,54803,56129,209,2.9,1031,14.4,10171,1008,9163,1.8,18.1,12822,6071,6751,10.8,22.8,-2651,-4.7,36.2,0,798,798,4115
1994,51,e) 4,6289,6530,54058,54719,219,3.2,876,12.8,10123,1266,8857,2.3,18.5,11444,4865,6579,8.9,20.9,-1321,-2.4,37,0,655,655,3729
1994,51,f) 5,5640,5906,50006,50834,198,3.2,718,11.6,8028,1353,6675,2.7,15.8,9684,3764,5920,7.4,19.1,-1656,-3.3,31.6,0,556,556,3001
1994,51,g) 6 to 10,23836,26087,296071,295579,923,3.4,2369,8.8,44630,9490,35140,3.2,15.1,43645,14062,29583,4.8,14.8,985,0.3,29.6,0,1639,1644,9563
1994,51,h) 11 to 15,13073,15099,213458,215809,459,3,1066,6.9,25691,5154,20537,2.4,11.9,30392,9160,21232,4.2,14.1,-4701,-2.2,23.8,0,678,683,5113
1994,51,i) 16 to 20,4860,6889,108189,107189,273,3.9,478,6.8,14294,4344,9950,4.1,13.3,12294,3656,8638,3.4,11.5,2000,1.8,23,0,223,230,1347
1994,51,l) Left Censored,22590,45255,1381198,1427237,2163,4.7,3008,6.6,165847,48425,117422,3.4,11.6,257926,45633,212293,3.2,18.1,-92079,-6.5,23.2,0,922,944,5405
1994,53,a) 0,13421,13491,63216,31774,13372,198.2,0,0,62884,62884,0,197.9,197.9,0,0,0,0,0,62884,197.9,0,0,,,
1994,53,b) 1,9469,9567,59677,59720,63,0.6,2837,25.5,17176,1171,16005,2,28.8,17262,9397,7865,15.7,28.9,-86,-0.1,57.6,0,2192,2192,7888
1994,53,c) 2,7996,8237,58453,60806,306,3.4,1675,18.7,12707,2082,10625,3.4,20.9,17413,7556,9857,12.4,28.6,-4706,-7.7,41.8,0,1315,1315,6165
1994,53,d) 3,6855,7054,53284,55310,242,3.2,1175,15.6,10145,1379,8766,2.5,18.3,14197,5601,8596,10.1,25.7,-4052,-7.4,36.6,0,899,900,4455
1994,53,e) 4,7048,7305,59126,60607,254,3.3,1104,14.2,11086,1097,9989,1.8,18.3,14048,5459,8589,9,23.2,-2962,-4.9,36.6,0,810,812,4163
1994,53,f) 5,4441,4641,43444,44874,181,3.7,620,12.7,7475,1311,6164,2.9,16.7,10334,4550,5784,10.1,23,-2859,-6.3,33.4,0,472,472,3417
1994,53,g) 6 to 10,21317,23101,258417,261492,869,3.6,2318,9.7,37636,6025,31611,2.3,14.4,43786,14836,28950,5.7,16.7,-6150,-2.3,28.8,0,1616,1621,8877
1994,53,h) 11 to 15,13398,15331,204069,205603,566,3.6,1184,7.6,30184,6522,23662,3.2,14.7,33251,10405,22846,5.1,16.2,-3067,-1.5,29.4,0,780,783,6889
1994,53,i) 16 to 20,5108,6710,98188,97600,238,3.5,487,7.1,13668,2038,11630,2.1,14,12491,3456,9035,3.5,12.8,1177,1.2,25.6,0,241,241,1539
1994,53,l) Left Censored,18675,33660,961648,965321,1798,5.3,2278,6.7,107373,29137,78236,3,11.1,114718,26738,87980,2.8,11.9,-7345,-0.8,22.2,0,802,814,4723
1994,54,a) 0,2702,2713,12924,6477,2696,198.7,0,0,12895,12895,0,199.1,199.1,0,0,0,0,0,12895,199.1,0,0,,,
1994,54,b) 1,2105,2111,11576,11689,8,0.3,389,16.7,3275,269,3006,2.3,28,3501,1816,1685,15.5,30,-226,-2,56,0,284,284,1501
1994,54,c) 2,1708,1741,10977,11538,40,2.1,293,15.6,2140,320,1820,2.8,18.5,3262,1481,1781,12.8,28.3,-1122,-9.8,37,0,237,237,1230
1994,54,d) 3,1575,1682,16563,17159,51,2.9,236,13.3,2670,323,2347,1.9,15.6,3861,1520,2341,8.9,22.5,-1191,-6.9,31.2,0,186,186,932
1994,54,e) 4,1473,1492,11115,11290,45,2.9,195,12.4,2169,195,1974,1.7,19.2,2519,1065,1454,9.4,22.3,-350,-3.1,38.4,0,156,156,886
1994,54,f) 5,1314,1356,12768,13086,47,3.3,157,11.1,1748,191,1557,1.5,13.4,2384,539,1845,4.1,18.2,-636,-4.8,26.8,0,128,128,456
1994,54,g) 6 to 10,5739,6130,66042,67372,208,3.3,561,8.9,7981,1609,6372,2.4,11.8,10640,3602,7038,5.3,15.8,-2659,-4,23.6,0,420,423,2263
1994,54,h) 11 to 15,3572,3996,43936,44282,122,3,266,6.5,5020,1137,3883,2.6,11.3,5712,1977,3735,4.5,12.9,-692,-1.6,22.6,0,173,173,873
1994,54,i) 16 to 20,1480,2017,28023,27614,117,5.8,129,6.4,3972,1168,2804,4.2,14.4,3153,686,2467,2.5,11.4,819,3,22.8,0,71,71,279
1994,54,l) Left Censored,7758,12573,284415,281790,529,4.2,735,5.8,34500,9210,25290,3.3,12.2,29249,8378,20871,3,10.4,5251,1.8,20.8,0,327,329,2046
1994,55,a) 0,8767,8814,48182,24160,8744,198.4,0,0,48045,48045,0,198.9,198.9,0,0,0,0,0,48045,198.9,0,0,,,
1994,55,b) 1,6876,6944,47158,45971,48,0.6,1583,20.3,13325,2507,10818,5.5,29,10950,5972,4978,13,23.8,2375,5.2,47.6,0,1245,1249,4960
1994,55,c) 2,5613,5718,42886,44788,168,2.7,971,15.8,7522,1007,6515,2.2,16.8,11326,5079,6247,11.3,25.3,-3804,-8.5,33.6,0,766,766,4231
1994,55,d) 3,5225,5443,42115,43743,142,2.5,699,12.2,6969,1215,5754,2.8,15.9,10224,3955,6269,9,23.4,-3255,-7.5,31.8,0,555,561,3249
1994,55,e) 4,4798,5063,43687,44387,140,2.6,611,11.5,7123,982,6141,2.2,16,8522,3854,4668,8.7,19.2,-1399,-3.2,32,0,466,466,2687
1994,55,f) 5,4487,4647,41242,42543,131,2.7,514,10.6,7263,669,6594,1.6,17.1,9864,2946,6918,6.9,23.2,-2601,-6.1,34.2,0,399,400,2293
1994,55,g) 6 to 10,19077,20568,241207,243468,549,2.6,1727,8.2,29219,4337,24882,1.8,12,33743,11507,22236,4.7,13.9,-4524,-1.9,24,0,1291,1299,8603
1994,55,h) 11 to 15,11566,13141,174124,175141,345,2.6,928,6.9,20439,3745,16694,2.1,11.7,22472,6302,16170,3.6,12.8,-2033,-1.1,23.4,0,643,644,4199
1994,55,i) 16 to 20,4856,6583,106637,105671,218,3.3,396,5.9,14075,2046,12029,1.9,13.3,12142,2975,9167,2.8,11.5,1933,1.8,23,0,227,228,1280
1994,55,l) Left Censored,24969,39917,1287980,1280029,1490,3.7,2232,5.5,123476,29784,93692,2.3,9.6,107575,26680,80895,2.1,8.4,15901,1.2,16.8,0,974,991,6689
1994,56,a) 0,1387,1392,6794,3404,1383,198.7,0,0,6781,,,,199.2,0,0,0,0,0,6781,199.2,0,1,,,
1994,56,b) 1,998,1005,6488,6304,5,0.4,230,20.3,1879,,,,29.8,1510,818,692,13,24,369,5.8,48,1,183,183,696
1994,56,c) 2,779,782,4407,4617,24,2.9,127,15.2,868,118,750,2.6,18.8,1287,489,798,10.6,27.9,-419,-9.1,37.6,0,99,99,436
1994,56,d) 3,693,700,3874,4154,24,3.3,92,12.5,630,67,563,1.6,15.2,1190,524,666,12.6,28.6,-560,-13.4,30.4,0,72,72,413
1994,56,e) 4,600,608,3885,3841,20,3.1,77,12.1,747,86,661,2.2,19.4,658,274,384,7.1,17.1,89,2.3,34.2,0,53,53,225
1994,56,f) 5,515,545,3933,4037,26,4.6,62,11,667,117,550,2.9,16.5,874,357,517,8.8,21.6,-207,-5.1,33,0,40,40,175
1994,56,g) 6 to 10,2217,2318,19802,20133,85,3.5,250,10.4,2702,474,2228,2.4,13.4,3364,1295,2069,6.4,16.7,-662,-3.3,26.8,0,183,183,1021
1994,56,h) 11 to 15,1901,2153,19068,18830,86,3.9,140,6.4,2985,779,2206,4.1,15.9,2508,673,1835,3.6,13.3,477,2.6,26.6,0,94,96,399
1994,56,i) 16 to 20,701,864,10552,10533,35,4,48,5.5,1617,549,1068,5.2,15.4,1579,527,1052,5,15,38,0.4,30,0,26,26,130
1994,56,l) Left Censored,2564,3999,68481,68093,174,4.3,234,5.8,8007,1675,6332,2.5,11.8,7230,1728,5502,2.5,10.6,777,1.2,21.2,0,99,99,617
1995,01,a) 0,7797,7834,46053,23131,7769,198.3,0,0,45844,45844,0,198.2,198.2,0,0,0,0,0,45844,198.2,0,0,,,
1995,01,b) 1,5950,6023,48728,48069,22,0.3,1644,23.8,14225,625,13600,1.3,29.6,12907,6955,5952,14.5,26.9,1318,2.7,53.8,0,1356,1356,6007
1995,01,c) 2,4584,4644,37347,37289,149,2.9,925,18.3,9603,1256,8347,3.4,25.8,9487,5057,4430,13.6,25.4,116,0.4,50.8,0,770,776,4480
1995,01,d) 3,3840,3935,36309,36958,138,3.3,645,15.4,6950,658,6292,1.8,18.8,8248,3684,4564,10,22.3,-1298,-3.5,37.6,0,534,534,3154
1995,01,e) 4,3386,3575,30995,31435,121,3.2,452,12.1,5776,791,4985,2.5,18.4,6656,2938,3718,9.3,21.2,-880,-2.8,36.8,0,355,355,2113
1995,01,f) 5,3201,3321,31400,31008,106,3,425,12.2,6218,520,5698,1.7,20.1,5434,2358,3076,7.6,17.5,784,2.6,35,0,347,347,1907
1995,01,g) 6 to 10,12993,14315,185615,183956,512,3.5,1322,9,27635,5073,22562,2.8,15,24316,8457,15859,4.6,13.2,3319,1.8,26.4,0,1000,1005,5968
1995,01,h) 11 to 15,8777,9776,134461,133956,323,3.2,676,6.8,18269,3424,14845,2.6,13.6,17258,5758,11500,4.3,12.9,1011,0.7,25.8,0,446,452,3772
1995,01,i) 16 to 20,4646,6561,111231,109721,261,3.9,431,6.5,14962,3870,11092,3.5,13.6,11944,3460,8484,3.2,10.9,3018,2.7,21.8,0,254,256,2181
1995,01,l) Left Censored,13802,25925,842906,831485,1221,4.7,1646,6.3,101347,24737,76610,3,12.2,78505,21333,57172,2.6,9.4,22842,2.8,18.8,0,600,624,3989
1995,02,a) 0,1390,1395,6196,3131,1376,197.3,0,0,6131,6131,0,195.8,195.8,0,0,0,0,0,6131,195.8,0,0,,,
1995,02,b) 1,966,971,5352,5601,4,0.4,300,26.3,1399,23,1376,0.4,25,1896,1119,777,20,33.9,-497,-8.9,50,0,223,223,895
1995,02,c) 2,846,857,5839,5812,36,3.9,165,17.8,1393,107,1286,1.8,24,1339,618,721,10.6,23,54,1,46,0,123,123,503
1995,02,d) 3,658,697,4382,4490,27,3.6,117,15.8,1048,119,929,2.7,23.3,1264,503,761,11.2,28.2,-216,-4.9,46.6,0,87,87,376
1995,02,e) 4,665,685,4622,5055,28,3.9,101,13.9,1051,294,757,5.8,20.8,1916,448,1468,8.9,37.9,-865,-17.1,41.6,0,74,74,340
1995,02,f) 5,643,656,4327,4494,33,4.8,85,12.5,697,120,577,2.7,15.5,1030,392,638,8.7,22.9,-333,-7.4,31,0,63,63,247
1995,02,g) 6 to 10,2294,2477,25368,26011,89,3.5,279,10.8,3299,403,2896,1.5,12.7,4584,1777,2807,6.8,17.6,-1285,-4.9,25.4,0,189,190,1446
1995,02,h) 11 to 15,1732,1960,19327,19414,78,3.9,139,7,2847,555,2292,2.9,14.7,3020,838,2182,4.3,15.6,-173,-0.9,29.4,0,86,86,450
1995,02,i) 16 to 20,842,1116,14639,14818,43,3.8,83,7.3,1845,358,1487,2.4,12.5,2202,767,1435,5.2,14.9,-357,-2.4,25,0,42,43,387
1995,02,l) Left Censored,1811,3329,84308,83869,168,5,203,6.1,11424,3605,7819,4.3,13.6,10546,2400,8146,2.9,12.6,878,1,25.2,0,56,63,313
1995,04,a) 0,9448,9510,58129,29143,9448,198.7,0,0,57973,57973,0,198.9,198.9,0,0,0,0,0,57973,198.9,0,0,,,
1995,04,b) 1,6878,7007,54850,55528,61,0.8,2034,25.1,15932,1146,14786,2.1,28.7,17287,10083,7204,18.2,31.1,-1355,-2.4,57.4,0,1676,1676,8506
1995,04,c) 2,5146,5234,45633,45908,186,3.2,1124,19.6,11193,1666,9527,3.6,24.4,11742,6626,5116,14.4,25.6,-549,-1.2,48.8,0,928,928,5535
1995,04,d) 3,4352,4524,53465,50615,184,3.8,811,16.7,16557,2057,14500,4.1,32.7,10856,5234,5622,10.3,21.4,5701,11.3,42.8,0,639,639,4319
1995,04,e) 4,3961,4119,38805,39194,170,3.9,597,13.7,7476,979,6497,2.5,19.1,8254,4037,4217,10.3,21.1,-778,-2,38.2,0,481,487,3216
1995,04,f) 5,3583,3728,40502,39950,155,4,477,12.2,8744,1325,7419,3.3,21.9,7640,3389,4251,8.5,19.1,1104,2.8,38.2,0,385,386,2633
1995,04,g) 6 to 10,14248,15645,210582,208552,679,4.2,1652,10.2,37229,8513,28716,4.1,17.9,33169,12035,21134,5.8,15.9,4060,2,31.8,0,1192,1197,8901
1995,04,h) 11 to 15,9126,10899,171861,170924,461,4.1,937,8.4,25711,6179,19532,3.6,15,23837,6812,17025,4,13.9,1874,1.1,27.8,0,551,555,3324
1995,04,i) 16 to 20,4009,5315,101679,101198,247,4.6,450,8.3,15252,3056,12196,3,15.1,14290,4873,9417,4.8,14.1,962,1,28.2,0,227,238,2090
1995,04,l) Left Censored,9408,20629,704238,691490,1349,6.5,1490,7.2,98831,31706,67125,4.6,14.3,73335,21112,52223,3.1,10.6,25496,3.7,21.2,0,357,434,2966
1995,05,a) 0,5183,5215,28273,14200,5169,198.2,0,0,28146,28146,0,198.2,198.2,0,0,0,0,0,28146,198.2,0,0,,,
1995,05,b) 1,3733,3777,25808,25714,16,0.4,1108,25.3,6784,144,6640,0.6,26.4,6595,4149,2446,16.1,25.6,189,0.8,51.2,0,927,928,3595
1995,05,c) 2,3098,3132,21823,21445,98,2.9,570,16.9,5301,625,4676,2.9,24.7,4545,2386,2159,11.1,21.2,756,3.5,42.4,0,475,475,2101
1995,05,d) 3,2477,2575,20773,22509,77,2.8,452,16.3,3383,575,2808,2.6,15,6855,4231,2624,18.8,30.5,-3472,-15.5,30,0,352,353,3506
1995,05,e) 4,2136,2251,18418,18822,70,2.9,322,13.5,3245,329,2916,1.7,17.2,4053,1695,2358,9,21.5,-808,-4.3,34.4,0,252,252,1083
1995,05,f) 5,2053,2141,17151,17204,65,2.9,252,11.3,3067,621,2446,3.6,17.8,3172,1430,1742,8.3,18.4,-105,-0.6,35.6,0,206,206,1066
1995,05,g) 6 to 10,7734,8280,92193,93985,289,3.4,809,9.5,13907,2623,11284,2.8,14.8,17491,8928,8563,9.5,18.6,-3584,-3.8,29.6,0,617,618,6769
1995,05,h) 11 to 15,5939,6585,82930,81184,198,2.9,464,6.9,13125,2116,11009,2.6,16.2,9633,3128,6505,3.9,11.9,3492,4.3,23.8,0,325,325,2247
1995,05,i) 16 to 20,3237,3966,57723,56506,134,3.3,285,7,8786,2167,6619,3.8,15.5,6352,1581,4771,2.8,11.2,2434,4.3,22.4,0,186,186,796
1995,05,l) Left Censored,9005,15562,509737,501083,773,4.9,989,6.3,60466,13068,47398,2.6,12.1,43159,14363,28796,2.9,8.6,17307,3.5,17.2,0,409,411,2173
1995,06,a) 0,57923,58251,364368,183221,57752,198.3,0,0,362295,362295,0,197.7,197.7,0,0,0,0,0,362295,197.7,0,0,,,
1995,06,b) 1,42296,43026,361458,360667,275,0.6,12594,25.2,109100,8221,100879,2.3,30.2,107518,60541,46977,16.8,29.8,1582,0.4,59.6,0,10115,10120,49921
1995,06,c) 2,33940,34529,310067,314132,1331,3.5,7331,19.4,77271,8866,68405,2.8,24.6,85400,45790,39610,14.6,27.2,-8129,-2.6,49.2,0,6018,6018,39425
1995,06,d) 3,30488,31879,304555,308836,1397,4.1,5600,16.4,62299,9881,52418,3.2,20.2,70861,33652,37209,10.9,22.9,-8562,-2.7,40.4,0,4387,4401,26453
1995,06,e) 4,28910,30243,278872,284153,1303,4.1,4865,15.1,54044,7436,46608,2.6,19,64605,29374,35231,10.3,22.7,-10561,-3.7,38,0,3672,3703,22184
1995,06,f) 5,27845,29117,280279,283195,1352,4.4,4358,14.2,53445,7972,45473,2.8,18.9,59276,25767,33509,9.1,20.9,-5831,-2,37.8,0,3197,3219,18808
1995,06,g) 6 to 10,110599,120436,1505363,1514778,5080,4.1,14177,11.3,235986,39799,196187,2.6,15.6,254816,95508,159308,6.3,16.8,-18830,-1.2,31.2,0,9964,10048,65558
1995,06,h) 11 to 15,74832,86551,1260725,1257637,3299,3.7,7837,8.8,185067,33921,151146,2.7,14.7,178890,59266,119624,4.7,14.2,6177,0.5,28.4,0,4899,4957,31015
1995,06,i) 16 to 20,36715,48776,883996,871981,1875,3.8,4046,8.1,136356,27645,108711,3.2,15.6,112326,34547,77779,4,12.9,24030,2.7,25.8,0,2231,2282,12752
1995,06,l) Left Censored,82934,165833,5221456,5235466,8694,5.2,12994,7.7,606211,161689,444522,3.1,11.6,634231,177144,457087,3.4,12.1,-28020,-0.5,23.2,0,4401,4547,29845
1995,08,a) 0,11411,11483,60105,30213,11426,199,0,0,59785,59785,0,197.9,197.9,0,0,0,0,0,59785,197.9,0,0,,,
1995,08,b) 1,8548,8655,59975,59618,57,0.6,2344,23.7,17421,1992,15429,3.3,29.2,16707,9435,7272,15.8,28,714,1.2,56,0,1843,1845,7840
1995,08,c) 2,6626,6677,48130,49786,233,3.2,1277,17.7,11364,1666,9698,3.3,22.8,14675,7917,6758,15.9,29.5,-3311,-6.7,45.6,0,1044,1044,7028
1995,08,d) 3,5332,5429,46019,46330,184,3.2,844,14.6,9154,1343,7811,2.9,19.8,9776,4896,4880,10.6,21.1,-622,-1.3,39.6,0,653,655,4129
1995,08,e) 4,4769,4969,40422,40862,186,3.6,690,13.2,7693,1698,5995,4.2,18.8,8572,3781,4791,9.3,21,-879,-2.2,37.6,0,504,506,2715
1995,08,f) 5,4104,4274,39294,39088,168,3.8,502,11.3,7738,1462,6276,3.7,19.8,7325,3081,4244,7.9,18.7,413,1.1,37.4,0,381,383,2429
1995,08,g) 6 to 10,15902,17043,199782,200599,601,3.4,1649,9.4,31468,5274,26194,2.6,15.7,33102,12608,20494,6.3,16.5,-1634,-0.8,31.4,0,1180,1186,9356
1995,08,h) 11 to 15,10835,12393,180510,177314,474,3.7,943,7.5,29941,6776,23165,3.8,16.9,23548,6356,17192,3.6,13.3,6393,3.6,26.6,0,598,600,3928
1995,08,i) 16 to 20,5231,6810,104085,101461,324,4.7,537,7.8,18340,4546,13794,4.5,18.1,13092,3506,9586,3.5,12.9,5248,5.2,25.8,0,276,276,1555
1995,08,l) Left Censored,12692,23858,744888,733445,1559,6.5,1647,6.9,105442,34545,70897,4.7,14.4,82556,22471,60085,3.1,11.3,22886,3.1,22.6,0,487,493,3747
1995,09,a) 0,5924,5959,31777,15939,5912,198.4,0,0,31677,31677,0,198.7,198.7,0,0,0,0,0,31677,198.7,0,0,,,
1995,09,b) 1,4582,4615,31884,31604,18,0.3,995,19.3,8753,178,8575,0.6,27.7,8193,4105,4088,13,25.9,560,1.8,51.8,0,788,788,3608
1995,09,c) 2,3856,3883,30380,31400,121,2.9,641,15.4,6651,582,6069,1.9,21.2,8690,3315,5375,10.6,27.7,-2039,-6.5,42.4,0,509,509,2721
1995,09,d) 3,3305,3404,27697,28212,109,3,503,13.9,4687,583,4104,2.1,16.6,5716,2629,3087,9.3,20.3,-1029,-3.7,33.2,0,389,409,2299
1995,09,e) 4,3007,3119,25687,26148,120,3.7,376,11.5,4359,649,3710,2.5,16.7,5280,2193,3087,8.4,20.2,-921,-3.5,33.4,0,299,299,1777
1995,09,f) 5,3092,3179,26175,26519,118,3.5,415,12.5,4205,324,3881,1.2,15.9,4892,2237,2655,8.4,18.4,-687,-2.5,31.8,0,306,307,1740
1995,09,g) 6 to 10,14217,15013,158723,158825,558,3.6,1479,9.6,22351,3255,19096,2,14.1,22554,7157,15397,4.5,14.2,-203,-0.1,28.2,0,1057,1066,4532
1995,09,h) 11 to 15,8988,9800,110760,110999,292,2.9,757,7.5,14047,1723,12324,1.6,12.7,14525,4658,9867,4.2,13.1,-478,-0.4,25.4,0,528,528,3114
1995,09,i) 16 to 20,4554,5571,80184,79424,202,3.6,400,7.1,9862,1389,8473,1.7,12.4,8342,2275,6067,2.9,10.5,1520,1.9,21,0,230,233,1070
1995,09,l) Left Censored,17221,26469,869572,874763,1191,4.4,1780,6.6,90442,33182,57260,3.8,10.3,100824,28244,72580,3.2,11.5,-10382,-1.2,20.6,0,678,700,5023
1995,10,a) 0,1615,1625,9002,4521,1610,198.2,0,0,8963,8963,0,198.3,198.3,0,0,0,0,0,8963,198.3,0,0,,,
1995,10,b) 1,1249,1258,9083,8609,14,1,281,20,3202,243,2959,2.8,37.2,2253,1557,696,18.1,26.2,949,11,52.4,0,236,236,1405
1995,10,c) 2,1021,1025,6412,6646,27,2.4,172,15.6,1376,71,1305,1.1,20.7,1843,1053,790,15.8,27.7,-467,-7,41.4,0,132,132,537
1995,10,d) 3,816,842,5727,6022,31,3.4,144,16,987,110,877,1.8,16.4,1577,1013,564,16.8,26.2,-590,-9.8,32.8,0,112,112,805
1995,10,e) 4,760,787,6391,6301,34,4.2,100,12.3,1231,158,1073,2.5,19.5,1050,331,719,5.3,16.7,181,2.8,33.4,0,85,85,284
1995,10,f) 5,726,753,5326,5508,26,3.3,88,11.2,853,143,710,2.6,15.5,1217,689,528,12.5,22.1,-364,-6.6,31,0,62,62,385
1995,10,g) 6 to 10,2835,3002,31767,31539,95,3.1,313,10.1,5426,988,4438,3.1,17.2,4970,1864,3106,5.9,15.8,456,1.4,31.6,0,227,227,1155
1995,10,h) 11 to 15,1711,1879,25037,24812,71,3.7,127,6.6,3471,601,2870,2.4,14,3020,834,2186,3.4,12.2,451,1.8,24.4,0,77,77,437
1995,10,i) 16 to 20,914,1143,27299,26363,53,4.6,57,5,3705,797,2908,3,14.1,1833,256,1577,1,7,1872,7.1,14,0,38,38,136
1995,10,l) Left Censored,3533,5827,197234,193756,358,6.1,442,7.5,26866,5209,21657,2.7,13.9,19909,5678,14231,2.9,10.3,6957,3.6,20.6,0,118,123,890
1995,11,a) 0,1095,1111,7679,3857,1103,198.6,0,0,7645,7645,0,198.2,198.2,0,0,0,0,0,7645,198.2,0,0,,,
1995,11,b) 1,897,918,7323,7484,20,2,202,19.7,2065,250,1815,3.3,27.6,2386,1448,938,19.3,31.9,-321,-4.3,55.2,0,162,162,1330
1995,11,c) 2,736,741,6940,7055,21,2.7,115,14.6,1259,146,1113,2.1,17.8,1488,853,635,12.1,21.1,-229,-3.3,35.6,0,81,81,646
1995,11,d) 3,691,725,27679,27457,30,4,102,13.4,2238,588,1650,2.1,8.2,1794,1005,789,3.7,6.5,444,1.7,13,0,74,74,520
1995,11,e) 4,627,638,6396,6468,20,3,68,10.3,1000,117,883,1.8,15.5,1143,269,874,4.2,17.7,-143,-2.2,31,0,50,50,214
1995,11,f) 5,603,640,6963,6913,17,2.6,63,9.6,1313,231,1082,3.3,19,1212,476,736,6.9,17.5,101,1.5,35,0,53,53,447
1995,11,g) 6 to 10,2637,2796,38148,38548,91,3.1,284,9.8,5133,764,4369,2,13.3,5932,1894,4038,4.9,15.4,-799,-2.1,26.6,0,183,185,1072
1995,11,h) 11 to 15,2025,2268,34824,35335,99,4.2,213,9.1,4509,867,3642,2.5,12.8,5530,1768,3762,5,15.7,-1021,-2.9,25.6,0,115,115,1005
1995,11,i) 16 to 20,1046,1285,45182,47939,36,2.7,87,6.6,4578,410,4168,0.9,9.5,10092,709,9383,1.5,21.1,-5514,-11.6,19,0,44,45,338
1995,11,l) Left Censored,4398,6652,226687,226738,364,5.4,519,7.7,27260,6543,20717,2.9,12,27362,9098,18264,4,12.1,-102,-0.1,24,0,161,164,1866
1995,12,a) 0,37202,37405,203686,102239,37153,198.7,0,0,202895,202895,0,198.5,198.5,0,0,0,0,0,202895,198.5,0,0,,,
1995,12,b) 1,28448,28802,205655,207243,138,0.4,8786,26.3,60536,3781,56755,1.8,29.2,63711,39201,24510,18.9,30.7,-3175,-1.5,58.4,0,7294,7301,34451
1995,12,c) 2,23227,23541,190541,195741,844,3.2,5475,21.1,43560,6092,37468,3.1,22.3,53960,31932,22028,16.3,27.6,-10400,-5.3,44.6,0,4616,4616,27576
1995,12,d) 3,19528,20039,170248,178833,781,3.6,3636,16.9,35692,4008,31684,2.2,20,52862,22082,30780,12.3,29.6,-17170,-9.6,40,0,3026,3030,17939
1995,12,e) 4,16895,17448,149423,152826,603,3.2,2765,14.9,30993,3824,27169,2.5,20.3,37799,20454,17345,13.4,24.7,-6806,-4.4,40.6,0,2187,2190,15488
1995,12,f) 5,15713,16235,149095,150273,585,3.4,2302,13.5,27204,4868,22336,3.2,18.1,29560,13751,15809,9.2,19.7,-2356,-1.6,36.2,0,1854,1855,11665
1995,12,g) 6 to 10,57685,62636,733892,733435,2192,3.4,7122,10.9,145662,50609,95053,6.9,19.9,144748,55816,88932,7.6,19.7,914,0.2,39.4,0,5295,5354,39804
1995,12,h) 11 to 15,34353,39266,509975,511395,1534,3.8,3444,8.5,84649,29689,54960,5.8,16.6,87489,30043,57446,5.9,17.1,-2840,-0.5,33.2,0,2285,2319,15348
1995,12,i) 16 to 20,15107,20294,315087,313325,789,3.8,1760,8.5,48272,12936,35336,4.1,15.4,44748,14164,30584,4.5,14.3,3524,1.1,28.6,0,970,985,5855
1995,12,l) Left Censored,35566,81206,2492247,2465386,5032,6.2,5933,7.3,326142,97954,228188,4,13.2,272419,80628,191791,3.3,11,53723,2.2,22,0,1769,1807,12231
1995,13,a) 0,15511,15702,97955,49108,15600,198.7,0,0,97694,97694,0,198.9,198.9,0,0,0,0,0,97694,198.9,0,0,,,
1995,13,b) 1,11602,11793,91353,91501,76,0.6,3226,23.9,27608,2938,24670,3.2,30.2,27904,15346,12558,16.8,30.5,-296,-0.3,60.4,0,2633,2633,12735
1995,13,c) 2,9149,9245,78129,82531,331,3.3,1887,18.7,16582,2184,14398,2.6,20.1,25386,14913,10473,18.1,30.8,-8804,-10.7,40.2,0,1550,1553,13486
1995,13,d) 3,7527,7763,71360,72267,276,3.3,1268,15.3,14695,2790,11905,3.9,20.3,16509,8678,7831,12,22.8,-1814,-2.5,40.6,0,1004,1005,7533
1995,13,e) 4,6545,6832,67124,67798,256,3.6,950,13.2,12779,1852,10927,2.7,18.8,14126,6817,7309,10.1,20.8,-1347,-2,37.6,0,728,731,4861
1995,13,f) 5,5932,6117,61951,62552,232,3.6,810,12.6,11807,2016,9791,3.2,18.9,13008,6353,6655,10.2,20.8,-1201,-1.9,37.8,0,616,616,4591
1995,13,g) 6 to 10,24016,26214,346207,341161,1074,4,2611,9.7,60491,16179,44312,4.7,17.7,50398,19763,30635,5.8,14.8,10093,2.9,29.6,0,1832,1856,13077
1995,13,h) 11 to 15,15068,17532,232465,232150,660,3.7,1410,7.9,33630,6663,26967,2.9,14.5,33000,11536,21464,5,14.2,630,0.3,28.4,0,876,882,6131
1995,13,i) 16 to 20,7457,9769,176666,172906,413,4.2,705,7.1,30589,9307,21282,5.4,17.7,23069,6764,16305,3.9,13.3,7520,4.4,26.6,0,386,387,2914
1995,13,l) Left Censored,21637,46022,1634162,1598127,2833,6.1,3043,6.6,231917,69735,162182,4.4,14.5,159847,50039,109808,3.1,10,72070,4.5,20,0,907,922,6338
1995,15,a) 0,1952,1962,10913,5474,1948,198.6,0,0,10878,10878,0,198.7,198.7,0,0,0,0,0,10878,198.7,0,0,,,
1995,15,b) 1,1510,1528,17297,16961,9,0.5,415,23.6,3584,479,3105,2.8,21.1,2912,1514,1398,8.9,17.2,672,3.9,34.4,0,349,349,1300
1995,15,c) 2,1261,1294,9708,10050,31,2.2,262,18.5,2086,254,1832,2.5,20.8,2770,1128,1642,11.2,27.6,-684,-6.8,41.6,0,212,212,957
1995,15,d) 3,1140,1199,12192,12357,43,3.4,181,14.3,1730,556,1174,4.5,14,2059,767,1292,6.2,16.7,-329,-2.7,28,0,151,151,602
1995,15,e) 4,1143,1187,12528,13224,39,3.1,181,14.3,1433,257,1176,1.9,10.8,2825,1011,1814,7.6,21.4,-1392,-10.6,21.6,0,150,151,778
1995,15,f) 5,1021,1108,9423,9519,45,3.9,165,14.1,1348,261,1087,2.7,14.2,1539,649,890,6.8,16.2,-191,-2,28.4,0,132,132,478
1995,15,g) 6 to 10,4207,4713,55976,57096,161,3.3,512,10.5,6571,1434,5137,2.5,11.5,8810,2860,5950,5,15.4,-2239,-3.9,23,0,378,380,1905
1995,15,h) 11 to 15,3069,3580,39560,40492,111,3,268,7.3,4191,715,3476,1.8,10.4,6055,1652,4403,4.1,15,-1864,-4.6,20.8,0,173,174,1020
1995,15,i) 16 to 20,1594,2203,35707,35135,83,3.7,137,6.1,6126,3545,2581,10.1,17.4,4982,1265,3717,3.6,14.2,1144,3.2,28.4,0,76,78,372
1995,15,l) Left Censored,4650,8420,218938,221340,394,4.6,516,6.1,19790,6992,12798,3.2,8.9,24594,7917,16677,3.6,11.1,-4804,-2.2,17.8,0,166,169,1033
1995,16,a) 0,3041,3051,13983,7011,3031,198.7,0,0,13944,13944,0,198.9,198.9,0,0,0,0,0,13944,198.9,0,0,,,
1995,16,b) 1,2314,2339,14318,14525,10,0.4,664,24.6,3823,680,3143,4.7,26.3,4236,2423,1813,16.7,29.2,-413,-2.9,52.6,0,508,509,1898
1995,16,c) 2,1706,1726,11387,11721,63,3.4,332,17.7,2537,525,2012,4.5,21.6,3204,1533,1671,13.1,27.3,-667,-5.7,43.2,0,261,261,1246
1995,16,d) 3,1477,1505,10741,11135,56,3.5,263,16.3,2078,399,1679,3.6,18.7,2865,1241,1624,11.1,25.7,-787,-7,37.4,0,203,203,920
1995,16,e) 4,1225,1255,9316,9284,51,3.9,157,12,1768,411,1357,4.4,19,1703,638,1065,6.9,18.3,65,0.7,36.6,0,119,119,461
1995,16,f) 5,1224,1258,10082,10244,50,3.8,171,12.9,1817,195,1622,1.9,17.7,2141,887,1254,8.7,20.9,-324,-3.2,35.4,0,126,126,610
1995,16,g) 6 to 10,4244,4539,51494,51195,162,3.5,432,9.3,7750,1390,6360,2.7,15.1,7152,2516,4636,4.9,14,598,1.1,28,0,305,305,1858
1995,16,h) 11 to 15,2866,3208,36186,35925,122,3.7,243,7.4,5538,1348,4190,3.8,15.4,5016,1593,3423,4.4,14,522,1.4,28,0,157,157,775
1995,16,i) 16 to 20,1648,1969,33799,32784,103,5.2,126,6.3,5236,572,4664,1.7,16,3206,861,2345,2.6,9.8,2030,6.2,19.6,0,78,80,460
1995,16,l) Left Censored,4272,7266,176590,177675,330,4.5,474,6.5,20593,5072,15521,2.9,11.6,22763,10026,12737,5.6,12.8,-2170,-1.2,23.2,0,177,179,886
1995,17,a) 0,20440,20535,119735,60080,20377,198.5,0,0,119311,119311,0,198.6,198.6,0,0,0,0,0,119311,198.6,0,0,,,
1995,17,b) 1,15790,15966,124585,122063,87,0.5,3775,21,38092,2671,35421,2.2,31.2,33047,16808,16239,13.8,27.1,5045,4.1,54.2,0,2949,2951,13686
1995,17,c) 2,13306,13451,111026,110948,366,2.5,2320,16,27944,2336,25608,2.1,25.2,27788,14860,12928,13.4,25,156,0.2,50,0,1841,1841,12291
1995,17,d) 3,11536,11964,108680,110256,441,3.5,1664,13.2,19779,3237,16542,2.9,17.9,22931,12086,10845,11,20.8,-3152,-2.9,35.8,0,1307,1310,9903
1995,17,e) 4,10530,11071,101933,102135,355,3.1,1366,11.8,18398,2618,15780,2.6,18,18801,7569,11232,7.4,18.4,-403,-0.4,36,0,1026,1032,5705
1995,17,f) 5,9952,10276,118276,119001,335,3.1,1241,11.6,18011,2283,15728,1.9,15.1,19460,8590,10870,7.2,16.4,-1449,-1.3,30.2,0,964,967,5277
1995,17,g) 6 to 10,40678,43563,550999,552356,1364,3,3978,8.9,75168,13040,62128,2.4,13.6,77881,29732,48149,5.4,14.1,-2713,-0.5,27.2,0,2771,2779,20656
1995,17,h) 11 to 15,27910,31340,465274,463211,979,3.1,2218,6.9,61486,12656,48830,2.7,13.3,57360,17885,39475,3.9,12.4,4126,0.9,24.8,0,1446,1457,9990
1995,17,i) 16 to 20,14258,18105,297787,294979,563,3.1,1234,6.7,41473,9571,31902,3.2,14.1,35856,8788,27068,3,12.2,5617,1.9,24.4,0,708,719,4482
1995,17,l) Left Censored,48713,83450,2872514,2865429,4014,4.8,5524,6.6,324368,88879,235489,3.1,11.3,310199,81495,228704,2.8,10.8,14169,0.5,21.6,0,2005,2048,15434
1995,18,a) 0,10009,10079,58522,29350,10016,198.7,0,0,58344,58344,0,198.8,198.8,0,0,0,0,0,58344,198.8,0,0,,,
1995,18,b) 1,7647,7753,55936,55540,40,0.5,1990,22.5,15832,675,15157,1.2,28.5,15040,8637,6403,15.6,27.1,792,1.4,54.2,0,1648,1648,7445
1995,18,c) 2,6304,6383,46754,47222,180,2.6,1158,16.8,10183,967,9216,2,21.6,11118,5798,5320,12.3,23.5,-935,-1.9,43.2,0,949,949,4836
1995,18,d) 3,5418,5659,52254,52698,193,3.2,857,14.3,9901,2175,7726,4.1,18.8,10789,4598,6191,8.7,20.5,-888,-1.7,37.6,0,706,708,3817
1995,18,e) 4,5080,5351,48343,48720,183,3.3,662,11.8,9039,1157,7882,2.4,18.6,9792,4922,4870,10.1,20.1,-753,-1.5,37.2,0,514,516,3391
1995,18,f) 5,4804,5047,48975,49386,152,2.9,534,10.2,7796,1203,6593,2.4,15.8,8617,3064,5553,6.2,17.4,-821,-1.6,31.6,0,432,432,2264
1995,18,g) 6 to 10,18759,20568,266232,264502,660,3.1,1763,8.3,38751,5968,32783,2.3,14.7,35290,11126,24164,4.2,13.3,3461,1.4,26.6,0,1292,1304,7405
1995,18,h) 11 to 15,12879,14558,193680,191898,454,3.1,905,6.1,26574,5298,21276,2.8,13.8,23009,7235,15774,3.8,12,3565,1.8,24,0,606,611,4635
1995,18,i) 16 to 20,6665,8820,147322,147005,292,3.2,623,6.9,18029,3523,14506,2.4,12.3,17394,5087,12307,3.5,11.8,635,0.5,23.6,0,355,362,2855
1995,18,l) Left Censored,23175,42594,1444277,1424827,2252,5.3,2648,6.2,172100,47387,124713,3.3,12.1,133199,34834,98365,2.4,9.3,38901,2.8,18.6,0,988,992,6839
1995,19,a) 0,4974,5011,27229,13667,4978,198.7,0,0,27124,27124,0,198.5,198.5,0,0,0,0,0,27124,198.5,0,0,,,
1995,19,b) 1,3911,3951,25113,24976,20,0.4,980,21.9,7002,926,6076,3.7,28,6728,3797,2931,15.2,26.9,274,1.1,53.8,0,774,774,3256
1995,19,c) 2,3121,3141,21193,21244,100,3,570,16.8,4887,750,4137,3.5,23,4988,2752,2236,13,23.5,-101,-0.5,46,0,476,476,2394
1995,19,d) 3,2788,2896,22552,24377,87,2.8,457,14.8,4034,757,3277,3.1,16.5,7683,5433,2250,22.3,31.5,-3649,-15,33,0,370,370,1804
1995,19,e) 4,2582,2692,21298,21534,92,3.2,342,12.1,3335,490,2845,2.3,15.5,3807,1519,2288,7.1,17.7,-472,-2.2,31,0,280,282,1239
1995,19,f) 5,2388,2471,20038,19904,73,2.8,282,10.9,3941,1029,2912,5.2,19.8,3673,1721,1952,8.6,18.5,268,1.3,37,0,232,233,1130
1995,19,g) 6 to 10,9622,10426,126489,126039,347,3.2,995,9.3,18096,2876,15220,2.3,14.4,17196,6800,10396,5.4,13.6,900,0.8,27.2,0,735,736,4698
1995,19,h) 11 to 15,7793,8829,99175,99881,256,2.8,624,6.9,11895,1814,10081,1.8,11.9,13307,5677,7630,5.7,13.3,-1412,-1.4,23.8,0,415,417,2450
1995,19,i) 16 to 20,4453,6018,75082,74578,168,2.7,346,5.7,9247,1339,7908,1.8,12.4,8239,2190,6049,2.9,11,1008,1.4,22,0,189,190,979
1995,19,l) Left Censored,15465,25046,670601,660139,1001,4,1366,5.4,70929,17270,53659,2.6,10.7,50005,13449,36556,2,7.6,20924,3.1,15.2,0,574,581,2862
1995,20,a) 0,5126,5162,28660,14373,5122,198.5,0,0,28575,28575,0,198.8,198.8,0,0,0,0,0,28575,198.8,0,0,,,
1995,20,b) 1,3928,3976,26047,26262,23,0.5,1029,22.7,6909,335,6574,1.3,26.3,7338,3989,3349,15.2,27.9,-429,-1.6,52.6,0,856,856,3504
1995,20,c) 2,3138,3170,23273,23919,91,2.6,610,17.7,4717,470,4247,2,19.7,6009,2924,3085,12.2,25.1,-1292,-5.4,39.4,0,511,511,2578
1995,20,d) 3,2726,2803,22568,22947,98,3.3,456,15.2,4456,879,3577,3.8,19.4,5214,2065,3149,9,22.7,-758,-3.3,38.8,0,360,366,1739
1995,20,e) 4,2417,2543,19720,20148,97,3.6,345,12.9,3400,418,2982,2.1,16.9,4255,1942,2313,9.6,21.1,-855,-4.2,33.8,0,272,273,1620
1995,20,f) 5,2171,2268,20590,20573,88,3.7,284,12,3592,511,3081,2.5,17.5,3558,1478,2080,7.2,17.3,34,0.2,34.6,0,229,229,1213
1995,20,g) 6 to 10,9222,9862,106837,107329,377,3.7,957,9.4,13342,2510,10832,2.3,12.4,14325,5678,8647,5.3,13.3,-983,-0.9,24.8,0,696,698,3919
1995,20,h) 11 to 15,7139,7906,88388,88505,230,2.8,609,7.5,11688,2098,9590,2.4,13.2,11921,4006,7915,4.5,13.5,-233,-0.3,26.4,0,409,409,2449
1995,20,i) 16 to 20,3624,4803,68866,68672,172,3.5,330,6.8,8151,1931,6220,2.8,11.9,7762,2571,5191,3.7,11.3,389,0.6,22.6,0,183,187,895
1995,20,l) Left Censored,12515,20658,550968,547653,814,3.9,1167,5.6,55043,13139,41904,2.4,10.1,48412,13178,35234,2.4,8.8,6631,1.3,17.6,0,468,478,2729
1995,21,a) 0,6392,6443,38566,19305,6419,199.3,0,0,38522,38522,0,199.5,199.5,0,0,0,0,0,38522,199.5,0,0,,,
1995,21,b) 1,4780,4849,36028,36531,30,0.5,1288,23.3,9889,880,9009,2.4,27.1,10894,6395,4499,17.5,29.8,-1005,-2.7,54.2,0,1062,1062,5184
1995,21,c) 2,4076,4141,34354,34740,88,1.9,799,17.7,7810,1738,6072,5,22.5,8581,4387,4194,12.6,24.7,-771,-2.2,45,0,672,672,3836
1995,21,d) 3,3484,3614,29374,31021,115,3,512,13.4,5635,797,4838,2.6,18.2,8928,3534,5394,11.4,28.8,-3293,-10.6,36.4,0,410,410,2259
1995,21,e) 4,2991,3089,25103,26245,117,3.6,415,12.8,4726,1143,3583,4.4,18,7009,3034,3975,11.6,26.7,-2283,-8.7,36,0,340,340,2381
1995,21,f) 5,2909,3029,29305,29435,85,2.7,396,12.4,4778,764,4014,2.6,16.2,5038,2274,2764,7.7,17.1,-260,-0.9,32.4,0,303,304,1718
1995,21,g) 6 to 10,11732,12745,167384,166083,384,2.9,1192,9.1,25251,4605,20646,2.8,15.2,22649,8376,14273,5,13.6,2602,1.6,27.2,0,927,928,6081
1995,21,h) 11 to 15,7999,8923,122141,121496,286,3.1,594,6.5,16277,2650,13627,2.2,13.4,14987,4072,10915,3.4,12.3,1290,1.1,24.6,0,411,413,2482
1995,21,i) 16 to 20,4073,5238,89875,87646,180,3.4,350,6.6,13876,3025,10851,3.5,15.8,9418,3061,6357,3.5,10.7,4458,5.1,21.4,0,199,213,1408
1995,21,l) Left Censored,13784,24716,751643,744123,1205,4.8,1545,6.2,86325,22779,63546,3.1,11.6,71284,22971,48313,3.1,9.6,15041,2,19.2,0,556,558,4784
1995,22,a) 0,7037,7082,49704,24947,7039,198.8,0,0,49515,49515,0,198.5,198.5,0,0,0,0,0,49515,198.5,0,0,,,
1995,22,b) 1,5611,5709,50811,50173,41,0.6,1529,23.4,16379,916,15463,1.8,32.6,15103,8501,6602,16.9,30.1,1276,2.5,60.2,0,1267,1269,7463
1995,22,c) 2,4486,4545,40926,43465,137,2.8,840,17.1,7684,914,6770,2.1,17.7,12762,7838,4924,18,29.4,-5078,-11.7,35.4,0,699,705,7185
1995,22,d) 3,3837,3975,35133,36394,129,3.1,609,14.4,7515,1005,6510,2.8,20.6,10036,5589,4447,15.4,27.6,-2521,-7,41.2,0,470,472,4410
1995,22,e) 4,3373,3555,36751,36467,126,3.4,469,12.5,7206,724,6482,2,19.8,6638,2839,3799,7.8,18.2,568,1.6,36.4,0,381,381,2214
1995,22,f) 5,3026,3131,33630,32829,87,2.6,381,11.6,7305,559,6746,1.7,22.3,5702,2201,3501,6.7,17.4,1603,4.9,34.8,0,284,284,1706
1995,22,g) 6 to 10,11971,13055,154389,155749,441,3.3,1324,9.8,22894,5128,17766,3.3,14.7,25614,10236,15378,6.6,16.4,-2720,-1.7,29.4,0,976,976,6843
1995,22,h) 11 to 15,10495,11862,152331,150051,504,4.2,816,6.8,23868,7621,16247,5.1,15.9,19308,5728,13580,3.8,12.9,4560,3,25.8,0,550,555,2923
1995,22,i) 16 to 20,5098,6444,95351,94524,222,3.4,388,5.9,14869,2892,11977,3.1,15.7,13214,3703,9511,3.9,14,1655,1.7,28,0,225,235,1576
1995,22,l) Left Censored,14882,27165,736985,738504,1186,4.3,1822,6.6,86645,24192,62453,3.3,11.7,89683,29657,60026,4,12.1,-3038,-0.4,23.4,0,634,663,4579
1995,23,a) 0,2737,2741,11404,5714,2723,198.7,0,0,11380,,,,199.2,0,0,0,0,0,11380,199.2,0,1,,,
1995,23,b) 1,1940,1953,11315,11428,4,0.2,519,23.2,3160,,,,27.7,3386,1857,1529,16.2,29.6,-226,-1.9,55.4,1,411,411,1506
1995,23,c) 2,1610,1631,10875,11085,50,2.9,267,15.3,2001,171,1830,1.5,18.1,2421,1233,1188,11.1,21.8,-420,-3.7,36.2,0,220,220,1089
1995,23,d) 3,1317,1367,9286,9583,36,2.5,217,14.9,1485,161,1324,1.7,15.5,2078,1143,935,11.9,21.7,-593,-6.2,31,0,152,154,838
1995,23,e) 4,1211,1262,8604,8705,31,2.3,171,12.8,1477,299,1178,3.4,17,1678,717,961,8.2,19.3,-201,-2.3,34,0,133,133,601
1995,23,f) 5,1252,1272,9432,9554,39,2.9,168,12.6,1586,129,1457,1.4,16.6,1830,887,943,9.3,19.2,-244,-2.6,33.2,0,125,125,626
1995,23,g) 6 to 10,5796,6135,57546,57286,208,3.3,640,10.1,8513,1971,6542,3.4,14.9,7993,2818,5175,4.9,14,520,0.9,28,0,456,458,2084
1995,23,h) 11 to 15,3279,3658,44571,44098,143,3.8,283,7.6,5864,888,4976,2,13.3,4918,1578,3340,3.6,11.2,946,2.1,22.4,0,201,201,1105
1995,23,i) 16 to 20,1740,2265,31936,31106,88,3.8,151,6.6,4960,932,4028,3,15.9,3299,789,2510,2.5,10.6,1661,5.3,21.2,0,88,89,472
1995,23,l) Left Censored,5285,8404,226021,226175,324,3.8,564,6.6,22137,5238,16899,2.3,9.8,22445,6022,16423,2.7,9.9,-308,-0.1,19.6,0,224,224,1599
1995,24,a) 0,9172,9246,48544,24375,9187,198.7,0,0,48339,48339,0,198.3,198.3,0,0,0,0,0,48339,198.3,0,0,,,
1995,24,b) 1,6851,6947,49772,50143,39,0.5,1760,22.3,14230,1099,13131,2.2,28.4,14972,7990,6982,15.9,29.9,-742,-1.5,56.8,0,1423,1423,7026
1995,24,c) 2,5800,5889,51688,50481,199,3.1,1100,17.3,13142,1368,11774,2.7,26,10728,5799,4929,11.5,21.3,2414,4.7,42.6,0,868,868,4684
1995,24,d) 3,4864,5058,42000,42090,197,3.7,751,14.1,8409,1283,7126,3,20,8588,4487,4101,10.7,20.4,-179,-0.4,40,0,570,573,3574
1995,24,e) 4,4539,4732,43097,42626,212,4.3,590,12,8520,1313,7207,3.1,20,7577,3141,4436,7.4,17.8,943,2.2,35.6,0,457,457,2393
1995,24,f) 5,4472,4595,40885,40460,189,4,539,11.3,7930,1179,6751,2.9,19.6,7080,2691,4389,6.7,17.5,850,2.1,35,0,426,427,2129
1995,24,g) 6 to 10,18284,19610,231903,230191,659,3.3,1966,9.7,37155,8010,29145,3.5,16.1,33730,12308,21422,5.3,14.7,3425,1.4,29.4,0,1405,1415,8717
1995,24,h) 11 to 15,10757,12183,168345,166825,432,3.5,934,7.5,24670,5343,19327,3.2,14.8,21630,7062,14568,4.2,13,3040,1.8,26,0,604,607,3312
1995,24,i) 16 to 20,5272,6961,114929,113647,218,3.1,476,6.7,15448,3453,11995,3,13.6,12883,4034,8849,3.5,11.3,2565,2.3,22.6,0,280,281,1621
1995,24,l) Left Censored,17601,32465,1008934,1001916,1744,5.3,2358,7.2,121602,33570,88032,3.4,12.1,107566,34419,73147,3.4,10.7,14036,1.4,21.4,0,730,758,7326
1995,25,a) 0,10993,11061,61575,30897,10972,198.4,0,0,61356,61356,0,198.6,198.6,0,0,0,0,0,61356,198.6,0,0,,,
1995,25,b) 1,8404,8454,61536,59568,35,0.4,1869,19.7,19026,1508,17518,2.5,31.9,15090,8748,6342,14.7,25.3,3936,6.6,50.6,0,1474,1474,7641
1995,25,c) 2,6634,6696,53928,54438,198,2.8,1094,15.3,12195,1092,11103,2,22.4,13215,6869,6346,12.6,24.3,-1020,-1.9,44.8,0,910,910,6035
1995,25,d) 3,5621,5923,58595,58229,228,3.6,860,13.8,11353,1476,9877,2.5,19.5,10620,4890,5730,8.4,18.2,733,1.3,36.4,0,646,653,3519
1995,25,e) 4,4989,5189,48637,48520,201,3.7,666,12.3,9342,1219,8123,2.5,19.3,9107,4264,4843,8.8,18.8,235,0.5,37.6,0,524,524,3184
1995,25,f) 5,5000,5220,51715,51568,183,3.4,621,11.4,9067,1285,7782,2.5,17.6,8772,3557,5215,6.9,17,295,0.6,34,0,465,465,2629
1995,25,g) 6 to 10,24100,25635,312325,311941,948,3.6,2440,9.2,43385,5643,37742,1.8,13.9,42617,15556,27061,5,13.7,768,0.2,27.4,0,1738,1752,10809
1995,25,h) 11 to 15,15080,17042,256696,255819,667,3.8,1248,7.2,35448,6705,28743,2.6,13.9,33694,11306,22388,4.4,13.2,1754,0.7,26.4,0,817,825,6705
1995,25,i) 16 to 20,7403,9837,196213,195295,383,3.8,706,7.1,22954,5708,17246,2.9,11.8,21118,6813,14305,3.5,10.8,1836,1,21.6,0,343,355,3242
1995,25,l) Left Censored,29166,46776,1586999,1583778,2270,4.8,3374,7.1,182869,49254,133615,3.1,11.5,176426,50217,126209,3.2,11.1,6443,0.4,22.2,0,1287,1321,11069
1995,26,a) 0,16268,16350,99140,49750,16236,198.6,0,0,98780,98780,0,198.6,198.6,0,0,0,0,0,98780,198.6,0,0,,,
1995,26,b) 1,12123,12256,97539,92913,66,0.5,2616,19.2,32337,3500,28837,3.8,34.8,23084,11404,11680,12.3,24.8,9253,10,49.6,0,2040,2040,9338
1995,26,c) 2,10116,10262,84807,85225,348,3.2,1691,15.4,19431,4479,14952,5.3,22.8,20266,10007,10259,11.7,23.8,-835,-1,45.6,0,1371,1371,8635
1995,26,d) 3,8785,9084,77877,78495,278,2.9,1257,13.1,15033,1590,13443,2,19.2,16268,7381,8887,9.4,20.7,-1235,-1.5,38.4,0,1036,1037,6331
1995,26,e) 4,8226,8579,75419,76831,244,2.7,1082,12,13511,1588,11923,2.1,17.6,16335,7097,9238,9.2,21.3,-2824,-3.7,35.2,0,852,852,5909
1995,26,f) 5,7905,8202,78732,80742,219,2.5,970,11.3,14327,3041,11286,3.8,17.7,18347,6685,11662,8.3,22.7,-4020,-5,35.4,0,752,754,4869
1995,26,g) 6 to 10,31501,34116,405282,401710,1029,2.9,3114,8.8,63619,13717,49902,3.4,15.8,56474,20492,35982,5.1,14.1,7145,1.7,28.2,0,2290,2312,14248
1995,26,h) 11 to 15,20495,23355,315409,310911,682,2.9,1544,6.5,44657,7590,37067,2.4,14.4,35660,12783,22877,4.1,11.5,8997,2.9,23,0,1042,1050,8077
1995,26,i) 16 to 20,10776,14101,220164,218412,405,2.8,928,6.5,28799,5182,23617,2.4,13.2,25294,7692,17602,3.5,11.6,3505,1.6,23.2,0,553,556,3432
1995,26,l) Left Censored,34901,62983,2199989,2174769,2777,4.4,3947,6.2,267046,70629,196417,3.2,12.3,216606,61451,155155,2.8,10,50440,2.3,20,0,1427,1443,11710
1995,27,a) 0,8861,8910,61025,30602,8866,199,0,0,60846,60846,0,198.8,198.8,0,0,0,0,0,60846,198.8,0,0,,,
1995,27,b) 1,7069,7138,49698,50356,33,0.4,1592,19.9,13575,1230,12345,2.4,27,14891,8431,6460,16.7,29.6,-1316,-2.6,54,0,1210,1211,7442
1995,27,c) 2,5840,5963,48951,49569,191,3,974,15.3,10628,2249,8379,4.5,21.4,11863,6805,5058,13.7,23.9,-1235,-2.5,42.8,0,739,739,5675
1995,27,d) 3,4991,5177,41391,41675,171,3.1,743,13.6,7710,1281,6429,3.1,18.5,8277,4031,4246,9.7,19.9,-567,-1.4,37,0,570,570,3225
1995,27,e) 4,4685,4899,46096,46029,131,2.6,519,10.2,7774,1030,6744,2.2,16.9,7639,2868,4771,6.2,16.6,135,0.3,33.2,0,389,389,2147
1995,27,f) 5,4255,4426,41420,42082,128,2.8,505,10.9,6868,1494,5374,3.6,16.3,8192,3302,4890,7.8,19.5,-1324,-3.2,32.6,0,356,359,2412
1995,27,g) 6 to 10,16957,18387,229038,228305,544,2.9,1640,8.6,32185,4887,27298,2.1,14.1,30719,10690,20029,4.7,13.5,1466,0.6,27,0,1170,1179,7706
1995,27,h) 11 to 15,11329,12925,196314,193800,432,3.3,883,6.7,27385,6409,20976,3.3,14.1,22357,6799,15558,3.5,11.5,5028,2.6,23,0,576,586,4153
1995,27,i) 16 to 20,6240,8062,127643,125676,247,3,553,6.7,16552,2784,13768,2.2,13.2,12618,3812,8806,3,10,3934,3.2,20,0,276,284,1880
1995,27,l) Left Censored,20156,34045,1203980,1191165,1413,4.1,2078,6,129476,36595,92881,3.1,10.9,103847,27448,76399,2.3,8.7,25629,2.2,17.4,0,782,791,5511
1995,28,a) 0,4530,4561,27415,13752,4532,198.7,0,0,27327,27327,0,198.7,198.7,0,0,0,0,0,27327,198.7,0,0,,,
1995,28,b) 1,3447,3484,32393,32060,18,0.4,960,24,10311,1080,9231,3.4,32.2,9645,4895,4750,15.3,30.1,666,2.1,60.2,0,806,806,4354
1995,28,c) 2,2758,2805,25469,26922,105,3.5,549,18,6502,1702,4800,6.3,24.2,9407,4719,4688,17.5,34.9,-2905,-10.7,48.4,0,467,467,4307
1995,28,d) 3,2134,2236,18822,19040,72,3,353,14.9,3168,627,2541,3.3,16.6,3603,1627,1976,8.5,18.9,-435,-2.3,33.2,0,285,285,1322
1995,28,e) 4,1990,2088,19225,19151,71,3.2,302,13.7,3338,501,2837,2.6,17.4,3190,1325,1865,6.9,16.7,148,0.7,33.4,0,224,224,998
1995,28,f) 5,1891,1942,16327,16591,61,3,274,13.4,2780,257,2523,1.5,16.8,3307,1561,1746,9.4,19.9,-527,-3.1,33.6,0,211,211,1107
1995,28,g) 6 to 10,7157,7708,93274,93433,287,3.6,812,10.2,12848,2426,10422,2.6,13.8,13166,4284,8882,4.6,14.1,-318,-0.3,27.6,0,634,634,3265
1995,28,h) 11 to 15,5644,6201,75404,75348,196,3.1,476,7.5,11562,2487,9075,3.3,15.3,11449,4302,7147,5.7,15.2,113,0.1,30.4,0,317,317,2264
1995,28,i) 16 to 20,2977,3736,51595,51460,129,3.4,278,7.3,7031,1818,5213,3.5,13.7,6761,1993,4768,3.9,13.1,270,0.6,26.2,0,164,164,754
1995,28,l) Left Censored,9245,16391,488231,483898,756,4.6,1011,6.1,59903,20181,39722,4.2,12.4,51238,15445,35793,3.2,10.6,8665,1.8,21.2,0,410,417,4337
1995,29,a) 0,10948,11008,58487,29407,10923,198.5,0,0,58161,58161,0,197.8,197.8,0,0,0,0,0,58161,197.8,0,0,,,
1995,29,b) 1,8306,8444,59475,59204,67,0.7,2437,25,17870,2245,15625,3.8,30.2,17328,10242,7086,17.3,29.3,542,0.9,58.6,0,1955,1957,8582
1995,29,c) 2,6542,6659,51350,52074,214,2.9,1356,18.6,12555,1400,11155,2.7,24.1,14003,7366,6637,14.1,26.9,-1448,-2.8,48.2,0,1119,1119,6328
1995,29,d) 3,5491,5670,51181,51668,193,3.2,941,15.5,10841,1499,9342,2.9,21,11815,6243,5572,12.1,22.9,-974,-1.9,42,0,747,747,3831
1995,29,e) 4,4956,5233,44587,44895,157,2.9,675,12.3,7816,1262,6554,2.8,17.4,8431,3555,4876,7.9,18.8,-615,-1.4,34.8,0,541,542,2960
1995,29,f) 5,4603,4774,45631,45268,170,3.4,588,11.8,10417,2923,7494,6.5,23,9690,3559,6131,7.9,21.4,727,1.6,42.8,0,470,470,2785
1995,29,g) 6 to 10,19437,20899,234887,236515,693,3.2,2064,9.5,33252,5360,27892,2.3,14.1,36507,14926,21581,6.3,15.4,-3255,-1.3,28.2,0,1533,1538,9402
1995,29,h) 11 to 15,12754,14603,191426,190219,525,3.5,1099,7.4,26496,6458,20038,3.4,13.9,24081,7976,16105,4.2,12.7,2415,1.2,25.4,0,725,727,4601
1995,29,i) 16 to 20,6673,8739,133343,133654,284,3.2,649,7.3,16108,4092,12016,3.1,12.1,16729,4393,12336,3.3,12.5,-621,-0.4,24.2,0,380,384,2593
1995,29,l) Left Censored,22222,38865,1265407,1256037,1780,4.5,2477,6.3,148099,34756,113343,2.8,11.8,129358,35241,94117,2.8,10.3,18741,1.5,20.6,0,927,953,6054
1995,30,a) 0,2576,2585,11548,5803,2571,198.9,0,0,11491,11491,0,198,198,0,0,0,0,0,11491,198,0,0,,,
1995,30,b) 1,1802,1819,9846,10084,11,0.5,519,24.6,2446,170,2276,1.7,24.3,2922,1748,1174,17.3,29,-476,-4.7,48.6,0,405,405,1347
1995,30,c) 2,1442,1456,8562,8683,53,3.4,259,16.5,1879,461,1418,5.3,21.6,2120,1106,1014,12.7,24.4,-241,-2.8,43.2,0,204,204,833
1995,30,d) 3,1251,1271,7962,8207,42,3.1,196,14.4,1318,103,1215,1.3,16.1,1807,820,987,10,22,-489,-5.9,32.2,0,157,157,674
1995,30,e) 4,1072,1095,7990,8024,21,1.8,133,11.5,1347,231,1116,2.9,16.8,1414,661,753,8.2,17.6,-67,-0.8,33.6,0,103,103,557
1995,30,f) 5,944,955,7451,7443,26,2.6,132,13,1338,116,1222,1.6,18,1321,616,705,8.3,17.7,17,0.3,35.4,0,103,103,506
1995,30,g) 6 to 10,3817,4046,36446,36834,175,4.2,444,10.6,5132,880,4252,2.4,13.9,5907,2674,3233,7.3,16,-775,-2.1,27.8,0,328,330,1832
1995,30,h) 11 to 15,2910,3224,30772,30375,116,3.5,231,7,4618,1244,3374,4.1,15.2,3824,1144,2680,3.8,12.6,794,2.6,25.2,0,158,158,789
1995,30,i) 16 to 20,1621,1986,21330,21083,56,2.8,135,6.7,2709,268,2441,1.3,12.8,2214,778,1436,3.7,10.5,495,2.3,21,0,93,94,560
1995,30,l) Left Censored,4058,6461,114287,113857,246,3.8,344,5.3,11230,2658,8572,2.3,9.9,10369,3177,7192,2.8,9.1,861,0.8,18.2,0,176,176,1369
1995,31,a) 0,3076,3101,17404,8730,3079,198.6,0,0,17348,17348,0,198.7,198.7,0,0,0,0,0,17348,198.7,0,0,,,
1995,31,b) 1,2438,2479,17535,17068,12,0.4,623,22.1,5321,459,4862,2.7,31.2,4387,2329,2058,13.6,25.7,934,5.5,51.4,0,493,493,1901
1995,31,c) 2,2025,2053,15320,15271,62,2.8,315,14.4,3368,663,2705,4.3,22.1,3270,1563,1707,10.2,21.4,98,0.7,42.8,0,256,256,1364
1995,31,d) 3,1772,1812,13082,13326,51,2.6,271,14,2249,251,1998,1.9,16.9,2737,1376,1361,10.3,20.5,-488,-3.6,33.8,0,212,214,1082
1995,31,e) 4,1545,1608,13096,12994,54,3.2,220,13,2955,299,2656,2.3,22.7,2750,1460,1290,11.2,21.2,205,1.5,42.4,0,175,175,844
1995,31,f) 5,1490,1586,14498,14572,48,2.9,197,11.9,2147,258,1889,1.8,14.7,2295,1083,1212,7.4,15.7,-148,-1,29.4,0,152,153,759
1995,31,g) 6 to 10,6289,6765,87539,86528,194,2.8,609,8.7,12004,1480,10524,1.7,13.9,9982,3573,6409,4.1,11.5,2022,2.4,23,0,448,450,2317
1995,31,h) 11 to 15,4764,5390,60841,60664,153,2.8,378,6.9,8237,1730,6507,2.9,13.6,7882,2491,5391,4.1,13,355,0.6,26,0,256,257,1385
1995,31,i) 16 to 20,2693,3409,42321,42287,88,2.5,194,5.6,4824,851,3973,2,11.4,4756,1321,3435,3.1,11.2,68,0.2,22.4,0,127,127,772
1995,31,l) Left Censored,8985,14034,375551,371032,515,3.6,748,5.3,39126,8432,30694,2.3,10.5,30087,8812,21275,2.4,8.1,9039,2.4,16.2,0,326,330,1803
1995,32,a) 0,3984,3998,31598,15871,3962,198.2,0,0,31454,31454,0,198.2,198.2,0,0,0,0,0,31454,198.2,0,0,,,
1995,32,b) 1,2770,2807,27394,26547,27,0.8,841,25.8,9109,1113,7996,4.2,34.3,7415,4175,3240,15.7,27.9,1694,6.4,55.8,0,703,703,3717
1995,32,c) 2,1992,2014,20940,21527,74,3.3,485,21.8,4790,506,4284,2.4,22.3,5964,3460,2504,16.1,27.7,-1174,-5.4,44.6,0,402,402,2865
1995,32,d) 3,1596,1658,18229,18302,68,3.8,308,17.3,4283,374,3909,2,23.4,4429,2041,2388,11.2,24.2,-146,-0.8,46.8,0,238,238,1441
1995,32,e) 4,1492,1550,17687,17450,85,5.2,228,14,3623,501,3122,2.9,20.8,3148,1469,1679,8.4,18,475,2.8,36,0,170,170,1079
1995,32,f) 5,1380,1436,17494,17208,75,5,204,13.6,3748,630,3118,3.7,21.8,3175,1092,2083,6.3,18.5,573,3.3,37,0,149,149,778
1995,32,g) 6 to 10,4892,5391,81901,81567,256,4.6,612,11,14440,2252,12188,2.8,17.7,13772,5413,8359,6.6,16.9,668,0.8,33.8,0,444,447,3582
1995,32,h) 11 to 15,3152,3670,67240,65999,163,4.3,319,8.5,9747,2220,7527,3.4,14.8,7265,2064,5201,3.1,11,2482,3.8,22,0,185,185,997
1995,32,i) 16 to 20,1668,2203,58613,58872,137,6.2,137,6.2,7262,3511,3751,6,12.3,7780,2912,4868,4.9,13.2,-518,-0.9,24.6,0,85,85,2326
1995,32,l) Left Censored,3971,7222,321831,317616,558,7.8,492,6.8,37076,11304,25772,3.6,11.7,28645,6394,22251,2,9,8431,2.7,18,0,142,144,1069
1995,33,a) 0,2688,2696,14820,7429,2678,198.7,0,0,14783,14783,0,199,199,0,0,0,0,0,14783,199,0,0,,,
1995,33,b) 1,2031,2046,12568,12767,5,0.2,479,20.7,3365,111,3254,0.9,26.4,3762,1956,1806,15.3,29.5,-397,-3.1,52.8,0,387,387,1684
1995,33,c) 2,1571,1592,11056,11038,57,3.3,279,16.4,2750,425,2325,3.9,24.9,2714,1540,1174,14,24.6,36,0.3,49.2,0,225,225,1348
1995,33,d) 3,1347,1401,10647,10763,46,3.1,199,13.5,2091,268,1823,2.5,19.4,2323,1054,1269,9.8,21.6,-232,-2.2,38.8,0,146,146,795
1995,33,e) 4,1217,1257,10334,10194,52,4,153,11.7,1923,229,1694,2.2,18.9,1642,837,805,8.2,16.1,281,2.8,32.2,0,117,117,504
1995,33,f) 5,1210,1247,9630,9715,57,4.4,132,10.3,1591,195,1396,2,16.4,1761,508,1253,5.2,18.1,-170,-1.7,32.8,0,105,105,399
1995,33,g) 6 to 10,5782,6092,69547,68949,243,3.9,648,10.3,10209,1578,8631,2.3,14.8,9013,3617,5396,5.2,13.1,1196,1.7,26.2,0,481,483,2807
1995,33,h) 11 to 15,3180,3487,41184,40722,148,4.2,285,8,5984,1447,4537,3.6,14.7,5059,1883,3176,4.6,12.4,925,2.3,24.8,0,199,199,1150
1995,33,i) 16 to 20,1610,2098,32141,31341,107,5.1,139,6.6,4938,1740,3198,5.6,15.8,3338,815,2523,2.6,10.7,1600,5.1,21.4,0,76,76,399
1995,33,l) Left Censored,5090,8380,247856,245764,450,5.3,556,6.6,28183,9609,18574,3.9,11.5,23998,7908,16090,3.2,9.8,4185,1.7,19.6,0,166,169,1589
1995,34,a) 0,17004,17113,89483,44907,16995,198.6,0,0,89153,89153,0,198.5,198.5,0,0,0,0,0,89153,198.5,0,0,,,
1995,34,b) 1,12122,12194,80065,80224,31,0.2,2883,20.9,21702,521,21181,0.6,27.1,22019,11870,10149,14.8,27.4,-317,-0.3,54.2,0,2245,2245,9901
1995,34,c) 2,10284,10339,75684,76157,351,3.2,1797,16.2,16820,1482,15338,1.9,22.1,17765,9605,8160,12.6,23.3,-945,-1.2,44.2,0,1461,1461,7585
1995,34,d) 3,8568,8762,67092,68463,283,3,1272,13.7,12388,1051,11337,1.5,18.1,15130,6902,8228,10.1,22.1,-2742,-4,36.2,0,979,980,5340
1995,34,e) 4,7954,8125,61215,61439,301,3.5,1067,12.5,12134,1410,10724,2.3,19.7,12581,5242,7339,8.5,20.5,-447,-0.8,39.4,0,803,804,3978
1995,34,f) 5,7658,7821,64506,63900,275,3.4,934,11.4,11651,1267,10384,2,18.2,10439,4511,5928,7.1,16.3,1212,1.9,32.6,0,706,716,3449
1995,34,g) 6 to 10,33420,34891,389048,391484,1262,3.5,3669,10.2,56250,9294,46956,2.4,14.4,61121,24191,36930,6.2,15.6,-4871,-1.2,28.8,0,2661,2672,16017
1995,34,h) 11 to 15,21109,22798,289375,290267,712,3,1764,7.6,38322,6250,32072,2.2,13.2,40106,13127,26979,4.5,13.8,-1784,-0.6,26.4,0,1213,1215,8328
1995,34,i) 16 to 20,10636,12410,188363,185358,410,3.2,916,7.2,28133,5753,22380,3.1,15.2,22122,6870,15252,3.7,11.9,6011,3.3,23.8,0,544,550,2838
1995,34,l) Left Censored,36386,57966,1833715,1837807,2572,4.4,4028,6.9,201657,56238,145419,3.1,11,209841,63624,146217,3.5,11.4,-8184,-0.4,22,0,1624,1695,13043
1995,35,a) 0,3501,3518,20233,10143,3493,198.6,0,0,20180,20180,0,199,199,0,0,0,0,0,20180,199,0,0,,,
1995,35,b) 1,2597,2642,18524,18999,22,0.7,769,25.1,5032,302,4730,1.6,26.5,5981,3502,2479,18.4,31.5,-949,-5,53,0,622,622,2891
1995,35,c) 2,2009,2023,15325,15754,78,3.6,400,18.2,3314,432,2882,2.7,21,4171,2295,1876,14.6,26.5,-857,-5.5,42,0,337,337,2004
1995,35,d) 3,1654,1728,14765,15181,67,3.6,320,17.2,2906,595,2311,3.9,19.1,3737,2094,1643,13.8,24.6,-831,-5.5,38.2,0,255,255,1628
1995,35,e) 4,1610,1720,15134,15032,63,3.5,233,12.8,2837,419,2418,2.8,18.9,2632,1236,1396,8.2,17.5,205,1.4,35,0,187,187,979
1995,35,f) 5,1424,1455,12250,12228,60,4,175,11.5,2375,532,1843,4.4,19.4,2331,943,1388,7.7,19.1,44,0.3,38.2,0,138,138,798
1995,35,g) 6 to 10,5521,5948,68059,68275,232,3.8,661,10.7,9551,1392,8159,2,14,9982,4117,5865,6,14.6,-431,-0.6,28,0,459,462,2447
1995,35,h) 11 to 15,4071,4637,56703,55335,182,3.8,423,8.9,10081,2302,7779,4.2,18.2,7344,2576,4768,4.7,13.3,2737,4.9,26.6,0,268,269,1463
1995,35,i) 16 to 20,2139,2740,33480,33372,115,4.1,227,8.1,4894,959,3935,2.9,14.7,4678,1746,2932,5.2,14,216,0.7,28,0,135,135,766
1995,35,l) Left Censored,5391,9301,236039,235365,490,5.2,590,6.3,27083,6883,20200,2.9,11.5,25735,8208,17527,3.5,10.9,1348,0.6,21.8,0,202,210,1334
1995,36,a) 0,35540,35722,182755,91949,35450,198.5,0,0,181613,181613,0,197.5,197.5,0,0,0,0,0,181613,197.5,0,0,,,
1995,36,b) 1,26362,26498,182387,181413,74,0.2,6901,22.9,52459,1950,50509,1.1,28.9,50511,27298,23213,15,27.8,1948,1.1,55.6,0,5514,5514,22944
1995,36,c) 2,21985,22193,164760,167753,750,3.1,4375,18.2,36273,4238,32035,2.5,21.6,42259,23306,18953,13.9,25.2,-5986,-3.6,43.2,0,3585,3585,19539
1995,36,d) 3,18570,18998,147833,150500,679,3.4,3166,15.6,29416,3680,25736,2.4,19.5,34750,18961,15789,12.6,23.1,-5334,-3.6,39,0,2528,2531,15370
1995,36,e) 4,17331,17741,142566,144116,622,3.3,2588,13.8,29349,2946,26403,2,20.4,32449,13605,18844,9.4,22.5,-3100,-2.1,40.8,0,2055,2055,11547
1995,36,f) 5,16385,16771,131383,134594,521,3,2176,12.3,21893,2055,19838,1.5,16.3,28315,11998,16317,8.9,21,-6422,-4.7,32.6,0,1726,1727,9293
1995,36,g) 6 to 10,69565,72552,786722,792064,2233,3,7707,10.2,95944,14994,80950,1.9,12.1,106628,42396,64232,5.4,13.5,-10684,-1.4,24.2,0,5818,5846,30636
1995,36,h) 11 to 15,43917,48011,611451,612547,1417,2.9,3945,8,78140,14334,63806,2.3,12.8,80332,26531,53801,4.3,13.1,-2192,-0.3,25.6,0,2727,2749,16426
1995,36,i) 16 to 20,21219,26427,432001,433977,857,3.2,2016,7.5,52556,11442,41114,2.6,12.1,56507,15166,41341,3.5,13,-3951,-0.9,24.2,0,1304,1320,7255
1995,36,l) Left Censored,79329,124297,3880216,3907916,5061,4,8992,7.1,419530,117500,302030,3,10.7,474929,113865,361064,2.9,12.2,-55399,-1.5,21.4,0,3999,4044,27415
1995,37,a) 0,14375,14470,78788,39612,14363,198.5,0,0,78352,78352,0,197.8,197.8,0,0,0,0,0,78352,197.8,0,0,,,
1995,37,b) 1,10553,10698,81528,78336,79,0.7,2650,21.9,26087,3084,23003,3.9,33.3,19702,10955,8747,14,25.2,6385,8.1,50.4,0,2166,2166,9638
1995,37,c) 2,8191,8286,62016,63047,258,2.9,1547,17.3,13935,1899,12036,3,22.1,15997,8817,7180,14,25.4,-2062,-3.3,44.2,0,1298,1300,7749
1995,37,d) 3,6948,7223,67520,67914,251,3.3,1014,13.3,12363,1781,10582,2.6,18.2,13151,6429,6722,9.5,19.4,-788,-1.2,36.4,0,814,814,5550
1995,37,e) 4,6463,6758,60357,60420,216,3,894,12.6,11337,1956,9381,3.2,18.8,11463,5310,6153,8.8,19,-126,-0.2,37.6,0,691,692,3886
1995,37,f) 5,6292,6531,60328,59922,219,3.2,748,11,10984,1316,9668,2.2,18.3,10171,4518,5653,7.5,17,813,1.3,34,0,589,591,3655
1995,37,g) 6 to 10,25442,27742,337410,332685,1018,3.6,2615,9.2,53497,11298,42199,3.4,16.1,44047,16246,27801,4.9,13.2,9450,2.9,26.4,0,1895,1904,10444
1995,37,h) 11 to 15,17137,19663,260307,257325,689,3.4,1299,6.5,35598,7626,27972,3,13.8,29633,9525,20108,3.7,11.5,5965,2.3,23,0,825,826,5213
1995,37,i) 16 to 20,8117,10616,171147,168569,414,3.9,645,6,24076,5910,18166,3.5,14.3,18919,4672,14247,2.8,11.2,5157,3.1,22.4,0,384,384,1947
1995,37,l) Left Censored,25252,49960,1765209,1749066,2233,4.4,2847,5.7,191576,47780,143796,2.7,11,159289,43625,115664,2.5,9.1,32287,1.9,18.2,0,1025,1040,8696
1995,38,a) 0,1262,1262,6778,3399,1257,199.2,0,0,6758,6758,0,198.8,198.8,0,0,0,0,0,6758,198.8,0,0,,,
1995,38,b) 1,1065,1069,6363,6240,7,0.6,198,16.8,1687,115,1572,1.8,27,1441,754,687,12.1,23.1,246,3.9,46.2,0,152,152,646
1995,38,c) 2,866,870,5961,5997,26,2.8,131,14.1,1182,165,1017,2.8,19.7,1254,718,536,12,20.9,-72,-1.2,39.4,0,108,109,562
1995,38,d) 3,738,747,5380,5323,28,3.6,99,12.6,1030,105,925,2,19.3,915,413,502,7.8,17.2,115,2.1,34.4,0,70,70,317
1995,38,e) 4,665,687,5362,5365,17,2.4,82,11.4,753,55,698,1,14,759,341,418,6.4,14.1,-6,-0.1,28,0,63,63,266
1995,38,f) 5,622,653,4227,4337,21,3.1,71,10.5,618,58,560,1.3,14.2,838,327,511,7.5,19.3,-220,-5.1,28.4,0,50,50,245
1995,38,g) 6 to 10,2676,2819,25828,25555,90,3.1,240,8.3,3641,409,3232,1.6,14.2,3095,1127,1968,4.4,12.1,546,2.1,24.2,0,191,191,940
1995,38,h) 11 to 15,2196,2471,25192,25036,54,2.1,164,6.5,2861,280,2581,1.1,11.4,2549,670,1879,2.7,10.2,312,1.2,20.4,0,99,99,444
1995,38,i) 16 to 20,1176,1409,16570,16404,38,2.6,104,7.2,2210,489,1721,3,13.5,1878,620,1258,3.8,11.4,332,2.1,22.8,0,66,71,383
1995,38,l) Left Censored,3955,5996,125341,124475,207,3.4,320,5.3,13452,2492,10960,2,10.8,11720,3859,7861,3.1,9.4,1732,1.4,18.8,0,144,144,1005
1995,39,a) 0,17377,17513,100299,50304,17408,198.8,0,0,99990,99990,0,198.8,198.8,0,0,0,0,0,99990,198.8,0,0,,,
1995,39,b) 1,13258,13525,101304,99253,119,0.8,3100,20.4,28688,2391,26297,2.4,28.9,24586,13874,10712,14,24.8,4102,4.1,49.6,0,2490,2491,11966
1995,39,c) 2,11001,11195,96865,97779,353,2.9,1894,15.8,22085,3565,18520,3.6,22.6,23912,11464,12448,11.7,24.5,-1827,-1.9,45.2,0,1566,1566,10296
1995,39,d) 3,9359,9692,82860,82325,288,2.8,1391,13.5,16327,2403,13924,2.9,19.8,15257,7180,8077,8.7,18.5,1070,1.3,37,0,1110,1110,5634
1995,39,e) 4,8769,9205,84955,84658,304,3.2,1134,11.8,15860,2486,13374,2.9,18.7,15266,7195,8071,8.5,18,594,0.7,36,0,875,875,5307
1995,39,f) 5,8354,8743,85588,85115,254,2.8,1016,11.1,15116,2130,12986,2.5,17.8,14170,5962,8208,7,16.6,946,1.2,33.2,0,760,761,4307
1995,39,g) 6 to 10,34786,38272,494692,494979,1230,3.1,3447,8.7,72849,13153,59696,2.7,14.7,73422,25383,48039,5.1,14.8,-573,-0.1,29.4,0,2489,2501,17032
1995,39,h) 11 to 15,23633,27251,377761,375590,816,2.9,1860,6.7,48056,9100,38956,2.4,12.8,43714,14551,29163,3.9,11.6,4342,1.2,23.2,0,1186,1204,7774
1995,39,i) 16 to 20,13025,17179,286999,285089,567,3.3,1022,5.9,37064,8790,28274,3.1,13,33244,10888,22356,3.8,11.7,3820,1.3,23.4,0,569,583,6316
1995,39,l) Left Censored,45921,84420,2776859,2748759,3656,4.3,5195,6.1,313037,82600,230437,3,11.4,256837,66048,190789,2.4,9.3,56200,2.1,18.6,0,1827,1882,10605
1995,40,a) 0,6356,6390,34550,17349,6341,198.5,0,0,34403,34403,0,198.3,198.3,0,0,0,0,0,34403,198.3,0,0,,,
1995,40,b) 1,4863,4900,32513,33730,25,0.4,1460,25.7,8508,429,8079,1.3,25.2,10942,6455,4487,19.1,32.4,-2434,-7.2,50.4,0,1221,1221,5057
1995,40,c) 2,3900,3939,28201,29695,117,2.7,795,18.5,6547,657,5890,2.2,22,9535,6011,3524,20.2,32.1,-2988,-10.1,44,0,667,667,5145
1995,40,d) 3,3322,3411,26502,26856,98,2.7,514,14.2,4772,678,4094,2.5,17.8,5480,2596,2884,9.7,20.4,-708,-2.6,35.6,0,421,421,2225
1995,40,e) 4,2971,3080,24341,24951,95,2.9,409,12.6,3873,475,3398,1.9,15.5,5093,2148,2945,8.6,20.4,-1220,-4.9,31,0,333,335,1467
1995,40,f) 5,2709,2822,24298,24558,86,2.9,357,12,4040,532,3508,2.2,16.5,4559,1977,2582,8.1,18.6,-519,-2.1,33,0,291,291,1615
1995,40,g) 6 to 10,10539,11318,132890,133036,378,3.2,1218,10.4,19091,2871,16220,2.2,14.4,19382,7537,11845,5.7,14.6,-291,-0.2,28.8,0,904,912,4690
1995,40,h) 11 to 15,9056,10151,116272,115904,299,2.9,804,7.7,15850,2462,13388,2.1,13.7,15113,5445,9668,4.7,13,737,0.7,26,0,557,562,2958
1995,40,i) 16 to 20,4132,5336,73601,72716,219,4,369,6.8,9653,2102,7551,2.9,13.3,7882,2484,5398,3.4,10.8,1771,2.5,21.6,0,243,243,1269
1995,40,l) Left Censored,11969,21113,529290,529635,910,4.3,1365,6.4,57356,14948,42408,2.8,10.8,58046,16670,41376,3.1,11,-690,-0.2,21.6,0,537,539,2708
1995,41,a) 0,8301,8347,40372,20257,8290,198.6,0,0,40230,40230,0,198.6,198.6,0,0,0,0,0,40230,198.6,0,0,,,
1995,41,b) 1,6216,6301,38113,38025,39,0.5,1737,24,10913,735,10178,1.9,28.7,10737,6297,4440,16.6,28.2,176,0.5,56.4,0,1368,1368,5130
1995,41,c) 2,4657,4719,31038,31548,164,3.2,938,18.2,7383,1101,6282,3.5,23.4,8403,4672,3731,14.8,26.6,-1020,-3.2,46.8,0,741,741,3785
1995,41,d) 3,4011,4185,35354,35549,182,4.1,663,14.9,7197,1174,6023,3.3,20.2,7586,3366,4220,9.5,21.3,-389,-1.1,40.4,0,520,520,2800
1995,41,e) 4,3647,3762,28353,28462,152,3.8,568,14.3,5786,779,5007,2.7,20.3,6003,2834,3169,10,21.1,-217,-0.8,40.6,0,445,447,2173
1995,41,f) 5,3746,3878,34531,33890,157,3.9,506,12.5,7001,1031,5970,3,20.7,5719,2458,3261,7.3,16.9,1282,3.8,33.8,0,387,387,1804
1995,41,g) 6 to 10,12567,13407,144984,144499,560,4,1396,10.1,23545,3325,20220,2.3,16.3,22574,8024,14550,5.6,15.6,971,0.7,31.2,0,979,985,5844
1995,41,h) 11 to 15,8698,9837,133667,132123,381,3.8,746,7.4,20869,4829,16040,3.7,15.8,17780,5706,12074,4.3,13.5,3089,2.3,27,0,465,467,2744
1995,41,i) 16 to 20,4600,5864,87112,85281,232,3.9,394,6.6,12388,2756,9632,3.2,14.5,8725,2648,6077,3.1,10.2,3663,4.3,20.4,0,231,238,1663
1995,41,l) Left Censored,11970,21018,587425,582442,1055,5,1566,7.4,72309,21057,51252,3.6,12.4,62343,17719,44624,3,10.7,9966,1.7,21.4,0,518,563,4708
1995,42,a) 0,17781,17943,107025,53857,17813,198.6,0,0,106337,106337,0,197.4,197.4,0,0,0,0,0,106337,197.4,0,0,,,
1995,42,b) 1,13028,13233,112382,109350,94,0.6,2835,19.2,30382,3179,27203,2.9,27.8,24318,13794,10524,12.6,22.2,6064,5.6,44.4,0,2312,2316,11346
1995,42,c) 2,11277,11410,88889,90273,319,2.6,1810,14.8,18875,2721,16154,3,20.9,21642,11570,10072,12.8,24,-2767,-3.1,41.8,0,1500,1500,10072
1995,42,d) 3,10342,10775,86609,87637,349,3.1,1468,12.9,16938,2642,14296,3,19.3,18993,9037,9956,10.3,21.7,-2055,-2.4,38.6,0,1209,1212,6756
1995,42,e) 4,9969,10408,86950,87459,316,2.9,1172,10.8,15761,2001,13760,2.3,18,16779,7218,9561,8.3,19.2,-1018,-1.2,36,0,924,925,5341
1995,42,f) 5,9797,10126,87193,86503,321,3.1,1029,9.8,15493,2405,13088,2.8,17.9,14113,6019,8094,7,16.3,1380,1.6,32.6,0,789,791,4519
1995,42,g) 6 to 10,42254,45038,502857,505446,1431,3.1,4042,8.7,67440,10002,57438,2,13.3,72618,26815,45803,5.3,14.4,-5178,-1.1,26.6,0,2963,2983,19189
1995,42,h) 11 to 15,26977,30273,410225,408760,804,2.6,2104,6.8,51017,8685,42332,2.1,12.5,48087,15958,32129,3.9,11.8,2930,0.7,23.6,0,1434,1436,9411
1995,42,i) 16 to 20,14071,18040,290810,287636,547,3,1144,6.2,36248,7778,28470,2.7,12.6,29900,9971,19929,3.5,10.4,6348,2.2,20.8,0,686,693,5150
1995,42,l) Left Censored,51391,89856,2862524,2854012,3869,4.3,5919,6.5,296027,79735,216292,2.8,10.4,279003,81759,197244,2.9,9.8,17024,0.6,19.6,0,2329,2363,19710
1995,44,a) 0,1845,1850,7959,4021,1832,198.1,0,0,7877,7877,0,195.9,195.9,0,0,0,0,0,7877,195.9,0,0,,,
1995,44,b) 1,1517,1528,13641,13719,5,0.3,389,22.3,2758,322,2436,2.3,20.1,2914,1278,1636,9.3,21.2,-156,-1.1,40.2,0,303,304,1079
1995,44,c) 2,1244,1248,7600,7942,44,3.3,232,17.3,1438,191,1247,2.4,18.1,2122,1249,873,15.7,26.7,-684,-8.6,36.2,0,180,180,908
1995,44,d) 3,1042,1054,8210,8365,33,2.9,158,14.1,1429,114,1315,1.4,17.1,1738,838,900,10,20.8,-309,-3.7,34.2,0,125,125,749
1995,44,e) 4,924,943,8277,8148,24,2.4,130,13,1909,551,1358,6.8,23.4,1650,932,718,11.4,20.3,259,3.1,40.6,0,102,103,768
1995,44,f) 5,937,959,6421,6725,32,3.2,135,13.3,970,79,891,1.2,14.4,1577,813,764,12.1,23.4,-607,-9,28.8,0,114,114,657
1995,44,g) 6 to 10,4390,4575,43619,43033,196,4.2,430,9.1,6882,1267,5615,2.9,16,5710,2016,3694,4.7,13.3,1172,2.7,26.6,0,320,320,1375
1995,44,h) 11 to 15,2596,2778,34673,33864,109,3.9,197,7,5553,1496,4057,4.4,16.4,3934,1004,2930,3,11.6,1619,4.8,23.2,0,129,129,557
1995,44,i) 16 to 20,1431,1643,23076,22600,63,3.8,106,6.4,3367,1251,2116,5.5,14.9,2414,617,1797,2.7,10.7,953,4.2,21.4,0,66,70,285
1995,44,l) Left Censored,5622,7672,223305,222717,331,4.3,496,6.4,23253,6239,17014,2.8,10.4,22077,5434,16643,2.4,9.9,1176,0.5,19.8,0,213,215,1168
1995,45,a) 0,7251,7284,42630,21365,7240,198.8,0,0,42530,42530,0,199.1,199.1,0,0,0,0,0,42530,199.1,0,0,,,
1995,45,b) 1,5107,5188,43395,43206,41,0.7,1415,23.8,11996,1076,10920,2.5,27.8,11617,6884,4733,15.9,26.9,379,0.9,53.8,0,1132,1132,5536
1995,45,c) 2,4080,4142,30986,32156,149,3.3,835,18.5,6619,751,5868,2.3,20.6,8959,4863,4096,15.1,27.9,-2340,-7.3,41.2,0,690,690,3934
1995,45,d) 3,3489,3579,31969,33634,119,3.1,614,16,7011,2078,4933,6.2,20.8,10340,5103,5237,15.2,30.7,-3329,-9.9,41.6,0,486,488,2716
1995,45,e) 4,3259,3436,28822,28833,115,3.2,467,12.9,5675,1254,4421,4.3,19.7,5697,2616,3081,9.1,19.8,-22,-0.1,39.4,0,367,368,2133
1995,45,f) 5,2973,3063,26921,27267,117,3.6,401,12.5,5007,735,4272,2.7,18.4,5699,3015,2684,11.1,20.9,-692,-2.5,36.8,0,319,319,2275
1995,45,g) 6 to 10,12310,13611,162322,160769,495,3.5,1319,9.4,25864,7289,18575,4.5,16.1,22758,9201,13557,5.7,14.2,3106,1.9,28.4,0,947,948,5621
1995,45,h) 11 to 15,8126,9275,115349,115864,283,3,717,7.6,15231,2580,12651,2.2,13.1,16261,6285,9976,5.4,14,-1030,-0.9,26.2,0,462,464,3573
1995,45,i) 16 to 20,3882,5009,78411,77670,174,3.4,347,6.8,11378,2994,8384,3.9,14.6,9896,2001,7895,2.6,12.7,1482,1.9,25.4,0,203,212,1050
1995,45,l) Left Censored,12198,23687,808172,801979,1125,4.7,1454,6.1,85356,21189,64167,2.6,10.6,72972,20161,52811,2.5,9.1,12384,1.5,18.2,0,541,556,3481
1995,46,a) 0,1604,1616,7755,3905,1606,198.8,0,0,7700,7700,0,197.2,197.2,0,0,0,0,0,7700,197.2,0,0,,,
1995,46,b) 1,1362,1379,8735,8753,7,0.5,299,19.4,1949,149,1800,1.7,22.3,1985,1049,936,12,22.7,-36,-0.4,44.6,0,236,236,827
1995,46,c) 2,1027,1037,7049,7087,32,2.9,170,15.2,1389,234,1155,3.3,19.6,1465,692,773,9.8,20.7,-76,-1.1,39.2,0,140,140,523
1995,46,d) 3,914,946,6376,6541,26,2.6,117,11.8,940,75,865,1.1,14.4,1269,516,753,7.9,19.4,-329,-5,28.8,0,96,96,464
1995,46,e) 4,812,832,6958,7053,17,1.9,108,12.2,1058,156,902,2.2,15,1247,601,646,8.5,17.7,-189,-2.7,30,0,80,80,509
1995,46,f) 5,827,845,7519,7480,28,3.2,81,9.3,1094,149,945,2,14.6,1016,377,639,5,13.6,78,1,27.2,0,61,61,286
1995,46,g) 6 to 10,2965,3105,35740,35262,83,2.6,300,9.3,5051,399,4652,1.1,14.3,4094,1795,2299,5.1,11.6,957,2.7,23.2,0,214,214,1208
1995,46,h) 11 to 15,2222,2501,25925,25445,68,2.7,178,6.9,3650,1027,2623,4,14.3,2689,834,1855,3.3,10.6,961,3.7,21.2,0,114,114,521
1995,46,i) 16 to 20,1222,1486,18038,17850,46,3,94,6.2,2487,382,2105,2.1,13.9,2110,514,1596,2.9,11.8,377,2.1,23.6,0,68,69,353
1995,46,l) Left Censored,4216,6222,140388,138816,214,3.4,322,5.1,13507,2198,11309,1.6,9.7,10363,3972,6391,2.9,7.5,3144,2.2,15,0,154,154,714
1995,47,a) 0,9808,9885,61664,31001,9805,198.4,0,0,61327,61327,0,197.8,197.8,0,0,0,0,0,61327,197.8,0,0,,,
1995,47,b) 1,7177,7263,63385,62771,49,0.6,2027,24.2,17882,1117,16765,1.8,28.5,16654,9678,6976,15.4,26.5,1228,2,53,0,1699,1699,8489
1995,47,c) 2,5871,5994,68801,60515,199,3.1,1186,18.2,29457,1350,28107,2.2,48.7,12884,6774,6110,11.2,21.3,16573,27.4,42.6,0,979,979,5347
1995,47,d) 3,4858,5050,49699,50348,173,3.2,744,13.9,10763,2053,8710,4.1,21.4,12061,5637,6424,11.2,24,-1298,-2.6,42.8,0,593,595,4782
1995,47,e) 4,4350,4570,47253,47678,164,3.4,652,13.5,8046,1005,7041,2.1,16.9,8895,4562,4333,9.6,18.7,-849,-1.8,33.8,0,491,493,2961
1995,47,f) 5,4031,4196,39957,39665,160,3.7,518,11.8,7761,1542,6219,3.9,19.6,7177,3302,3875,8.3,18.1,584,1.5,36.2,0,415,415,2759
1995,47,g) 6 to 10,16895,18467,234768,234484,636,3.3,1784,9.4,35434,5477,29957,2.3,15.1,34866,12103,22763,5.2,14.9,568,0.2,29.8,0,1298,1311,8209
1995,47,h) 11 to 15,11578,13143,175256,172853,424,3.2,900,6.7,25768,4613,21155,2.7,14.9,20962,6899,14063,4,12.1,4806,2.8,24.2,0,588,593,3880
1995,47,i) 16 to 20,5939,8325,161926,158063,374,4.5,509,6.1,25837,6488,19349,4.1,16.3,18112,4515,13597,2.9,11.5,7725,4.8,23,0,276,290,1703
1995,47,l) Left Censored,18310,34955,1234053,1214511,1723,4.9,2154,6.1,150254,40650,109604,3.3,12.4,111170,28771,82399,2.4,9.2,39084,3.2,18.4,0,748,764,5224
1995,48,a) 0,36928,37285,242467,121648,37051,198.7,0,0,241639,241639,0,198.6,198.6,0,0,0,0,0,241639,198.6,0,0,,,
1995,48,b) 1,27565,28202,231564,229881,229,0.7,8161,25.1,74229,5249,68980,2.3,32.3,70862,42087,28775,18.3,30.8,3367,1.5,61.6,0,6779,6781,35532
1995,48,c) 2,22086,22524,203580,207105,767,3.1,4687,19,51701,6111,45590,3,25,58752,33546,25206,16.2,28.4,-7051,-3.4,50,0,3919,3929,29369
1995,48,d) 3,18896,19723,201484,206230,702,3.3,3369,15.9,38747,6470,32277,3.1,18.8,48239,24263,23976,11.8,23.4,-9492,-4.6,37.6,0,2693,2701,18927
1995,48,e) 4,17047,17993,186929,186421,616,3.2,2545,13.4,40631,5645,34986,3,21.8,39615,17783,21832,9.5,21.3,1016,0.5,42.6,0,1990,1999,13871
1995,48,f) 5,15002,15903,170840,171310,580,3.5,2114,12.7,33454,6930,26524,4,19.5,34393,14222,20171,8.3,20.1,-939,-0.6,39,0,1639,1669,11465
1995,48,g) 6 to 10,56113,62330,755605,761843,2234,3.5,6665,10.3,120931,24727,96204,3.2,15.9,133407,54212,79195,7.1,17.5,-12476,-1.6,31.8,0,4749,4823,34505
1995,48,h) 11 to 15,43423,49895,668006,657944,1764,3.5,3969,7.8,113861,24757,89104,3.8,17.3,93737,33174,60563,5,14.2,20124,3.1,28.4,0,2534,2548,17720
1995,48,i) 16 to 20,19217,26567,413995,406572,1103,4.1,1878,7,64969,17027,47942,4.2,16,50123,14119,36004,3.5,12.3,14846,3.7,24.6,0,1078,1095,5869
1995,48,l) Left Censored,47758,108725,3518808,3488716,6625,6.1,7904,7.2,457526,138647,318879,4,13.1,397341,103612,293729,3,11.4,60185,1.7,22.8,0,2351,2460,13493
1995,49,a) 0,4505,4537,32223,16165,4497,198.2,0,0,32116,32116,0,198.7,198.7,0,0,0,0,0,32116,198.7,0,0,,,
1995,49,b) 1,3268,3361,27613,27790,40,1,1004,25.8,8025,687,7338,2.5,28.9,8379,4504,3875,16.2,30.2,-354,-1.3,57.8,0,804,804,3679
1995,49,c) 2,2435,2471,21844,22184,84,3.1,469,17.5,4829,552,4277,2.5,21.8,5508,2853,2655,12.9,24.8,-679,-3,43.6,0,392,392,2542
1995,49,d) 3,2013,2068,19374,19345,70,3.2,330,15,4642,445,4197,2.3,24,4584,2399,2185,12.4,23.7,58,0.3,47.4,0,248,248,1881
1995,49,e) 4,1718,1788,19022,19018,64,3.4,247,13.1,3717,845,2872,4.4,19.5,3709,1647,2062,8.7,19.5,8,0,39,0,173,174,1241
1995,49,f) 5,1451,1534,17845,17664,50,3.1,194,12.1,3551,323,3228,1.8,20.1,3189,1575,1614,8.9,18.1,362,2,36.2,0,163,164,1363
1995,49,g) 6 to 10,5489,5973,97710,97837,219,3.5,629,10.2,18126,2395,15731,2.4,18.5,18379,6326,12053,6.5,18.8,-253,-0.3,37,0,457,457,5042
1995,49,h) 11 to 15,3768,4298,69560,70165,143,3.2,351,8,10255,1498,8757,2.1,14.6,11465,2897,8568,4.1,16.3,-1210,-1.7,29.2,0,222,224,1551
1995,49,i) 16 to 20,2136,2660,47112,46433,129,4.8,186,6.9,6850,1496,5354,3.2,14.8,5491,1873,3618,4,11.8,1359,3,23.6,0,99,102,1197
1995,49,l) Left Censored,5691,10459,381038,373860,647,6.2,629,6,47022,13859,33163,3.7,12.6,32666,9694,22972,2.6,8.7,14356,3.9,17.4,0,205,212,1758
1995,50,a) 0,1431,1433,6504,3268,1422,198.5,0,0,6472,,,,198,0,0,0,0,0,6472,198,0,1,,,
1995,50,b) 1,1170,1186,6435,6489,2,0.2,245,18.6,1575,,,,24.3,1682,887,795,13.7,25.9,-107,-1.6,48.6,1,189,189,777
1995,50,c) 2,1015,1022,5528,5687,32,2.9,169,15.4,892,65,827,1.1,15.7,1210,600,610,10.6,21.3,-318,-5.6,31.4,0,144,144,532
1995,50,d) 3,810,827,5706,5889,24,2.7,125,14.2,827,73,754,1.2,14,1192,490,702,8.3,20.2,-365,-6.2,28,0,99,99,390
1995,50,e) 4,783,804,5226,5267,24,2.9,85,10.2,755,85,670,1.6,14.3,836,273,563,5.2,15.9,-81,-1.6,28.6,0,70,70,223
1995,50,f) 5,820,845,5106,5447,27,3,100,11.3,744,74,670,1.4,13.7,1425,650,775,11.9,26.2,-681,-12.5,27.4,0,87,87,543
1995,50,g) 6 to 10,3630,3783,31588,31581,109,2.8,353,9,4115,571,3544,1.8,13,4101,1575,2526,5,13,14,0,26,0,265,265,1274
1995,50,h) 11 to 15,2091,2254,22713,22584,66,2.9,146,6.4,2801,505,2296,2.2,12.4,2542,845,1697,3.7,11.3,259,1.1,22.6,0,109,109,622
1995,50,i) 16 to 20,994,1209,17714,17650,44,3.6,86,7,2514,933,1581,5.3,14.2,2386,1100,1286,6.2,13.5,128,0.7,27,0,46,46,339
1995,50,l) Left Censored,3160,4617,115299,115657,177,3.8,300,6.4,11930,1887,10043,1.6,10.3,12646,5147,7499,4.5,10.9,-716,-0.6,20.6,0,130,131,1563
1995,51,a) 0,12554,12641,68192,34192,12565,198.8,0,0,68000,68000,0,198.9,198.9,0,0,0,0,0,68000,198.9,0,0,,,
1995,51,b) 1,9084,9212,65369,64645,51,0.5,2488,23.6,19381,2889,16492,4.5,30,17932,10343,7589,16,27.7,1449,2.3,55.4,0,2018,2018,9009
1995,51,c) 2,7696,7784,57074,58333,258,3.1,1386,16.5,13344,1442,11902,2.5,22.9,15862,8661,7201,14.8,27.2,-2518,-4.3,45.8,0,1141,1142,7266
1995,51,d) 3,6431,6701,57758,58899,214,3,1070,15,11000,1348,9652,2.3,18.7,13282,5974,7308,10.1,22.6,-2282,-3.9,37.4,0,833,838,4342
1995,51,e) 4,5891,6101,54330,54719,207,3.2,793,12.4,10482,1216,9266,2.2,19.2,11259,5066,6193,9.3,20.6,-777,-1.4,38.4,0,601,603,3200
1995,51,f) 5,5770,6019,53353,53387,244,3.9,704,11.2,10502,1676,8826,3.1,19.7,10570,4320,6250,8.1,19.8,-68,-0.1,39.4,0,550,552,3618
1995,51,g) 6 to 10,23476,25697,303695,301243,910,3.4,2413,9.1,48167,8314,39853,2.8,16,43263,16840,26423,5.6,14.4,4904,1.6,28.8,0,1677,1690,10649
1995,51,h) 11 to 15,14326,16335,227423,224901,559,3.4,1197,7.2,31369,7818,23551,3.5,13.9,26324,7625,18699,3.4,11.7,5045,2.2,23.4,0,703,704,3692
1995,51,i) 16 to 20,6886,9353,149559,148700,296,3.1,662,6.9,20508,5718,14790,3.8,13.8,18790,6823,11967,4.6,12.6,1718,1.2,25.2,0,359,368,2439
1995,51,l) Left Censored,21738,44657,1395428,1386091,2242,5,2819,6.3,162785,46438,116347,3.4,11.7,144110,41984,102126,3,10.4,18675,1.3,20.8,0,828,840,5672
1995,53,a) 0,13328,13406,67534,33929,13280,198.1,0,0,67211,67211,0,198.1,198.1,0,0,0,0,0,67211,198.1,0,0,,,
1995,53,b) 1,9859,9973,60263,61675,55,0.5,3238,27.6,16899,1244,15655,2,27.4,19722,11504,8218,18.7,32,-2823,-4.6,54.8,0,2523,2523,9095
1995,53,c) 2,7892,8017,54295,56768,318,3.6,1731,19.7,12241,1353,10888,2.4,21.6,17186,9575,7611,16.9,30.3,-4945,-8.7,43.2,0,1373,1373,8239
1995,53,d) 3,6906,7148,55113,56527,266,3.5,1254,16.3,10711,1244,9467,2.2,18.9,13538,6729,6809,11.9,23.9,-2827,-5,37.8,0,995,996,5458
1995,53,e) 4,6138,6356,51823,52823,259,3.9,904,13.5,9120,1496,7624,2.8,17.3,11119,4465,6654,8.5,21,-1999,-3.7,34.6,0,697,700,3577
1995,53,f) 5,6357,6620,56044,57283,289,4.2,922,13.3,10230,1424,8806,2.5,17.9,12707,5455,7252,9.5,22.2,-2477,-4.3,35.8,0,659,660,3547
1995,53,g) 6 to 10,20208,21876,249606,251552,873,3.9,2267,10,36618,7340,29278,2.9,14.6,40510,14951,25559,5.9,16.1,-3892,-1.5,29.2,0,1632,1641,11257
1995,53,h) 11 to 15,14103,16172,221567,220606,657,4,1299,7.9,31562,7265,24297,3.3,14.3,29639,7870,21769,3.6,13.4,1923,0.9,26.8,0,861,871,5287
1995,53,i) 16 to 20,7102,9148,133539,133245,345,3.7,723,7.7,17340,3322,14018,2.5,13,16752,4894,11858,3.7,12.6,588,0.4,25.2,0,405,413,2073
1995,53,l) Left Censored,17900,32884,962113,960663,1678,5,2353,7.1,108228,31256,76972,3.3,11.3,105328,32411,72917,3.4,11,2900,0.3,22,0,786,835,7937
1995,54,a) 0,2950,2970,15460,7756,2954,198.9,0,0,15408,15408,0,198.7,198.7,0,0,0,0,0,15408,198.7,0,0,,,
1995,54,b) 1,2078,2101,12753,12747,17,0.7,562,23.4,3744,295,3449,2.3,29.4,3732,2359,1373,18.5,29.3,12,0.1,58.6,0,472,472,2083
1995,54,c) 2,1808,1817,11549,11587,65,3.3,342,17.4,2993,442,2551,3.8,25.8,3069,1866,1203,16.1,26.5,-76,-0.7,51.6,0,275,275,1442
1995,54,d) 3,1539,1577,11475,11263,54,3.3,199,12,2398,381,2017,3.4,21.3,1974,775,1199,6.9,17.5,424,3.8,35,0,158,158,664
1995,54,e) 4,1406,1512,15868,16229,37,2.3,202,12.6,2435,275,2160,1.7,15,3156,1128,2028,7,19.4,-721,-4.4,30,0,146,146,780
1995,54,f) 5,1346,1366,11767,11430,48,3.4,171,12,2922,445,2477,3.9,25.6,2247,1409,838,12.3,19.7,675,5.9,39.4,0,133,133,766
1995,54,g) 6 to 10,5451,5813,69035,68630,203,3.4,566,9.4,10075,2038,8037,3,14.7,9265,3443,5822,5,13.5,810,1.2,27,0,412,412,2313
1995,54,h) 11 to 15,3991,4405,47932,47707,122,2.7,266,5.9,5845,1038,4807,2.2,12.3,5394,1692,3702,3.5,11.3,451,1,22.6,0,180,180,1139
1995,54,i) 16 to 20,2027,2653,35874,35210,113,4.2,181,6.7,4943,953,3990,2.7,14,3615,853,2762,2.4,10.3,1328,3.7,20.6,0,107,108,460
1995,54,l) Left Censored,7454,12361,285959,285301,548,4.4,768,6.2,31609,8051,23558,2.8,11.1,30293,10711,19582,3.8,10.6,1316,0.5,21.2,0,280,282,1368
1995,55,a) 0,8921,8982,49630,24946,8932,198.9,0,0,49369,49369,0,197.9,197.9,0,0,0,0,0,49369,197.9,0,0,,,
1995,55,b) 1,6923,7000,48029,47664,40,0.5,1690,21.4,12505,1386,11119,2.9,26.2,11775,6926,4849,14.5,24.7,730,1.5,49.4,0,1317,1317,5452
1995,55,c) 2,5974,6060,43955,45510,185,2.8,1007,15.5,8872,1040,7832,2.3,19.5,11981,6797,5184,14.9,26.3,-3109,-6.8,39,0,805,805,5986
1995,55,d) 3,5042,5153,41805,42228,161,3,661,12.2,7222,781,6441,1.8,17.1,8067,3313,4754,7.8,19.1,-845,-2,34.2,0,544,545,2915
1995,55,e) 4,4780,5009,42473,42331,149,2.8,577,11,6971,1028,5943,2.4,16.5,6686,2836,3850,6.7,15.8,285,0.7,31.6,0,443,444,2056
1995,55,f) 5,4386,4626,42421,42648,139,2.9,534,11.1,6422,831,5591,1.9,15.1,6875,2929,3946,6.9,16.1,-453,-1,30.2,0,402,402,2255
1995,55,g) 6 to 10,18734,20245,245190,245047,594,2.8,1775,8.5,32909,5959,26950,2.4,13.4,32624,11440,21184,4.7,13.3,285,0.1,26.6,0,1302,1310,8336
1995,55,h) 11 to 15,12173,13696,192926,189920,381,2.7,968,6.9,26030,4710,21320,2.5,13.7,20018,7196,12822,3.8,10.5,6012,3.2,21,0,654,661,4098
1995,55,i) 16 to 20,6761,8799,135975,135488,268,3,624,6.9,16589,2592,13997,1.9,12.2,15614,4863,10751,3.6,11.5,975,0.7,23,0,349,400,2201
1995,55,l) Left Censored,23974,39104,1307132,1295659,1376,3.5,2143,5.4,125485,26260,99225,2,9.7,102539,23991,78548,1.9,7.9,22946,1.8,15.8,0,950,992,6307
1995,56,a) 0,1373,1379,5623,2832,1368,198.4,0,0,5582,,,,197.1,0,0,0,0,0,5582,197.1,0,1,,,
1995,56,b) 1,1084,1088,7701,7207,4,0.3,277,22.3,2845,,,,39.5,1856,923,933,12.8,25.8,989,13.7,51.6,1,209,209,714
1995,56,c) 2,844,855,5732,6362,22,2.4,167,18,1029,94,935,1.5,16.2,2288,1309,979,20.6,36,-1259,-19.8,32.4,0,127,127,681
1995,56,d) 3,679,683,4043,4213,15,2.1,108,14.8,630,41,589,1,15,970,469,501,11.1,23,-340,-8,30,0,84,84,359
1995,56,e) 4,633,641,3993,3927,16,2.4,60,8.9,786,46,740,1.2,20,654,269,385,6.9,16.7,132,3.3,33.4,0,48,48,238
1995,56,f) 5,538,546,3646,3757,22,3.8,77,13.3,589,50,539,1.3,15.7,811,399,412,10.6,21.6,-222,-5.9,31.4,0,62,62,350
1995,56,g) 6 to 10,2159,2271,20518,20655,89,3.8,223,9.5,2604,342,2262,1.7,12.6,2878,1117,1761,5.4,13.9,-274,-1.3,25.2,0,157,157,775
1995,56,h) 11 to 15,1851,2082,17516,17945,72,3.4,164,7.7,2169,457,1712,2.5,12.1,3026,643,2383,3.6,16.9,-857,-4.8,24.2,0,115,115,426
1995,56,i) 16 to 20,1026,1236,14958,14734,33,2.6,93,7.3,1994,193,1801,1.3,13.5,1546,380,1166,2.6,10.5,448,3,21,0,60,61,240
1995,56,l) Left Censored,2491,3910,68754,68471,161,4.1,231,5.9,8107,2120,5987,3.1,11.8,7540,2378,5162,3.5,11,567,0.8,22,0,93,93,415
1996,01,a) 0,7835,7877,41130,20682,7810,198.3,0,0,40896,40896,0,197.7,197.7,0,0,0,0,0,40896,197.7,0,0,,,
1996,01,b) 1,5872,5927,44088,44685,30,0.4,1769,25.7,12840,2440,10400,5.5,28.7,14033,8259,5774,18.5,31.4,-1193,-2.7,57.4,0,1490,1490,7361
1996,01,c) 2,4975,5064,46009,47288,160,2.9,1062,19.2,10873,1259,9614,2.7,23,13431,7475,5956,15.8,28.4,-2558,-5.4,46,0,891,891,6737
1996,01,d) 3,4009,4073,34401,35579,126,2.9,668,15.3,5819,545,5274,1.5,16.4,8175,3918,4257,11,23,-2356,-6.6,32.8,0,545,545,3098
1996,01,e) 4,3493,3585,35396,35810,123,3.3,480,12.8,5985,813,5172,2.3,16.7,6812,2618,4194,7.3,19,-827,-2.3,33.4,0,378,378,1774
1996,01,f) 5,3074,3275,29917,30052,105,3.1,392,11.4,5201,687,4514,2.3,17.3,5471,2167,3304,7.2,18.2,-270,-0.9,34.6,0,312,312,1792
1996,01,g) 6 to 10,12865,13899,185514,187094,424,2.9,1509,10.5,25920,4131,21789,2.2,13.9,29080,9778,19302,5.2,15.5,-3160,-1.6,27.8,0,1113,1113,6821
1996,01,h) 11 to 15,9171,10480,144557,144275,314,2.9,739,6.9,18116,2843,15273,2,12.6,17552,5513,12039,3.8,12.2,564,0.4,24.4,0,498,498,3405
1996,01,i) 16 to 20,5778,7917,132127,131841,309,3.9,509,6.4,17767,3450,14317,2.6,13.5,17195,4527,12668,3.4,13,572,0.5,26,0,305,305,1930
1996,01,l) Left Censored,13175,25562,836474,840535,1320,5.1,1645,6.4,95060,32702,62358,3.9,11.3,103182,27877,75305,3.3,12.3,-8122,-1,22.6,0,586,586,4160
1996,02,a) 0,1349,1359,5780,2920,1330,195.7,0,0,5721,5721,0,195.9,195.9,0,0,0,0,0,5721,195.9,0,0,,,
1996,02,b) 1,1029,1042,5750,5843,9,0.7,323,26.5,1621,166,1455,2.8,27.7,1806,1097,709,18.8,30.9,-185,-3.2,55.4,0,229,229,793
1996,02,c) 2,840,850,5528,5431,35,3.8,152,16.7,1565,532,1033,9.8,28.8,1371,581,790,10.7,25.2,194,3.6,50.4,0,124,124,485
1996,02,d) 3,748,766,4569,5041,39,4.8,115,14.2,988,186,802,3.7,19.6,1932,1280,652,25.4,38.3,-944,-18.7,39.2,0,84,84,384
1996,02,e) 4,571,608,4048,4219,24,3.7,116,17.8,898,67,831,1.6,21.3,1239,591,648,14,29.4,-341,-8.1,42.6,0,81,81,380
1996,02,f) 5,616,636,4368,4507,28,4.2,80,12.1,667,90,577,2,14.8,944,488,456,10.8,20.9,-277,-6.1,29.6,0,54,54,447
1996,02,g) 6 to 10,2275,2411,24111,24365,89,3.6,270,10.8,3116,323,2793,1.3,12.8,3623,1087,2536,4.5,14.9,-507,-2.1,25.6,0,179,179,781
1996,02,h) 11 to 15,1847,2091,21142,21242,77,3.6,146,6.9,3175,296,2879,1.4,14.9,3375,860,2515,4,15.9,-200,-1,29.8,0,89,89,458
1996,02,i) 16 to 20,1087,1415,18317,18267,61,4.3,95,6.6,2403,491,1912,2.7,13.2,2303,705,1598,3.9,12.6,100,0.6,25.2,0,47,47,288
1996,02,l) Left Censored,1766,3263,83484,83799,167,5.1,225,6.8,10118,1842,8276,2.2,12.1,10747,4180,6567,5,12.8,-629,-0.7,24.2,0,43,43,425
1996,04,a) 0,9488,9557,56853,28581,9470,198.2,0,0,56544,56544,0,197.8,197.8,0,0,0,0,0,56544,197.8,0,0,,,
1996,04,b) 1,7106,7211,59382,58450,66,0.8,2160,25.8,18609,2142,16467,3.7,31.8,16745,9260,7485,15.8,28.6,1864,3.2,57.2,0,1781,1781,8159
1996,04,c) 2,5822,5998,52309,53611,244,3.8,1191,18.3,12001,1776,10225,3.3,22.4,14605,7702,6903,14.4,27.2,-2604,-4.8,44.8,0,979,979,6019
1996,04,d) 3,4512,4664,43881,44702,231,4.7,780,15.8,9167,1995,7172,4.5,20.5,10808,4492,6316,10,24.2,-1641,-3.7,41,0,628,628,3735
1996,04,e) 4,3872,4060,53570,53109,169,3.9,602,14,12060,4240,7820,8,22.7,11138,5460,5678,10.3,21,922,1.7,42,0,464,464,4428
1996,04,f) 5,3561,3727,38331,38174,131,3.3,517,13.2,8279,1319,6960,3.5,21.7,7965,3869,4096,10.1,20.9,314,0.8,41.8,0,387,387,3201
1996,04,g) 6 to 10,14128,15423,211689,211794,580,3.6,1697,10.6,34440,6701,27739,3.2,16.3,34649,14100,20549,6.7,16.4,-209,-0.1,32.6,0,1183,1183,9068
1996,04,h) 11 to 15,9531,11244,183149,182072,474,4.1,983,8.6,26749,5884,20865,3.2,14.7,24595,8743,15852,4.8,13.5,2154,1.2,27,0,553,553,3735
1996,04,i) 16 to 20,5332,7063,131774,130308,366,5.1,556,7.8,19532,5676,13856,4.4,15,16600,5256,11344,4,12.7,2932,2.3,25.4,0,316,316,2405
1996,04,l) Left Censored,9021,20575,729182,718475,1447,7,1512,7.3,99158,29711,69447,4.1,13.8,77745,21088,56657,2.9,10.8,21413,3,21.6,0,360,361,2340
1996,05,a) 0,4944,5010,26585,13400,4963,198.1,0,0,26370,26370,0,196.8,196.8,0,0,0,0,0,26370,196.8,0,0,,,
1996,05,b) 1,3933,3981,27547,27656,33,0.7,1160,25.2,8000,448,7552,1.6,28.9,8217,4958,3259,17.9,29.7,-217,-0.8,57.8,0,984,984,4400
1996,05,c) 2,3178,3234,23038,24176,111,3.2,620,17.7,4455,737,3718,3,18.4,6730,3224,3506,13.3,27.8,-2275,-9.4,36.8,0,545,545,2866
1996,05,d) 3,2671,2706,19550,20561,69,2.4,485,16.6,3298,319,2979,1.6,16,5319,2641,2678,12.8,25.9,-2021,-9.9,32,0,395,395,2184
1996,05,e) 4,2212,2309,20135,20471,99,4.1,359,14.7,3702,748,2954,3.7,18.1,4374,1949,2425,9.5,21.4,-672,-3.3,36.2,0,288,288,1606
1996,05,f) 5,1936,2059,17597,17960,71,3.3,253,11.8,2734,399,2335,2.2,15.2,3459,1521,1938,8.5,19.3,-725,-4.1,30.4,0,196,196,1204
1996,05,g) 6 to 10,7710,8236,85714,86523,250,2.9,872,10.2,12447,1950,10497,2.3,14.4,14064,5496,8568,6.4,16.3,-1617,-1.9,28.8,0,658,658,3688
1996,05,h) 11 to 15,5972,6545,94585,95543,190,2.8,531,7.9,11968,1512,10456,1.6,12.5,13885,3394,10491,3.6,14.5,-1917,-2,25,0,359,360,1943
1996,05,i) 16 to 20,4091,4966,72234,73137,175,3.4,405,8,8345,2917,5428,4,11.4,10151,2999,7152,4.1,13.9,-1806,-2.5,22.8,0,223,223,1476
1996,05,l) Left Censored,8635,15271,503877,503042,734,4.8,989,6.4,50428,11690,38738,2.3,10,48759,11127,37632,2.2,9.7,1669,0.3,19.4,0,358,358,2356
1996,06,a) 0,60157,60643,369123,185539,60148,198.4,0,0,367169,367169,0,197.9,197.9,0,0,0,0,0,367169,197.9,0,0,,,
1996,06,b) 1,44207,44725,374833,366324,291,0.6,12441,24.2,121015,4650,116365,1.3,33,103996,57585,46411,15.7,28.4,17019,4.6,56.8,0,9887,9887,47946
1996,06,c) 2,35818,36601,337591,346083,1336,3.4,7410,18.6,74383,8217,66166,2.4,21.5,91367,47905,43462,13.8,26.4,-16984,-4.9,43,0,5936,5936,40409
1996,06,d) 3,29436,30143,299526,303814,1280,4,5416,16.8,67527,9101,58426,3,22.2,76103,37959,38144,12.5,25,-8576,-2.8,44.4,0,4391,4391,32110
1996,06,e) 4,27079,28405,284115,291701,1214,4,4478,14.9,53516,9542,43974,3.3,18.3,68688,30145,38543,10.3,23.5,-15172,-5.2,36.6,0,3465,3465,23421
1996,06,f) 5,26157,27502,273064,276888,1263,4.4,3933,13.6,52131,9075,43056,3.3,18.8,59778,27161,32617,9.8,21.6,-7647,-2.8,37.6,0,2963,2963,21221
1996,06,g) 6 to 10,110228,119200,1454027,1477612,4826,3.9,13888,11.2,225774,35711,190063,2.4,15.3,272944,100885,172059,6.8,18.5,-47170,-3.2,30.6,0,9667,9669,63908
1996,06,h) 11 to 15,75298,86728,1316952,1333480,3043,3.4,8170,9.1,178269,33998,144271,2.5,13.4,211326,69111,142215,5.2,15.8,-33057,-2.4,26.8,0,5045,5046,34148
1996,06,i) 16 to 20,47407,61714,1036136,1057046,2193,3.5,4838,7.7,133184,28910,104274,2.7,12.6,175004,78835,96169,7.5,16.6,-41820,-4,25.2,0,2712,2713,14729
1996,06,l) Left Censored,78130,160480,5208002,5229057,7850,4.8,12961,7.9,664110,178256,485854,3.4,12.7,706220,221973,484247,4.2,13.5,-42110,-0.8,25.4,0,4189,4196,30666
1996,08,a) 0,11275,11338,59407,29827,11264,198.7,0,0,59160,59160,0,198.3,198.3,0,0,0,0,0,59160,198.3,0,0,,,
1996,08,b) 1,8653,8784,60730,61079,86,0.8,2546,25.1,18082,1547,16535,2.5,29.6,18779,11376,7403,18.6,30.7,-697,-1.1,59.2,0,2014,2014,9535
1996,08,c) 2,7337,7468,53190,55450,255,3.2,1420,17.6,11397,1546,9851,2.8,20.6,15917,7741,8176,14,28.7,-4520,-8.1,41.2,0,1152,1152,6522
1996,08,d) 3,5791,5860,45638,46653,187,3,964,15.4,8582,1000,7582,2.1,18.4,10612,4517,6095,9.7,22.7,-2030,-4.3,36.8,0,775,775,3720
1996,08,e) 4,4784,4889,42044,43421,165,3.2,701,13.6,7050,884,6166,2,16.2,9803,3840,5963,8.8,22.6,-2753,-6.4,32.4,0,548,548,2975
1996,08,f) 5,4347,4536,39396,40117,188,4,610,12.8,7679,1562,6117,3.9,19.1,9121,4111,5010,10.2,22.7,-1442,-3.6,38.2,0,429,429,2796
1996,08,g) 6 to 10,15911,17064,198787,199510,641,3.6,1778,10.1,32076,7574,24502,3.8,16.1,33521,12243,21278,6.1,16.8,-1445,-0.7,32.2,0,1249,1249,8433
1996,08,h) 11 to 15,11104,12660,184280,185829,451,3.5,1113,8.6,25990,4855,21135,2.6,14,29087,10490,18597,5.6,15.7,-3097,-1.7,28,0,639,639,5077
1996,08,i) 16 to 20,6795,8695,145171,142821,399,4.5,676,7.6,24842,7664,17178,5.4,17.4,20142,5530,14612,3.9,14.1,4700,3.3,28.2,0,364,364,2276
1996,08,l) Left Censored,12177,23265,744756,743708,1439,6.1,1949,8.3,110865,43798,67067,5.9,14.9,108769,43328,65441,5.8,14.6,2096,0.3,29.2,0,481,482,3435
1996,09,a) 0,5562,5600,34174,17169,5543,198,0,0,34011,34011,0,198.1,198.1,0,0,0,0,0,34011,198.1,0,0,,,
1996,09,b) 1,4756,4811,32151,31985,24,0.4,1078,20,8647,419,8228,1.3,27,8315,4802,3513,15,26,332,1,52,0,818,818,4088
1996,09,c) 2,3954,3997,29717,30805,118,2.7,706,16.4,5416,594,4822,1.9,17.6,7591,3000,4591,9.7,24.6,-2175,-7,35.2,0,585,585,2653
1996,09,d) 3,3479,3522,30244,30175,121,3.3,466,12.6,5998,892,5106,3,19.9,5860,2468,3392,8.2,19.4,138,0.5,38.8,0,372,372,2149
1996,09,e) 4,3005,3102,25853,26896,84,2.6,375,11.5,3808,369,3439,1.4,14.2,5894,2346,3548,8.7,21.9,-2086,-7.7,28.4,0,285,285,1944
1996,09,f) 5,2721,2835,25259,25463,95,3.2,373,12.5,4097,507,3590,2,16.1,4505,1794,2711,7,17.7,-408,-1.6,32.2,0,276,276,1306
1996,09,g) 6 to 10,13917,14643,156950,156984,538,3.6,1497,9.9,23838,5348,18490,3.4,15.2,23906,9053,14853,5.8,15.2,-68,0,30.4,0,1038,1038,5728
1996,09,h) 11 to 15,9360,10218,120394,122629,277,2.6,846,8.1,14656,3365,11291,2.7,12,19126,7077,12049,5.8,15.6,-4470,-3.6,24,0,546,547,4247
1996,09,i) 16 to 20,5772,6919,96055,95479,207,2.9,491,7,12885,2655,10230,2.8,13.5,11732,4067,7665,4.3,12.3,1153,1.2,24.6,0,287,287,1834
1996,09,l) Left Censored,16501,25762,861405,865990,1139,4.4,1782,6.8,91107,33327,57780,3.8,10.5,100276,26617,73659,3.1,11.6,-9169,-1.1,21,0,645,645,4948
1996,10,a) 0,1559,1562,8690,4390,1542,197.4,0,0,8601,8601,0,195.9,195.9,0,0,0,0,0,8601,195.9,0,0,,,
1996,10,b) 1,1304,1321,8839,8908,8,0.5,284,19.3,1879,73,1806,0.8,21.1,2017,1082,935,12.1,22.6,-138,-1.5,42.2,0,219,219,826
1996,10,c) 2,1085,1099,8352,8708,27,2.3,184,15.6,2360,639,1721,7.3,27.1,3071,1289,1782,14.8,35.3,-711,-8.2,54.2,0,147,147,1182
1996,10,d) 3,918,922,6012,6212,31,3.2,137,14.1,1155,358,797,5.8,18.6,1555,522,1033,8.4,25,-400,-6.4,37.2,0,114,114,451
1996,10,e) 4,761,787,6015,5924,28,3.4,100,12.2,1242,197,1045,3.3,21,1060,412,648,7,17.9,182,3.1,35.8,0,82,82,355
1996,10,f) 5,673,695,5946,6032,16,2.2,115,15.6,1127,47,1080,0.8,18.7,1299,654,645,10.8,21.5,-172,-2.8,37.4,0,85,85,465
1996,10,g) 6 to 10,2888,3032,30780,31084,97,3.1,301,9.6,4552,1141,3411,3.7,14.6,5159,1510,3649,4.9,16.6,-607,-2,29.2,0,205,205,1024
1996,10,h) 11 to 15,1801,2021,26258,26324,75,3.6,176,8.5,3626,749,2877,2.8,13.8,3757,1387,2370,5.3,14.3,-131,-0.5,27.6,0,112,112,928
1996,10,i) 16 to 20,1141,1412,34326,34124,60,4.2,107,7.5,4184,413,3771,1.2,12.3,3780,1166,2614,3.4,11.1,404,1.2,22.2,0,54,54,336
1996,10,l) Left Censored,3437,5682,188538,191901,327,5.7,450,7.8,19618,6113,13505,3.2,10.2,26343,9078,17265,4.7,13.7,-6725,-3.5,20.4,0,100,100,1366
1996,11,a) 0,1129,1134,7488,3752,1123,198.1,0,0,7472,7472,0,199.1,199.1,0,0,0,0,0,7472,199.1,0,0,,,
1996,11,b) 1,894,922,8358,8208,18,1.8,190,18.7,2270,358,1912,4.4,27.7,1970,890,1080,10.8,24,300,3.7,48,0,140,140,735
1996,11,c) 2,792,815,6582,6933,20,2.3,116,13.4,1009,94,915,1.4,14.6,1711,759,952,10.9,24.7,-702,-10.1,29.2,0,93,93,592
1996,11,d) 3,659,667,6356,6651,31,4.4,105,14.9,893,256,637,3.8,13.4,1482,566,916,8.5,22.3,-589,-8.9,26.8,0,89,89,527
1996,11,e) 4,655,718,11699,19876,32,4.3,77,10.4,1016,308,708,1.5,5.1,17370,648,16722,3.3,87.4,-16354,-82.3,10.2,0,51,51,588
1996,11,f) 5,582,598,6005,6129,34,5.5,75,12.1,1035,178,857,2.9,16.9,1283,537,746,8.8,20.9,-248,-4,33.8,0,58,58,418
1996,11,g) 6 to 10,2546,2706,35635,36466,95,3.4,305,10.8,4914,748,4166,2.1,13.5,6575,2289,4286,6.3,18,-1661,-4.5,27,0,197,197,1250
1996,11,h) 11 to 15,2129,2354,35860,36601,97,4,192,8,4482,980,3502,2.7,12.2,5963,1787,4176,4.9,16.3,-1481,-4.1,24.4,0,107,107,471
1996,11,i) 16 to 20,1315,1601,51059,50829,65,4,105,6.5,4204,994,3210,2,8.3,3744,735,3009,1.4,7.4,460,0.9,14.8,0,64,64,357
1996,11,l) Left Censored,4196,6371,219461,222445,329,5.1,524,8.1,21418,5342,16076,2.4,9.6,27386,8595,18791,3.9,12.3,-5968,-2.7,19.2,0,145,145,847
1996,12,a) 0,37439,37647,200977,101078,37344,198.4,0,0,199799,199799,0,197.7,197.7,0,0,0,0,0,199799,197.7,0,0,,,
1996,12,b) 1,28143,28417,187129,191823,151,0.5,8471,25.7,53817,5649,48168,2.9,28.1,63204,37227,25977,19.4,32.9,-9387,-4.8,56.2,0,6959,6959,31775
1996,12,c) 2,23719,24122,174517,185839,889,3.4,5297,20,41670,8232,33438,4.4,22.4,64313,37271,27042,20.1,34.6,-22643,-12.2,44.8,0,4465,4465,32747
1996,12,d) 3,20017,20424,187423,187902,727,3.3,3726,17,41698,5684,36014,3,22.2,42655,20908,21747,11.1,22.7,-957,-0.5,44.4,0,3054,3054,17494
1996,12,e) 4,17121,17664,153831,160512,591,3.1,2881,15.3,29962,7199,22763,4.5,18.7,43323,19210,24113,12,27,-13361,-8.3,37.4,0,2350,2350,16220
1996,12,f) 5,15080,15625,142794,145702,465,2.8,2223,13.4,25783,2877,22906,2,17.7,31599,14984,16615,10.3,21.7,-5816,-4,35.4,0,1774,1775,11005
1996,12,g) 6 to 10,58689,63268,717227,727445,2046,3.1,7122,10.8,118303,22017,96286,3,16.3,138739,52988,85751,7.3,19.1,-20436,-2.8,32.6,0,5300,5300,37675
1996,12,h) 11 to 15,35655,40871,570077,577727,1432,3.4,3878,9.2,92108,18324,73784,3.2,15.9,107407,32273,75134,5.6,18.6,-15299,-2.7,31.8,0,2516,2516,18730
1996,12,i) 16 to 20,19440,25572,389178,387884,1007,3.9,2134,8.2,57854,16894,40960,4.4,14.9,55266,20631,34635,5.3,14.2,2588,0.7,28.4,0,1163,1163,7387
1996,12,l) Left Censored,33658,79283,2544411,2526739,4686,5.8,6432,8,363365,137306,226059,5.4,14.4,328021,105437,222584,4.2,13,35344,1.4,26,0,1646,1646,13679
1996,13,a) 0,16174,16298,98115,49233,16176,198.5,0,0,97764,97764,0,198.6,198.6,0,0,0,0,0,97764,198.6,0,0,,,
1996,13,b) 1,11823,12076,96841,97833,110,0.8,3488,25.1,28220,2081,26139,2.1,28.8,30204,18338,11866,18.7,30.9,-1984,-2.1,57.6,0,2811,2811,14785
1996,13,c) 2,9778,10004,87329,88568,309,2.8,2041,18.7,21560,2835,18725,3.2,24.3,24037,12873,11164,14.5,27.1,-2477,-2.8,48.6,0,1671,1671,11247
1996,13,d) 3,7992,8120,73250,75641,320,3.7,1406,16.2,15128,2002,13126,2.6,20,19910,10039,9871,13.3,26.3,-4782,-6.3,40,0,1154,1154,7898
1996,13,e) 4,6735,6990,67629,69420,261,3.5,1012,13.7,13281,3227,10054,4.6,19.1,16862,8633,8229,12.4,24.3,-3581,-5.2,38.2,0,794,794,6762
1996,13,f) 5,5979,6290,67966,67374,263,4,775,11.8,13139,2869,10270,4.3,19.5,11955,5274,6681,7.8,17.7,1184,1.8,35.4,0,592,592,4075
1996,13,g) 6 to 10,23742,25835,337522,341646,930,3.5,2743,10.3,49930,10726,39204,3.1,14.6,58177,21858,36319,6.4,17,-8247,-2.4,29.2,0,1941,1941,14560
1996,13,h) 11 to 15,16150,18531,268793,263177,706,3.7,1455,7.7,50559,8551,42008,3.2,19.2,39326,12870,26456,4.9,14.9,11233,4.3,29.8,0,923,923,6008
1996,13,i) 16 to 20,9317,12281,213192,212856,538,4.3,955,7.6,30146,7795,22351,3.7,14.2,29474,9505,19969,4.5,13.8,672,0.4,27.6,0,506,506,3890
1996,13,l) Left Censored,20619,45158,1637842,1638085,2819,6.2,3630,8,215587,71671,143916,4.4,13.2,216072,75544,140528,4.6,13.2,-485,0,26.4,0,879,879,6953
1996,15,a) 0,1977,2022,13271,6860,1996,197.4,0,0,12822,,,,186.9,0,0,0,0,0,12822,186.9,0,1,,,
1996,15,b) 1,1475,1493,11761,11266,12,0.7,436,25.2,3962,,,,35.2,2971,1831,1140,16.3,26.4,991,8.8,52.8,1,344,344,1487
1996,15,c) 2,1246,1268,15937,16549,33,2.4,275,19.7,1822,184,1638,1.1,11,3045,1075,1970,6.5,18.4,-1223,-7.4,22,0,225,225,908
1996,15,d) 3,1086,1113,8766,9284,42,3.5,217,18,1085,138,947,1.5,11.7,2121,950,1171,10.2,22.8,-1036,-11.1,23.4,0,163,163,699
1996,15,e) 4,1005,1040,11129,11633,28,2.5,174,15.6,1521,139,1382,1.2,13.1,2529,1186,1343,10.2,21.7,-1008,-8.6,26.2,0,133,133,782
1996,15,f) 5,1035,1079,11930,12211,36,3.2,139,12.3,1415,191,1224,1.6,11.6,1977,807,1170,6.6,16.2,-562,-4.6,23.2,0,106,106,634
1996,15,g) 6 to 10,4046,4494,50463,52161,155,3.3,548,11.7,6157,1286,4871,2.5,11.8,9553,3022,6531,5.8,18.3,-3396,-6.5,23.6,0,381,381,2009
1996,15,h) 11 to 15,3110,3621,42938,43917,104,2.8,273,7.4,4980,1323,3657,3,11.3,6937,2300,4637,5.2,15.8,-1957,-4.5,22.6,0,173,173,972
1996,15,i) 16 to 20,2066,2822,40316,41846,63,2.2,159,5.5,3452,780,2672,1.9,8.2,6512,1401,5111,3.3,15.6,-3060,-7.4,16.4,0,86,86,418
1996,15,l) Left Censored,4453,8120,215290,216765,332,4,614,7.4,23715,9307,14408,4.3,10.9,26664,7993,18671,3.7,12.3,-2949,-1.4,21.8,0,165,165,1163
1996,16,a) 0,3169,3185,15602,7844,3151,197.9,0,0,15517,15517,0,197.8,197.8,0,0,0,0,0,15517,197.8,0,0,,,
1996,16,b) 1,2326,2341,13320,13530,10,0.4,641,23.8,3614,159,3455,1.2,26.7,4034,2148,1886,15.9,29.8,-420,-3.1,53.4,0,499,499,1778
1996,16,c) 2,1936,1965,13171,13720,77,3.6,414,19.3,2894,313,2581,2.3,21.1,3991,2360,1631,17.2,29.1,-1097,-8,42.2,0,324,324,2097
1996,16,d) 3,1456,1475,10603,11174,49,3.1,282,17.6,1848,171,1677,1.5,16.5,2990,1408,1582,12.6,26.8,-1142,-10.3,33,0,215,215,1205
1996,16,e) 4,1348,1380,9794,10266,66,4.6,178,12.3,1558,297,1261,2.9,15.2,2502,872,1630,8.5,24.4,-944,-9.2,30.4,0,142,142,724
1996,16,f) 5,1116,1149,8633,8971,33,2.7,139,11.6,1504,312,1192,3.5,16.8,2179,921,1258,10.3,24.3,-675,-7.5,33.6,0,110,110,795
1996,16,g) 6 to 10,4342,4633,49032,50247,179,3.7,477,10,6633,1393,5240,2.8,13.2,9062,3424,5638,6.8,18,-2429,-4.8,26.4,0,361,361,2812
1996,16,h) 11 to 15,2980,3340,40775,40799,128,3.8,267,7.8,6072,1485,4587,3.6,14.9,6120,2105,4015,5.2,15,-48,-0.1,29.8,0,169,169,1498
1996,16,i) 16 to 20,2068,2472,43082,41394,125,5,209,8.3,7649,2158,5491,5.2,18.5,4273,1090,3183,2.6,10.3,3376,8.2,20.6,0,126,126,506
1996,16,l) Left Censored,4062,7089,174835,175184,341,4.8,479,6.7,22765,5305,17460,3,13,23463,7578,15885,4.3,13.4,-698,-0.4,26,0,180,180,1067
1996,17,a) 0,20517,20601,117204,58948,20380,197.9,0,0,116512,116512,0,197.7,197.7,0,0,0,0,0,116512,197.7,0,0,,,
1996,17,b) 1,16127,16329,122153,120693,133,0.7,3991,21.6,36303,2466,33837,2,30.1,33383,16827,16556,13.9,27.7,2920,2.4,55.4,0,3088,3088,12966
1996,17,c) 2,13649,13838,113729,118720,394,2.6,2440,16.4,21193,2520,18673,2.1,17.9,31174,14391,16783,12.1,26.3,-9981,-8.4,35.8,0,1922,1922,11649
1996,17,d) 3,11877,12079,116278,113564,411,3.2,1715,13.4,26968,2602,24366,2.3,23.7,21541,9202,12339,8.1,19,5427,4.7,38,0,1360,1360,7888
1996,17,e) 4,10475,10904,105225,106059,325,2.8,1382,12.1,17877,3142,14735,3,16.9,19545,8234,11311,7.8,18.4,-1668,-1.5,33.8,0,1058,1058,5819
1996,17,f) 5,9689,10260,96022,98479,353,3.3,1153,10.8,14242,2491,11751,2.5,14.5,19155,6212,12943,6.3,19.5,-4913,-5,29,0,897,897,4777
1996,17,g) 6 to 10,40423,43121,533874,543311,1345,3,4155,9.3,69427,13149,56278,2.4,12.8,88301,28467,59834,5.2,16.3,-18874,-3.5,25.6,0,2959,2959,20079
1996,17,h) 11 to 15,28793,32248,499383,498327,904,2.7,2482,7.5,62824,10785,52039,2.2,12.6,60712,18857,41855,3.8,12.2,2112,0.4,24.4,0,1657,1657,9402
1996,17,i) 16 to 20,18051,22585,354634,361776,713,3.1,1703,7.4,37716,8251,29465,2.3,10.4,51999,13171,38828,3.6,14.4,-14283,-4,20.8,0,934,934,5675
1996,17,l) Left Censored,46315,81222,2873138,2882549,3899,4.7,6059,7.4,324783,100230,224553,3.5,11.3,343606,91181,252425,3.2,11.9,-18823,-0.6,22.6,0,2065,2066,15184
1996,18,a) 0,9907,9993,56206,28223,9919,198.5,0,0,55966,55966,0,198.3,198.3,0,0,0,0,0,55966,198.3,0,0,,,
1996,18,b) 1,7777,7870,55479,56283,55,0.6,2083,23.2,14237,1079,13158,1.9,25.3,15844,8451,7393,15,28.2,-1607,-2.9,50.6,0,1703,1703,7002
1996,18,c) 2,6562,6679,53122,54236,178,2.5,1218,16.9,11277,1788,9489,3.3,20.8,13505,6619,6886,12.2,24.9,-2228,-4.1,41.6,0,999,999,5301
1996,18,d) 3,5613,5718,43606,44797,217,3.6,863,14.3,8074,1571,6503,3.5,18,10456,4974,5482,11.1,23.3,-2382,-5.3,36,0,710,710,4286
1996,18,e) 4,4923,5158,51734,52200,145,2.7,651,12,9670,1914,7756,3.7,18.5,10602,3291,7311,6.3,20.3,-932,-1.8,37,0,507,507,2685
1996,18,f) 5,4652,4918,46755,47221,135,2.6,567,11,7236,1198,6038,2.5,15.3,8168,3234,4934,6.8,17.3,-932,-2,30.6,0,451,451,2440
1996,18,g) 6 to 10,18573,20360,266913,269666,648,3.1,1980,9.4,36645,7647,28998,2.8,13.6,42151,14150,28001,5.2,15.6,-5506,-2,27.2,0,1484,1485,9188
1996,18,h) 11 to 15,13515,15342,207274,209442,481,3.1,1149,7.3,25595,5791,19804,2.8,12.2,29930,9773,20157,4.7,14.3,-4335,-2.1,24.4,0,718,718,5160
1996,18,i) 16 to 20,8489,10807,186284,183354,282,2.5,818,7.4,27548,3932,23616,2.1,15,21688,6077,15611,3.3,11.8,5860,3.2,23.6,0,430,430,2666
1996,18,l) Left Censored,22066,41544,1413991,1430940,2031,4.8,2964,7.1,149253,47264,101989,3.3,10.4,183151,61062,122089,4.3,12.8,-33898,-2.4,20.8,0,962,962,10228
1996,19,a) 0,4894,4921,26196,13239,4870,197.9,0,0,25914,25914,0,195.7,195.7,0,0,0,0,0,25914,195.7,0,0,,,
1996,19,b) 1,3974,4033,26509,26394,36,0.8,928,20.5,7413,756,6657,2.9,28.1,7183,3458,3725,13.1,27.2,230,0.9,54.4,0,718,718,2518
1996,19,c) 2,3423,3470,23596,24118,117,3.2,568,15.3,4876,468,4408,1.9,20.2,5919,3269,2650,13.6,24.5,-1043,-4.3,40.4,0,454,454,2803
1996,19,d) 3,2787,2812,19933,20522,81,2.7,399,13.4,3427,423,3004,2.1,16.7,4604,2233,2371,10.9,22.4,-1177,-5.7,33.4,0,331,331,2018
1996,19,e) 4,2473,2589,22263,22771,76,2.8,379,13.8,3372,598,2774,2.6,14.8,4387,1891,2496,8.3,19.3,-1015,-4.5,29.6,0,309,309,1380
1996,19,f) 5,2357,2494,22004,21630,84,3.2,292,11.2,3852,541,3311,2.5,17.8,3103,1289,1814,6,14.3,749,3.5,28.6,0,221,221,991
1996,19,g) 6 to 10,9519,10347,127203,126775,349,3.3,957,9,18085,5623,12462,4.4,14.3,17229,5703,11526,4.5,13.6,856,0.7,27.2,0,715,715,3759
1996,19,h) 11 to 15,7748,8799,107567,107175,263,2.9,641,7.1,13137,3462,9675,3.2,12.3,12352,3985,8367,3.7,11.5,785,0.8,23,0,416,416,2203
1996,19,i) 16 to 20,5596,7329,87577,88143,184,2.5,489,6.5,9445,2127,7318,2.4,10.7,10576,3506,7070,4,12,-1131,-1.3,21.4,0,306,306,1775
1996,19,l) Left Censored,14906,24358,675712,673405,802,3.3,1439,5.8,67135,16318,50817,2.4,10,62521,15512,47009,2.3,9.3,4614,0.7,18.6,0,552,553,3527
1996,20,a) 0,5147,5180,26902,13493,5152,198.9,0,0,26819,26819,0,198.8,198.8,0,0,0,0,0,26819,198.8,0,0,,,
1996,20,b) 1,3980,4037,29263,29151,32,0.7,1078,23.4,9096,1457,7639,5,31.2,8871,5149,3722,17.7,30.4,225,0.8,60.8,0,887,887,4535
1996,20,c) 2,3304,3356,24336,25064,96,2.6,702,19.2,4820,626,4194,2.5,19.2,6275,3667,2608,14.6,25,-1455,-5.8,38.4,0,566,566,3204
1996,20,d) 3,2773,2810,22004,22522,85,2.8,431,14.4,3878,575,3303,2.6,17.2,4913,2142,2771,9.5,21.8,-1035,-4.6,34.4,0,366,366,1930
1996,20,e) 4,2473,2555,21876,22185,73,2.7,318,11.9,3554,401,3153,1.8,16,4171,1701,2470,7.7,18.8,-617,-2.8,32,0,256,256,1458
1996,20,f) 5,2190,2317,19948,19762,72,3,294,12.1,3538,354,3184,1.8,17.9,3165,1343,1822,6.8,16,373,1.9,32,0,234,234,1073
1996,20,g) 6 to 10,8980,9595,109898,110954,327,3.3,1019,10.3,14250,2801,11449,2.5,12.8,16361,6258,10103,5.6,14.7,-2111,-1.9,25.6,0,767,767,4421
1996,20,h) 11 to 15,7293,8096,89391,89837,292,3.5,599,7.3,12309,3023,9286,3.4,13.7,13201,5240,7961,5.8,14.7,-892,-1,27.4,0,405,405,3235
1996,20,i) 16 to 20,4572,5866,84527,85026,179,3,428,7.1,9629,2267,7362,2.7,11.3,10627,4238,6389,5,12.5,-998,-1.2,22.6,0,225,225,1787
1996,20,l) Left Censored,12054,20324,559097,554456,881,4.3,1202,5.9,64124,18909,45215,3.4,11.6,54842,15155,39687,2.7,9.9,9282,1.7,19.8,0,457,457,2758
1996,21,a) 0,6167,6233,41741,21062,6183,198.4,0,0,41359,41359,0,196.4,196.4,0,0,0,0,0,41359,196.4,0,0,,,
1996,21,b) 1,4950,5046,40513,40590,35,0.6,1355,23.5,11805,3448,8357,8.5,29.1,11958,6196,5762,15.3,29.5,-153,-0.4,58.2,0,1138,1138,5595
1996,21,c) 2,4042,4124,33577,34564,131,2.9,816,18.2,7068,1259,5809,3.6,20.4,9042,4816,4226,13.9,26.2,-1974,-5.8,40.8,0,675,675,4402
1996,21,d) 3,3560,3635,31742,32975,114,2.9,593,15.3,5173,665,4508,2,15.7,7639,3467,4172,10.5,23.2,-2466,-7.5,31.4,0,502,502,2864
1996,21,e) 4,3136,3256,28221,28811,90,2.6,446,13,5109,1080,4029,3.7,17.7,6288,2768,3520,9.6,21.8,-1179,-4.1,35.4,0,354,354,2346
1996,21,f) 5,2704,2810,24448,24891,85,2.9,376,12.7,4382,816,3566,3.3,17.6,5267,2416,2851,9.7,21.2,-885,-3.6,35.2,0,302,302,1849
1996,21,g) 6 to 10,11677,12663,159983,162979,380,2.9,1225,9.4,20560,4213,16347,2.6,12.6,26552,8980,17572,5.5,16.3,-5992,-3.7,25.2,0,915,915,5912
1996,21,h) 11 to 15,8454,9359,128861,131113,259,2.7,680,7.1,15966,3983,11983,3,12.2,20469,5779,14690,4.4,15.6,-4503,-3.4,24.4,0,438,438,3548
1996,21,i) 16 to 20,5019,6319,107788,108446,199,3.1,494,7.6,12240,2445,9795,2.3,11.3,13555,4305,9250,4,12.5,-1315,-1.2,22.6,0,275,275,1636
1996,21,l) Left Censored,13210,24512,748480,750426,1329,5.4,1537,6.2,82077,24712,57365,3.3,10.9,85968,22553,63415,3,11.5,-3891,-0.6,21.8,0,546,546,3645
1996,22,a) 0,7125,7143,43444,21789,7091,198.5,0,0,43310,43310,0,198.8,198.8,0,0,0,0,0,43310,198.8,0,0,,,
1996,22,b) 1,5453,5511,52188,50590,23,0.4,1461,23.2,17484,908,16576,1.8,34.6,14287,7701,6586,15.2,28.2,3197,6.4,56.4,0,1201,1201,6452
1996,22,c) 2,4811,4911,44077,46127,160,3,907,17.1,8569,990,7579,2.1,18.6,12668,6283,6385,13.6,27.5,-4099,-8.9,37.2,0,749,749,5173
1996,22,d) 3,3964,4034,39676,40564,125,2.9,613,14.3,7592,1020,6572,2.5,18.7,9368,4132,5236,10.2,23.1,-1776,-4.4,37.4,0,511,511,3785
1996,22,e) 4,3479,3623,34226,34872,112,2.9,459,12.1,5730,810,4920,2.3,16.4,7021,2886,4135,8.3,20.1,-1291,-3.7,32.8,0,356,356,2274
1996,22,f) 5,3118,3305,34590,35852,106,3.1,349,10.2,5316,1433,3883,4,14.8,7839,2277,5562,6.4,21.9,-2523,-7.1,29.6,0,264,264,1677
1996,22,g) 6 to 10,11900,12855,164287,164068,415,3.1,1161,8.8,24997,4274,20723,2.6,15.2,24558,8942,15616,5.5,15,439,0.2,30,0,882,882,6148
1996,22,h) 11 to 15,10587,12064,156592,157576,340,2.8,810,6.6,19073,2635,16438,1.7,12.1,21041,6595,14446,4.2,13.4,-1968,-1.3,24.2,0,539,539,3292
1996,22,i) 16 to 20,6517,8133,123022,123360,232,2.8,487,5.9,15004,2898,12106,2.3,12.2,15680,3478,12202,2.8,12.7,-676,-0.5,24.4,0,320,321,1546
1996,22,l) Left Censored,14332,26623,735091,732361,1173,4.4,1613,6,86590,22036,64554,3,11.8,81129,20692,60437,2.8,11.1,5461,0.7,22.2,0,516,516,3290
1996,23,a) 0,2780,2794,13266,6780,2768,198.1,0,0,12973,12973,0,191.3,191.3,0,0,0,0,0,12973,191.3,0,0,,,
1996,23,b) 1,2146,2156,10972,11122,10,0.4,538,22,2824,52,2772,0.5,25.4,3124,1720,1404,15.5,28.1,-300,-2.7,50.8,0,426,426,1435
1996,23,c) 2,1691,1710,11208,11221,58,3.2,284,15.5,2595,398,2197,3.5,23.1,2620,1306,1314,11.6,23.3,-25,-0.2,46.2,0,239,239,1195
1996,23,d) 3,1387,1408,10155,10520,40,2.6,251,16.5,1911,187,1724,1.8,18.2,2641,1610,1031,15.3,25.1,-730,-6.9,36.4,0,205,205,971
1996,23,e) 4,1169,1221,8825,9052,43,3.3,187,14.4,1360,193,1167,2.1,15,1814,750,1064,8.3,20,-454,-5,30,0,140,140,587
1996,23,f) 5,1129,1190,8668,8638,54,4.4,123,10.1,1404,274,1130,3.2,16.3,1344,466,878,5.4,15.6,60,0.7,31.2,0,104,104,365
1996,23,g) 6 to 10,5714,5978,55156,55774,215,3.5,618,10,6851,1125,5726,2,12.3,8087,2984,5103,5.4,14.5,-1236,-2.2,24.6,0,486,486,2192
1996,23,h) 11 to 15,3463,3844,44511,45621,118,3,282,7.2,5162,797,4365,1.7,11.3,7381,3253,4128,7.1,16.2,-2219,-4.9,22.6,0,195,195,2393
1996,23,i) 16 to 20,2228,2876,40667,40488,125,4.3,204,7,5094,1225,3869,3,12.6,4735,1199,3536,3,11.7,359,0.9,23.4,0,110,110,540
1996,23,l) Left Censored,5041,8171,221960,224298,376,4.5,546,6.6,18900,5749,13151,2.6,8.4,23576,5586,17990,2.5,10.5,-4676,-2.1,16.8,0,218,218,1214
1996,24,a) 0,8834,8876,49378,24826,8791,198.1,0,0,49105,49105,0,197.8,197.8,0,0,0,0,0,49105,197.8,0,0,,,
1996,24,b) 1,7203,7309,47361,47752,52,0.6,1827,22.1,13984,965,13019,2,29.3,14765,8528,6237,17.9,30.9,-781,-1.6,58.6,0,1432,1432,6546
1996,24,c) 2,5869,5992,46036,47220,191,3,1100,17,9788,1755,8033,3.7,20.7,12156,5449,6707,11.5,25.7,-2368,-5,41.4,0,903,903,4434
1996,24,d) 3,5088,5169,47257,48665,176,3.2,855,15.5,7621,961,6660,2,15.7,10436,4999,5437,10.3,21.4,-2815,-5.7,31.4,0,670,670,4290
1996,24,e) 4,4351,4565,40860,41603,180,3.7,656,13.6,7514,2194,5320,5.3,18.1,8999,4304,4695,10.3,21.6,-1485,-3.5,36.2,0,494,494,2710
1996,24,f) 5,4124,4317,42834,42928,151,3.3,554,12.2,7493,992,6501,2.3,17.5,7681,3080,4601,7.2,17.9,-188,-0.4,35,0,407,410,2462
1996,24,g) 6 to 10,18215,19341,225270,230457,636,3.2,2041,10.2,33308,8266,25042,3.6,14.5,43681,15189,28492,6.6,19,-10373,-4.5,29,0,1420,1421,10846
1996,24,h) 11 to 15,11463,13002,174199,176063,397,3,1060,8,22992,4195,18797,2.4,13.1,26720,8835,17885,5,15.2,-3728,-2.1,26.2,0,633,633,4027
1996,24,i) 16 to 20,6673,8632,140796,141962,289,3.3,577,6.6,15976,4332,11644,3.1,11.3,18307,4705,13602,3.3,12.9,-2331,-1.6,22.6,0,335,336,2427
1996,24,l) Left Censored,16753,31474,990064,1000280,1483,4.6,2421,7.6,115796,36176,79620,3.6,11.6,136228,41083,95145,4.1,13.6,-20432,-2,23.2,0,713,713,6243
1996,25,a) 0,10626,10667,57905,29269,10590,198.6,0,0,57272,57272,0,195.7,195.7,0,0,0,0,0,57272,195.7,0,0,,,
1996,25,b) 1,8808,8926,66117,63480,67,0.7,2018,20.2,20875,1195,19680,1.9,32.9,15601,8874,6727,14,24.6,5274,8.3,49.2,0,1566,1567,7258
1996,25,c) 2,7391,7462,61375,61580,194,2.4,1129,14.2,13423,1251,12172,2,21.8,13832,6620,7212,10.8,22.5,-409,-0.7,43.6,0,908,908,5620
1996,25,d) 3,5930,6010,52915,53193,189,3,844,13.3,10838,1200,9638,2.3,20.4,11394,5399,5995,10.1,21.4,-556,-1,40.8,0,703,703,4765
1996,25,e) 4,5083,5449,54945,55002,220,3.9,683,12,10456,1984,8472,3.6,19,10569,5098,5471,9.3,19.2,-113,-0.2,38,0,556,556,4320
1996,25,f) 5,4595,4793,48242,47151,175,3.5,530,10.7,9781,1789,7992,3.8,20.7,7598,3456,4142,7.3,16.1,2183,4.6,32.2,0,421,421,2839
1996,25,g) 6 to 10,23291,24872,302254,306024,849,3.3,2354,9.2,39800,6242,33558,2,13,47339,20635,26704,6.7,15.5,-7539,-2.5,26,0,1689,1689,13531
1996,25,h) 11 to 15,15978,17961,267235,268672,539,2.9,1362,7.4,32168,5094,27074,1.9,12,35042,11835,23207,4.4,13,-2874,-1,24,0,903,903,7280
1996,25,i) 16 to 20,9426,12098,231491,232421,388,3.1,937,7.6,26315,5665,20650,2.4,11.3,28175,8507,19668,3.7,12.1,-1860,-0.8,22.6,0,448,448,3343
1996,25,l) Left Censored,27935,45516,1584141,1591384,2102,4.6,3327,7.2,172946,47532,125414,3,10.9,187432,65062,122370,4.1,11.8,-14486,-0.9,21.8,0,1135,1135,8738
1996,26,a) 0,16151,16245,98670,49797,16089,198.1,0,0,97747,97747,0,196.3,196.3,0,0,0,0,0,97747,196.3,0,0,,,
1996,26,b) 1,13182,13318,102415,100298,78,0.5,2832,19.1,30288,2266,28022,2.3,30.2,26054,11893,14161,11.9,26,4234,4.2,52,0,2221,2221,9467
1996,26,c) 2,10599,10764,90799,93381,322,2.8,1719,14.9,20075,1549,18526,1.7,21.5,25238,9989,15249,10.7,27,-5163,-5.5,43,0,1372,1372,8879
1996,26,d) 3,9071,9229,79572,81610,269,2.8,1266,13,14341,2625,11716,3.2,17.6,18416,7162,11254,8.8,22.6,-4075,-5,35.2,0,1015,1015,5984
1996,26,e) 4,7912,8207,75910,78352,216,2.5,1098,12.7,11178,1143,10035,1.5,14.3,16062,6499,9563,8.3,20.5,-4884,-6.2,28.6,0,876,876,5391
1996,26,f) 5,7514,7854,70278,73027,219,2.7,937,11.4,9540,1167,8373,1.6,13.1,15037,6043,8994,8.3,20.6,-5497,-7.5,26.2,0,720,720,5061
1996,26,g) 6 to 10,31548,33937,395582,403024,1018,2.9,3199,9.1,52846,10127,42719,2.5,13.1,67730,23317,44413,5.8,16.8,-14884,-3.7,26.2,0,2384,2384,16730
1996,26,h) 11 to 15,21441,24758,356284,357290,710,2.8,1702,6.7,43914,7989,35925,2.2,12.3,45925,14459,31466,4,12.9,-2011,-0.6,24.6,0,1140,1140,9512
1996,26,i) 16 to 20,13573,17297,269704,267949,440,2.5,1176,6.7,35160,7162,27998,2.7,13.1,31649,8332,23317,3.1,11.8,3511,1.3,23.6,0,665,665,4217
1996,26,l) Left Censored,33305,61670,2156133,2171322,2737,4.4,3898,6.3,215190,51169,164021,2.4,9.9,245568,61452,184116,2.8,11.3,-30378,-1.4,19.8,0,1435,1435,11376
1996,27,a) 0,9214,9267,52280,26350,9164,197.8,0,0,51860,51860,0,196.8,196.8,0,0,0,0,0,51860,196.8,0,0,,,
1996,27,b) 1,7349,7436,51410,50929,192,2.3,1560,19,15422,4871,10551,9.6,30.3,14459,7314,7145,14.4,28.4,963,1.9,56.8,0,1157,1157,5449
1996,27,c) 2,6206,6288,47768,48682,187,2.8,1020,15.2,9484,1146,8338,2.4,19.5,11312,5612,5700,11.5,23.2,-1828,-3.7,39,0,804,804,4848
1996,27,d) 3,5227,5384,46879,47749,193,3.4,758,13.4,9224,1924,7300,4,19.3,10964,5626,5338,11.8,23,-1740,-3.7,38.6,0,613,614,5046
1996,27,e) 4,4566,4754,40046,40577,150,3,569,11.5,6988,863,6125,2.1,17.2,8049,3602,4447,8.9,19.8,-1061,-2.6,34.4,0,433,433,2694
1996,27,f) 5,4317,4546,45302,45812,139,2.9,524,11.1,7688,2215,5473,4.8,16.8,8708,3037,5671,6.6,19,-1020,-2.2,33.6,0,393,393,2319
1996,27,g) 6 to 10,16995,18311,219394,221444,576,3.1,1677,8.9,29044,4982,24062,2.2,13.1,33143,11598,21545,5.2,15,-4099,-1.9,26.2,0,1175,1175,8177
1996,27,h) 11 to 15,11824,13506,213195,213755,362,2.6,925,6.7,24570,4265,20305,2,11.5,25690,7924,17766,3.7,12,-1120,-0.5,23,0,590,591,4431
1996,27,i) 16 to 20,7885,10003,156163,156237,325,3.2,637,6.3,18207,3469,14738,2.2,11.7,18354,6008,12346,3.8,11.7,-147,0,23.4,0,353,353,2659
1996,27,l) Left Censored,19304,33088,1218285,1218986,1228,3.7,2134,6.4,128399,33610,94789,2.8,10.5,129801,28233,101568,2.3,10.6,-1402,-0.1,21,0,749,749,6165
1996,28,a) 0,4482,4547,27174,13615,4523,198.9,0,0,27118,27118,0,199.2,199.2,0,0,0,0,0,27118,199.2,0,0,,,
1996,28,b) 1,3455,3501,24037,25471,23,0.6,1012,25.1,6209,960,5249,3.8,24.4,9076,4414,4662,17.3,35.6,-2867,-11.2,48.8,0,834,834,3742
1996,28,c) 2,2874,2922,28198,29511,103,3.2,632,19.8,5050,1298,3752,4.4,17.1,7675,4065,3610,13.8,26,-2625,-8.9,34.2,0,513,513,3167
1996,28,d) 3,2374,2429,23122,24081,73,2.8,441,16.9,4172,860,3312,3.6,17.3,6090,3199,2891,13.3,25.3,-1918,-8,34.6,0,363,363,2889
1996,28,e) 4,1893,2004,18536,18740,76,3.6,308,14.5,3753,1041,2712,5.6,20,4161,1545,2616,8.2,22.2,-408,-2.2,40,0,245,245,1172
1996,28,f) 5,1779,1875,18328,18732,38,1.9,236,11.9,2658,202,2456,1.1,14.2,3465,1520,1945,8.1,18.5,-807,-4.3,28.4,0,188,188,1227
1996,28,g) 6 to 10,7058,7553,86719,88865,291,3.7,843,10.8,11816,3189,8627,3.6,13.3,16107,6677,9430,7.5,18.1,-4291,-4.8,26.6,0,619,619,4429
1996,28,h) 11 to 15,5730,6282,78188,79257,214,3.3,501,7.8,10199,1807,8392,2.3,12.9,12336,4370,7966,5.5,15.6,-2137,-2.7,25.8,0,345,345,1479
1996,28,i) 16 to 20,3770,4696,72443,70418,153,3.2,365,7.6,12857,3450,9407,4.9,18.3,8806,2605,6201,3.7,12.5,4051,5.8,25,0,208,208,1201
1996,28,l) Left Censored,8854,16120,481499,484477,801,4.9,1021,6.3,50779,16569,34210,3.4,10.5,56734,16424,40310,3.4,11.7,-5955,-1.2,21,0,390,390,2766
1996,29,a) 0,10517,10589,56251,28261,10494,198.2,0,0,55980,55980,0,198.1,198.1,0,0,0,0,0,55980,198.1,0,0,,,
1996,29,b) 1,8367,8473,55489,56897,71,0.7,2423,24.9,15162,1543,13619,2.7,26.6,17978,10614,7364,18.7,31.6,-2816,-5,53.2,0,1985,1985,9268
1996,29,c) 2,7079,7234,55163,56981,242,3.1,1400,17.9,11241,1817,9424,3.2,19.7,14877,7099,7778,12.5,26.1,-3636,-6.4,39.4,0,1162,1162,5893
1996,29,d) 3,5693,5838,47113,48911,192,3.1,1018,16.3,8592,1416,7176,2.9,17.6,12188,5756,6432,11.8,24.9,-3596,-7.3,35.2,0,819,819,4814
1996,29,e) 4,4871,5088,50326,50511,173,3.2,729,13.6,9094,2109,6985,4.2,18,9464,4096,5368,8.1,18.7,-370,-0.7,36,0,565,565,3059
1996,29,f) 5,4553,4850,43563,44255,161,3.2,554,11,6201,1098,5103,2.5,14,7585,2962,4623,6.7,17.1,-1384,-3.1,28,0,447,447,2380
1996,29,g) 6 to 10,18929,20241,224902,228763,655,3.1,2053,9.8,31890,6746,25144,2.9,13.9,39611,15919,23692,7,17.3,-7721,-3.4,27.8,0,1483,1483,11625
1996,29,h) 11 to 15,13651,15634,210385,212916,492,3.1,1143,7.2,24886,5813,19073,2.7,11.7,29947,7614,22333,3.6,14.1,-5061,-2.4,23.4,0,762,762,3915
1996,29,i) 16 to 20,8353,10705,165739,165155,341,3.1,786,7.2,22661,7267,15394,4.4,13.7,21493,5906,15587,3.6,13,1168,0.7,26,0,469,469,2692
1996,29,l) Left Censored,21202,38081,1268718,1265404,1676,4.4,2351,6.1,147907,38395,109512,3,11.7,141280,39716,101564,3.1,11.2,6627,0.5,22.4,0,864,864,5058
1996,30,a) 0,2591,2594,11903,5971,2578,198.8,0,0,11865,11865,0,198.7,198.7,0,0,0,0,0,11865,198.7,0,0,,,
1996,30,b) 1,1985,1997,11279,11348,10,0.4,542,23.7,2905,595,2310,5.2,25.6,3042,1668,1374,14.7,26.8,-137,-1.2,51.2,0,422,422,1437
1996,30,c) 2,1531,1552,9471,9627,55,3.3,299,17.8,1886,306,1580,3.2,19.6,2198,1105,1093,11.5,22.8,-312,-3.2,39.2,0,226,226,919
1996,30,d) 3,1268,1283,7615,7941,42,3.1,201,14.7,1302,147,1155,1.9,16.4,1953,1012,941,12.7,24.6,-651,-8.2,32.8,0,154,154,836
1996,30,e) 4,1148,1178,7722,7831,42,3.4,134,10.9,1221,236,985,3,15.6,1438,514,924,6.6,18.4,-217,-2.8,31.2,0,102,102,423
1996,30,f) 5,960,999,7726,7882,33,3.1,129,12.3,1124,242,882,3.1,14.3,1435,597,838,7.6,18.2,-311,-3.9,28.6,0,96,96,460
1996,30,g) 6 to 10,3777,3963,35149,35686,133,3.2,419,10.2,4337,818,3519,2.3,12.2,5411,2139,3272,6,15.2,-1074,-3,24.4,0,286,286,1472
1996,30,h) 11 to 15,2869,3142,28936,29397,92,2.8,263,8.1,3529,364,3165,1.2,12,4450,1604,2846,5.5,15.1,-921,-3.1,24,0,165,165,969
1996,30,i) 16 to 20,2081,2533,29259,29188,78,3,166,6.4,3415,446,2969,1.5,11.7,3272,903,2369,3.1,11.2,143,0.5,22.4,0,114,114,561
1996,30,l) Left Censored,3869,6137,112654,114120,227,3.6,536,8.5,10834,2464,8370,2.2,9.5,13766,4748,9018,4.2,12.1,-2932,-2.6,19,0,181,181,1184
1996,31,a) 0,3092,3104,17673,8878,3066,197.6,0,0,17591,17591,0,198.1,198.1,0,0,0,0,0,17591,198.1,0,0,,,
1996,31,b) 1,2449,2483,17417,17385,19,0.7,579,20.7,4394,562,3832,3.2,25.3,4329,2466,1863,14.2,24.9,65,0.4,49.8,0,490,490,2080
1996,31,c) 2,2097,2143,15280,16383,64,2.8,379,16.4,2685,394,2291,2.4,16.4,4891,2060,2831,12.6,29.9,-2206,-13.5,32.8,0,319,319,1809
1996,31,d) 3,1831,1869,15080,15158,56,2.9,233,11.9,2478,402,2076,2.7,16.3,2633,1088,1545,7.2,17.4,-155,-1.1,32.6,0,184,184,875
1996,31,e) 4,1592,1633,12292,12680,49,2.8,231,13.4,1959,533,1426,4.2,15.4,2735,1192,1543,9.4,21.6,-776,-6.2,30.8,0,180,180,924
1996,31,f) 5,1415,1474,11258,12150,43,2.8,169,11,1879,244,1635,2,15.5,3663,788,2875,6.5,30.1,-1784,-14.6,31,0,127,127,609
1996,31,g) 6 to 10,6036,6529,83479,83189,201,3,604,9,10534,1604,8930,1.9,12.7,9954,3592,6362,4.3,12,580,0.7,24,0,471,471,2389
1996,31,h) 11 to 15,4888,5540,70199,70433,149,2.6,465,8.2,8196,1503,6693,2.1,11.6,8664,3191,5473,4.5,12.3,-468,-0.7,23.2,0,294,294,1815
1996,31,i) 16 to 20,3315,4168,56909,56497,132,3.1,312,7.3,6700,1463,5237,2.6,11.9,5876,1820,4056,3.2,10.4,824,1.5,20.8,0,200,200,1130
1996,31,l) Left Censored,8606,13630,382972,379168,488,3.5,868,6.3,41148,11141,30007,2.9,10.9,33540,8781,24759,2.3,8.8,7608,2.1,17.6,0,352,352,1986
1996,32,a) 0,3998,4025,35713,17917,3991,198.3,0,0,35592,35592,0,198.6,198.6,0,0,0,0,0,35592,198.6,0,0,,,
1996,32,b) 1,2953,2987,29526,28936,28,0.8,949,27.2,11817,3070,8747,10.6,40.8,10637,4962,5675,17.1,36.8,1180,4,73.6,0,789,789,4207
1996,32,c) 2,2261,2306,26214,26718,84,3.3,553,21.6,6272,592,5680,2.2,23.5,7280,3633,3647,13.6,27.2,-1008,-3.7,47,0,446,446,2804
1996,32,d) 3,1711,1745,20358,20650,80,4.3,329,17.5,4336,735,3601,3.6,21,4919,2442,2477,11.8,23.8,-583,-2.8,42,0,278,278,2074
1996,32,e) 4,1418,1464,17840,17479,65,4.2,234,15.1,4240,503,3737,2.9,24.3,3518,1194,2324,6.8,20.1,722,4.2,40.2,0,187,187,990
1996,32,f) 5,1363,1423,17808,17693,67,4.5,195,13.1,3588,491,3097,2.8,20.3,3358,1658,1700,9.4,19,230,1.3,38,0,144,144,1384
1996,32,g) 6 to 10,5125,5561,81523,82255,284,5,598,10.4,14692,4087,10605,5,17.9,16155,7705,8450,9.4,19.6,-1463,-1.7,35.8,0,407,407,4884
1996,32,h) 11 to 15,3116,3722,67719,67356,147,3.8,338,8.8,10301,2549,7752,3.8,15.3,9575,2887,6688,4.3,14.2,726,1.1,28.4,0,197,197,1623
1996,32,i) 16 to 20,2129,2778,79812,79170,129,4.5,237,8.4,10628,3457,7171,4.4,13.4,9344,2933,6411,3.7,11.8,1284,1.6,23.6,0,124,124,1741
1996,32,l) Left Censored,3873,7293,327892,325366,688,9.5,634,8.7,43128,14228,28900,4.4,13.3,38076,14019,24057,4.3,11.7,5052,1.6,23.4,0,148,148,1093
1996,33,a) 0,2772,2792,14851,7462,2775,198.8,0,0,14778,14778,0,198,198,0,0,0,0,0,14778,198,0,0,,,
1996,33,b) 1,2125,2137,14389,14440,10,0.4,523,21.6,3846,147,3699,1,26.6,3948,2218,1730,15.4,27.3,-102,-0.7,53.2,0,428,428,1952
1996,33,c) 2,1748,1764,12331,12422,53,2.8,319,16.8,2592,221,2371,1.8,20.9,2773,1405,1368,11.3,22.3,-181,-1.4,41.8,0,252,252,1211
1996,33,d) 3,1417,1440,11190,11093,48,3.2,196,12.9,2392,266,2126,2.4,21.6,2198,916,1282,8.3,19.8,194,1.8,39.6,0,155,155,794
1996,33,e) 4,1199,1251,10786,10669,54,4.1,194,14.7,2170,454,1716,4.3,20.3,1935,856,1079,8,18.1,235,2.2,36.2,0,132,132,624
1996,33,f) 5,1122,1169,9984,10036,53,4.4,131,10.9,1619,292,1327,2.9,16.1,1722,646,1076,6.4,17.2,-103,-1.1,32.2,0,106,106,484
1996,33,g) 6 to 10,5683,5988,67670,67051,235,3.8,543,8.8,9591,1278,8313,1.9,14.3,8352,2903,5449,4.3,12.5,1239,1.8,25,0,393,394,2110
1996,33,h) 11 to 15,3505,3799,48090,48062,131,3.4,301,7.7,6119,990,5129,2.1,12.7,6063,1612,4451,3.4,12.6,56,0.1,25.2,0,201,201,1156
1996,33,i) 16 to 20,2023,2575,38639,38688,94,3.6,185,7.1,4604,980,3624,2.5,11.9,4701,2073,2628,5.4,12.2,-97,-0.3,23.8,0,93,93,1067
1996,33,l) Left Censored,4875,8213,249938,248989,435,5.2,585,7.1,27171,6862,20309,2.8,10.9,25273,7397,17876,3,10.2,1898,0.7,20.4,0,179,179,1463
1996,34,a) 0,16946,17015,86909,43676,16880,198.4,0,0,86467,86467,0,198,198,0,0,0,0,0,86467,198,0,0,,,
1996,34,b) 1,13294,13597,88579,88832,144,0.9,3456,22.4,25466,1928,23538,2.2,28.7,25972,14291,11681,16.1,29.2,-506,-0.5,57.4,0,2665,2665,11486
1996,34,c) 2,10353,10437,75035,76970,290,2.6,1947,17.2,15941,1435,14506,1.9,20.7,19810,9946,9864,12.9,25.7,-3869,-5,41.4,0,1530,1530,8101
1996,34,d) 3,9150,9217,70899,73136,305,3.1,1389,14.2,12283,1624,10659,2.2,16.8,16757,7173,9584,9.8,22.9,-4474,-6.1,33.6,0,1110,1110,5900
1996,34,e) 4,7760,7931,63898,65097,259,3.1,1078,12.9,10516,1303,9213,2,16.2,12913,5594,7319,8.6,19.8,-2397,-3.6,32.4,0,836,836,4510
1996,34,f) 5,7258,7447,60242,60729,276,3.5,943,12.1,10240,1771,8469,2.9,16.9,11214,4558,6656,7.5,18.5,-974,-1.6,33.8,0,730,730,3466
1996,34,g) 6 to 10,32878,34329,367217,373414,1129,3.2,3575,10.1,48060,8613,39447,2.3,12.9,60454,20639,39815,5.5,16.2,-12394,-3.3,25.8,0,2652,2653,15465
1996,34,h) 11 to 15,21840,23661,307971,313598,694,2.9,1899,7.8,37137,6407,30730,2,11.8,48391,15709,32682,5,15.4,-11254,-3.6,23.6,0,1333,1333,6719
1996,34,i) 16 to 20,13589,15598,241630,243027,455,2.9,1144,7.2,29687,5844,23843,2.4,12.2,32481,8695,23786,3.6,13.4,-2794,-1.2,24.4,0,750,750,3820
1996,34,l) Left Censored,34483,55738,1800595,1813001,2321,4.1,4430,7.8,218987,66949,152038,3.7,12.1,243801,76852,166949,4.2,13.4,-24814,-1.3,24.2,0,1683,1683,11874
1996,35,a) 0,3450,3472,19769,9958,3440,198.2,0,0,19623,19623,0,197.1,197.1,0,0,0,0,0,19623,197.1,0,0,,,
1996,35,b) 1,2646,2681,18640,19326,30,1,770,24.9,4744,523,4221,2.7,24.5,6115,3533,2582,18.3,31.6,-1371,-7.1,49,0,623,623,3119
1996,35,c) 2,2206,2253,17089,17590,77,3.1,436,17.8,3585,384,3201,2.2,20.4,4586,2325,2261,13.2,26.1,-1001,-5.7,40.8,0,349,349,1882
1996,35,d) 3,1753,1780,14525,14593,68,3.6,296,15.6,3111,464,2647,3.2,21.3,3247,1213,2034,8.3,22.3,-136,-1,42.6,0,242,242,1053
1996,35,e) 4,1476,1551,14495,14888,55,3.4,218,13.3,2597,767,1830,5.2,17.4,3383,1477,1906,9.9,22.7,-786,-5.3,34.8,0,169,169,1025
1996,35,f) 5,1462,1581,13524,14403,66,4,206,12.5,2082,440,1642,3.1,14.5,3840,2125,1715,14.8,26.7,-1758,-12.2,29,0,154,154,1866
1996,35,g) 6 to 10,5551,5911,67837,68895,227,3.7,603,9.9,9629,2178,7451,3.2,14,11744,3748,7996,5.4,17,-2115,-3,28,0,440,440,2546
1996,35,h) 11 to 15,4077,4625,53374,54363,169,3.6,385,8.1,7061,1785,5276,3.3,13,9039,3606,5433,6.6,16.6,-1978,-3.6,26,0,263,263,2106
1996,35,i) 16 to 20,2764,3531,47485,48008,179,5,281,7.8,6312,1747,4565,3.6,13.1,7358,2008,5350,4.2,15.3,-1046,-2.2,26.2,0,156,158,959
1996,35,l) Left Censored,5184,9210,237995,236045,511,5.5,603,6.5,29972,6958,23014,2.9,12.7,26072,7177,18895,3,11,3900,1.7,22,0,203,203,1219
1996,36,a) 0,36012,36124,191126,95926,35854,198.5,0,0,190401,190401,0,198.5,198.5,0,0,0,0,0,190401,198.5,0,0,,,
1996,36,b) 1,27713,28578,187231,186586,322,1,7279,22.5,53386,5315,48071,2.8,28.6,52095,27754,24341,14.9,27.9,1291,0.7,55.8,0,5682,5682,23177
1996,36,c) 2,22415,22563,167361,173965,699,2.9,4476,18.3,34988,3642,31346,2.1,20.1,48196,25781,22415,14.8,27.7,-13208,-7.6,40.2,0,3710,3711,22208
1996,36,d) 3,19196,19425,150407,155580,668,3.2,3380,16.2,27361,3954,23407,2.5,17.6,37706,20518,17188,13.2,24.2,-10345,-6.6,35.2,0,2820,2820,17914
1996,36,e) 4,16541,16971,144094,145947,552,3.1,2571,14.3,26380,4337,22043,3,18.1,30086,13725,16361,9.4,20.6,-3706,-2.5,36.2,0,2071,2072,11157
1996,36,f) 5,15679,16157,130471,135698,594,3.5,2164,12.8,22060,3837,18223,2.8,16.3,32513,12426,20087,9.2,24,-10453,-7.7,32.6,0,1729,1729,9937
1996,36,g) 6 to 10,67843,70526,754187,767723,2131,2.9,7854,10.7,94731,17303,77428,2.3,12.3,121803,49343,72460,6.4,15.9,-27072,-3.6,24.6,0,5945,5945,33681
1996,36,h) 11 to 15,45911,50067,621181,629826,1429,2.8,4308,8.4,73276,13256,60020,2.1,11.6,90565,27466,63099,4.4,14.4,-17289,-2.8,23.2,0,3071,3072,18040
1996,36,i) 16 to 20,26828,32772,518880,525647,997,3,2638,7.9,59206,13005,46201,2.5,11.3,72740,22117,50623,4.2,13.8,-13534,-2.5,22.6,0,1637,1637,9884
1996,36,l) Left Censored,75021,119148,3820813,3855576,4548,3.7,9261,7.6,404777,118578,286199,3.1,10.5,474304,132560,341744,3.4,12.3,-69527,-1.8,21,0,3961,3961,29179
1996,37,a) 0,14630,14801,87139,43752,14687,198.5,0,0,86774,86774,0,198.3,198.3,0,0,0,0,0,86774,198.3,0,0,,,
1996,37,b) 1,11184,11313,75753,75508,84,0.7,2962,23,21433,2422,19011,3.2,28.4,20942,11277,9665,14.9,27.7,491,0.7,55.4,0,2367,2367,9383
1996,37,c) 2,9008,9166,72638,76508,289,2.9,1714,17.3,14256,1583,12673,2.1,18.6,21996,11615,10381,15.2,28.7,-7740,-10.1,37.2,0,1394,1394,10085
1996,37,d) 3,7251,7385,62906,62196,259,3.3,1129,14.4,14663,2268,12395,3.6,23.6,13242,5761,7481,9.3,21.3,1421,2.3,42.6,0,911,911,4839
1996,37,e) 4,6301,6599,65268,66454,222,3.2,845,12.2,10674,1436,9238,2.2,16.1,13046,5335,7711,8,19.6,-2372,-3.5,32.2,0,659,659,4506
1996,37,f) 5,5944,6255,59639,59957,227,3.5,709,10.9,10917,1754,9163,2.9,18.2,11553,4432,7121,7.4,19.3,-636,-1.1,36.4,0,549,549,2956
1996,37,g) 6 to 10,25115,27297,324868,326752,987,3.5,2592,9.2,45510,9724,35786,3,13.9,49278,16550,32728,5.1,15.1,-3768,-1.2,27.8,0,1841,1841,11173
1996,37,h) 11 to 15,18492,20981,279495,282055,657,3.1,1511,7.1,34559,7365,27194,2.6,12.3,39678,15219,24459,5.4,14.1,-5119,-1.8,24.6,0,944,944,7976
1996,37,i) 16 to 20,10195,13243,209616,212321,499,3.7,939,7,25584,6919,18665,3.3,12,30994,8735,22259,4.1,14.6,-5410,-2.6,24,0,535,535,3870
1996,37,l) Left Censored,24271,49167,1763252,1769828,2442,4.9,3186,6.4,187945,51538,136407,2.9,10.6,201098,55623,145475,3.1,11.4,-13153,-0.8,21.2,0,941,941,7298
1996,38,a) 0,1265,1272,8990,4518,1256,197.5,0,0,8945,,,,198,0,0,0,0,0,8945,198,0,1,,,
1996,38,b) 1,989,990,6767,6891,3,0.3,257,22.8,1493,,,,21.7,1741,794,947,11.5,25.3,-248,-3.6,43.4,1,196,196,666
1996,38,c) 2,952,960,5848,6091,24,2.4,131,12.9,918,76,842,1.2,15.1,1403,497,906,8.2,23,-485,-7.9,30.2,0,107,107,431
1996,38,d) 3,787,792,5815,5917,14,1.7,94,11.3,983,83,900,1.4,16.6,1187,491,696,8.3,20.1,-204,-3.5,33.2,0,74,74,449
1996,38,e) 4,679,690,5100,5216,21,2.9,77,10.7,623,116,507,2.2,11.9,854,304,550,5.8,16.4,-231,-4.5,23.8,0,61,61,280
1996,38,f) 5,607,628,5500,5433,16,2.4,73,11.1,1103,371,732,6.8,20.3,968,451,517,8.3,17.8,135,2.5,35.6,0,52,52,315
1996,38,g) 6 to 10,2627,2780,26254,26069,74,2.6,229,8,3923,623,3300,2.4,15,3552,1101,2451,4.2,13.6,371,1.4,27.2,0,176,176,938
1996,38,h) 11 to 15,2165,2437,23997,24729,55,2.2,180,7.2,2275,288,1987,1.2,9.2,3738,1065,2673,4.3,15.1,-1463,-5.9,18.4,0,128,128,726
1996,38,i) 16 to 20,1520,1784,19856,20110,50,2.8,112,6.2,2087,398,1689,2,10.4,2595,613,1982,3,12.9,-508,-2.5,20.8,0,62,62,267
1996,38,l) Left Censored,3807,5829,124151,125038,201,3.4,358,6.1,12190,2761,9429,2.2,9.7,13963,4282,9681,3.4,11.2,-1773,-1.5,19.4,0,142,142,857
1996,39,a) 0,16838,16984,105259,52953,16837,198.3,0,0,104612,104612,0,197.6,197.6,0,0,0,0,0,104612,197.6,0,0,,,
1996,39,b) 1,13785,13976,100763,98928,111,0.7,3369,21.4,29629,3346,26283,3.4,30,25958,13373,12585,13.5,26.2,3671,3.8,52.4,0,2709,2709,11663
1996,39,c) 2,11378,11685,96594,98295,349,2.8,2094,16.6,21436,3067,18369,3.1,21.8,24838,11685,13153,11.9,25.3,-3402,-3.5,43.6,0,1718,1718,10128
1996,39,d) 3,9727,9951,90455,93244,289,2.7,1494,14.1,16498,1991,14507,2.1,17.7,22076,9529,12547,10.2,23.7,-5578,-6,35.4,0,1225,1225,7723
1996,39,e) 4,8369,8703,79703,81055,221,2.4,1177,12.8,13294,1605,11689,2,16.4,15997,6613,9384,8.2,19.7,-2703,-3.3,32.8,0,935,935,5643
1996,39,f) 5,8027,8483,84825,84940,251,2.8,999,11.3,14493,1847,12646,2.2,17.1,14723,5711,9012,6.7,17.3,-230,-0.2,34.2,0,775,776,4014
1996,39,g) 6 to 10,34514,37616,460168,465534,1150,3,3506,9,62016,11837,50179,2.5,13.3,72747,23881,48866,5.1,15.6,-10731,-2.3,26.6,0,2516,2516,16489
1996,39,h) 11 to 15,24320,28246,414216,418482,797,2.8,2034,7,46121,8996,37125,2.1,11,54652,17530,37122,4.2,13.1,-8531,-2.1,22,0,1279,1279,9254
1996,39,i) 16 to 20,16365,21217,355465,354141,603,2.8,1410,6.5,44841,13785,31056,3.9,12.7,42192,12258,29934,3.5,11.9,2649,0.8,23.8,0,781,783,5545
1996,39,l) Left Censored,43957,82615,2789991,2789123,3689,4.4,5440,6.5,316610,90180,226430,3.2,11.4,314875,87290,227585,3.1,11.3,1735,0.1,22.6,0,1724,1724,12951
1996,40,a) 0,6337,6381,35328,17757,6321,198.1,0,0,35143,35143,0,197.9,197.9,0,0,0,0,0,35143,197.9,0,0,,,
1996,40,b) 1,4794,4856,33869,34188,32,0.6,1459,25.9,9554,922,8632,2.7,27.9,10191,5610,4581,16.4,29.8,-637,-1.9,55.8,0,1213,1214,4998
1996,40,c) 2,4030,4080,29212,30606,122,2.7,907,20.2,6397,655,5742,2.1,20.9,9185,5330,3855,17.4,30,-2788,-9.1,41.8,0,758,758,4773
1996,40,d) 3,3396,3448,27072,27554,123,3.3,589,16,5356,932,4424,3.4,19.4,6320,3050,3270,11.1,22.9,-964,-3.5,38.8,0,498,498,2674
1996,40,e) 4,2974,3060,25950,26024,94,2.9,434,13.4,4751,1011,3740,3.9,18.3,4898,2233,2665,8.6,18.8,-147,-0.5,36.6,0,357,357,1770
1996,40,f) 5,2714,2819,23553,24154,86,2.9,356,12.1,3563,579,2984,2.4,14.8,4765,2357,2408,9.8,19.7,-1202,-4.9,29.6,0,280,280,1968
1996,40,g) 6 to 10,10442,11169,133442,133517,380,3.3,1133,9.8,21866,5727,16139,4.3,16.4,22015,8364,13651,6.3,16.5,-149,-0.1,32.8,0,842,842,5232
1996,40,h) 11 to 15,9138,10175,120074,120244,326,3.1,780,7.5,15941,3415,12526,2.8,13.3,16281,4849,11432,4,13.5,-340,-0.2,26.6,0,533,533,2807
1996,40,i) 16 to 20,5364,6740,94478,93485,249,3.6,519,7.6,13443,4715,8728,5,14.4,11456,4050,7406,4.3,12.3,1987,2.1,24.6,0,297,298,1568
1996,40,l) Left Censored,11409,20741,536769,534243,967,4.6,1374,6.6,60947,20374,40573,3.8,11.4,55894,16360,39534,3.1,10.5,5053,0.9,21,0,502,503,2851
1996,41,a) 0,8160,8232,47199,23702,8162,198.3,0,0,46995,46995,0,198.3,198.3,0,0,0,0,0,46995,198.3,0,0,,,
1996,41,b) 1,6399,6455,38662,38932,26,0.4,1757,23.7,10201,543,9658,1.4,26.2,10741,5885,4856,15.1,27.6,-540,-1.4,52.4,0,1356,1356,4407
1996,41,c) 2,5298,5411,34797,36007,212,3.6,1041,17.8,7869,1184,6685,3.3,21.9,10288,5247,5041,14.6,28.6,-2419,-6.7,43.8,0,843,843,4605
1996,41,d) 3,4113,4178,31287,31029,149,3.4,656,14.8,7386,559,6827,1.8,23.8,6870,3136,3734,10.1,22.1,516,1.7,44.2,0,519,520,2465
1996,41,e) 4,3606,3754,33518,33993,141,3.6,532,13.4,5512,673,4839,2,16.2,6462,3044,3418,9,19,-950,-2.8,32.4,0,397,398,2340
1996,41,f) 5,3326,3449,28548,28484,119,3.3,427,11.8,5626,946,4680,3.3,19.8,5498,2518,2980,8.8,19.3,128,0.5,38.6,0,329,329,1765
1996,41,g) 6 to 10,13055,13828,146110,148211,538,3.8,1535,10.7,22023,3362,18661,2.3,14.9,26224,10775,15449,7.3,17.7,-4201,-2.8,29.8,0,1102,1102,7870
1996,41,h) 11 to 15,8751,9973,144770,144525,371,3.6,812,8,19923,5019,14904,3.5,13.8,19433,5568,13865,3.9,13.4,490,0.4,26.8,0,538,538,3411
1996,41,i) 16 to 20,6007,7508,110685,110359,270,3.5,547,7.2,14699,3970,10729,3.6,13.3,14046,4223,9823,3.8,12.7,653,0.6,25.4,0,316,316,1944
1996,41,l) Left Censored,11390,20809,601439,594485,1241,5.9,1368,6.6,74601,16142,58459,2.7,12.5,60693,15943,44750,2.7,10.2,13908,2.3,20.4,0,477,477,3645
1996,42,a) 0,17253,17392,108267,54649,17224,198.1,0,0,107236,107236,0,196.2,196.2,0,0,0,0,0,107236,196.2,0,0,,,
1996,42,b) 1,14223,14472,105978,106976,108,0.7,3309,20.4,27923,2447,25476,2.3,26.1,29920,17165,12755,16,28,-1997,-1.9,52.2,0,2621,2621,14521
1996,42,c) 2,11246,11473,101337,106092,305,2.5,1937,15.7,16962,2109,14853,2,16,26472,14970,11502,14.1,25,-9510,-9,32,0,1596,1596,13651
1996,42,d) 3,10048,10216,83906,86399,269,2.5,1430,13.2,15838,2144,13694,2.5,18.3,20823,10216,10607,11.8,24.1,-4985,-5.8,36.6,0,1155,1155,8720
1996,42,e) 4,9382,9813,84462,86238,264,2.6,1233,12,13409,2130,11279,2.5,15.5,16961,6609,10352,7.7,19.7,-3552,-4.2,31,0,966,966,5226
1996,42,f) 5,9193,9681,85599,86666,289,2.9,1031,10.3,12929,2058,10871,2.4,14.9,15063,5450,9613,6.3,17.4,-2134,-2.5,29.8,0,844,844,4472
1996,42,g) 6 to 10,41544,44179,473212,480863,1257,2.8,4306,9.4,59640,11085,48555,2.3,12.4,74942,28410,46532,5.9,15.6,-15302,-3.2,24.8,0,3209,3209,20738
1996,42,h) 11 to 15,28274,31794,444102,445442,876,2.7,2265,7,53107,16250,36857,3.6,11.9,55787,18618,37169,4.2,12.5,-2680,-0.6,23.8,0,1512,1512,10442
1996,42,i) 16 to 20,17734,22286,358886,358740,639,2.8,1518,6.7,37954,7799,30155,2.2,10.6,37662,10927,26735,3,10.5,292,0.1,21,0,950,952,5939
1996,42,l) Left Censored,48908,87489,2837528,2852436,3728,4.2,5879,6.6,288362,80214,208148,2.8,10.1,318178,93251,224927,3.3,11.2,-29816,-1.1,20.2,0,2235,2235,14503
1996,44,a) 0,1997,2001,10155,5117,1992,199.1,0,0,10076,10076,0,196.9,196.9,0,0,0,0,0,10076,196.9,0,0,,,
1996,44,b) 1,1425,1437,8009,7912,10,0.6,382,23.3,2311,49,2262,0.6,29.2,2116,1314,802,16.6,26.7,195,2.5,53.4,0,300,300,1068
1996,44,c) 2,1307,1316,13634,13625,38,2.7,249,17.6,2533,125,2408,0.9,18.6,2514,1334,1180,9.8,18.5,19,0.1,37,0,205,205,1193
1996,44,d) 3,1101,1109,7265,7629,37,3.1,177,15,1154,170,984,2.2,15.1,1882,1005,877,13.2,24.7,-728,-9.6,30.2,0,146,146,907
1996,44,e) 4,944,957,7615,7905,28,2.8,124,12.3,1121,143,978,1.8,14.2,1701,625,1076,7.9,21.5,-580,-7.3,28.4,0,102,102,504
1996,44,f) 5,840,860,7453,7613,29,3.2,110,12.2,1096,217,879,2.9,14.4,1415,517,898,6.8,18.6,-319,-4.2,28.8,0,83,83,420
1996,44,g) 6 to 10,4290,4484,42765,43308,155,3.3,464,10,5328,682,4646,1.6,12.3,6413,2245,4168,5.2,14.8,-1085,-2.5,24.6,0,353,353,1560
1996,44,h) 11 to 15,2708,2872,33698,35029,71,2.4,243,8.2,4512,1361,3151,3.9,12.9,7174,2847,4327,8.1,20.5,-2662,-7.6,25.8,0,172,172,1902
1996,44,i) 16 to 20,1772,2006,28315,28338,39,1.9,157,7.6,3075,704,2371,2.5,10.9,3121,1038,2083,3.7,11,-46,-0.1,21.8,0,82,82,590
1996,44,l) Left Censored,5341,7422,219085,221020,288,3.8,520,6.9,19657,5501,14156,2.5,8.9,23526,7521,16005,3.4,10.6,-3869,-1.7,17.8,0,219,221,1501
1996,45,a) 0,7294,7338,41461,20801,7289,198.7,0,0,41321,41321,0,198.6,198.6,0,0,0,0,0,41321,198.6,0,0,,,
1996,45,b) 1,5485,5563,43649,43027,73,1.1,1639,25.5,13577,1852,11725,4.3,31.6,12333,6892,5441,16,28.7,1244,2.9,57.4,0,1327,1327,5922
1996,45,c) 2,4337,4433,39352,41239,178,3.7,875,18.2,7926,1544,6382,3.7,19.2,11699,5723,5976,13.9,28.4,-3773,-9.2,38.4,0,717,717,5110
1996,45,d) 3,3584,3697,31189,31427,171,4.3,625,15.9,6643,1272,5371,4,21.1,7119,3119,4000,9.9,22.7,-476,-1.6,42.2,0,519,519,2804
1996,45,e) 4,3140,3264,35382,35256,168,4.9,478,14,7348,3208,4140,9.1,20.8,7096,2582,4514,7.3,20.1,252,0.7,40.2,0,373,373,2068
1996,45,f) 5,2980,3195,28384,28559,133,4,363,10.9,5061,1203,3858,4.2,17.7,5410,1934,3476,6.8,18.9,-349,-1.2,35.4,0,293,293,1676
1996,45,g) 6 to 10,11972,13115,159697,160557,456,3.4,1384,10.2,22934,4903,18031,3.1,14.3,24654,9141,15513,5.7,15.4,-1720,-1.1,28.6,0,969,969,6508
1996,45,h) 11 to 15,8682,9938,119974,121042,344,3.4,757,7.5,16067,4100,11967,3.4,13.3,18202,5931,12271,4.9,15,-2135,-1.7,26.6,0,493,493,3428
1996,45,i) 16 to 20,4954,6374,97507,96266,288,4.5,433,6.7,14150,4442,9708,4.6,14.7,11667,2890,8777,3,12.1,2483,2.6,24.2,0,247,247,1265
1996,45,l) Left Censored,11675,23213,801432,805776,1119,4.8,1502,6.4,81586,23874,57712,3,10.1,90275,24407,65868,3,11.2,-8689,-1.1,20.2,0,491,491,3754
1996,46,a) 0,1687,1705,8825,4439,1686,197.8,0,0,8773,8773,0,197.6,197.6,0,0,0,0,0,8773,197.6,0,0,,,
1996,46,b) 1,1239,1256,7964,7946,8,0.6,340,23.7,2041,86,1955,1.1,25.7,2005,1056,949,13.3,25.2,36,0.5,50.4,0,272,272,922
1996,46,c) 2,1154,1171,7993,8344,20,1.6,214,16.8,1144,77,1067,0.9,13.7,1845,869,976,10.4,22.1,-701,-8.4,27.4,0,168,168,749
1996,46,d) 3,918,931,6665,6819,26,2.6,130,13.2,990,133,857,2,14.5,1298,675,623,9.9,19,-308,-4.5,29,0,95,95,586
1996,46,e) 4,810,846,6165,6248,17,1.9,112,12.5,935,289,646,4.6,15,1100,365,735,5.8,17.6,-165,-2.6,30,0,85,85,301
1996,46,f) 5,749,769,6030,6376,25,3.1,95,11.8,681,92,589,1.4,10.7,1373,718,655,11.3,21.5,-692,-10.8,21.4,0,78,78,606
1996,46,g) 6 to 10,3000,3129,37476,37826,100,3.1,297,9.2,5191,2055,3136,5.4,13.7,5890,1840,4050,4.9,15.6,-699,-1.9,27.4,0,228,228,1269
1996,46,h) 11 to 15,2296,2579,23232,23906,65,2.5,186,7,2340,331,2009,1.4,9.8,3687,1221,2466,5.1,15.4,-1347,-5.6,19.6,0,121,121,665
1996,46,i) 16 to 20,1550,1848,23379,23864,50,2.7,121,6.4,2192,387,1805,1.6,9.2,3162,1052,2110,4.4,13.3,-970,-4.1,18.4,0,79,79,313
1996,46,l) Left Censored,4045,6049,140933,140981,222,3.6,393,6.4,13169,3019,10150,2.1,9.3,13265,4515,8750,3.2,9.4,-96,-0.1,18.6,0,163,163,941
1996,47,a) 0,9938,10008,64447,32435,9924,198.3,0,0,64025,64025,0,197.4,197.4,0,0,0,0,0,64025,197.4,0,0,,,
1996,47,b) 1,7345,7477,59255,60511,79,0.9,2285,26.3,17225,1425,15800,2.4,28.5,19737,10949,8788,18.1,32.6,-2512,-4.1,57,0,1914,1914,9385
1996,47,c) 2,6001,6105,52195,55558,184,2.8,1278,19.1,11085,2463,8622,4.4,20,17811,9832,7979,17.7,32.1,-6726,-12.1,40,0,1051,1051,7753
1996,47,d) 3,5179,5321,46630,57684,183,3.2,864,15.3,9251,1598,7653,2.8,16,31359,24811,6548,43,54.4,-22108,-38.4,32,0,701,701,24031
1996,47,e) 4,4366,4547,44610,46710,153,3.2,650,13.6,7799,1506,6293,3.2,16.7,11999,4985,7014,10.7,25.7,-4200,-9,33.4,0,510,510,3940
1996,47,f) 5,3951,4200,45900,47039,135,3.1,528,12,7597,1734,5863,3.7,16.2,9874,5312,4562,11.3,21,-2277,-4.8,32.4,0,417,417,4040
1996,47,g) 6 to 10,16718,18298,235416,237873,704,3.7,1754,9.3,33809,10024,23785,4.2,14.2,38723,12929,25794,5.4,16.3,-4914,-2.1,28.4,0,1323,1324,9001
1996,47,h) 11 to 15,12139,13742,182648,184441,438,3.1,1065,7.6,22954,5808,17146,3.1,12.4,26539,9222,17317,5,14.4,-3585,-2,24.8,0,647,647,5150
1996,47,i) 16 to 20,7331,10043,193346,191204,434,4.3,716,7,28059,8846,19213,4.6,14.7,23775,6538,17237,3.4,12.4,4284,2.3,24.8,0,360,360,2260
1996,47,l) Left Censored,17467,34604,1224015,1230128,1856,5.3,2218,6.4,127687,35696,91991,2.9,10.4,139913,38295,101618,3.1,11.4,-12226,-1,20.8,0,736,739,4312
1996,48,a) 0,37622,38056,249004,125159,37750,198.4,0,0,247691,247691,0,197.9,197.9,0,0,0,0,0,247691,197.9,0,0,,,
1996,48,b) 1,27957,28498,240949,241310,239,0.7,8289,25.2,75032,6131,68901,2.5,31.1,75754,43604,32150,18.1,31.4,-722,-0.3,62.2,0,6911,6911,35914
1996,48,c) 2,23024,23767,217596,222968,820,3.2,5009,19.3,49376,5924,43452,2.7,22.1,60120,31048,29072,13.9,27,-10744,-4.9,44.2,0,4124,4124,26067
1996,48,d) 3,19237,19780,188807,194514,731,3.5,3371,16,40148,6555,33593,3.4,20.6,51561,26914,24647,13.8,26.5,-11413,-5.9,41.2,0,2782,2782,23079
1996,48,e) 4,16907,17766,187939,192338,651,3.5,2559,13.7,33487,6327,27160,3.3,17.4,42285,18350,23935,9.5,22,-8798,-4.6,34.8,0,2029,2029,14510
1996,48,f) 5,15468,16469,178636,183256,605,3.5,2141,12.4,30399,5074,25325,2.8,16.6,39639,15073,24566,8.2,21.6,-9240,-5,33.2,0,1665,1665,11976
1996,48,g) 6 to 10,55990,61740,777037,786900,2246,3.5,7036,11,119419,27031,92388,3.4,15.2,139145,51704,87441,6.6,17.7,-19726,-2.5,30.4,0,4922,4922,33073
1996,48,h) 11 to 15,47195,54581,773205,768060,1832,3.3,4291,7.7,122600,28267,94333,3.7,16,112311,33893,78418,4.4,14.6,10289,1.4,29.2,0,2747,2747,18975
1996,48,i) 16 to 20,21989,29900,475478,473088,1134,3.7,2357,7.7,72041,19160,52881,4,15.2,67263,24277,42986,5.1,14.2,4778,1,28.4,0,1225,1226,8333
1996,48,l) Left Censored,45222,106462,3535195,3525758,6199,5.8,8228,7.7,462019,147154,314865,4.2,13.1,443146,132668,310478,3.8,12.6,18873,0.5,25.2,0,2220,2222,14551
1996,49,a) 0,4885,4930,30626,15365,4885,198.2,0,0,30523,30523,0,198.7,198.7,0,0,0,0,0,30523,198.7,0,0,,,
1996,49,b) 1,3432,3472,34824,33517,19,0.5,1003,25.1,10688,292,10396,0.9,31.9,8073,4899,3174,14.6,24.1,2615,7.8,48.2,0,803,803,4092
1996,49,c) 2,2771,2869,26126,26767,119,3.8,579,18.6,5999,1022,4977,3.8,22.4,7280,4297,2983,16.1,27.2,-1281,-4.8,44.8,0,450,450,3471
1996,49,d) 3,2107,2152,20922,21230,74,3.2,381,16.5,4187,422,3765,2,19.7,4803,1985,2818,9.3,22.6,-616,-2.9,39.4,0,303,303,1735
1996,49,e) 4,1796,1854,18670,19212,85,4.3,286,14.6,3754,1039,2715,5.4,19.5,4838,2792,2046,14.5,25.2,-1084,-5.7,39,0,214,214,2205
1996,49,f) 5,1596,1662,19248,19152,62,3.6,192,11.1,3744,723,3021,3.8,19.5,3552,1543,2009,8.1,18.5,192,1,37,0,159,159,1070
1996,49,g) 6 to 10,5561,6045,98718,97443,229,3.7,632,10.1,16819,3729,13090,3.8,17.3,14268,5117,9151,5.3,14.6,2551,2.7,29.2,0,450,450,3393
1996,49,h) 11 to 15,3817,4388,74710,74850,173,3.9,381,8.5,9749,1727,8022,2.3,13,10029,2603,7426,3.5,13.4,-280,-0.4,26,0,274,275,2045
1996,49,i) 16 to 20,2709,3322,59228,58928,161,4.8,238,7.1,7774,1884,5890,3.2,13.2,7174,2075,5099,3.5,12.2,600,1,24.4,0,128,128,823
1996,49,l) Left Censored,5488,10375,387346,384751,568,5.5,663,6.4,46713,16688,30025,4.3,12.1,41522,9909,31613,2.6,10.8,5191,1.3,21.6,0,211,211,1162
1996,50,a) 0,1434,1438,7072,3548,1422,197.8,0,0,7048,7048,0,198.6,198.6,0,0,0,0,0,7048,198.6,0,0,,,
1996,50,b) 1,1143,1150,6398,6605,9,0.7,269,20.8,1607,252,1355,3.8,24.3,2020,1003,1017,15.2,30.6,-413,-6.3,48.6,0,210,210,885
1996,50,c) 2,999,1014,6001,6148,30,2.7,184,16.8,1075,100,975,1.6,17.5,1368,745,623,12.1,22.3,-293,-4.8,35,0,146,146,553
1996,50,d) 3,876,883,4804,5153,24,2.5,154,16.2,830,69,761,1.3,16.1,1528,975,553,18.9,29.7,-698,-13.6,32.2,0,130,130,888
1996,50,e) 4,737,755,5303,5503,25,3.2,93,11.8,766,94,672,1.7,13.9,1165,464,701,8.4,21.2,-399,-7.3,27.8,0,80,80,440
1996,50,f) 5,718,732,5022,5124,26,3.4,96,12.5,798,88,710,1.7,15.6,1001,550,451,10.7,19.5,-203,-3.9,31.2,0,68,68,463
1996,50,g) 6 to 10,3515,3639,29570,30171,94,2.5,401,10.6,3649,674,2975,2.2,12.1,4851,1896,2955,6.3,16.1,-1202,-4,24.2,0,315,315,1606
1996,50,h) 11 to 15,2295,2513,25425,25362,75,2.9,154,6,2666,371,2295,1.5,10.5,2540,685,1855,2.7,10,126,0.5,20,0,111,111,459
1996,50,i) 16 to 20,1264,1498,21573,20942,49,3.2,86,5.7,3377,1052,2325,5,16.1,2115,778,1337,3.7,10.1,1262,6,20.2,0,54,54,286
1996,50,l) Left Censored,3059,4547,111676,113690,199,4.3,261,5.7,10722,2867,7855,2.5,9.4,14750,7851,6899,6.9,13,-4028,-3.6,18.8,0,100,100,1138
1996,51,a) 0,12148,12224,64668,32486,12113,198.2,0,0,64364,64364,0,198.1,198.1,0,0,0,0,0,64364,198.1,0,0,,,
1996,51,b) 1,9719,9859,67322,67199,91,0.8,2674,23.8,19458,1890,17568,2.8,29,19211,10984,8227,16.3,28.6,247,0.4,57.2,0,2112,2112,9343
1996,51,c) 2,7687,7838,62540,63715,266,3.1,1569,18.4,14816,2249,12567,3.5,23.3,17166,8650,8516,13.6,26.9,-2350,-3.6,46.6,0,1280,1280,6953
1996,51,d) 3,6765,6873,56266,57297,201,2.7,1085,14.8,11401,1197,10204,2.1,19.9,13463,5608,7855,9.8,23.5,-2062,-3.6,39.8,0,870,870,4703
1996,51,e) 4,5784,6046,54990,56191,185,2.9,850,13.3,9600,1771,7829,3.2,17.1,12001,5084,6917,9,21.4,-2401,-4.3,34.2,0,633,633,3544
1996,51,f) 5,5339,5571,51749,52622,205,3.5,747,12.8,8446,1560,6886,3,16.1,10192,3698,6494,7,19.4,-1746,-3.3,32.2,0,525,525,2629
1996,51,g) 6 to 10,23095,24840,279839,284700,844,3.3,2689,10.4,40322,7833,32489,2.8,14.2,50044,17212,32832,6,17.6,-9722,-3.4,28.4,0,1883,1883,10906
1996,51,h) 11 to 15,15464,17946,261071,260591,584,3.2,1353,7.4,35203,7997,27206,3.1,13.5,34242,10092,24150,3.9,13.1,961,0.4,26.2,0,812,812,4868
1996,51,i) 16 to 20,8805,11617,183294,183508,405,3.4,845,7.1,23032,6190,16842,3.4,12.6,23459,6803,16656,3.7,12.8,-427,-0.2,25.2,0,417,417,2355
1996,51,l) Left Censored,20798,43918,1383993,1391666,2374,5.4,3018,6.8,159851,50815,109036,3.7,11.5,175197,51328,123869,3.7,12.6,-15346,-1.1,23,0,799,799,4921
1996,53,a) 0,13536,13611,66102,33295,13455,197.7,0,0,65615,65615,0,197.1,197.1,0,0,0,0,0,65615,197.1,0,0,,,
1996,53,b) 1,9924,10040,62923,64813,75,0.6,3135,26.7,17482,1277,16205,2,27,21261,11889,9372,18.3,32.8,-3779,-5.8,54,0,2423,2423,10261
1996,53,c) 2,8310,8444,54941,57279,367,4,1808,19.6,12150,1837,10313,3.2,21.2,16825,8896,7929,15.5,29.4,-4675,-8.2,42.4,0,1435,1435,7496
1996,53,d) 3,6905,7066,48847,51232,323,4.3,1257,16.7,9197,1584,7613,3.1,18,13966,6078,7888,11.9,27.3,-4769,-9.3,36,0,996,996,5309
1996,53,e) 4,6121,6369,52674,53691,250,3.7,987,14.6,9657,1601,8056,3,18,11691,4809,6882,9,21.8,-2034,-3.8,36,0,750,750,3784
1996,53,f) 5,5631,5857,50071,51367,257,4.2,769,12.6,8095,1336,6759,2.6,15.8,10686,4348,6338,8.5,20.8,-2591,-5,31.6,0,584,584,3526
1996,53,g) 6 to 10,21113,22646,249230,253495,875,3.7,2677,11.4,35227,6114,29113,2.4,13.9,43756,16976,26780,6.7,17.3,-8529,-3.4,27.8,0,1884,1885,11323
1996,53,h) 11 to 15,14375,16547,233221,235208,582,3.4,1478,8.7,30390,6078,24312,2.6,12.9,34364,10270,24094,4.4,14.6,-3974,-1.7,25.8,0,921,922,5599
1996,53,i) 16 to 20,9129,11547,170902,169936,457,3.9,862,7.3,23478,6471,17007,3.8,13.8,21545,5735,15810,3.4,12.7,1933,1.1,25.4,0,479,480,2619
1996,53,l) Left Censored,16987,32233,959351,961517,1981,6.1,2559,7.9,106657,33384,73273,3.5,11.1,110988,28788,82200,3,11.5,-4331,-0.4,22.2,0,723,723,5297
1996,54,a) 0,2756,2791,16260,8222,2770,198.5,0,0,16076,16076,0,195.5,195.5,0,0,0,0,0,16076,195.5,0,0,,,
1996,54,b) 1,2205,2231,14857,14820,11,0.4,675,26,4445,185,4260,1.2,30,4371,2493,1878,16.8,29.5,74,0.5,59,0,543,543,2138
1996,54,c) 2,1761,1788,11626,12152,47,2.4,328,16.9,2248,279,1969,2.3,18.5,3299,1545,1754,12.7,27.1,-1051,-8.6,37,0,267,267,1355
1996,54,d) 3,1570,1587,11211,11246,67,3.9,277,16.3,2557,603,1954,5.4,22.7,2626,1223,1403,10.9,23.4,-69,-0.7,45.4,0,217,217,1052
1996,54,e) 4,1393,1451,10382,11157,48,3.1,198,13,1441,203,1238,1.8,12.9,2990,1245,1745,11.2,26.8,-1549,-13.9,25.8,0,147,147,973
1996,54,f) 5,1263,1360,13574,14621,44,3.1,183,12.8,1741,219,1522,1.5,11.9,3835,1852,1983,12.7,26.2,-2094,-14.3,23.8,0,131,131,708
1996,54,g) 6 to 10,5377,5662,59424,59638,187,3.2,586,10,7871,1294,6577,2.2,13.2,8298,3286,5012,5.5,13.9,-427,-0.7,26.4,0,427,427,2584
1996,54,h) 11 to 15,4156,4599,56552,58062,147,3.1,306,6.5,5486,955,4531,1.6,9.4,8506,1694,6812,2.9,14.6,-3020,-5.2,18.8,0,193,193,926
1996,54,i) 16 to 20,2552,3300,44142,44486,99,2.9,225,6.7,4353,936,3417,2.1,9.8,5041,1270,3771,2.9,11.3,-688,-1.5,19.6,0,139,139,564
1996,54,l) Left Censored,7184,12126,281609,284916,548,4.5,754,6.2,30475,10899,19576,3.8,10.7,37088,10317,26771,3.6,13,-6613,-2.3,21.4,0,303,303,1466
1996,55,a) 0,8803,8846,50540,25438,8766,198.2,0,0,50204,50204,0,197.4,197.4,0,0,0,0,0,50204,197.4,0,0,,,
1996,55,b) 1,7121,7207,49028,50131,50,0.6,1682,20.8,12566,1217,11349,2.4,25.1,14771,8621,6150,17.2,29.5,-2205,-4.4,50.2,0,1323,1323,5367
1996,55,c) 2,6040,6132,45190,46736,193,2.9,1028,15.7,8189,1103,7086,2.4,17.5,11281,5491,5790,11.7,24.1,-3092,-6.6,35,0,827,827,4793
1996,55,d) 3,5367,5469,41973,43048,189,3.3,771,13.4,7318,1210,6108,2.8,17,9468,4711,4757,10.9,22,-2150,-5,34,0,616,616,3262
1996,55,e) 4,4605,4731,39791,40763,131,2.7,564,11.4,5492,887,4605,2.2,13.5,7436,2671,4765,6.6,18.2,-1944,-4.7,27,0,452,453,2202
1996,55,f) 5,4428,4648,41276,41876,141,2.9,501,10.4,6062,1167,4895,2.8,14.5,7262,2980,4282,7.1,17.3,-1200,-2.8,29,0,361,361,2023
1996,55,g) 6 to 10,18342,19757,239418,241317,621,3,1906,9.3,29020,5875,23145,2.4,12,32818,11577,21241,4.8,13.6,-3798,-1.6,24,0,1378,1379,8061
1996,55,h) 11 to 15,12739,14428,196786,198252,373,2.5,1016,6.9,22458,4625,17833,2.3,11.3,25390,7481,17909,3.8,12.8,-2932,-1.5,22.6,0,649,650,3919
1996,55,i) 16 to 20,8502,10816,166633,167751,361,3.3,731,6.6,16800,3446,13354,2.1,10,19036,5367,13669,3.2,11.3,-2236,-1.3,20,0,424,424,2581
1996,55,l) Left Censored,22992,38252,1313837,1313214,1402,3.6,2287,5.9,120237,26406,93831,2,9.2,118991,30982,88009,2.4,9.1,1246,0.1,18.2,0,913,916,6078
1996,56,a) 0,1482,1485,6265,3154,1469,197.8,0,0,6222,6222,0,197.3,197.3,0,0,0,0,0,6222,197.3,0,0,,,
1996,56,b) 1,1076,1085,5747,5679,4,0.3,270,21.9,1585,62,1523,1.1,27.9,1449,780,669,13.7,25.5,136,2.4,51,0,214,214,654
1996,56,c) 2,935,942,5831,6747,33,3.3,175,17.3,1091,132,959,2,16.2,2922,896,2026,13.3,43.3,-1831,-27.1,32.4,0,133,133,754
1996,56,d) 3,739,751,5177,5449,25,3.1,125,15.6,817,82,735,1.5,15,1361,612,749,11.2,25,-544,-10,30,0,92,92,474
1996,56,e) 4,614,618,3838,3936,27,4.1,89,13.7,534,67,467,1.7,13.6,730,268,462,6.8,18.5,-196,-4.9,27.2,0,63,63,208
1996,56,f) 5,578,587,3560,3776,19,3.1,76,12.4,514,75,439,2,13.6,945,381,564,10.1,25,-431,-11.4,27.2,0,54,54,252
1996,56,g) 6 to 10,2089,2190,19426,19821,72,3.2,238,10.5,2334,428,1906,2.2,11.8,3123,979,2144,4.9,15.8,-789,-4,23.6,0,192,192,812
1996,56,h) 11 to 15,1851,2043,17667,18081,49,2.3,151,7.2,2053,468,1585,2.6,11.4,2881,972,1909,5.4,15.9,-828,-4.5,22.8,0,87,87,436
1996,56,i) 16 to 20,1276,1533,17389,17736,45,2.9,126,8,1872,213,1659,1.2,10.6,2565,630,1935,3.6,14.5,-693,-3.9,21.2,0,75,75,365
1996,56,l) Left Censored,2362,3793,65923,67179,148,3.8,261,6.8,6416,1518,4898,2.3,9.6,8927,2140,6787,3.2,13.3,-2511,-3.7,19.2,0,105,105,387
1997,01,a) 0,7722,7844,45650,22929,7784,198.5,0,0,45442,45442,0,198.2,198.2,0,0,0,0,0,45442,198.2,0,0,,,
1997,01,b) 1,5882,6086,39227,39995,150,2.1,1841,26.3,11512,1650,9862,4.1,28.8,13048,8305,4743,20.8,32.6,-1536,-3.8,57.6,0,1510,1510,6408
1997,01,c) 2,4921,5023,36459,38918,180,3.3,1059,19.4,7668,2256,5412,5.8,19.7,12586,7461,5125,19.2,32.3,-4918,-12.6,39.4,0,878,878,6590
1997,01,d) 3,4271,4391,39236,42283,167,3.5,836,17.7,7731,1729,6002,4.1,18.3,13825,8177,5648,19.3,32.7,-6094,-14.4,36.6,0,684,684,7213
1997,01,e) 4,3575,3651,32640,32719,131,3.4,540,14,6149,541,5608,1.7,18.8,6307,2913,3394,8.9,19.3,-158,-0.5,37.6,0,428,428,2138
1997,01,f) 5,3152,3292,36671,35838,98,2.8,391,11.4,8463,1137,7326,3.2,23.6,6797,2824,3973,7.9,19,1666,4.6,38,0,302,302,1820
1997,01,g) 6 to 10,12496,13515,168323,172111,522,3.7,1533,10.9,24388,4177,20211,2.4,14.2,31964,13043,18921,7.6,18.6,-7576,-4.4,28.4,0,1131,1131,7017
1997,01,h) 11 to 15,9544,10995,151310,151240,411,3.7,862,7.7,22484,4339,18145,2.9,14.9,22344,6713,15631,4.4,14.8,140,0.1,29.6,0,535,535,3752
1997,01,i) 16 to 20,6878,9141,164559,163119,444,4.8,812,8.7,27786,9756,18030,6,17,24906,7869,17037,4.8,15.3,2880,1.7,30.6,0,369,369,2541
1997,01,l) Left Censored,12678,25483,830079,837891,1504,5.9,1815,7.1,99807,28666,71141,3.4,11.9,115431,31092,84339,3.7,13.8,-15624,-1.9,23.8,0,526,526,4309
1997,02,a) 0,1382,1387,5968,3002,1368,197.3,0,0,5933,5933,0,197.6,197.6,0,0,0,0,0,5933,197.6,0,0,,,
1997,02,b) 1,998,1013,5235,5418,7,0.6,308,26,1543,91,1452,1.7,28.5,1908,1132,776,20.9,35.2,-365,-6.7,57,0,220,220,890
1997,02,c) 2,871,884,5290,5470,28,2.9,175,18.2,1160,147,1013,2.7,21.2,1520,599,921,11,27.8,-360,-6.6,42.4,0,134,134,482
1997,02,d) 3,722,731,4642,4837,29,3.7,131,16.7,878,85,793,1.8,18.2,1267,584,683,12.1,26.2,-389,-8,36.4,0,102,102,458
1997,02,e) 4,675,686,4052,4166,26,3.6,92,12.8,907,129,778,3.1,21.8,1134,422,712,10.1,27.2,-227,-5.4,43.6,0,70,70,282
1997,02,f) 5,508,542,3647,3815,27,4.7,77,13.5,681,107,574,2.8,17.9,1017,265,752,6.9,26.7,-336,-8.8,35.8,0,54,54,190
1997,02,g) 6 to 10,2265,2378,25085,24530,103,4.2,289,11.7,5569,1532,4037,6.2,22.7,4459,1544,2915,6.3,18.2,1110,4.5,36.4,0,189,189,974
1997,02,h) 11 to 15,1923,2220,21640,21795,101,4.5,184,8.1,3891,808,3083,3.7,17.9,4200,961,3239,4.4,19.3,-309,-1.4,35.8,0,110,110,576
1997,02,i) 16 to 20,1297,1685,23546,23073,77,4.5,106,6.2,3672,646,3026,2.8,15.9,2725,603,2122,2.6,11.8,947,4.1,23.6,0,46,46,285
1997,02,l) Left Censored,1743,3258,83017,83285,222,6.8,248,7.6,12306,2752,9554,3.3,14.8,12841,3593,9248,4.3,15.4,-535,-0.6,29.6,0,45,45,279
1997,04,a) 0,9904,10079,62222,31256,9975,197.9,0,0,61933,61933,0,198.1,198.1,0,0,0,0,0,61933,198.1,0,0,,,
1997,04,b) 1,7134,7244,56478,55903,58,0.7,2158,25.7,18157,2074,16083,3.7,32.5,17007,10595,6412,19,30.4,1150,2.1,60.8,0,1763,1763,8476
1997,04,c) 2,5960,6121,58233,58485,261,3.9,1311,19.7,16485,2609,13876,4.5,28.2,16988,9695,7293,16.6,29,-503,-0.8,56.4,0,1062,1062,7816
1997,04,d) 3,5086,5318,54094,53005,200,3.5,881,15.6,13813,3546,10267,6.7,26.1,11634,5661,5973,10.7,21.9,2179,4.2,43.8,0,732,732,4877
1997,04,e) 4,3967,4165,41274,42432,188,4.3,691,15.7,7814,1360,6454,3.2,18.4,10129,4511,5618,10.6,23.9,-2315,-5.5,36.8,0,542,542,3534
1997,04,f) 5,3458,3674,67318,61053,150,3.9,547,14.1,22983,5539,17444,9.1,37.6,10453,4067,6386,6.7,17.1,12530,20.5,34.2,0,406,406,2633
1997,04,g) 6 to 10,14042,15285,202796,204697,791,5,1784,11.3,34983,8028,26955,3.9,17.1,38784,15579,23205,7.6,18.9,-3801,-1.8,34.2,0,1248,1248,10703
1997,04,h) 11 to 15,9893,11799,190499,191237,622,5.2,1090,9.1,30104,7373,22731,3.9,15.7,31579,7537,24042,3.9,16.5,-1475,-0.8,31.4,0,607,607,3885
1997,04,i) 16 to 20,6597,8687,165372,163278,533,6,794,9,30263,9092,21171,5.6,18.5,26074,10167,15907,6.2,16,4189,2.5,32,0,360,360,3716
1997,04,l) Left Censored,8771,20877,756431,747505,2184,10.5,2150,10.3,134128,49502,84626,6.6,17.9,116276,50567,65709,6.8,15.6,17852,2.3,31.2,0,345,345,1858
1997,05,a) 0,4854,4891,28427,14249,4860,198.7,0,0,28357,28357,0,199,199,0,0,0,0,0,28357,199,0,0,,,
1997,05,b) 1,3635,3725,23932,24793,37,0.9,1187,27.3,6427,357,6070,1.4,25.9,8149,4834,3315,19.5,32.9,-1722,-7,51.8,0,991,991,3771
1997,05,c) 2,3267,3338,24427,25762,101,2.8,722,19.8,4466,682,3784,2.6,17.3,7136,3789,3347,14.7,27.7,-2670,-10.4,34.6,0,605,605,3284
1997,05,d) 3,2743,2823,21213,22219,81,2.7,474,15.6,3885,835,3050,3.8,17.5,5896,2561,3335,11.5,26.5,-2011,-9,35,0,394,394,1951
1997,05,e) 4,2369,2424,18165,18728,98,3.8,368,14.4,3347,683,2664,3.6,17.9,4472,1786,2686,9.5,23.9,-1125,-6,35.8,0,303,303,1428
1997,05,f) 5,1980,2095,18534,19354,77,3.5,292,13.3,2879,785,2094,4.1,14.9,4518,1674,2844,8.6,23.3,-1639,-8.4,29.8,0,213,213,1259
1997,05,g) 6 to 10,7623,8219,82416,85633,315,3.7,917,10.8,12005,2983,9022,3.5,14,18439,8561,9878,10,21.5,-6434,-7.5,28,0,643,643,5125
1997,05,h) 11 to 15,6017,6677,82352,82948,261,3.8,531,7.8,11230,2735,8495,3.3,13.5,12421,3458,8963,4.2,15,-1191,-1.5,27,0,344,344,2031
1997,05,i) 16 to 20,4826,5871,96326,97366,276,4.6,472,7.9,12544,2696,9848,2.8,12.9,14624,3195,11429,3.3,15,-2080,-2.1,25.8,0,273,273,1645
1997,05,l) Left Censored,8309,15091,510902,505757,908,6,1077,7.1,63285,15477,47808,3.1,12.5,52995,14363,38632,2.8,10.5,10290,2,21,0,326,326,1805
1997,06,a) 0,60431,61292,388183,194929,60738,198.2,0,0,386509,386509,0,198.3,198.3,0,0,0,0,0,386509,198.3,0,0,,,
1997,06,b) 1,45966,46764,379444,374462,432,0.8,12873,24,121766,13028,108738,3.5,32.5,111801,66476,45325,17.8,29.9,9965,2.6,59.8,0,10086,10086,54794
1997,06,c) 2,37232,38129,340926,352528,1632,3.9,7781,18.8,91262,10800,80462,3.1,25.9,114466,55887,58579,15.9,32.5,-23204,-6.6,51.8,0,6188,6188,47756
1997,06,d) 3,30993,31882,320437,328611,1315,3.8,5736,16.8,67875,10964,56911,3.3,20.7,84222,39823,44399,12.1,25.6,-16347,-4.9,41.4,0,4477,4477,31691
1997,06,e) 4,26029,26978,276632,286721,1165,4.1,4172,14.6,58837,9837,49000,3.4,20.5,79014,31931,47083,11.1,27.6,-20177,-7.1,41,0,3325,3325,24728
1997,06,f) 5,24293,25714,281329,279700,1176,4.4,3766,13.9,59966,8895,51071,3.2,21.4,56707,25317,31390,9.1,20.3,3259,1.1,40.6,0,2769,2769,19139
1997,06,g) 6 to 10,107966,116576,1423483,1428926,5596,4.6,13909,11.5,260274,50580,209694,3.5,18.2,271159,107252,163907,7.5,19,-10885,-0.8,36.4,0,9604,9604,66267
1997,06,h) 11 to 15,75783,87132,1288450,1281038,4004,4.5,8746,9.8,222497,48277,174220,3.8,17.4,207674,77525,130149,6.1,16.2,14823,1.2,32.4,0,5009,5010,36462
1997,06,i) 16 to 20,58122,75270,1339625,1330328,3867,5,6881,9,217439,66936,150503,5,16.3,198845,59944,138901,4.5,14.9,18594,1.4,29.8,0,3266,3266,21011
1997,06,l) Left Censored,74477,155371,5294374,5294563,10283,6.5,17171,10.8,787687,216606,571081,4.1,14.9,788065,289117,498948,5.5,14.9,-378,0,29.8,0,3833,3833,40967
1997,08,a) 0,11603,11722,65089,32679,11634,198.5,0,0,64821,64821,0,198.4,198.4,0,0,0,0,0,64821,198.4,0,0,,,
1997,08,b) 1,8496,8631,54628,55982,103,1,2550,25.6,15881,1758,14123,3.1,28.4,18588,11560,7028,20.6,33.2,-2707,-4.8,56.8,0,1977,1977,9162
1997,08,c) 2,7265,7456,55913,56800,300,3.7,1550,19.1,14332,2236,12096,3.9,25.2,16106,9227,6879,16.2,28.4,-1774,-3.2,50.4,0,1209,1209,6230
1997,08,d) 3,6376,6517,48083,49891,243,3.5,1117,16,9998,2363,7635,4.7,20,13613,6931,6682,13.9,27.3,-3615,-7.3,40,0,869,869,5193
1997,08,e) 4,5110,5234,40748,42051,199,3.6,774,14,7788,1427,6361,3.4,18.5,10394,5167,5227,12.3,24.7,-2606,-6.2,37,0,596,596,4339
1997,08,f) 5,4314,4475,41659,41216,213,4.6,585,12.5,8756,2054,6702,5,21.2,7869,3521,4348,8.5,19.1,887,2.1,38.2,0,437,437,2667
1997,08,g) 6 to 10,16223,17481,197137,199187,828,4.6,1948,10.8,36480,10656,25824,5.3,18.3,40579,16400,24179,8.2,20.4,-4099,-2.1,36.6,0,1336,1336,10979
1997,08,h) 11 to 15,11285,12926,182916,186093,690,5.2,1174,8.9,29189,7440,21749,4,15.7,35542,15102,20440,8.1,19.1,-6353,-3.4,31.4,0,671,671,4644
1997,08,i) 16 to 20,8360,10610,181514,181762,630,5.9,931,8.6,30509,11007,19502,6.1,16.8,31005,9628,21377,5.3,17.1,-496,-0.3,33.6,0,430,430,4461
1997,08,l) Left Censored,11805,23319,762558,756292,1868,8,2124,9,118745,38667,80078,5.1,15.7,106212,35761,70451,4.7,14,12533,1.7,28,0,431,431,2828
1997,09,a) 0,5558,5620,32138,16106,5579,198.5,0,0,32064,32064,0,199.1,199.1,0,0,0,0,0,32064,199.1,0,0,,,
1997,09,b) 1,4370,4456,39339,35802,50,1,1080,21.5,15627,1708,13919,4.8,43.6,8552,5242,3310,14.6,23.9,7075,19.7,47.8,0,827,827,4496
1997,09,c) 2,4054,4141,30900,30889,139,3.1,760,17,7926,1272,6654,4.1,25.7,7904,4868,3036,15.8,25.6,22,0.1,51.2,0,604,604,4254
1997,09,d) 3,3469,3516,28834,28995,110,2.9,564,15.1,5555,470,5085,1.6,19.2,5876,2477,3399,8.5,20.3,-321,-1.1,38.4,0,450,450,2111
1997,09,e) 4,3119,3186,26486,27711,103,3.1,424,12.7,4910,522,4388,1.9,17.7,7359,4360,2999,15.7,26.6,-2449,-8.9,35.4,0,335,335,3624
1997,09,f) 5,2744,2846,33686,34997,101,3.4,354,11.9,3660,561,3099,1.6,10.5,6281,2962,3319,8.5,17.9,-2621,-7.4,21,0,260,260,2158
1997,09,g) 6 to 10,13180,13881,149604,150042,530,3.7,1454,10.1,25252,5521,19731,3.7,16.8,26128,10952,15176,7.3,17.4,-876,-0.6,33.6,0,1007,1007,6038
1997,09,h) 11 to 15,9690,10608,122903,123288,429,4,897,8.3,17208,3724,13484,3,14,17978,6053,11925,4.9,14.6,-770,-0.6,28,0,579,579,3405
1997,09,i) 16 to 20,7054,8368,126222,125810,330,3.9,665,7.8,19359,4931,14428,3.9,15.4,18535,4923,13612,3.9,14.7,824,0.7,29.4,0,331,331,1591
1997,09,l) Left Censored,15875,25319,876779,871855,1483,5.8,2133,8.3,115312,31741,83571,3.6,13.2,105463,34564,70899,4,12.1,9849,1.1,24.2,0,626,626,5120
1997,10,a) 0,1607,1621,9363,4704,1611,198.8,0,0,9319,9319,0,198.1,198.1,0,0,0,0,0,9319,198.1,0,0,,,
1997,10,b) 1,1225,1251,10919,9945,16,1.1,274,19.7,3810,540,3270,5.4,38.3,1862,1056,806,10.6,18.7,1948,19.6,37.4,0,220,220,850
1997,10,c) 2,1128,1153,8824,8798,51,4.2,190,15.5,1783,277,1506,3.1,20.3,1730,841,889,9.6,19.7,53,0.6,39.4,0,146,146,730
1997,10,d) 3,954,979,7644,7612,38,3.7,133,12.9,1438,190,1248,2.5,18.9,1374,568,806,7.5,18.1,64,0.8,36.2,0,114,114,531
1997,10,e) 4,804,814,5955,5923,27,3.1,119,13.8,1117,104,1013,1.8,18.9,1052,494,558,8.3,17.8,65,1.1,35.6,0,94,94,360
1997,10,f) 5,682,708,6299,5888,20,2.7,87,11.8,1701,232,1469,3.9,28.9,878,404,474,6.9,14.9,823,14,29.8,0,64,64,332
1997,10,g) 6 to 10,2816,2934,31173,31029,109,3.6,348,11.4,5644,557,5087,1.8,18.2,5356,2334,3022,7.5,17.3,288,0.9,34.6,0,242,242,1490
1997,10,h) 11 to 15,1903,2109,24227,24189,94,4.4,195,9,3904,618,3286,2.6,16.1,3828,1539,2289,6.4,15.8,76,0.3,31.6,0,111,111,875
1997,10,i) 16 to 20,1401,1748,41853,41882,99,5.6,125,7.1,6159,1761,4398,4.2,14.7,6216,1491,4725,3.6,14.8,-57,-0.1,29.4,0,53,53,401
1997,10,l) Left Censored,3453,5837,191763,190901,533,9.1,549,9.4,27393,11061,16332,5.8,14.3,25668,10068,15600,5.3,13.4,1725,0.9,26.8,0,115,115,1838
1997,11,a) 0,1150,1171,7638,3842,1160,198.1,0,0,7592,7592,0,197.6,197.6,0,0,0,0,0,7592,197.6,0,0,,,
1997,11,b) 1,884,890,6423,6542,9,0.9,225,22.3,1462,147,1315,2.2,22.3,1700,844,856,12.9,26,-238,-3.7,44.6,0,164,164,691
1997,11,c) 2,773,794,7497,7888,33,3.9,144,16.9,1379,119,1260,1.5,17.5,2160,995,1165,12.6,27.4,-781,-9.9,35,0,115,115,858
1997,11,d) 3,717,738,6209,6482,18,2.3,99,12.7,935,67,868,1,14.4,1480,577,903,8.9,22.8,-545,-8.4,28.8,0,73,73,355
1997,11,e) 4,591,606,6227,6159,17,2.7,79,12.4,1143,95,1048,1.5,18.6,1006,367,639,6,16.3,137,2.3,32.6,0,63,63,279
1997,11,f) 5,592,662,11828,11822,29,4.2,90,13,1602,659,943,5.6,13.6,1589,565,1024,4.8,13.4,13,0.2,26.8,0,60,60,365
1997,11,g) 6 to 10,2453,2587,34923,35374,111,4.1,334,12.4,5735,1171,4564,3.3,16.2,6637,2475,4162,7,18.8,-902,-2.6,32.4,0,189,189,1007
1997,11,h) 11 to 15,2106,2310,32731,32291,86,3.6,217,9.1,5383,1585,3798,4.9,16.7,4503,1718,2785,5.3,13.9,880,2.8,27.8,0,115,115,749
1997,11,i) 16 to 20,1585,1927,60996,60813,70,3.5,173,8.7,5682,1196,4486,2,9.3,5316,1356,3960,2.2,8.7,366,0.6,17.4,0,78,78,457
1997,11,l) Left Censored,4006,6121,215385,218159,400,6.4,674,10.8,25918,6061,19857,2.8,11.9,31465,13013,18452,6,14.4,-5547,-2.5,23.8,0,157,157,1632
1997,12,a) 0,37290,37653,223519,112174,37402,198.7,0,0,222691,222691,0,198.5,198.5,0,0,0,0,0,222691,198.5,0,0,,,
1997,12,b) 1,27932,28353,188280,192404,216,0.7,8876,26.9,58983,4415,54568,2.3,30.7,67230,39007,28223,20.3,34.9,-8247,-4.2,61.4,0,7266,7266,33525
1997,12,c) 2,23200,23590,165050,173666,837,3.2,5352,20.6,37987,5899,32088,3.4,21.9,55219,32411,22808,18.7,31.8,-17232,-9.9,43.8,0,4417,4417,26660
1997,12,d) 3,20232,20730,167739,169023,740,3.3,3982,17.8,40530,6791,33739,4,24,43098,23594,19504,14,25.5,-2568,-1.5,48,0,3217,3217,19867
1997,12,e) 4,17462,18161,158021,163056,822,4.3,3030,15.7,31871,5404,26467,3.3,19.5,41943,23709,18234,14.5,25.7,-10072,-6.2,39,0,2451,2451,19649
1997,12,f) 5,15161,15820,144341,146821,568,3.4,2384,14.2,26810,4133,22677,2.8,18.3,31769,14718,17051,10,21.6,-4959,-3.3,36.6,0,1862,1862,12075
1997,12,g) 6 to 10,58500,63138,717484,730968,2442,3.7,7698,11.7,125231,32326,92905,4.4,17.1,152198,60553,91645,8.3,20.8,-26967,-3.7,34.2,0,5530,5530,38760
1997,12,h) 11 to 15,36658,41907,582433,590889,1962,4.6,4247,9.9,112105,34139,77966,5.8,19,129018,54896,74122,9.3,21.8,-16913,-2.8,38,0,2616,2617,23381
1997,12,i) 16 to 20,23931,31357,485963,487144,1798,5.6,3004,9.4,78028,24117,53911,5,16,80390,26746,53644,5.5,16.5,-2362,-0.5,32,0,1471,1471,10258
1997,12,l) Left Censored,32021,79271,2581594,2577157,6530,8.2,7474,9.4,388218,128597,259621,5,15.1,379344,129471,249873,5,14.7,8874,0.4,29.4,0,1632,1632,15523
1997,13,a) 0,16068,16312,92155,46330,16219,198.9,0,0,91651,91651,0,197.8,197.8,0,0,0,0,0,91651,197.8,0,0,,,
1997,13,b) 1,12124,12331,92314,93901,136,1,3784,26.5,28651,3062,25589,3.3,30.5,31824,19504,12320,20.8,33.9,-3173,-3.4,61,0,3010,3010,15661
1997,13,c) 2,9866,10180,84163,88193,386,3.5,2157,19.4,19742,3187,16555,3.6,22.4,27801,16449,11352,18.7,31.5,-8059,-9.1,44.8,0,1794,1794,14933
1997,13,d) 3,8492,8758,86359,86008,316,3.4,1491,15.9,20943,2817,18126,3.3,24.4,20240,10643,9597,12.4,23.5,703,0.9,47,0,1177,1177,7864
1997,13,e) 4,7063,7303,69138,70495,327,4.2,1115,14.5,14997,3189,11808,4.5,21.3,17712,9448,8264,13.4,25.1,-2715,-3.8,42.6,0,894,894,7371
1997,13,f) 5,6044,6328,65178,65846,231,3.5,866,13,11705,1907,9798,2.9,17.8,13041,5999,7042,9.1,19.8,-1336,-2,35.6,0,653,653,4589
1997,13,g) 6 to 10,23387,25566,319005,326697,1143,4.3,2893,10.9,50997,12554,38443,3.8,15.6,66380,23056,43324,7.1,20.3,-15383,-4.7,31.2,0,2026,2026,14381
1997,13,h) 11 to 15,16771,19156,265797,271822,797,4.1,1665,8.5,43331,12612,30719,4.6,15.9,55380,28730,26650,10.6,20.4,-12049,-4.5,31.8,0,980,980,20595
1997,13,i) 16 to 20,11360,14937,271746,267201,808,5.3,1277,8.4,49280,17338,31942,6.5,18.4,40190,12727,27463,4.8,15,9090,3.4,30,0,589,589,4044
1997,13,l) Left Censored,19853,45244,1673749,1667492,3337,7.3,3815,8.4,254020,79771,174249,4.8,15.2,241507,73439,168068,4.4,14.5,12513,0.7,29,0,841,841,7692
1997,15,a) 0,1883,1890,9814,4919,1878,198.7,0,0,9790,9790,0,199,199,0,0,0,0,0,9790,199,0,0,,,
1997,15,b) 1,1535,1598,12384,12618,28,1.5,398,22,3265,659,2606,5.2,25.9,3733,2132,1601,16.9,29.6,-468,-3.7,51.8,0,324,324,1877
1997,15,c) 2,1256,1281,11324,11837,48,3.5,241,17.4,1609,175,1434,1.5,13.6,2635,974,1661,8.2,22.3,-1026,-8.7,27.2,0,195,195,864
1997,15,d) 3,1098,1124,15550,15712,42,3.5,180,15.1,2028,240,1788,1.5,12.9,2352,870,1482,5.5,15,-324,-2.1,25.8,0,150,150,691
1997,15,e) 4,946,992,9096,9118,48,4.6,166,15.8,1487,334,1153,3.7,16.3,1531,639,892,7,16.8,-44,-0.5,32.6,0,130,130,537
1997,15,f) 5,894,936,10339,10889,37,3.7,147,14.9,1093,187,906,1.7,10,2193,918,1275,8.4,20.1,-1100,-10.1,20,0,113,113,583
1997,15,g) 6 to 10,3978,4383,50677,51753,174,3.8,562,12.3,6691,1032,5659,2,12.9,8843,3496,5347,6.8,17.1,-2152,-4.2,25.8,0,364,364,1938
1997,15,h) 11 to 15,2972,3384,38212,39286,122,3.5,316,9.1,4131,595,3536,1.5,10.5,6279,1921,4358,4.9,16,-2148,-5.5,21,0,195,195,1195
1997,15,i) 16 to 20,2586,3479,52034,51472,173,4.9,290,8.2,8052,1617,6435,3.1,15.6,6928,2094,4834,4.1,13.5,1124,2.1,27,0,133,133,824
1997,15,l) Left Censored,4318,7942,211703,213870,365,4.5,637,7.9,22305,6028,16277,2.8,10.4,26639,7361,19278,3.4,12.5,-4334,-2.1,20.8,0,158,158,1089
1997,16,a) 0,3337,3381,16141,8114,3342,197.7,0,0,16054,16054,0,197.9,197.9,0,0,0,0,0,16054,197.9,0,0,,,
1997,16,b) 1,2356,2385,14960,15146,22,0.8,750,26.9,4166,557,3609,3.7,27.5,4537,2770,1767,18.3,30,-371,-2.5,55,0,584,584,2263
1997,16,c) 2,1930,1952,11558,12320,66,3.1,439,20.5,2287,209,2078,1.7,18.6,3811,1958,1853,15.9,30.9,-1524,-12.3,37.2,0,359,359,1645
1997,16,d) 3,1716,1752,11744,12234,81,4.4,278,15,2176,325,1851,2.7,17.8,3155,1379,1776,11.3,25.8,-979,-8,35.6,0,220,220,1162
1997,16,e) 4,1306,1340,9980,10437,69,4.9,210,14.9,1958,282,1676,2.7,18.8,2871,1711,1160,16.4,27.5,-913,-8.7,37.6,0,148,148,634
1997,16,f) 5,1220,1249,9287,9457,33,2.5,158,12.1,1800,145,1655,1.5,19,2140,738,1402,7.8,22.6,-340,-3.6,38,0,118,118,520
1997,16,g) 6 to 10,4334,4597,43802,45780,170,3.5,556,11.6,6325,1159,5166,2.5,13.8,10280,4749,5531,10.4,22.5,-3955,-8.7,27.6,0,354,354,1897
1997,16,h) 11 to 15,2994,3402,40572,41722,171,4.9,318,9.1,6159,1793,4366,4.3,14.8,8459,4030,4429,9.7,20.3,-2300,-5.5,29.6,0,192,192,1328
1997,16,i) 16 to 20,2449,3000,52274,51497,184,6.1,235,7.8,7648,2404,5244,4.7,14.9,6094,1747,4347,3.4,11.8,1554,3.1,23.6,0,130,130,866
1997,16,l) Left Censored,3933,6965,178042,177214,416,5.9,618,8.7,25008,6603,18405,3.7,14.1,23352,7235,16117,4.1,13.2,1656,0.9,26.4,0,155,155,962
1997,17,a) 0,20230,20497,121265,60945,20320,198.3,0,0,120640,120640,0,197.9,197.9,0,0,0,0,0,120640,197.9,0,0,,,
1997,17,b) 1,16018,16248,114013,114728,178,1,4152,22.6,34069,5525,28544,4.8,29.7,35499,20923,14576,18.2,30.9,-1430,-1.2,59.4,0,3298,3298,17732
1997,17,c) 2,13911,14231,110827,115555,517,3.4,2494,16.3,24070,3248,20822,2.8,20.8,33525,18476,15049,16,29,-9455,-8.2,41.6,0,1968,1968,16632
1997,17,d) 3,12006,12259,109776,110390,403,3.1,1904,14.6,24114,4123,19991,3.7,21.8,25342,11793,13549,10.7,23,-1228,-1.2,43.6,0,1502,1502,9957
1997,17,e) 4,10650,10958,105227,109629,392,3.4,1468,12.7,16488,2676,13812,2.4,15,25292,13641,11651,12.4,23.1,-8804,-8.1,30,0,1177,1177,12218
1997,17,f) 5,9447,9893,104556,104527,311,3,1229,11.8,17738,3886,13852,3.7,17,17679,6909,10770,6.6,16.9,59,0.1,33.8,0,944,944,5617
1997,17,g) 6 to 10,39840,42584,515765,521730,1473,3.3,4469,10.1,77529,18668,58861,3.6,14.9,89459,32526,56933,6.2,17.1,-11930,-2.2,29.8,0,3101,3101,20080
1997,17,h) 11 to 15,29242,32701,500759,503645,1139,3.4,2789,8.3,68221,14446,53775,2.9,13.5,73993,20839,53154,4.1,14.7,-5772,-1.2,27,0,1679,1679,10348
1997,17,i) 16 to 20,21944,27380,462678,459995,1320,4.7,2243,8,65016,15532,49484,3.4,14.1,59649,19330,40319,4.2,13,5367,1.1,26,0,1047,1047,7490
1997,17,l) Left Censored,44446,79540,2877428,2876927,4697,5.8,6762,8.4,360723,95196,265527,3.3,12.5,359721,117240,242481,4.1,12.5,1002,0,25,0,1856,1856,12667
1997,18,a) 0,9790,9878,55888,28058,9812,198.7,0,0,55660,55660,0,198.4,198.4,0,0,0,0,0,55660,198.4,0,0,,,
1997,18,b) 1,7660,7832,59135,57498,99,1.1,2121,23.8,19629,1698,17931,3,34.1,16354,9819,6535,17.1,28.4,3275,5.7,56.8,0,1739,1739,7787
1997,18,c) 2,6632,6795,49892,52046,248,3.4,1277,17.4,10421,1681,8740,3.2,20,14729,8461,6268,16.3,28.3,-4308,-8.3,40,0,1035,1035,6979
1997,18,d) 3,5722,5879,50162,51323,189,3,973,15.5,9584,1317,8267,2.6,18.7,11906,6150,5756,12,23.2,-2322,-4.5,37.4,0,788,788,4314
1997,18,e) 4,5002,5164,42204,42883,184,3.4,708,13,7952,2041,5911,4.8,18.5,9309,4036,5273,9.4,21.7,-1357,-3.2,37,0,579,579,3381
1997,18,f) 5,4441,4778,53677,52700,160,3.2,578,11.6,11811,1899,9912,3.6,22.4,9856,3368,6488,6.4,18.7,1955,3.7,37.4,0,450,450,2562
1997,18,g) 6 to 10,18339,20030,251568,254887,762,3.7,2124,10.2,37640,7667,29973,3,14.8,44278,16946,27332,6.6,17.4,-6638,-2.6,29.6,0,1520,1520,11219
1997,18,h) 11 to 15,13940,16007,218363,219649,683,4.2,1327,8.1,31703,8798,22905,4,14.4,34276,13532,20744,6.2,15.6,-2573,-1.2,28.8,0,819,819,5943
1997,18,i) 16 to 20,10052,12970,226597,230267,601,4.6,996,7.6,30240,8679,21561,3.8,13.1,37579,12427,25152,5.4,16.3,-7339,-3.2,26.2,0,511,511,3534
1997,18,l) Left Censored,21215,41099,1425043,1419100,2600,6.3,3197,7.7,175189,45791,129398,3.2,12.3,163302,52937,110365,3.7,11.5,11887,0.8,23,0,833,833,8708
1997,19,a) 0,4843,4937,27135,13610,4900,198.5,0,0,27051,27051,0,198.8,198.8,0,0,0,0,0,27051,198.8,0,0,,,
1997,19,b) 1,3886,3935,24442,24906,36,0.8,923,20.9,6195,557,5638,2.2,24.9,7122,4004,3118,16.1,28.6,-927,-3.7,49.8,0,722,722,3392
1997,19,c) 2,3417,3497,23995,24916,123,3.3,610,16.2,4559,657,3902,2.6,18.3,6401,3811,2590,15.3,25.7,-1842,-7.4,36.6,0,508,508,3180
1997,19,d) 3,3018,3075,22351,22765,91,2.8,476,14.6,4088,775,3313,3.4,18,4916,2292,2624,10.1,21.6,-828,-3.6,36,0,368,368,1672
1997,19,e) 4,2522,2559,16968,17853,76,2.8,307,11.5,2905,715,2190,4,16.3,4675,2181,2494,12.2,26.2,-1770,-9.9,32.6,0,252,252,2000
1997,19,f) 5,2230,2349,23609,23104,84,3.4,328,13.3,5539,979,4560,4.2,24,4528,2218,2310,9.6,19.6,1011,4.4,39.2,0,244,244,1748
1997,19,g) 6 to 10,9461,10143,114950,116352,365,3.5,1111,10.6,16100,3374,12726,2.9,13.8,18903,7978,10925,6.9,16.2,-2803,-2.4,27.6,0,794,794,5302
1997,19,h) 11 to 15,7598,8779,115115,115921,305,3.4,663,7.4,15295,3699,11596,3.2,13.2,16906,5211,11695,4.5,14.6,-1611,-1.4,26.4,0,404,404,2512
1997,19,i) 16 to 20,6658,8733,112893,112700,396,4.5,631,7.1,14366,4176,10190,3.7,12.7,13980,3903,10077,3.5,12.4,386,0.3,24.8,0,321,321,1726
1997,19,l) Left Censored,14321,23913,671302,674407,1085,4.5,1660,6.9,76814,17484,59330,2.6,11.4,83025,26352,56673,3.9,12.3,-6211,-0.9,22.8,0,542,542,5267
1997,20,a) 0,5191,5247,30613,15368,5210,198.6,0,0,30490,30490,0,198.4,198.4,0,0,0,0,0,30490,198.4,0,0,,,
1997,20,b) 1,3925,3975,25334,25903,31,0.7,1134,24.8,7362,1344,6018,5.2,28.4,8499,4742,3757,18.3,32.8,-1137,-4.4,56.8,0,928,928,4188
1997,20,c) 2,3372,3435,25875,26874,109,2.9,639,17.2,5720,1231,4489,4.6,21.3,7718,4606,3112,17.1,28.7,-1998,-7.4,42.6,0,508,508,3846
1997,20,d) 3,2879,2936,22531,22822,112,3.6,506,16.1,4870,873,3997,3.8,21.3,5452,2563,2889,11.2,23.9,-582,-2.6,42.6,0,396,396,1936
1997,20,e) 4,2471,2518,20426,20856,76,2.9,348,13.1,3341,507,2834,2.4,16,4200,1923,2277,9.2,20.1,-859,-4.1,32,0,283,283,1485
1997,20,f) 5,2224,2320,19456,20410,92,3.8,315,12.9,2757,619,2138,3,13.5,4664,2151,2513,10.5,22.9,-1907,-9.4,27,0,238,238,1540
1997,20,g) 6 to 10,8799,9445,107728,108151,366,3.7,1007,10.3,16195,2907,13288,2.7,15,17041,6631,10410,6.1,15.8,-846,-0.8,30,0,704,704,4523
1997,20,h) 11 to 15,7217,8020,90819,90839,325,4,707,8.6,13330,3487,9843,3.8,14.7,13369,4416,8953,4.9,14.7,-39,0,29.4,0,447,447,2425
1997,20,i) 16 to 20,5623,7236,105710,105010,376,5.1,568,7.7,16136,4457,11679,4.2,15.4,14736,4427,10309,4.2,14,1400,1.4,28,0,273,273,1461
1997,20,l) Left Censored,11626,20140,574844,569154,1274,6.3,1570,7.7,74328,22564,51764,4,13.1,62947,17985,44962,3.2,11.1,11381,2,22.2,0,426,426,2963
1997,21,a) 0,6344,6432,37170,18638,6395,198.8,0,0,37065,37065,0,198.9,198.9,0,0,0,0,0,37065,198.9,0,0,,,
1997,21,b) 1,4713,4845,37718,39685,57,1,1368,24.7,9794,607,9187,1.5,24.7,13727,7905,5822,19.9,34.6,-3933,-9.9,49.4,0,1132,1132,5958
1997,21,c) 2,4268,4375,35343,36410,150,3.2,779,16.6,7114,881,6233,2.4,19.5,9247,4666,4581,12.8,25.4,-2133,-5.9,39,0,633,633,4087
1997,21,d) 3,3540,3633,31657,32320,122,3.2,587,15.2,6219,743,5476,2.3,19.2,7545,3851,3694,11.9,23.3,-1326,-4.1,38.4,0,484,484,3105
1997,21,e) 4,3165,3271,30091,30818,112,3.2,471,13.6,5017,725,4292,2.4,16.3,6471,2787,3684,9,21,-1454,-4.7,32.6,0,362,362,2110
1997,21,f) 5,2819,2948,26399,26807,91,2.9,363,11.7,4356,554,3802,2.1,16.2,5171,1865,3306,7,19.3,-815,-3.1,32.4,0,269,269,1334
1997,21,g) 6 to 10,11392,12305,146891,147767,491,3.9,1283,10.1,23316,5827,17489,3.9,15.8,25067,9543,15524,6.5,17,-1751,-1.2,31.6,0,936,936,6662
1997,21,h) 11 to 15,8633,9642,132230,134046,329,3.3,862,8.7,16117,3010,13107,2.2,12,19748,6550,13198,4.9,14.7,-3631,-2.7,24,0,513,513,3087
1997,21,i) 16 to 20,6040,7570,137100,137397,341,4.4,612,7.9,20599,6171,14428,4.5,15,21192,6125,15067,4.5,15.4,-593,-0.4,30,0,311,311,2227
1997,21,l) Left Censored,12694,24327,772072,762302,1567,6.4,1912,7.8,108320,29459,78861,3.9,14.2,88780,29480,59300,3.9,11.6,19540,2.6,23.2,0,521,521,3700
1997,22,a) 0,7186,7280,48345,24271,7220,198.4,0,0,48148,48148,0,198.4,198.4,0,0,0,0,0,48148,198.4,0,0,,,
1997,22,b) 1,5430,5480,43930,43825,32,0.5,1584,25.1,13132,325,12807,0.7,30,12921,7356,5565,16.8,29.5,211,0.5,59,0,1283,1283,5752
1997,22,c) 2,4624,4700,48036,49353,153,3,892,17.5,10412,1023,9389,2.1,21.1,13045,6156,6889,12.5,26.4,-2633,-5.3,42.2,0,731,731,5269
1997,22,d) 3,4218,4348,41767,43206,132,2.8,701,15.1,7324,654,6670,1.5,17,10201,4587,5614,10.6,23.6,-2877,-6.6,34,0,578,578,3369
1997,22,e) 4,3558,3670,39504,39427,131,3.4,490,12.7,7852,2022,5830,5.1,19.9,7697,2773,4924,7,19.5,155,0.4,39,0,401,401,2248
1997,22,f) 5,3143,3295,32471,33283,118,3.4,438,12.7,5359,907,4452,2.7,16.1,6983,2988,3995,9,21,-1624,-4.9,32.2,0,328,328,1785
1997,22,g) 6 to 10,11768,12892,166019,169548,428,3.2,1339,10,27766,4695,23071,2.8,16.4,34824,14740,20084,8.7,20.5,-7058,-4.1,32.8,0,901,901,6064
1997,22,h) 11 to 15,10451,11885,151797,152889,395,3.3,916,7.5,21455,3329,18126,2.2,14,23639,7838,15801,5.1,15.5,-2184,-1.5,28,0,574,574,4065
1997,22,i) 16 to 20,8070,10126,158851,158632,429,4.2,672,6.6,22956,6100,16856,3.8,14.5,22518,6843,15675,4.3,14.2,438,0.3,28.4,0,381,381,3069
1997,22,l) Left Censored,13744,26044,730529,731004,1526,5.8,2092,7.9,99292,26425,72867,3.6,13.6,100241,35263,64978,4.8,13.7,-949,-0.1,27.2,0,572,572,4990
1997,23,a) 0,2723,2747,12003,6032,2722,198.2,0,0,11943,11943,0,198,198,0,0,0,0,0,11943,198,0,0,,,
1997,23,b) 1,2181,2222,13022,12966,24,1,539,21.5,3533,417,3116,3.2,27.2,3421,1969,1452,15.2,26.4,112,0.8,52.8,0,410,410,1554
1997,23,c) 2,1858,1872,10532,10657,56,2.8,323,16.1,2109,224,1885,2.1,19.8,2359,1185,1174,11.1,22.1,-250,-2.3,39.6,0,256,256,1044
1997,23,d) 3,1475,1496,10654,10845,41,2.6,239,14.9,1989,128,1861,1.2,18.3,2371,1141,1230,10.5,21.9,-382,-3.6,36.6,0,189,189,1020
1997,23,e) 4,1254,1278,9696,9832,46,3.4,173,12.9,1693,355,1338,3.6,17.2,1964,748,1216,7.6,20,-271,-2.8,34.4,0,132,132,516
1997,23,f) 5,1076,1148,8248,8607,68,5.7,142,12,1292,335,957,3.9,15,2009,786,1223,9.1,23.3,-717,-8.3,30,0,100,100,471
1997,23,g) 6 to 10,5412,5661,51852,52578,209,3.6,613,10.4,6943,1264,5679,2.4,13.2,8395,3387,5008,6.4,16,-1452,-2.8,26.4,0,462,462,2342
1997,23,h) 11 to 15,3735,4170,46644,46791,209,4.9,337,8,5803,1739,4064,3.7,12.4,6096,2339,3757,5,13,-293,-0.6,24.8,0,206,206,1576
1997,23,i) 16 to 20,2636,3450,50092,49949,202,5.8,269,7.7,7181,2082,5099,4.2,14.4,6894,2176,4718,4.4,13.8,287,0.6,27.6,0,134,134,933
1997,23,l) Left Censored,4855,7969,222530,222342,370,4.6,655,8.1,24660,4928,19732,2.2,11.1,24283,8807,15476,4,10.9,377,0.2,21.8,0,186,186,2146
1997,24,a) 0,9205,9300,52169,26199,9243,198.8,0,0,51940,51940,0,198.3,198.3,0,0,0,0,0,51940,198.3,0,0,,,
1997,24,b) 1,6854,7005,48402,48596,95,1.2,1863,23.4,15290,1745,13545,3.6,31.5,15678,9714,5964,20,32.3,-388,-0.8,63,0,1459,1459,7840
1997,24,c) 2,6116,6228,44225,45385,214,3.2,1236,18.3,10972,1550,9422,3.4,24.2,13291,7618,5673,16.8,29.3,-2319,-5.1,48.4,0,959,959,5439
1997,24,d) 3,5100,5275,45788,45540,202,3.6,874,15.5,10693,1637,9056,3.6,23.5,10196,4969,5227,10.9,22.4,497,1.1,44.8,0,678,678,4039
1997,24,e) 4,4522,4632,46879,46836,178,3.6,677,13.8,8273,827,7446,1.8,17.7,8187,3809,4378,8.1,17.5,86,0.2,35,0,528,528,2960
1997,24,f) 5,3891,4148,41303,40937,171,3.9,560,12.9,8031,1460,6571,3.6,19.6,7298,3281,4017,8,17.8,733,1.8,35.6,0,419,419,2420
1997,24,g) 6 to 10,17565,18735,225703,224941,721,3.7,2039,10.5,40542,6465,34077,2.9,18,39018,11990,27028,5.3,17.3,1524,0.7,34.6,0,1440,1440,8262
1997,24,h) 11 to 15,12151,13719,180941,181388,574,4.1,1247,8.9,28634,6540,22094,3.6,15.8,29528,10902,18626,6,16.3,-894,-0.5,31.6,0,711,711,4934
1997,24,i) 16 to 20,8104,10416,176631,175702,466,4.4,914,8.6,26372,7564,18808,4.3,15,24514,7490,17024,4.3,14,1858,1,28,0,401,401,2512
1997,24,l) Left Censored,16038,30855,1007780,1002259,2016,6.4,2934,9.4,151251,52908,98343,5.3,15.1,140209,47931,92278,4.8,14,11042,1.1,28,0,712,712,5228
1997,25,a) 0,11219,11355,63755,32000,11274,198.6,0,0,63510,63510,0,198.5,198.5,0,0,0,0,0,63510,198.5,0,0,,,
1997,25,b) 1,8555,8627,62357,60081,31,0.3,1913,19.8,18729,828,17901,1.4,31.2,14177,7891,6286,13.1,23.6,4552,7.6,47.2,0,1496,1496,6635
1997,25,c) 2,7654,7800,64179,63713,254,3,1268,15.2,15435,1552,13883,2.4,24.2,14502,6877,7625,10.8,22.8,933,1.4,45.6,0,1010,1010,5799
1997,25,d) 3,6615,6725,59603,59714,226,3.2,933,13.2,11398,1694,9704,2.8,19.1,11620,5674,5946,9.5,19.5,-222,-0.4,38.2,0,759,759,4954
1997,25,e) 4,5356,5493,50932,51683,156,2.7,672,11.7,10005,1231,8774,2.4,19.4,11507,4934,6573,9.5,22.3,-1502,-2.9,38.8,0,544,544,4300
1997,25,f) 5,4652,5032,54442,53952,155,3,531,10.2,11046,1417,9629,2.6,20.5,10066,4364,5702,8.1,18.7,980,1.8,37.4,0,392,392,3365
1997,25,g) 6 to 10,22009,23454,303201,300256,853,3.5,2310,9.5,51352,10771,40581,3.6,17.1,45461,19234,26227,6.4,15.1,5891,2,30.2,0,1599,1599,10299
1997,25,h) 11 to 15,16729,18668,283523,280977,742,3.9,1563,8.2,46042,11890,34152,4.2,16.4,40950,17434,23516,6.2,14.6,5092,1.8,29.2,0,906,906,8561
1997,25,i) 16 to 20,11653,14922,283542,283177,765,5.1,1077,7.1,38703,11814,26889,4.2,13.7,37972,8801,29171,3.1,13.4,731,0.3,26.8,0,530,530,3683
1997,25,l) Left Censored,26869,45017,1580203,1581909,2528,5.6,3461,7.6,199008,63551,135457,4,12.6,202421,61021,141400,3.9,12.8,-3413,-0.2,25.2,0,1049,1049,11846
1997,26,a) 0,16309,16586,102060,51369,16450,198.4,0,0,101383,101383,0,197.4,197.4,0,0,0,0,0,101383,197.4,0,0,,,
1997,26,b) 1,12881,13026,105237,109542,91,0.6,3005,20.6,28543,4421,24122,4,26.1,37152,12460,24692,11.4,33.9,-8609,-7.8,52.2,0,2330,2330,10550
1997,26,c) 2,11275,11468,90220,94511,324,2.6,2050,16.6,18743,1756,16987,1.9,19.8,27325,12119,15206,12.8,28.9,-8582,-9.1,39.6,0,1652,1652,10621
1997,26,d) 3,9378,9589,87273,89288,284,2.8,1400,13.8,16225,1705,14520,1.9,18.2,20255,8774,11481,9.8,22.7,-4030,-4.5,36.4,0,1063,1063,5849
1997,26,e) 4,8132,8336,73955,76641,249,2.8,1121,12.8,11411,1670,9741,2.2,14.9,16783,6710,10073,8.8,21.9,-5372,-7,29.8,0,874,874,5696
1997,26,f) 5,7118,7455,74410,74822,212,2.7,938,12,13242,1803,11439,2.4,17.7,14065,6417,7648,8.6,18.8,-823,-1.1,35.4,0,733,733,5326
1997,26,g) 6 to 10,31067,33418,385042,388084,1167,3.4,3448,10,59436,11089,48347,2.9,15.3,65520,26229,39291,6.8,16.9,-6084,-1.6,30.6,0,2439,2439,15649
1997,26,h) 11 to 15,21948,25310,364956,367027,952,3.7,2141,8.3,54219,14854,39365,4,14.8,58360,20111,38249,5.5,15.9,-4141,-1.1,29.6,0,1273,1273,8247
1997,26,i) 16 to 20,16328,20673,336518,336406,813,3.9,1661,7.9,49305,13645,35660,4.1,14.7,49080,14504,34576,4.3,14.6,225,0.1,29.2,0,794,794,6169
1997,26,l) Left Censored,31866,60116,2168448,2155586,2912,4.8,4946,8.1,287023,65581,221442,3,13.3,261300,85605,175695,4,12.1,25723,1.2,24.2,0,1375,1375,11951
1997,27,a) 0,9485,9565,50253,25246,9482,198.3,0,0,50014,50014,0,198.1,198.1,0,0,0,0,0,50014,198.1,0,0,,,
1997,27,b) 1,7285,7372,49109,50102,73,0.9,1798,21.7,14039,1834,12205,3.7,28,16025,10645,5380,21.2,32,-1986,-4,56,0,1367,1367,8663
1997,27,c) 2,6172,6276,45033,47560,185,2.7,1239,18.1,9871,886,8985,1.9,20.8,14924,8503,6421,17.9,31.4,-5053,-10.6,41.6,0,1005,1005,6550
1997,27,d) 3,5533,5697,47106,47265,223,3.7,805,13.4,10452,2626,7826,5.6,22.1,10770,6267,4503,13.3,22.8,-318,-0.7,44.2,0,627,627,4944
1997,27,e) 4,4703,4929,44740,46018,188,3.6,624,12.1,8258,1920,6338,4.2,17.9,10813,4775,6038,10.4,23.5,-2555,-5.6,35.8,0,467,467,2914
1997,27,f) 5,4173,4376,39366,39598,141,3.1,494,10.8,6819,929,5890,2.3,17.2,7283,2910,4373,7.3,18.4,-464,-1.2,34.4,0,340,340,1933
1997,27,g) 6 to 10,17118,18539,215080,215201,742,3.9,1711,9,35302,6020,29282,2.8,16.4,35544,13014,22530,6,16.5,-242,-0.1,32.8,0,1167,1167,7821
1997,27,h) 11 to 15,12178,14007,209574,209806,525,3.7,1104,7.7,28614,6154,22460,2.9,13.6,29077,10333,18744,4.9,13.9,-463,-0.3,27.2,0,641,641,4340
1997,27,i) 16 to 20,9439,12066,207320,206596,593,4.8,925,7.6,30672,8782,21890,4.3,14.8,29224,8891,20333,4.3,14.1,1448,0.7,28.2,0,428,428,3221
1997,27,l) Left Censored,18485,32410,1236281,1231692,1729,5.3,2550,7.8,150732,40552,110180,3.3,12.2,141554,48735,92819,4,11.5,9178,0.7,23,0,708,708,7426
1997,28,a) 0,4483,4522,25431,12770,4480,198.1,0,0,25322,25322,0,198.3,198.3,0,0,0,0,0,25322,198.3,0,0,,,
1997,28,b) 1,3384,3482,24759,25487,56,1.4,1021,25.4,6921,1241,5680,4.9,27.2,8377,4614,3763,18.1,32.9,-1456,-5.7,54.4,0,826,826,3342
1997,28,c) 2,2922,2983,23239,23386,117,3.6,606,18.7,5346,1013,4333,4.3,22.9,5640,3276,2364,14,24.1,-294,-1.2,45.8,0,506,506,2748
1997,28,d) 3,2518,2595,27718,27900,114,4.1,433,15.7,5237,1119,4118,4,18.8,5600,2505,3095,9,20.1,-363,-1.3,37.6,0,355,355,1781
1997,28,e) 4,2156,2236,21380,22336,89,3.8,280,12,3438,933,2505,4.2,15.4,5350,1562,3788,7,24,-1912,-8.6,30.8,0,219,219,1343
1997,28,f) 5,1697,1819,16944,17708,78,4.1,269,14.1,2672,833,1839,4.7,15.1,4200,1707,2493,9.6,23.7,-1528,-8.6,30.2,0,193,193,1233
1997,28,g) 6 to 10,7040,7566,92358,92308,272,3.5,849,10.8,16535,1784,14751,1.9,17.9,16435,5004,11431,5.4,17.8,100,0.1,35.6,0,621,621,3419
1997,28,h) 11 to 15,5722,6310,72679,72615,250,3.9,472,7.4,11647,2220,9427,3.1,16,11519,3662,7857,5,15.9,128,0.1,31.8,0,318,318,1883
1997,28,i) 16 to 20,4453,5519,93094,92469,243,4.3,460,8.2,13606,3558,10048,3.8,14.7,12357,4373,7984,4.7,13.4,1249,1.3,26.8,0,268,268,1754
1997,28,l) Left Censored,8435,15912,485229,484952,897,5.6,1228,7.6,60554,15316,45238,3.2,12.5,59999,17180,42819,3.5,12.4,555,0.1,24.8,0,417,417,2886
1997,29,a) 0,10353,10441,54789,27469,10378,198.8,0,0,54641,54641,0,198.9,198.9,0,0,0,0,0,54641,198.9,0,0,,,
1997,29,b) 1,7985,8139,55792,55700,100,1.1,2350,25.1,17411,3209,14202,5.8,31.3,17226,9545,7681,17.1,30.9,185,0.4,61.8,0,1891,1891,7977
1997,29,c) 2,6882,7015,49108,51010,211,2.7,1557,20.1,10759,1316,9443,2.6,21.1,14562,8200,6362,16.1,28.5,-3803,-7.4,42.2,0,1272,1272,7126
1997,29,d) 3,6084,6290,53245,54095,227,3.4,1136,16.8,11044,2711,8333,5,20.4,12744,6229,6515,11.5,23.6,-1700,-3.2,40.8,0,924,924,5049
1997,29,e) 4,5015,5217,43365,45164,197,3.6,816,14.7,7237,965,6272,2.1,16,10834,5375,5459,11.9,24,-3597,-8,32,0,656,656,4570
1997,29,f) 5,4382,4591,48538,49346,169,3.5,633,13.1,8057,1056,7001,2.1,16.3,9674,4418,5256,9,19.6,-1617,-3.3,32.6,0,496,496,3012
1997,29,g) 6 to 10,18465,19869,218280,220668,710,3.4,2230,10.8,33818,5976,27842,2.7,15.3,38593,14077,24516,6.4,17.5,-4775,-2.2,30.6,0,1601,1601,9707
1997,29,h) 11 to 15,13954,15732,221075,218790,564,3.5,1317,8.2,33260,6534,26726,3,15.2,28689,9559,19130,4.4,13.1,4571,2.1,26.2,0,842,842,5298
1997,29,i) 16 to 20,10072,12945,221476,218740,574,4.3,1111,8.4,33685,12335,21350,5.6,15.4,28212,8689,19523,4,12.9,5473,2.5,25.8,0,542,542,3246
1997,29,l) Left Censored,20313,37403,1275389,1269459,1908,5,2961,7.8,162118,38562,123556,3,12.8,150258,48394,101864,3.8,11.8,11860,1,23.6,0,896,896,10010
1997,30,a) 0,2555,2567,11133,5612,2541,198,0,0,11043,11043,0,196.8,196.8,0,0,0,0,0,11043,196.8,0,0,,,
1997,30,b) 1,1990,2009,10585,11187,17,0.7,545,23.7,2465,131,2334,1.2,22,3668,1853,1815,16.6,32.8,-1203,-10.8,44,0,420,420,1561
1997,30,c) 2,1706,1723,9593,10238,49,2.6,311,16.7,1733,239,1494,2.3,16.9,3023,1725,1298,16.8,29.5,-1290,-12.6,33.8,0,236,236,1501
1997,30,d) 3,1364,1390,8610,8921,67,4.6,222,15.1,1462,299,1163,3.4,16.4,2083,833,1250,9.3,23.3,-621,-6.9,32.8,0,186,186,736
1997,30,e) 4,1145,1171,7119,7379,46,3.8,155,12.6,1114,191,923,2.6,15.1,1633,663,970,9,22.1,-519,-7,30.2,0,126,126,560
1997,30,f) 5,1045,1060,6873,7134,35,3.2,127,11.4,893,142,751,2,12.5,1415,574,841,8,19.8,-522,-7.3,25,0,102,102,495
1997,30,g) 6 to 10,3732,3928,33263,34256,149,3.7,439,10.8,4500,803,3697,2.3,13.1,6485,2416,4069,7.1,18.9,-1985,-5.8,26.2,0,318,318,1727
1997,30,h) 11 to 15,2966,3283,30447,30681,153,4.6,267,8,4279,1169,3110,3.8,13.9,4746,1512,3234,4.9,15.5,-467,-1.6,27.8,0,169,169,879
1997,30,i) 16 to 20,2423,2922,34554,34456,125,4.2,230,7.7,4858,903,3955,2.6,14.1,4661,1191,3470,3.5,13.5,197,0.6,27,0,139,139,616
1997,30,l) Left Censored,3705,5997,114041,114391,291,4.8,487,8,15068,3388,11680,3,13.2,15768,5836,9932,5.1,13.8,-700,-0.6,26.4,0,152,152,1096
1997,31,a) 0,3203,3236,15244,7659,3205,198.1,0,0,15170,15170,0,198.1,198.1,0,0,0,0,0,15170,198.1,0,0,,,
1997,31,b) 1,2434,2464,16736,16791,24,0.9,611,22,4439,416,4023,2.5,26.4,4549,2816,1733,16.8,27.1,-110,-0.7,52.8,0,468,468,2523
1997,31,c) 2,2066,2112,15096,16082,69,3,412,18,2840,625,2215,3.9,17.7,4811,2740,2071,17,29.9,-1971,-12.2,35.4,0,322,322,2117
1997,31,d) 3,1842,1896,13629,14605,73,3.6,285,14.2,2687,698,1989,4.8,18.4,4639,2536,2103,17.4,31.8,-1952,-13.4,36.8,0,223,223,2308
1997,31,e) 4,1648,1694,13080,13441,55,3.1,219,12.3,2338,480,1858,3.6,17.4,3059,1597,1462,11.9,22.8,-721,-5.4,34.8,0,178,178,985
1997,31,f) 5,1472,1519,11772,12003,54,3.4,171,10.8,2156,897,1259,7.5,18,2617,918,1699,7.6,21.8,-461,-3.8,36,0,135,135,830
1997,31,g) 6 to 10,5957,6463,76752,77197,258,3.9,646,9.7,16015,7641,8374,9.9,20.7,16904,3944,12960,5.1,21.9,-889,-1.2,41.4,0,468,468,2847
1997,31,h) 11 to 15,4890,5478,71542,72360,213,3.8,417,7.5,9171,1560,7611,2.2,12.7,10807,4100,6707,5.7,14.9,-1636,-2.2,25.4,0,271,271,1877
1997,31,i) 16 to 20,3984,5036,73202,73267,226,4.4,343,6.7,9430,2907,6523,4,12.9,9560,2386,7174,3.3,13,-130,-0.1,25.8,0,198,198,1209
1997,31,l) Left Censored,8313,13293,382299,382996,553,4.1,999,7.4,42532,11447,31085,3,11.1,43925,11724,32201,3.1,11.5,-1393,-0.4,22.2,0,288,288,1564
1997,32,a) 0,4415,4440,30915,15506,4407,198.5,0,0,30819,30819,0,198.8,198.8,0,0,0,0,0,30819,198.8,0,0,,,
1997,32,b) 1,2942,2991,38760,35871,33,0.9,986,28.2,14078,354,13724,1,39.2,8300,5024,3276,14,23.1,5778,16.1,46.2,0,809,809,4262
1997,32,c) 2,2448,2496,28882,28433,105,3.9,539,19.8,8691,1825,6866,6.4,30.6,7793,3852,3941,13.5,27.4,898,3.2,54.8,0,441,441,3098
1997,32,d) 3,1947,2010,24780,25397,102,4.7,391,18.2,4863,1534,3329,6,19.1,6096,2935,3161,11.6,24,-1233,-4.9,38.2,0,325,325,2356
1997,32,e) 4,1510,1551,21176,20704,68,4.1,250,15.2,4901,445,4456,2.1,23.7,3957,1776,2181,8.6,19.1,944,4.6,38.2,0,200,200,1618
1997,32,f) 5,1275,1325,15825,16631,61,4.4,201,14.4,2611,500,2111,3,15.7,4222,1412,2810,8.5,25.4,-1611,-9.7,31.4,0,152,152,969
1997,32,g) 6 to 10,5247,5724,83528,83152,328,5.6,641,10.9,15495,4128,11367,5,18.6,14743,4578,10165,5.5,17.7,752,0.9,35.4,0,443,443,3150
1997,32,h) 11 to 15,3240,3888,72769,72751,257,6.5,378,9.6,12373,3433,8940,4.7,17,12336,2799,9537,3.8,17,37,0,34,0,175,175,802
1997,32,i) 16 to 20,2631,3457,96118,94008,278,8,300,8.6,14209,6004,8205,6.4,15.1,9989,2363,7626,2.5,10.6,4220,4.5,21.2,0,138,138,836
1997,32,l) Left Censored,3842,7625,337759,335481,997,13.2,802,10.6,49980,19306,30674,5.8,14.9,45423,14693,30730,4.4,13.5,4557,1.4,27,0,133,133,1027
1997,33,a) 0,2767,2790,14151,7093,2774,198.9,0,0,14117,14117,0,199,199,0,0,0,0,0,14117,199,0,0,,,
1997,33,b) 1,2192,2229,15848,15404,13,0.5,540,21.5,4446,95,4351,0.6,28.9,3558,2274,1284,14.8,23.1,888,5.8,46.2,0,444,444,2085
1997,33,c) 2,1831,1843,12603,13111,50,2.5,312,15.7,2528,194,2334,1.5,19.3,3543,2071,1472,15.8,27,-1015,-7.7,38.6,0,254,254,1823
1997,33,d) 3,1561,1586,11699,11941,52,3.1,223,13.3,1928,147,1781,1.2,16.1,2412,1092,1320,9.1,20.2,-484,-4.1,32.2,0,180,180,956
1997,33,e) 4,1277,1295,10701,10753,44,3.2,164,12.1,2246,490,1756,4.6,20.9,2349,886,1463,8.2,21.8,-103,-0.9,41.8,0,125,125,752
1997,33,f) 5,1111,1177,11333,11373,53,4.3,135,11.1,2061,336,1725,3,18.1,2141,891,1250,7.8,18.8,-80,-0.7,36.2,0,107,107,702
1997,33,g) 6 to 10,5291,5533,55247,55646,181,3.1,608,10.6,8472,1349,7123,2.4,15.2,9269,3619,5650,6.5,16.7,-797,-1.5,30.4,0,428,428,2574
1997,33,h) 11 to 15,3799,4166,55311,57360,187,4.4,380,8.9,7597,1920,5677,3.3,13.2,11695,2933,8762,5.1,20.4,-4098,-7.2,26.4,0,247,247,1202
1997,33,i) 16 to 20,2408,3041,47799,47393,134,4.3,266,8.6,6460,1464,4996,3.1,13.6,5648,1592,4056,3.4,11.9,812,1.7,23.8,0,135,135,781
1997,33,l) Left Censored,4753,8153,254723,253873,491,6,678,8.2,30225,8006,22219,3.2,11.9,28524,9859,18665,3.9,11.2,1701,0.7,22.4,0,150,150,838
1997,34,a) 0,17655,17828,88043,44216,17690,198.5,0,0,87655,87655,0,198.2,198.2,0,0,0,0,0,87655,198.2,0,0,,,
1997,34,b) 1,13343,13483,90523,87560,83,0.5,3328,21.8,31797,4619,27178,5.3,36.3,25871,14218,11653,16.2,29.5,5926,6.8,59,0,2603,2603,11697
1997,34,c) 2,11413,11781,87753,87520,468,3.7,2153,17,22430,4302,18128,4.9,25.6,21963,11811,10152,13.5,25.1,467,0.5,50.2,0,1670,1670,9004
1997,34,d) 3,9153,9251,67007,68369,317,3.2,1461,14.9,14743,2014,12729,2.9,21.6,17467,9410,8057,13.8,25.5,-2724,-3.9,43.2,0,1149,1149,7479
1997,34,e) 4,8188,8284,65735,67944,282,3.2,1174,13.4,12687,1266,11421,1.9,18.7,17105,8569,8536,12.6,25.2,-4418,-6.5,37.4,0,942,942,7381
1997,34,f) 5,6948,7154,60700,62429,243,3.2,994,13.2,10620,1219,9401,2,17,14078,6989,7089,11.2,22.6,-3458,-5.6,34,0,767,767,5570
1997,34,g) 6 to 10,31869,33277,343789,343489,1220,3.5,3527,10.2,56214,8775,47439,2.6,16.4,55614,20608,35006,6,16.2,600,0.2,32.4,0,2496,2496,13710
1997,34,h) 11 to 15,22434,24417,322104,322696,873,3.5,2268,9,47982,10824,37158,3.4,14.9,49165,18372,30793,5.7,15.2,-1183,-0.3,29.8,0,1474,1474,9443
1997,34,i) 16 to 20,16372,18649,298396,298301,650,3.4,1596,8.3,42108,10461,31647,3.5,14.1,41918,12752,29166,4.3,14.1,190,0,28.2,0,893,893,5192
1997,34,l) Left Censored,32880,54123,1834541,1828762,3421,6.2,5237,9.5,276026,81245,194781,4.4,15.1,264468,97274,167194,5.3,14.5,11558,0.6,29,0,1565,1565,10876
1997,35,a) 0,3359,3389,18926,9518,3360,198.3,0,0,18816,18816,0,197.7,197.7,0,0,0,0,0,18816,197.7,0,0,,,
1997,35,b) 1,2533,2564,17815,18279,17,0.6,832,27.6,4837,329,4508,1.8,26.5,5765,3199,2566,17.5,31.5,-928,-5,53,0,670,670,2669
1997,35,c) 2,2222,2269,17271,17997,74,3,489,19.7,3696,498,3198,2.8,20.5,5148,2442,2706,13.6,28.6,-1452,-8.1,41,0,384,384,2038
1997,35,d) 3,1923,2004,16873,16856,95,4.5,341,16,3796,772,3024,4.6,22.5,3761,1759,2002,10.4,22.3,35,0.2,44.6,0,266,266,1440
1997,35,e) 4,1548,1595,13883,14340,66,3.9,248,14.7,2615,477,2138,3.3,18.2,3529,1183,2346,8.2,24.6,-914,-6.4,36.4,0,189,189,891
1997,35,f) 5,1322,1405,13931,14299,57,3.9,209,14.2,2313,509,1804,3.6,16.2,3049,1263,1786,8.8,21.3,-736,-5.1,32.4,0,158,158,937
1997,35,g) 6 to 10,5501,5932,68786,69428,237,3.8,725,11.7,10524,1816,8708,2.6,15.2,11808,4518,7290,6.5,17,-1284,-1.8,30.4,0,527,527,2999
1997,35,h) 11 to 15,4092,4671,53834,54545,218,4.6,411,8.6,7679,1909,5770,3.5,14.1,9101,3005,6096,5.5,16.7,-1422,-2.6,28.2,0,253,253,1642
1997,35,i) 16 to 20,3303,4144,56485,56240,197,4.7,351,8.3,9640,3118,6522,5.5,17.1,9149,2446,6703,4.3,16.3,491,0.8,32.6,0,173,173,798
1997,35,l) Left Censored,4956,9216,234983,237613,750,8.1,840,9.1,31118,9657,21461,4.1,13.1,36378,10434,25944,4.4,15.3,-5260,-2.2,26.2,0,211,211,1558
1997,36,a) 0,37278,37596,195720,98193,37318,198.5,0,0,195054,195054,0,198.6,198.6,0,0,0,0,0,195054,198.6,0,0,,,
1997,36,b) 1,28133,28376,187298,188317,178,0.6,7366,22.9,53604,3434,50170,1.8,28.5,55641,33737,21904,17.9,29.5,-2037,-1,57,0,5895,5895,28186
1997,36,c) 2,23470,24316,171391,177043,857,3.2,4954,18.7,36936,4314,32622,2.4,20.9,48240,24070,24170,13.6,27.2,-11304,-6.3,41.8,0,3886,3886,19530
1997,36,d) 3,19482,19671,152833,158447,592,2.8,3381,16,30849,3192,27657,2,19.5,42076,22545,19531,14.2,26.6,-11227,-7.1,39,0,2816,2816,16186
1997,36,e) 4,16954,17241,144954,147249,510,2.8,2623,14.3,27527,4325,23202,2.9,18.7,32117,15356,16761,10.4,21.8,-4590,-3.1,37.4,0,2131,2131,12533
1997,36,f) 5,14807,15196,133677,137844,473,2.9,2150,13.4,20866,2589,18277,1.9,15.1,29199,12486,16713,9.1,21.2,-8333,-6.1,30.2,0,1698,1698,10116
1997,36,g) 6 to 10,65845,68653,752249,759467,2204,3.1,7642,10.7,111401,20714,90687,2.7,14.7,125838,47175,78663,6.2,16.6,-14437,-1.9,29.4,0,5664,5664,29708
1997,36,h) 11 to 15,47363,51536,601573,606355,1648,3.1,4574,8.6,82074,15158,66916,2.5,13.5,91637,31916,59721,5.3,15.1,-9563,-1.6,27,0,3136,3136,20400
1997,36,i) 16 to 20,32364,39293,647024,650527,1319,3.3,3184,7.9,83324,19350,63974,3,12.8,90329,26565,63764,4.1,13.9,-7005,-1.1,25.6,0,1872,1872,13422
1997,36,l) Left Censored,71229,115387,3815663,3825660,5996,5.1,10224,8.7,488839,119089,369750,3.1,12.8,508832,179696,329136,4.7,13.3,-19993,-0.5,25.6,0,3634,3634,27527
1997,37,a) 0,15743,15953,88056,44234,15835,198.5,0,0,87644,87644,0,198.1,198.1,0,0,0,0,0,87644,198.1,0,0,,,
1997,37,b) 1,11363,11666,85123,85505,169,1.3,2992,22.6,23908,2344,21564,2.7,28,24672,13723,10949,16,28.9,-764,-0.9,56,0,2369,2369,11742
1997,37,c) 2,9552,9738,68371,69974,368,3.5,1843,17.5,15992,2618,13374,3.7,22.9,19198,11523,7675,16.5,27.4,-3206,-4.5,45.8,0,1505,1505,9010
1997,37,d) 3,7907,8118,66556,67773,303,3.5,1298,15,12799,1734,11065,2.6,18.9,15233,7882,7351,11.6,22.5,-2434,-3.6,37.8,0,1036,1036,6840
1997,37,e) 4,6458,6637,62064,62866,237,3.4,943,13.5,12405,3695,8710,5.9,19.7,14008,6539,7469,10.4,22.3,-1603,-2.6,39.4,0,781,781,5733
1997,37,f) 5,5707,6104,64642,64680,259,4.1,754,11.9,11880,2471,9409,3.8,18.4,11956,5347,6609,8.3,18.5,-76,-0.1,36.8,0,551,551,4018
1997,37,g) 6 to 10,24738,26916,322511,321310,1172,4.2,2691,9.7,53767,9590,44177,3,16.7,51365,19631,31734,6.1,16,2402,0.7,32,0,1904,1904,12183
1997,37,h) 11 to 15,19435,22077,274321,275696,872,3.9,1602,7.1,37628,7692,29936,2.8,13.6,40378,13058,27320,4.7,14.6,-2750,-1,27.2,0,974,974,6140
1997,37,i) 16 to 20,12278,16102,281832,277797,794,4.9,1219,7.5,43613,11358,32255,4.1,15.7,35543,10688,24855,3.8,12.8,8070,2.9,25.6,0,573,573,3799
1997,37,l) Left Censored,23403,49879,1787331,1782221,4059,8.2,3733,7.5,224254,73987,150267,4.2,12.6,214033,67879,146154,3.8,12,10221,0.6,24,0,882,882,6638
1997,38,a) 0,1206,1213,5984,3003,1200,197.9,0,0,5962,5962,0,198.5,198.5,0,0,0,0,0,5962,198.5,0,0,,,
1997,38,b) 1,987,1002,12249,10554,11,1,262,23.1,5523,570,4953,5.4,52.3,2133,1296,837,12.3,20.2,3390,32.1,40.4,0,200,200,1080
1997,38,c) 2,798,800,5896,6181,22,2.5,205,22.9,1322,120,1202,1.9,21.4,1891,1317,574,21.3,30.6,-569,-9.2,42.8,0,173,173,1205
1997,38,d) 3,821,829,4664,5167,19,2.1,139,15.6,679,75,604,1.5,13.1,1685,1029,656,19.9,32.6,-1006,-19.5,26.2,0,114,114,871
1997,38,e) 4,694,697,5098,5386,16,2.2,99,13.4,701,82,619,1.5,13,1277,618,659,11.5,23.7,-576,-10.7,26,0,84,84,583
1997,38,f) 5,610,626,4378,4666,21,3.2,84,12.8,646,90,556,1.9,13.8,1221,744,477,15.9,26.2,-575,-12.4,27.6,0,63,63,566
1997,38,g) 6 to 10,2515,2647,26108,26439,95,3.4,296,10.7,4005,701,3304,2.7,15.1,4667,2138,2529,8.1,17.7,-662,-2.6,30.2,0,197,197,1113
1997,38,h) 11 to 15,2130,2412,23329,23565,79,3.2,191,7.7,3077,473,2604,2,13.1,3549,1270,2279,5.4,15.1,-472,-2,26.2,0,114,114,647
1997,38,i) 16 to 20,1844,2195,28008,26883,71,3.2,145,6.5,5285,1426,3859,5.3,19.7,3035,774,2261,2.9,11.3,2250,8.4,22.6,0,82,82,381
1997,38,l) Left Censored,3656,5646,126944,125611,236,4.1,419,7.3,15509,4367,11142,3.5,12.3,12843,4393,8450,3.5,10.2,2666,2.1,20.4,0,133,133,1289
1997,39,a) 0,16954,17214,109764,55057,17093,198.6,0,0,109415,109415,0,198.7,198.7,0,0,0,0,0,109415,198.7,0,0,,,
1997,39,b) 1,13134,13424,104421,103548,166,1.1,3435,22.6,32692,6899,25793,6.7,31.6,30945,16509,14436,15.9,29.9,1747,1.7,59.8,0,2736,2736,13645
1997,39,c) 2,11828,12076,92382,96746,367,2.8,2187,16.8,19721,1978,17743,2,20.4,28448,13666,14782,14.1,29.4,-8727,-9,40.8,0,1783,1783,11481
1997,39,d) 3,10010,10375,87800,90579,351,3.2,1579,14.3,16307,1942,14365,2.1,18,21864,10439,11425,11.5,24.1,-5557,-6.1,36,0,1259,1259,7583
1997,39,e) 4,8693,9055,81787,85188,343,3.6,1214,12.8,14604,3084,11520,3.6,17.1,21405,10358,11047,12.2,25.1,-6801,-8,34.2,0,963,963,7182
1997,39,f) 5,7661,8005,75993,77484,257,3.1,933,11.2,11961,1986,9975,2.6,15.4,14942,6147,8795,7.9,19.3,-2981,-3.9,30.8,0,728,728,4891
1997,39,g) 6 to 10,33677,36944,447953,451650,1442,3.8,3814,10,71375,16851,54524,3.7,15.8,78769,28811,49958,6.4,17.4,-7394,-1.6,31.6,0,2701,2701,18593
1997,39,h) 11 to 15,24685,28681,411866,413286,1198,4.1,2500,8.5,58929,14058,44871,3.4,14.3,61769,22384,39385,5.4,14.9,-2840,-0.6,28.6,0,1613,1613,11035
1997,39,i) 16 to 20,19601,25228,435357,436631,1213,4.7,2228,8.7,67110,21509,45601,4.9,15.4,69657,20698,48959,4.7,16,-2547,-0.6,30.8,0,989,989,7470
1997,39,l) Left Censored,42282,81009,2806447,2806762,4555,5.5,6561,8,350578,106630,243948,3.8,12.5,351208,109577,241631,3.9,12.5,-630,0,25,0,1638,1638,13694
1997,40,a) 0,6659,6806,40276,20245,6747,198.3,0,0,40062,40062,0,197.9,197.9,0,0,0,0,0,40062,197.9,0,0,,,
1997,40,b) 1,4752,4821,31691,33250,44,0.8,1476,26.4,8857,619,8238,1.9,26.6,11975,8095,3880,24.3,36,-3118,-9.4,53.2,0,1231,1231,7091
1997,40,c) 2,3944,4011,29765,31490,130,2.9,917,20.7,6186,731,5455,2.3,19.6,9635,5497,4138,17.5,30.6,-3449,-11,39.2,0,767,767,4939
1997,40,d) 3,3524,3580,27022,27570,120,3.1,599,15.7,5573,541,5032,2,20.2,6668,3330,3338,12.1,24.2,-1095,-4,40.4,0,481,481,2796
1997,40,e) 4,2977,3065,25249,26063,98,3,483,14.8,4715,534,4181,2,18.1,6343,2519,3824,9.7,24.3,-1628,-6.2,36.2,0,384,384,2180
1997,40,f) 5,2660,2740,23172,24171,72,2.5,379,13.1,3481,229,3252,0.9,14.4,5478,2893,2585,12,22.7,-1997,-8.3,28.8,0,282,282,2304
1997,40,g) 6 to 10,10284,11051,130896,131998,450,3.9,1290,11.2,22882,6113,16769,4.6,17.3,25085,8401,16684,6.4,19,-2203,-1.7,34.6,0,915,915,5645
1997,40,h) 11 to 15,9027,10119,117215,117871,396,3.8,844,8.1,17017,3706,13311,3.1,14.4,18329,5486,12843,4.7,15.6,-1312,-1.2,28.8,0,535,535,3394
1997,40,i) 16 to 20,6534,8126,117547,119553,359,4.3,699,8.4,15065,4149,10916,3.5,12.6,19076,5373,13703,4.5,16,-4011,-3.4,25.2,0,368,368,2732
1997,40,l) Left Censored,10924,20622,552980,545409,1395,6.7,1613,7.8,80288,22967,57321,4.2,14.7,65146,18094,47052,3.3,11.9,15142,2.8,23.8,0,469,469,2796
1997,41,a) 0,8022,8099,40218,20171,8047,198.7,0,0,40095,40095,0,198.8,198.8,0,0,0,0,0,40095,198.8,0,0,,,
1997,41,b) 1,6213,6338,51124,50284,63,0.9,1810,24.9,13277,1396,11881,2.8,26.4,11597,6605,4992,13.1,23.1,1680,3.3,46.2,0,1420,1420,5496
1997,41,c) 2,5392,5471,36102,37215,198,3.3,1113,18.7,7484,1223,6261,3.3,20.1,9710,5298,4412,14.2,26.1,-2226,-6,40.2,0,860,860,4200
1997,41,d) 3,4606,4776,35106,35340,199,3.9,835,16.4,7233,1106,6127,3.1,20.5,7701,3421,4280,9.7,21.8,-468,-1.3,41,0,645,645,2718
1997,41,e) 4,3691,3768,29453,30260,142,3.6,539,13.6,5087,668,4419,2.2,16.8,6701,2595,4106,8.6,22.1,-1614,-5.3,33.6,0,410,410,1841
1997,41,f) 5,3248,3418,32049,32795,156,4.3,472,13.2,5512,873,4639,2.7,16.8,7004,3686,3318,11.2,21.4,-1492,-4.6,33.6,0,358,358,2212
1997,41,g) 6 to 10,13039,13873,141509,141856,589,4.1,1520,10.6,24940,5201,19739,3.7,17.6,25634,9240,16394,6.5,18.1,-694,-0.5,35.2,0,1031,1031,6187
1997,41,h) 11 to 15,8914,10301,150122,148700,497,4.7,876,8.3,24534,6353,18181,4.3,16.5,21690,6674,15016,4.5,14.6,2844,1.9,29.2,0,562,562,3827
1997,41,i) 16 to 20,7239,8975,139489,137651,448,4.9,722,7.9,22383,5422,16961,3.9,16.3,18707,6194,12513,4.5,13.6,3676,2.7,27.2,0,382,382,3091
1997,41,l) Left Censored,11026,20514,619726,612193,1344,6.5,1793,8.6,95942,25953,69989,4.2,15.7,80875,28106,52769,4.6,13.2,15067,2.5,26.4,0,450,450,3673
1997,42,a) 0,17913,18230,105192,52816,18092,198.5,0,0,104752,104752,0,198.3,198.3,0,0,0,0,0,104752,198.3,0,0,,,
1997,42,b) 1,13837,14128,105077,103803,180,1.1,3180,20.2,30365,3790,26575,3.7,29.3,27817,15975,11842,15.4,26.8,2548,2.5,53.6,0,2509,2509,13787
1997,42,c) 2,12307,12667,95905,99662,419,3.1,2060,15.2,20663,2771,17892,2.8,20.7,28177,17063,11114,17.1,28.3,-7514,-7.6,41.4,0,1650,1650,13706
1997,42,d) 3,10020,10295,87434,93496,317,2.9,1457,13.4,15929,1715,14214,1.8,17,28052,18662,9390,20,30,-12123,-13,34,0,1158,1158,17156
1997,42,e) 4,9023,9297,82480,82940,311,3.2,1209,12.4,15378,2078,13300,2.5,18.5,16298,7343,8955,8.9,19.7,-920,-1.2,37,0,982,982,6301
1997,42,f) 5,8492,8922,83462,84805,276,3,1125,12,13328,2171,11157,2.6,15.7,16014,7139,8875,8.4,18.9,-2686,-3.2,31.4,0,827,827,4505
1997,42,g) 6 to 10,40128,42807,447529,453529,1433,3.2,4260,9.6,66948,11235,55713,2.5,14.8,78948,30283,48665,6.7,17.4,-12000,-2.6,29.6,0,3095,3095,20196
1997,42,h) 11 to 15,29594,33249,467129,469195,1155,3.4,2622,7.7,61453,13827,47626,2.9,13.1,65584,23657,41927,5,14,-4131,-0.9,26.2,0,1645,1645,10866
1997,42,i) 16 to 20,21324,26648,449015,445363,1143,4.2,2135,7.9,68198,18457,49741,4.1,15.3,60894,20708,40186,4.6,13.7,7304,1.6,27.4,0,1053,1053,8352
1997,42,l) Left Censored,46734,86045,2845604,2845257,4954,5.7,6892,7.9,344415,96521,247894,3.4,12.1,343722,106441,237281,3.7,12.1,693,0,24.2,0,2144,2144,15699
1997,44,a) 0,1948,1962,9999,5008,1952,199,0,0,9982,9982,0,199.3,199.3,0,0,0,0,0,9982,199.3,0,0,,,
1997,44,b) 1,1550,1562,10698,10374,8,0.4,418,23.4,2963,475,2488,4.6,28.6,2314,1460,854,14.1,22.3,649,6.3,44.6,0,347,347,1299
1997,44,c) 2,1247,1259,8365,8140,42,3.1,207,15.4,2192,394,1798,4.8,26.9,1741,981,760,12.1,21.4,451,5.5,42.8,0,171,171,909
1997,44,d) 3,1149,1160,12557,13068,33,2.7,180,14.5,1804,178,1626,1.4,13.8,2826,740,2086,5.7,21.6,-1022,-7.8,27.6,0,151,151,628
1997,44,e) 4,1001,1008,6747,6863,25,2.4,114,10.8,996,112,884,1.6,14.5,1228,520,708,7.6,17.9,-232,-3.4,29,0,87,87,439
1997,44,f) 5,849,866,7159,7258,22,2.4,110,12.1,1079,177,902,2.4,14.9,1276,489,787,6.7,17.6,-197,-2.7,29.8,0,92,92,453
1997,44,g) 6 to 10,4074,4244,43239,43323,123,2.8,439,10,6988,835,6153,1.9,16.1,7156,3093,4063,7.1,16.5,-168,-0.4,32.2,0,336,336,1916
1997,44,h) 11 to 15,2852,3012,35972,35482,100,3.2,239,7.8,5592,1567,4025,4.4,15.8,4611,1935,2676,5.5,13,981,2.8,26,0,165,165,1111
1997,44,i) 16 to 20,2150,2432,33599,33955,93,3.8,179,7.2,4187,832,3355,2.5,12.3,4898,1696,3202,5,14.4,-711,-2.1,24.6,0,105,105,893
1997,44,l) Left Censored,5165,7248,220294,220037,338,4.6,566,7.7,24948,7452,17496,3.4,11.3,24433,6996,17437,3.2,11.1,515,0.2,22.2,0,209,209,1294
1997,45,a) 0,7495,7575,44968,22607,7515,198.4,0,0,44723,44723,0,197.8,197.8,0,0,0,0,0,44723,197.8,0,0,,,
1997,45,b) 1,5515,5619,41335,40884,93,1.4,1663,25.7,13354,1289,12065,3.2,32.7,12452,8006,4446,19.6,30.5,902,2.2,61,0,1366,1366,6905
1997,45,c) 2,4636,4744,39626,40998,212,4.1,971,18.9,10109,1561,8548,3.8,24.7,12853,7494,5359,18.3,31.4,-2744,-6.7,49.4,0,770,770,6691
1997,45,d) 3,3833,3956,37570,38348,162,3.9,639,15.2,7860,2239,5621,5.8,20.5,9416,4528,4888,11.8,24.6,-1556,-4.1,41,0,488,488,3225
1997,45,e) 4,3158,3299,32388,31995,126,3.6,496,14.2,7040,1320,5720,4.1,22,6253,2772,3481,8.7,19.5,787,2.5,39,0,382,382,2209
1997,45,f) 5,2847,2996,36821,36095,102,3.3,372,11.9,8321,1159,7162,3.2,23.1,6868,3655,3213,10.1,19,1453,4.1,38,0,285,285,2357
1997,45,g) 6 to 10,11866,13106,160099,160682,611,4.5,1410,10.4,26087,5087,21000,3.2,16.2,27252,9874,17378,6.1,17,-1165,-0.8,32.4,0,967,967,6784
1997,45,h) 11 to 15,9064,10374,122838,122861,450,4.3,848,8,18837,5124,13713,4.2,15.3,18882,6140,12742,5,15.4,-45,-0.1,30.6,0,516,516,3238
1997,45,i) 16 to 20,5945,7732,118944,119492,413,5.3,605,7.7,16618,4912,11706,4.1,13.9,17713,5352,12361,4.5,14.8,-1095,-0.9,27.8,0,309,309,2191
1997,45,l) Left Censored,11292,23182,802664,804443,1489,6.4,1769,7.6,94108,30529,63579,3.8,11.7,97666,29966,67700,3.7,12.1,-3558,-0.4,23.4,0,437,437,2710
1997,46,a) 0,1649,1666,8717,4370,1655,198.7,0,0,8694,8694,0,198.9,198.9,0,0,0,0,0,8694,198.9,0,0,,,
1997,46,b) 1,1287,1312,8327,8529,11,0.7,368,24.4,2300,287,2013,3.4,27,2704,1634,1070,19.2,31.7,-404,-4.7,54,0,293,293,1286
1997,46,c) 2,1072,1093,6940,7291,33,2.8,190,16.2,1214,235,979,3.2,16.7,1915,1049,866,14.4,26.3,-701,-9.6,33.4,0,152,152,837
1997,46,d) 3,1010,1024,7470,7707,35,3.2,177,16.1,1167,116,1051,1.5,15.1,1640,891,749,11.6,21.3,-473,-6.2,30.2,0,130,130,523
1997,46,e) 4,837,856,5911,6303,39,4.4,114,12.8,890,209,681,3.3,14.1,1674,544,1130,8.6,26.6,-784,-12.5,28.2,0,88,88,453
1997,46,f) 5,717,750,5548,5818,29,3.7,109,13.7,763,77,686,1.3,13.1,1303,682,621,11.7,22.4,-540,-9.3,26.2,0,87,87,610
1997,46,g) 6 to 10,3011,3152,33215,33360,114,3.5,333,10.2,5284,1328,3956,4,15.8,5574,2025,3549,6.1,16.7,-290,-0.9,31.6,0,235,235,1456
1997,46,h) 11 to 15,2283,2595,30539,29750,112,4.2,212,8,5285,1264,4021,4.2,17.8,3706,1277,2429,4.3,12.5,1579,5.3,25,0,129,129,609
1997,46,i) 16 to 20,1831,2150,27981,28150,84,3.8,178,8.1,3601,828,2773,2.9,12.8,3939,927,3012,3.3,14,-338,-1.2,25.6,0,88,88,422
1997,46,l) Left Censored,3864,5951,141481,141129,326,5.4,442,7.3,15712,5202,10510,3.7,11.1,15007,5262,9745,3.7,10.6,705,0.5,21.2,0,150,150,677
1997,47,a) 0,9727,9900,62350,31270,9818,198.3,0,0,62161,62161,0,198.8,198.8,0,0,0,0,0,62161,198.8,0,0,,,
1997,47,b) 1,7453,7603,65399,65095,92,1,2329,26.5,21623,2782,18841,4.3,33.2,21014,12445,8569,19.1,32.3,609,0.9,64.6,0,1941,1941,10692
1997,47,c) 2,6087,6230,53816,54783,210,3.1,1357,19.9,13276,1532,11744,2.8,24.2,15210,8862,6348,16.2,27.8,-1934,-3.6,48.4,0,1120,1120,7844
1997,47,d) 3,5135,5273,45817,46950,191,3.4,988,17.4,8929,1158,7771,2.5,19,11195,6046,5149,12.9,23.8,-2266,-4.8,38,0,798,798,5028
1997,47,e) 4,4612,4817,43983,44684,209,4.1,706,13.9,8600,1362,7238,3,19.2,10002,4015,5987,9,22.4,-1402,-3.2,38.4,0,559,559,3169
1997,47,f) 5,3940,4143,41731,42534,151,3.5,533,12.3,6997,884,6113,2.1,16.5,8603,3457,5146,8.1,20.2,-1606,-3.7,33,0,418,418,2653
1997,47,g) 6 to 10,16261,17855,223023,227462,713,3.9,1940,10.5,32643,7146,25497,3.1,14.4,41520,16525,24995,7.3,18.3,-8877,-3.9,28.8,0,1369,1369,12418
1997,47,h) 11 to 15,12676,14388,194968,193456,638,4.3,1189,8.1,31980,7669,24311,4,16.5,28956,11630,17326,6,15,3024,1.5,30,0,733,733,5308
1997,47,i) 16 to 20,8814,12046,230867,230120,644,5.3,864,7.1,36141,11118,25023,4.8,15.7,34646,7741,26905,3.4,15.1,1495,0.6,30.2,0,400,400,2362
1997,47,l) Left Censored,16886,34631,1245315,1242837,2421,7,2772,8,166953,53598,113355,4.3,13.4,161996,46183,115813,3.7,13,4957,0.4,26,0,694,694,5230
1997,48,a) 0,37037,37618,249801,125428,37331,198.5,0,0,248747,248747,0,198.3,198.3,0,0,0,0,0,248747,198.3,0,0,,,
1997,48,b) 1,28273,28945,245424,242795,350,1,8681,26,80038,14213,65825,5.9,33,74780,44513,30267,18.3,30.8,5258,2.2,61.6,0,7050,7050,37090
1997,48,c) 2,23146,23915,214447,222200,911,3.5,5158,19.7,52204,8046,44158,3.6,23.5,67710,39486,28224,17.8,30.5,-15506,-7,47,0,4255,4255,34325
1997,48,d) 3,19685,20570,205584,207850,797,3.6,3812,17.2,49647,8636,41011,4.2,23.9,54179,29395,24784,14.1,26.1,-4532,-2.2,47.8,0,3056,3056,24374
1997,48,e) 4,16981,17744,177813,186905,692,3.7,2702,14.4,37641,5548,32093,3,20.1,55825,26261,29564,14.1,29.9,-18184,-9.8,40.2,0,2153,2153,18570
1997,48,f) 5,15090,16093,186832,191180,604,3.6,2283,13.5,36186,5845,30341,3.1,18.9,44882,20289,24593,10.6,23.5,-8696,-4.6,37.8,0,1766,1766,16185
1997,48,g) 6 to 10,56333,62289,797204,800954,2792,4.3,7258,11.2,147540,31994,115546,4,18.4,155041,60689,94352,7.6,19.4,-7501,-1,36.8,0,5033,5033,38778
1997,48,h) 11 to 15,43563,51082,720117,719973,2400,4.6,4584,8.8,118007,34277,83730,4.8,16.4,117719,44918,72801,6.2,16.4,288,0,32.8,0,2752,2752,21346
1997,48,i) 16 to 20,31341,41378,662210,661216,2332,5.5,3698,8.8,107015,34563,72452,5.2,16.2,105027,34557,70470,5.2,15.9,1988,0.3,31.8,0,1797,1797,14006
1997,48,l) Left Censored,43240,105469,3637606,3607876,7774,7.3,9712,9.1,573718,176280,397438,4.9,15.9,514257,168918,345339,4.7,14.3,59461,1.6,28.6,0,2117,2117,16255
1997,49,a) 0,4993,5060,31569,15889,5024,198.6,0,0,31360,31360,0,197.4,197.4,0,0,0,0,0,31360,197.4,0,0,,,
1997,49,b) 1,3715,3787,35210,35928,33,0.8,1095,25.1,10863,604,10259,1.7,30.2,12298,8562,3736,23.8,34.2,-1435,-4,60.4,0,876,876,4074
1997,49,c) 2,2865,2935,30532,30340,111,3.5,625,19.5,7905,1270,6635,4.2,26.1,7520,4304,3216,14.2,24.8,385,1.3,49.6,0,488,488,3388
1997,49,d) 3,2390,2469,24213,24825,96,3.6,451,17,5206,806,4400,3.2,21,6430,2923,3507,11.8,25.9,-1224,-4.9,42,0,344,344,2272
1997,49,e) 4,1845,1925,19443,20204,84,4.1,319,15.6,3510,675,2835,3.3,17.4,5031,2561,2470,12.7,24.9,-1521,-7.5,34.8,0,248,248,1962
1997,49,f) 5,1646,1715,16481,17016,66,3.7,208,11.6,2929,659,2270,3.9,17.2,3999,1407,2592,8.3,23.5,-1070,-6.3,34.4,0,160,160,1134
1997,49,g) 6 to 10,5754,6236,98525,97683,260,4,653,10.1,18629,3916,14713,4,19.1,16945,6684,10261,6.8,17.3,1684,1.8,34.6,0,452,452,4687
1997,49,h) 11 to 15,3792,4363,73555,74223,211,4.7,409,9.2,11020,2405,8615,3.2,14.8,12355,3754,8601,5.1,16.6,-1335,-1.8,29.6,0,231,231,1928
1997,49,i) 16 to 20,3286,4036,75684,75889,224,5.5,337,8.2,11299,3203,8096,4.2,14.9,11708,3318,8390,4.4,15.4,-409,-0.5,29.8,0,175,175,1338
1997,49,l) Left Censored,5343,10496,408551,401338,839,8,883,8.4,64126,25465,38661,6.3,16,49699,19920,29779,5,12.4,14427,3.6,24.8,0,196,196,1383
1997,50,a) 0,1520,1533,6230,3136,1512,197.3,0,0,6188,6188,0,197.3,197.3,0,0,0,0,0,6188,197.3,0,0,,,
1997,50,b) 1,1131,1138,6712,6761,5,0.4,277,21.5,1830,24,1806,0.4,27.1,1928,1198,730,17.7,28.5,-98,-1.4,54.2,0,227,227,1084
1997,50,c) 2,978,988,5749,5976,30,2.8,183,17.2,1019,173,846,2.9,17.1,1473,634,839,10.6,24.6,-454,-7.5,34.2,0,140,140,504
1997,50,d) 3,881,905,5665,5960,29,3,137,14.3,897,168,729,2.8,15.1,1486,628,858,10.5,24.9,-589,-9.8,30.2,0,109,109,505
1997,50,e) 4,790,800,4515,4671,23,2.7,106,12.6,705,70,635,1.5,15.1,1017,443,574,9.5,21.8,-312,-6.7,30.2,0,85,85,255
1997,50,f) 5,668,682,5091,5196,16,2.2,87,12.1,733,34,699,0.7,14.1,943,470,473,9,18.1,-210,-4,28.2,0,68,68,390
1997,50,g) 6 to 10,3363,3484,27220,27680,113,3.2,325,9.1,3425,449,2976,1.6,12.4,4345,1525,2820,5.5,15.7,-920,-3.3,24.8,0,249,249,1236
1997,50,h) 11 to 15,2446,2677,31302,29382,120,4.4,232,8.5,7667,5114,2553,17.4,26.1,3826,1400,2426,4.8,13,3841,13.1,26,0,148,148,613
1997,50,i) 16 to 20,1539,1827,25706,25859,60,3.2,130,7,2893,828,2065,3.2,11.2,3199,783,2416,3,12.4,-306,-1.2,22.4,0,74,74,295
1997,50,l) Left Censored,2954,4463,110942,111461,209,4.6,328,7.3,10823,3033,7790,2.7,9.7,11860,4468,7392,4,10.6,-1037,-0.9,19.4,0,116,116,1100
1997,51,a) 0,12577,12716,69056,34640,12632,198.7,0,0,68833,68833,0,198.7,198.7,0,0,0,0,0,68833,198.7,0,0,,,
1997,51,b) 1,9334,9476,67442,65170,104,1,2613,24.1,22616,4906,17710,7.5,34.7,18072,10580,7492,16.2,27.7,4544,7,55.4,0,2059,2059,8628
1997,51,c) 2,8293,8525,63112,64712,358,3.9,1621,17.7,14727,2238,12489,3.5,22.8,17926,9857,8069,15.2,27.7,-3199,-4.9,45.6,0,1297,1297,8439
1997,51,d) 3,6860,7065,60444,61357,280,3.8,1028,13.8,13740,2748,10992,4.5,22.4,15566,8078,7488,13.2,25.4,-1826,-3,44.8,0,796,796,6415
1997,51,e) 4,6086,6256,54419,54887,257,3.9,856,13,10073,2027,8046,3.7,18.4,11009,4575,6434,8.3,20.1,-936,-1.7,36.8,0,687,687,3844
1997,51,f) 5,5327,5604,55192,54796,209,3.6,642,11,10220,1247,8973,2.3,18.7,9428,3874,5554,7.1,17.2,792,1.5,34.4,0,463,463,2664
1997,51,g) 6 to 10,22486,24166,277237,274694,1040,4.2,2557,10.3,48921,12957,35964,4.7,17.8,43835,16177,27658,5.9,16,5086,1.8,32,0,1743,1743,9703
1997,51,h) 11 to 15,16361,18958,269452,265107,796,4.1,1571,8.1,45806,9953,35853,3.8,17.3,37115,12014,25101,4.5,14,8691,3.3,28,0,908,908,5550
1997,51,i) 16 to 20,10738,14094,250456,248055,714,5,1174,8.2,40514,9570,30944,3.9,16.3,35712,10373,25339,4.2,14.4,4802,1.9,28.8,0,534,534,2931
1997,51,l) Left Censored,19989,43575,1410902,1399154,3060,7,3662,8.3,201044,62587,138457,4.5,14.4,177550,58647,118903,4.2,12.7,23494,1.7,25.4,0,775,775,7493
1997,53,a) 0,13437,13583,68539,34475,13453,198.1,0,0,68128,68128,0,197.6,197.6,0,0,0,0,0,68128,197.6,0,0,,,
1997,53,b) 1,10074,10217,63940,64551,96,0.8,3179,26.7,19144,1893,17251,2.9,29.7,20366,12594,7772,19.5,31.6,-1222,-1.9,59.4,0,2471,2471,10229
1997,53,c) 2,8390,8608,59169,60398,404,4.3,1764,18.9,13857,2371,11486,3.9,22.9,16315,8509,7806,14.1,27,-2458,-4.1,45.8,0,1390,1390,7234
1997,53,d) 3,7257,7440,53898,54728,345,4.3,1313,16.5,11578,1806,9772,3.3,21.2,13238,6192,7046,11.3,24.2,-1660,-3,42.4,0,1001,1001,4957
1997,53,e) 4,6140,6383,46970,47733,296,4.4,984,14.6,9486,1888,7598,4,19.9,11012,4987,6025,10.4,23.1,-1526,-3.2,39.8,0,762,762,4015
1997,53,f) 5,5503,5772,52501,52413,268,4.4,849,14,10600,1483,9117,2.8,20.2,10424,4355,6069,8.3,19.9,176,0.3,39.8,0,611,611,3382
1997,53,g) 6 to 10,21044,22509,241555,246235,1031,4.4,2816,12,42920,8601,34319,3.5,17.4,52279,22140,30139,9,21.2,-9359,-3.8,34.8,0,1919,1919,13144
1997,53,h) 11 to 15,14702,16883,233825,233488,805,4.6,1644,9.5,35330,6352,28978,2.7,15.1,34656,11642,23014,5,14.8,674,0.3,29.6,0,948,948,5727
1997,53,i) 16 to 20,10967,13912,216147,215414,699,4.9,1224,8.6,35858,9027,26831,4.2,16.6,34392,12132,22260,5.6,16,1466,0.6,32,0,575,575,5589
1997,53,l) Left Censored,16446,31872,963161,966486,2462,7.6,3141,9.7,148714,48018,100696,5,15.4,155364,72066,83298,7.5,16.1,-6650,-0.7,30.8,0,655,656,5340
1997,54,a) 0,2796,2809,13867,6961,2781,198,0,0,13812,13812,0,198.4,198.4,0,0,0,0,0,13812,198.4,0,0,,,
1997,54,b) 1,2082,2119,15050,15128,16,0.7,617,25.2,4013,436,3577,2.9,26.5,4169,2357,1812,15.6,27.6,-156,-1.1,53,0,505,505,1996
1997,54,c) 2,1877,1905,12966,13771,61,3,377,18.2,2686,290,2396,2.1,19.5,4296,1964,2332,14.3,31.2,-1610,-11.7,39,0,306,306,1519
1997,54,d) 3,1527,1554,10281,10828,43,2.6,267,16.1,1708,220,1488,2,15.8,2801,1158,1643,10.7,25.9,-1093,-10.1,31.6,0,213,213,856
1997,54,e) 4,1385,1410,10899,11014,49,3.3,222,14.8,2278,401,1877,3.6,20.7,2507,1369,1138,12.4,22.8,-229,-2.1,41.4,0,180,180,1273
1997,54,f) 5,1244,1309,10207,10162,45,3.3,171,12.4,1992,408,1584,4,19.6,1902,833,1069,8.2,18.7,90,0.9,37.4,0,129,129,658
1997,54,g) 6 to 10,5273,5571,57397,58289,201,3.5,545,9.5,7465,1331,6134,2.3,12.8,9248,3328,5920,5.7,15.9,-1783,-3.1,25.6,0,413,413,2720
1997,54,h) 11 to 15,4244,4753,58088,58445,167,3.4,374,7.7,7465,2176,5289,3.7,12.8,8178,2656,5522,4.5,14,-713,-1.2,25.6,0,233,233,1441
1997,54,i) 16 to 20,3077,3949,55099,54706,197,4.9,265,6.6,7870,2254,5616,4.1,14.4,7084,2300,4784,4.2,12.9,786,1.5,25.8,0,133,133,1002
1997,54,l) Left Censored,6902,12017,286200,285531,685,5.6,893,7.4,35809,9819,25990,3.4,12.5,34472,8075,26397,2.8,12.1,1337,0.4,24.2,0,266,266,1295
1997,55,a) 0,8889,8963,48851,24512,8907,198.8,0,0,48679,48679,0,198.6,198.6,0,0,0,0,0,48679,198.6,0,0,,,
1997,55,b) 1,7054,7134,50814,50193,73,0.9,1640,20.6,15506,4932,10574,9.8,30.9,14264,8236,6028,16.4,28.4,1242,2.5,56.8,0,1297,1297,6377
1997,55,c) 2,6149,6303,45300,46344,222,3.3,1055,15.6,8682,1355,7327,2.9,18.7,10770,4886,5884,10.5,23.2,-2088,-4.5,37.4,0,843,843,4297
1997,55,d) 3,5441,5561,41000,42618,192,3.3,730,12.5,6816,1055,5761,2.5,16,10051,4696,5355,11,23.6,-3235,-7.6,32,0,586,586,4090
1997,55,e) 4,4859,4978,41364,41548,161,3.1,627,12,7716,2428,5288,5.8,18.6,8083,3120,4963,7.5,19.5,-367,-0.9,37.2,0,486,486,2471
1997,55,f) 5,4191,4348,37208,38015,122,2.7,482,10.6,5529,885,4644,2.3,14.5,7142,3048,4094,8,18.8,-1613,-4.3,29,0,364,364,2134
1997,55,g) 6 to 10,18203,19693,217872,221561,745,3.7,1928,9.5,30270,6051,24219,2.7,13.7,37648,13648,24000,6.2,17,-7378,-3.3,27.4,0,1364,1364,8448
1997,55,h) 11 to 15,13108,14860,212032,210216,551,3.6,1144,7.5,30716,8865,21851,4.2,14.6,27083,8099,18984,3.9,12.9,3633,1.7,25.8,0,736,736,4240
1997,55,i) 16 to 20,10180,13037,207520,208876,637,4.8,976,7.4,26350,7795,18555,3.7,12.6,29062,8988,20074,4.3,13.9,-2712,-1.3,25.2,0,489,489,2521
1997,55,l) Left Censored,22076,37574,1331935,1326441,1841,4.8,2722,7.2,148409,37762,110647,2.8,11.2,137421,42743,94678,3.2,10.4,10988,0.8,20.8,0,848,848,5825
1997,56,a) 0,1399,1409,6204,3113,1395,198,0,0,6182,6182,0,198.6,198.6,0,0,0,0,0,6182,198.6,0,0,,,
1997,56,b) 1,1146,1156,5733,6028,15,1.1,313,23.7,1338,113,1225,1.9,22.2,1927,1083,844,18,32,-589,-9.8,44.4,0,235,235,904
1997,56,c) 2,921,930,5331,5464,25,2.5,168,16.7,1099,129,970,2.4,20.1,1364,627,737,11.5,25,-265,-4.9,40.2,0,134,134,514
1997,56,d) 3,827,838,5560,5663,33,3.7,134,15,1019,91,928,1.6,18,1225,637,588,11.2,21.6,-206,-3.6,36,0,105,105,525
1997,56,e) 4,676,687,4759,4949,24,3.3,84,11.7,697,106,591,2.1,14.1,1076,422,654,8.5,21.7,-379,-7.6,28.2,0,57,57,330
1997,56,f) 5,551,555,3546,3684,16,2.7,76,12.9,580,49,531,1.3,15.7,856,419,437,11.4,23.2,-276,-7.5,31.4,0,58,58,334
1997,56,g) 6 to 10,2065,2191,19238,19528,83,3.6,273,11.9,2994,332,2662,1.7,15.3,3573,1391,2182,7.1,18.3,-579,-3,30.6,0,198,198,985
1997,56,h) 11 to 15,1772,1972,17285,17322,76,3.8,156,7.7,2643,497,2146,2.9,15.3,2716,775,1941,4.5,15.7,-73,-0.4,30.6,0,96,96,420
1997,56,i) 16 to 20,1540,1817,20804,20777,82,4.4,163,8.8,3208,965,2243,4.6,15.4,3153,930,2223,4.5,15.2,55,0.2,30.4,0,89,89,522
1997,56,l) Left Censored,2262,3521,64929,65336,171,4.7,442,12,9120,2265,6855,3.5,14,9933,3774,6159,5.8,15.2,-813,-1.2,28,0,77,77,420
1998,01,a) 0,7464,7516,48840,24496,7464,198.6,0,0,48688,48688,0,198.8,198.8,0,0,0,0,0,48688,198.8,0,0,,,
1998,01,b) 1,5783,5898,43596,44307,12,0.2,1836,26.7,12929,793,12136,1.8,29.2,14351,8667,5684,19.6,32.4,-1422,-3.2,58.4,0,1519,1519,7112
1998,01,c) 2,4898,5100,35576,37139,178,3.2,1100,19.7,7403,1364,6039,3.7,19.9,10528,5387,5141,14.5,28.3,-3125,-8.4,39.8,0,901,901,4576
1998,01,d) 3,4216,4338,34427,35198,139,3,795,17,6846,1233,5613,3.5,19.4,8388,4159,4229,11.8,23.8,-1542,-4.4,38.8,0,661,661,3342
1998,01,e) 4,3739,3860,39265,39055,129,3.1,661,16,9262,702,8560,1.8,23.7,8842,4001,4841,10.2,22.6,420,1.1,45.2,0,537,537,3073
1998,01,f) 5,3214,3295,31032,31808,96,2.8,439,12.6,4586,508,4078,1.6,14.4,6138,2283,3855,7.2,19.3,-1552,-4.9,28.8,0,361,361,1760
1998,01,g) 6 to 10,12246,13172,156437,157416,404,2.9,1459,10.6,25844,5834,20010,3.7,16.4,27801,10483,17318,6.7,17.7,-1957,-1.3,32.8,0,1119,1119,8153
1998,01,h) 11 to 15,9851,11338,167750,171157,281,2.4,933,8,17260,2817,14443,1.6,10.1,24073,7887,16186,4.6,14.1,-6813,-4,20.2,0,592,592,3635
1998,01,i) 16 to 20,6258,7784,139335,141453,210,2.6,598,7.5,16496,3737,12759,2.6,11.7,20731,7316,13415,5.2,14.7,-4235,-3,23.4,0,349,349,2229
1998,01,j) 21 to 25,1506,2555,49097,53907,101,3.8,284,10.7,7903,1637,6266,3,14.7,17522,13280,4242,24.6,32.5,-9619,-17.8,29.4,0,71,71,602
1998,01,l) Left Censored,12009,24916,818909,818990,1417,5.6,1765,7,90575,22198,68377,2.7,11.1,90737,29540,61197,3.6,11.1,-162,0,22.2,0,556,556,4452
1998,02,a) 0,1402,1406,6966,3497,1388,197.4,0,0,6939,6939,0,198.4,198.4,0,0,0,0,0,6939,198.4,0,0,,,
1998,02,b) 1,1025,1031,5694,5784,3,0.2,321,26.6,1542,,,,26.7,1722,914,808,15.8,29.8,-180,-3.1,53.4,1,228,228,649
1998,02,c) 2,856,870,4866,4993,40,4.3,171,18.2,1075,,,,21.5,1329,599,730,12,26.6,-254,-5.1,43,1,131,131,462
1998,02,d) 3,745,758,4449,4843,29,3.5,143,17.4,718,64,654,1.3,14.8,1506,659,847,13.6,31.1,-788,-16.3,29.6,0,116,116,614
1998,02,e) 4,637,646,4433,4520,21,3.1,100,14.5,866,92,774,2,19.2,1040,406,634,9,23,-174,-3.8,38.4,0,78,78,348
1998,02,f) 5,606,618,3998,4018,20,3.1,87,13.4,906,98,808,2.4,22.5,945,431,514,10.7,23.5,-39,-1,45,0,66,66,374
1998,02,g) 6 to 10,2171,2275,20048,20485,89,3.8,274,11.6,3020,360,2660,1.8,14.7,3894,1309,2585,6.4,19,-874,-4.3,29.4,0,196,196,951
1998,02,h) 11 to 15,1900,2159,25335,25536,69,3.1,220,9.8,3404,601,2803,2.4,13.3,3806,1369,2437,5.4,14.9,-402,-1.6,26.6,0,105,105,552
1998,02,i) 16 to 20,1282,1538,19035,18727,71,4.6,91,5.9,3225,1348,1877,7.2,17.2,2608,695,1913,3.7,13.9,617,3.3,27.8,0,49,49,398
1998,02,j) 21 to 25,279,463,7997,8111,23,5,26,5.6,1188,345,843,4.3,14.6,1415,213,1202,2.6,17.4,-227,-2.8,29.2,0,8,8,51
1998,02,l) Left Censored,1671,3245,87530,85690,234,7.2,242,7.4,13483,3664,9819,4.3,15.7,9803,2841,6962,3.3,11.4,3680,4.3,22.8,0,55,55,217
1998,04,a) 0,9578,9641,67755,33997,9564,198.4,0,0,67516,67516,0,198.6,198.6,0,0,0,0,0,67516,198.6,0,0,,,
1998,04,b) 1,7372,7555,62803,61981,33,0.4,2386,27.1,19975,800,19175,1.3,32.2,18331,11228,7103,18.1,29.6,1644,2.6,59.2,0,1941,1941,9351
1998,04,c) 2,5999,6116,55177,55436,197,2.9,1294,19.4,14315,887,13428,1.6,25.8,14833,8552,6281,15.4,26.8,-518,-1,51.6,0,1047,1047,7483
1998,04,d) 3,5101,5267,54434,55532,222,3.9,1000,17.6,12560,1994,10566,3.6,22.6,14755,6402,8353,11.5,26.6,-2195,-4,45.2,0,804,804,5491
1998,04,e) 4,4423,4618,45845,49871,139,2.8,806,16.3,7126,983,6143,2,14.3,15178,5729,9449,11.5,30.4,-8052,-16.1,28.6,0,611,611,4656
1998,04,f) 5,3552,3732,39527,40361,144,3.6,556,14.1,7333,1348,5985,3.3,18.2,9001,3865,5136,9.6,22.3,-1668,-4.1,36.4,0,428,428,2748
1998,04,g) 6 to 10,13629,14640,216692,218461,504,3.3,1797,11.7,40194,10208,29986,4.7,18.4,43731,15090,28641,6.9,20,-3537,-1.6,36.8,0,1282,1282,9617
1998,04,h) 11 to 15,10080,12108,196677,196450,534,4.3,1118,9,29358,8558,20800,4.4,14.9,28905,12119,16786,6.2,14.7,453,0.2,29.4,0,691,691,7004
1998,04,i) 16 to 20,6592,8058,141162,145469,258,3.1,678,8.2,22602,5195,17407,3.6,15.5,31215,18384,12831,12.6,21.5,-8613,-6,31,0,340,340,14516
1998,04,j) 21 to 25,1170,2229,68302,65936,147,6.5,187,8.3,12856,4014,8842,6.1,19.5,8124,2325,5799,3.5,12.3,4732,7.2,24.6,0,63,63,829
1998,04,l) Left Censored,8365,20864,778465,767318,1564,7.5,1590,7.6,109521,31451,78070,4.1,14.3,87226,29826,57400,3.9,11.4,22295,2.9,22.8,0,321,321,3717
1998,05,a) 0,4686,4751,30928,15518,4715,198.5,0,0,30821,30821,0,198.6,198.6,0,0,0,0,0,30821,198.6,0,0,,,
1998,05,b) 1,3597,3629,25180,26546,0,0,1185,27.8,5926,0,5926,0,22.3,8658,5248,3410,19.8,32.6,-2732,-10.3,44.6,0,996,996,4706
1998,05,c) 2,2997,3095,22365,23233,89,2.6,698,20.5,4632,582,4050,2.5,19.9,6367,3618,2749,15.6,27.4,-1735,-7.5,39.8,0,569,569,2655
1998,05,d) 3,2779,2852,23089,23670,93,3,555,17.9,4375,449,3926,1.9,18.5,5537,2915,2622,12.3,23.4,-1162,-4.9,37,0,455,455,2540
1998,05,e) 4,2421,2506,20136,20556,70,2.6,376,14.1,3396,361,3035,1.8,16.5,4236,1881,2355,9.2,20.6,-840,-4.1,33,0,305,305,1531
1998,05,f) 5,2079,2134,17018,17430,51,2.2,323,14.2,2848,235,2613,1.3,16.3,3671,1576,2095,9,21.1,-823,-4.8,32.6,0,265,265,1190
1998,05,g) 6 to 10,7474,7930,76598,77706,228,2.8,929,11.2,10998,2155,8843,2.8,14.2,13214,5433,7781,7,17,-2216,-2.8,28.4,0,694,694,3848
1998,05,h) 11 to 15,6101,6846,87757,88035,200,2.8,605,8.6,10872,1922,8950,2.2,12.3,11428,4033,7395,4.6,13,-556,-0.7,24.6,0,418,418,2533
1998,05,i) 16 to 20,4434,5168,82176,82842,141,2.7,432,8.1,10093,1476,8617,1.8,12.2,11425,3587,7838,4.3,13.8,-1332,-1.6,24.4,0,274,274,1817
1998,05,j) 21 to 25,958,1455,33709,33756,60,4,115,7.8,3469,605,2864,1.8,10.3,3562,738,2824,2.2,10.6,-93,-0.3,20.6,0,53,53,191
1998,05,l) Left Censored,7866,14929,514552,513461,858,5.7,1109,7.4,60380,20970,39410,4.1,11.8,58197,22116,36081,4.3,11.3,2183,0.5,22.6,0,371,371,2569
1998,06,a) 0,60863,61319,429850,215728,60846,198.5,0,0,428244,428244,0,198.5,198.5,0,0,0,0,0,428244,198.5,0,0,,,
1998,06,b) 1,45690,46582,393402,390019,129,0.2,13665,25.3,117890,6000,111890,1.5,30.2,111124,66367,44757,17,28.5,6766,1.7,57,0,10860,10860,54759
1998,06,c) 2,38712,39562,351591,360708,1430,3.3,8287,19.2,83806,10429,73377,2.9,23.2,102039,55582,46457,15.4,28.3,-18233,-5.1,46.4,0,6609,6609,45122
1998,06,d) 3,32298,33368,332781,335636,1372,3.8,5950,16.6,73664,9976,63688,3,21.9,79374,39880,39494,11.9,23.6,-5710,-1.7,43.8,0,4661,4661,30417
1998,06,e) 4,27569,28496,309807,314391,1074,3.6,4361,14.4,59900,8045,51855,2.6,19.1,69067,30948,38119,9.8,22,-9167,-2.9,38.2,0,3405,3405,25009
1998,06,f) 5,23453,24407,272403,274280,899,3.5,3484,13.6,55165,6844,48321,2.5,20.1,58919,27316,31603,10,21.5,-3754,-1.4,40.2,0,2660,2660,19879
1998,06,g) 6 to 10,103787,111555,1347747,1351040,4466,3.9,12916,11.1,244834,37232,207602,2.8,18.1,251419,96930,154489,7.2,18.6,-6585,-0.5,36.2,0,9315,9315,66967
1998,06,h) 11 to 15,77856,89218,1389759,1391468,3576,3.9,7984,8.7,200373,35344,165029,2.5,14.4,203791,75970,127821,5.5,14.6,-3418,-0.2,28.8,0,5032,5032,34348
1998,06,i) 16 to 20,56262,67515,1177758,1164676,2091,3,5438,7.8,171912,28044,143868,2.4,14.8,145747,45682,100065,3.9,12.5,26165,2.3,25,0,3263,3263,21144
1998,06,j) 21 to 25,10650,18963,464143,452392,981,5.1,1453,7.6,77987,22169,55818,4.9,17.2,54485,16982,37503,3.8,12,23502,5.2,24,0,545,545,3342
1998,06,l) Left Censored,70475,152747,5343706,5300776,10268,6.7,12824,8.3,745118,238337,506781,4.5,14.1,659257,222105,437152,4.2,12.4,85861,1.7,24.8,0,3407,3407,30116
1998,08,a) 0,11708,11768,66943,33568,11697,198.8,0,0,66750,66750,0,198.9,198.9,0,0,0,0,0,66750,198.9,0,0,,,
1998,08,b) 1,8760,8893,64349,62908,44,0.4,2678,26,20515,1132,19383,1.8,32.6,17633,10657,6976,16.9,28,2882,4.6,56,0,2112,2112,8845
1998,08,c) 2,7170,7310,50760,52568,271,3.4,1556,19.5,10989,1128,9861,2.1,20.9,14605,8623,5982,16.4,27.8,-3616,-6.9,41.8,0,1235,1235,7020
1998,08,d) 3,6296,6470,51004,53414,247,3.6,1190,17.1,11334,2223,9111,4.2,21.2,16153,8316,7837,15.6,30.2,-4819,-9,42.4,0,925,925,6506
1998,08,e) 4,5616,5770,47215,47900,179,2.9,918,14.9,9644,1877,7767,3.9,20.1,11013,5376,5637,11.2,23,-1369,-2.9,40.2,0,702,702,4529
1998,08,f) 5,4624,4758,40436,40673,149,3,629,12.6,7925,1421,6504,3.5,19.5,8398,3982,4416,9.8,20.6,-473,-1.1,39,0,465,465,2711
1998,08,g) 6 to 10,16397,17516,196100,196725,631,3.5,1923,10.6,32195,6266,25929,3.2,16.4,33444,13304,20140,6.8,17,-1249,-0.6,32.8,0,1347,1347,8637
1998,08,h) 11 to 15,11426,13359,200962,199544,652,4.8,1154,8.5,32465,9976,22489,5,16.3,29629,9564,20065,4.8,14.8,2836,1.5,29.6,0,717,717,4924
1998,08,i) 16 to 20,8204,9723,157084,157272,368,3.7,747,7.5,21765,5154,16611,3.3,13.8,22141,7340,14801,4.7,14.1,-376,-0.3,27.6,0,447,447,2445
1998,08,j) 21 to 25,1498,2664,62764,60444,159,6,167,6.3,12096,3313,8783,5.5,20,7455,2115,5340,3.5,12.3,4641,7.7,24.6,0,64,64,436
1998,08,l) Left Censored,11287,23267,782807,770450,1737,7.5,1749,7.5,113758,33945,79813,4.4,14.8,89044,26716,62328,3.5,11.6,24714,3.2,23.2,0,424,424,2943
1998,09,a) 0,5694,5732,36585,18345,5688,198.5,0,0,36481,36481,0,198.9,198.9,0,0,0,0,0,36481,198.9,0,0,,,
1998,09,b) 1,4331,4393,30172,30239,12,0.2,1142,22.8,8667,535,8132,1.8,28.7,8801,4983,3818,16.5,29.1,-134,-0.4,57.4,0,895,895,3696
1998,09,c) 2,3805,3905,36088,37312,138,3.3,677,16.2,6498,904,5594,2.4,17.4,8946,4383,4563,11.7,24,-2448,-6.6,34.8,0,549,549,3955
1998,09,d) 3,3567,3664,29110,30636,110,2.8,579,14.8,5746,589,5157,1.9,18.8,8797,4751,4046,15.5,28.7,-3051,-9.9,37.6,0,469,469,4071
1998,09,e) 4,3096,3150,27042,27869,108,3.2,463,13.9,5169,522,4647,1.9,18.5,6822,3223,3599,11.6,24.5,-1653,-6,37,0,372,372,2590
1998,09,f) 5,2784,2844,23425,24529,89,3,405,13.5,4344,981,3363,4,17.7,6552,3648,2904,14.9,26.7,-2208,-9,35.4,0,321,321,2803
1998,09,g) 6 to 10,12341,12923,141746,142611,423,3.2,1369,10.2,21076,4729,16347,3.3,14.8,22806,7474,15332,5.2,16,-1730,-1.2,29.6,0,985,985,5205
1998,09,h) 11 to 15,10136,11051,137900,136804,324,2.9,888,7.8,20960,6880,14080,5,15.3,18768,6868,11900,5,13.7,2192,1.6,27.4,0,629,629,4371
1998,09,i) 16 to 20,6680,7626,102345,102399,190,2.4,570,7.3,13919,3936,9983,3.8,13.6,14027,3842,10185,3.8,13.7,-108,-0.1,27.2,0,376,376,2193
1998,09,j) 21 to 25,1438,2083,44488,44727,108,5.1,140,6.7,7257,1691,5566,3.8,16.2,7735,1215,6520,2.7,17.3,-478,-1.1,32.4,0,73,73,244
1998,09,l) Left Censored,15133,24545,874915,878866,1200,4.8,2022,8.1,99560,30898,68662,3.5,11.3,107462,32113,75349,3.7,12.2,-7902,-0.9,22.6,0,615,615,3833
1998,10,a) 0,1746,1755,12005,6017,1745,198.9,0,0,11976,11976,0,199,199,0,0,0,0,0,11976,199,0,0,,,
1998,10,b) 1,1276,1290,7842,8138,4,0.3,306,21.1,1662,31,1631,0.4,20.4,2253,1056,1197,13,27.7,-591,-7.3,40.8,0,243,243,857
1998,10,c) 2,1054,1083,9509,10214,30,2.6,192,16.5,1561,223,1338,2.2,15.3,2971,1368,1603,13.4,29.1,-1410,-13.8,30.6,0,161,161,1270
1998,10,d) 3,997,1014,7804,8128,30,2.8,148,13.8,1135,92,1043,1.1,14,1783,1098,685,13.5,21.9,-648,-7.9,28,0,118,118,941
1998,10,e) 4,820,848,7834,7711,19,2.1,142,15.6,1712,85,1627,1.1,22.2,1466,778,688,10.1,19,246,3.2,38,0,116,116,730
1998,10,f) 5,726,736,6067,6018,25,3.2,98,12.6,1421,172,1249,2.9,23.6,1322,712,610,11.8,22,99,1.6,44,0,78,78,610
1998,10,g) 6 to 10,2756,2856,28606,29404,95,3.2,335,11.3,4188,803,3385,2.7,14.2,5784,2365,3419,8,19.7,-1596,-5.5,28.4,0,239,239,1158
1998,10,h) 11 to 15,1961,2170,26840,26961,77,3.4,208,9.3,3707,936,2771,3.5,13.7,3948,1347,2601,5,14.6,-241,-0.9,27.4,0,135,135,720
1998,10,i) 16 to 20,1307,1498,21590,21841,43,2.8,107,7,2980,1136,1844,5.2,13.6,3482,766,2716,3.5,15.9,-502,-2.3,27.2,0,46,46,366
1998,10,j) 21 to 25,347,547,28238,26348,32,5.8,30,5.5,5451,1035,4416,3.9,20.7,1670,655,1015,2.5,6.3,3781,14.4,12.6,0,8,8,20
1998,10,l) Left Censored,3304,5721,190825,191676,376,6.5,498,8.6,25873,8826,17047,4.6,13.5,27575,7315,20260,3.8,14.4,-1702,-0.9,27,0,100,100,1360
1998,11,a) 0,1078,1084,8569,4296,1076,198.5,0,0,8547,8547,0,199,199,0,0,0,0,0,8547,199,0,0,,,
1998,11,b) 1,931,948,9834,9301,2,0.2,199,18.9,2492,,,,26.8,1426,798,628,8.6,15.3,1066,11.5,30.6,1,154,154,659
1998,11,c) 2,772,781,6023,6162,35,4.2,140,16.7,1111,,,,18,1388,720,668,11.7,22.5,-277,-4.5,36,1,100,100,637
1998,11,d) 3,689,711,7395,7400,23,3.1,99,13.2,1588,598,990,8.1,21.5,1597,659,938,8.9,21.6,-9,-0.1,43,0,75,75,575
1998,11,e) 4,634,652,5815,5998,15,2.2,97,14,894,38,856,0.6,14.9,1260,661,599,11,21,-366,-6.1,29.8,0,75,75,413
1998,11,f) 5,534,547,5952,6134,13,2.3,71,12.3,1056,201,855,3.3,17.2,1419,858,561,14,23.1,-363,-5.9,34.4,0,57,57,815
1998,11,g) 6 to 10,2423,2607,40501,40685,104,3.9,267,9.9,5193,1300,3893,3.2,12.8,5560,2192,3368,5.4,13.7,-367,-0.9,25.6,0,175,175,1374
1998,11,h) 11 to 15,2012,2199,31758,31790,67,3,198,8.7,4427,737,3690,2.3,13.9,4491,1461,3030,4.6,14.1,-64,-0.2,27.8,0,124,124,824
1998,11,i) 16 to 20,1482,1701,36323,36017,65,3.7,133,7.7,4468,718,3750,2,12.4,3856,1161,2695,3.2,10.7,612,1.7,21.4,0,64,64,376
1998,11,j) 21 to 25,380,576,36197,35017,20,3.4,30,5.2,5279,494,4785,1.4,15.1,2918,838,2080,2.4,8.3,2361,6.8,16.6,0,9,9,175
1998,11,l) Left Censored,3838,5987,211212,212412,369,6.1,518,8.5,23151,6084,17067,2.9,10.9,25550,6343,19207,3,12,-2399,-1.1,21.8,0,135,135,901
1998,12,a) 0,36957,37127,211397,106034,36873,198.6,0,0,210726,210726,0,198.7,198.7,0,0,0,0,0,210726,198.7,0,0,,,
1998,12,b) 1,27481,27882,223573,221676,78,0.2,9187,28,66386,1772,64614,0.8,29.9,62591,39872,22719,18,28.2,3795,1.7,56.4,0,7559,7559,33523
1998,12,c) 2,22895,23365,174828,180659,751,2.9,5510,21.3,39621,3879,35742,2.1,21.9,51283,28303,22980,15.7,28.4,-11662,-6.5,43.8,0,4492,4492,23523
1998,12,d) 3,19864,20287,158757,161369,703,3.2,3906,17.8,35015,5351,29664,3.3,21.7,40238,21836,18402,13.5,24.9,-5223,-3.2,43.4,0,3196,3196,18224
1998,12,e) 4,17672,18105,160972,162939,565,2.9,3098,16,34374,5698,28676,3.5,21.1,38308,21244,17064,13,23.5,-3934,-2.4,42.2,0,2453,2453,17149
1998,12,f) 5,15484,16196,150864,153673,502,2.9,2414,14,28033,4058,23975,2.6,18.2,33651,17758,15893,11.6,21.9,-5618,-3.7,36.4,0,1903,1903,13644
1998,12,g) 6 to 10,58201,62246,690665,695906,1885,2.9,7354,11.3,128617,23109,105508,3.3,18.5,139099,61478,77621,8.8,20,-10482,-1.5,37,0,5446,5446,39983
1998,12,h) 11 to 15,37630,43124,655679,644208,1296,2.9,4091,9.2,118604,32033,86571,5,18.4,95663,39221,56442,6.1,14.8,22941,3.6,29.6,0,2609,2609,22120
1998,12,i) 16 to 20,23536,28060,430030,433153,790,2.7,2616,9,54534,11237,43297,2.6,12.6,60780,21983,38797,5.1,14,-6246,-1.4,25.2,0,1517,1517,10144
1998,12,j) 21 to 25,4337,8343,158059,158996,419,4.9,683,8.1,27497,9162,18335,5.8,17.3,29370,11040,18330,6.9,18.5,-1873,-1.2,34.6,0,253,253,1997
1998,12,l) Left Censored,30243,77727,2614248,2599050,5921,7.5,7341,9.4,370237,118676,251561,4.6,14.2,339841,112429,227412,4.3,13.1,30396,1.1,26.2,0,1496,1496,12790
1998,13,a) 0,16492,16584,107249,53857,16461,198.5,0,0,106784,106784,0,198.3,198.3,0,0,0,0,0,106784,198.3,0,0,,,
1998,13,b) 1,12055,12313,89507,90658,38,0.3,3734,26.1,27387,1960,25427,2.2,30.2,29688,18385,11303,20.3,32.7,-2301,-2.5,60.4,0,3002,3002,15840
1998,13,c) 2,10055,10321,83107,86508,392,3.5,2313,20.4,18091,2531,15560,2.9,20.9,24893,14110,10783,16.3,28.8,-6802,-7.9,41.8,0,1831,1831,12224
1998,13,d) 3,8536,8828,78587,80055,288,3,1565,16.5,17319,1763,15556,2.2,21.6,20255,10880,9375,13.6,25.3,-2936,-3.7,43.2,0,1245,1245,8412
1998,13,e) 4,7521,7745,76220,79138,225,2.7,1173,14.2,13730,1754,11976,2.2,17.3,19566,8066,11500,10.2,24.7,-5836,-7.4,34.6,0,898,898,6170
1998,13,f) 5,6362,6645,69179,68609,253,3.6,898,12.9,15382,4177,11205,6.1,22.4,14241,6319,7922,9.2,20.8,1141,1.6,41.6,0,688,688,4850
1998,13,g) 6 to 10,23121,25021,300076,304419,863,3.3,2941,11.3,52218,12788,39430,4.2,17.2,60904,28409,32495,9.3,20,-8686,-2.8,34.4,0,2095,2095,17944
1998,13,h) 11 to 15,17180,19551,296521,296132,639,3.2,1772,8.8,41942,7891,34051,2.7,14.2,41165,15613,25552,5.3,13.9,777,0.3,27.8,0,1110,1110,7948
1998,13,i) 16 to 20,10704,13329,232446,233249,429,3.1,1057,7.7,35254,11620,23634,5,15.1,36859,12804,24055,5.5,15.8,-1605,-0.7,30.2,0,621,621,5452
1998,13,j) 21 to 25,2380,4289,96791,97489,260,6,335,7.7,15767,5352,10415,5.5,16.2,17163,6619,10544,6.8,17.6,-1396,-1.4,32.4,0,105,105,567
1998,13,l) Left Censored,18846,44789,1684808,1678439,3446,7.7,3719,8.3,234037,71416,162621,4.3,13.9,221298,73101,148197,4.4,13.2,12739,0.7,26.4,0,818,818,6886
1998,15,a) 0,1865,1877,14306,7182,1855,197.7,0,0,14249,14249,0,198.4,198.4,0,0,0,0,0,14249,198.4,0,0,,,
1998,15,b) 1,1430,1438,9988,9862,7,0.4,428,25.7,2900,,,,29.4,2648,1561,1087,15.8,26.9,252,2.5,53.8,1,340,340,1329
1998,15,c) 2,1290,1353,10621,11490,24,1.6,262,17.8,1818,,,,15.8,3555,2237,1318,19.5,30.9,-1737,-15.1,31.6,1,222,222,2118
1998,15,d) 3,1081,1106,10053,10674,41,3.4,206,17.3,2136,311,1825,2.9,20,3377,2366,1011,22.2,31.6,-1241,-11.6,40,0,166,166,771
1998,15,e) 4,952,978,13957,14745,26,2.5,168,16,1070,152,918,1,7.3,2646,1278,1368,8.7,17.9,-1576,-10.6,14.6,0,136,136,801
1998,15,f) 5,882,930,8971,8777,40,4.2,107,11.1,1923,254,1669,2.9,21.9,1535,597,938,6.8,17.5,388,4.4,35,0,89,89,504
1998,15,g) 6 to 10,3834,4190,45107,46564,147,3.4,482,11.1,5430,1448,3982,3.1,11.7,8343,3560,4783,7.6,17.9,-2913,-6.2,23.4,0,354,354,1727
1998,15,h) 11 to 15,2924,3400,44304,45304,104,3,285,8.1,4577,1102,3475,2.4,10.1,6577,2390,4187,5.3,14.5,-2000,-4.4,20.2,0,200,200,1076
1998,15,i) 16 to 20,2453,2958,37500,39395,60,2,242,7.9,2725,362,2363,0.9,6.9,6515,2143,4372,5.4,16.5,-3790,-9.6,13.8,0,128,128,452
1998,15,j) 21 to 25,507,913,15197,15552,24,2.6,62,6.7,1352,194,1158,1.2,8.7,2062,739,1323,4.8,13.3,-710,-4.6,17.4,0,21,21,86
1998,15,l) Left Censored,4162,7665,205459,208697,364,4.7,622,8,19857,5290,14567,2.5,9.5,26333,7768,18565,3.7,12.6,-6476,-3.1,19,0,139,139,662
1998,16,a) 0,3130,3150,19411,9786,3107,197.3,0,0,19250,19250,0,196.7,196.7,0,0,0,0,0,19250,196.7,0,0,,,
1998,16,b) 1,2485,2531,17556,17013,4,0.1,818,27.6,6208,,,,36.5,5121,3151,1970,18.5,30.1,1087,6.4,60.2,1,618,618,2456
1998,16,c) 2,2000,2034,14277,14561,74,3.3,413,18.7,3058,,,,21,3626,1877,1749,12.9,24.9,-568,-3.9,42,1,341,341,1647
1998,16,d) 3,1660,1682,10574,11040,60,3.3,317,17.5,2011,291,1720,2.6,18.2,2943,1475,1468,13.4,26.7,-932,-8.5,36.4,0,237,237,1184
1998,16,e) 4,1500,1538,11382,11561,55,3.3,258,15.7,2301,176,2125,1.5,19.9,2658,1225,1433,10.6,23,-357,-3.1,39.8,0,194,194,996
1998,16,f) 5,1197,1247,9493,9682,59,4.6,158,12.2,1533,276,1257,2.9,15.8,1910,631,1279,6.5,19.7,-377,-3.9,31.6,0,118,118,538
1998,16,g) 6 to 10,4438,4670,41197,42469,179,3.7,558,11.5,6210,1304,4906,3.1,14.6,8754,3296,5458,7.8,20.6,-2544,-6,29.2,0,376,376,1989
1998,16,h) 11 to 15,3075,3465,45415,44136,152,4.3,308,8.7,8987,4537,4450,10.3,20.4,6429,2398,4031,5.4,14.6,2558,5.8,29.2,0,187,187,1203
1998,16,i) 16 to 20,2243,2625,43018,41984,77,2.9,217,8,6798,1399,5399,3.3,16.2,4729,1619,3110,3.9,11.3,2069,4.9,22.6,0,127,127,828
1998,16,j) 21 to 25,488,751,16905,16804,29,3.8,51,6.7,1915,360,1555,2.1,11.4,1713,458,1255,2.7,10.2,202,1.2,20.4,0,20,20,94
1998,16,l) Left Censored,3792,6939,180212,179885,421,6.1,439,6.3,21230,6009,15221,3.3,11.8,20575,4620,15955,2.6,11.4,655,0.4,22.8,0,158,158,855
1998,17,a) 0,20045,20163,136385,68462,20009,198.5,0,0,135847,135847,0,198.4,198.4,0,0,0,0,0,135847,198.4,0,0,,,
1998,17,b) 1,15918,16228,117343,118851,70,0.4,4029,21.9,30687,2280,28407,1.9,25.8,33702,18656,15046,15.7,28.4,-3015,-2.6,51.6,0,3152,3152,15061
1998,17,c) 2,13822,14056,114616,113934,386,2.5,2477,16.4,28302,2505,25797,2.2,24.8,26938,13733,13205,12.1,23.6,1364,1.2,47.2,0,1986,1986,11703
1998,17,d) 3,12373,12731,107599,109320,409,3,1868,13.9,20392,3317,17075,3,18.7,23834,10599,13235,9.7,21.8,-3442,-3.1,37.4,0,1455,1455,8671
1998,17,e) 4,10867,11108,102389,105297,327,2.8,1422,12.2,17629,2115,15514,2,16.7,23444,11070,12374,10.5,22.3,-5815,-5.6,33.4,0,1111,1111,9815
1998,17,f) 5,9656,9971,95561,100060,306,2.9,1268,12.1,15952,2301,13651,2.3,15.9,24949,9155,15794,9.1,24.9,-8997,-9,31.8,0,961,961,6326
1998,17,g) 6 to 10,39023,41325,488410,492427,1159,2.7,4168,9.7,75495,10566,64929,2.1,15.3,83528,35780,47748,7.3,17,-8033,-1.7,30.6,0,3010,3010,23453
1998,17,h) 11 to 15,29824,33503,532299,534586,969,2.8,2551,7.4,66294,13267,53027,2.5,12.4,70868,19633,51235,3.7,13.3,-4574,-0.9,24.8,0,1710,1710,11857
1998,17,i) 16 to 20,20848,24108,401708,398219,544,2.2,1746,7.1,54530,7054,47476,1.8,13.7,47551,14400,33151,3.6,11.9,6979,1.8,23.8,0,1073,1073,7585
1998,17,j) 21 to 25,4626,7643,168862,167294,366,4.8,474,6.2,21825,6141,15684,3.7,13,18689,5408,13281,3.2,11.2,3136,1.8,22.4,0,188,188,1082
1998,17,l) Left Censored,42244,78175,2894331,2881368,4112,5.2,5418,6.9,336102,84343,251759,2.9,11.7,310176,89065,221111,3.1,10.8,25926,0.9,21.6,0,1808,1808,14975
1998,18,a) 0,9709,9798,68987,34721,9720,198.4,0,0,68532,68532,0,197.4,197.4,0,0,0,0,0,68532,197.4,0,0,,,
1998,18,b) 1,7564,7674,56669,55417,43,0.5,2066,23.5,17115,1938,15177,3.5,30.9,14610,8263,6347,14.9,26.4,2505,4.5,52.8,0,1701,1701,6737
1998,18,c) 2,6450,6652,57209,58306,187,2.6,1336,18.4,11088,1506,9582,2.6,19,13282,6722,6560,11.5,22.8,-2194,-3.8,38,0,1113,1113,5538
1998,18,d) 3,5808,5969,46671,48044,158,2.5,952,14.9,7843,719,7124,1.5,16.3,10589,4645,5944,9.7,22,-2746,-5.7,32.6,0,760,760,3810
1998,18,e) 4,5095,5250,45745,47120,146,2.6,751,13.5,8259,2130,6129,4.5,17.5,11008,4505,6503,9.6,23.4,-2749,-5.9,35,0,602,602,3470
1998,18,f) 5,4537,4699,40329,41210,97,2,564,11.4,6745,540,6205,1.3,16.4,8507,3853,4654,9.3,20.6,-1762,-4.2,32.8,0,445,445,2717
1998,18,g) 6 to 10,18113,19610,238934,243221,483,2.4,1945,9.6,34648,5026,29622,2.1,14.2,43222,17384,25838,7.1,17.8,-8574,-3.6,28.4,0,1427,1427,11202
1998,18,h) 11 to 15,14263,16545,240771,241234,447,2.6,1253,7.4,33300,6430,26870,2.7,13.8,34225,13443,20782,5.6,14.2,-925,-0.4,27.6,0,844,844,6402
1998,18,i) 16 to 20,9309,10876,174833,175924,247,2.2,766,6.9,21479,4779,16700,2.7,12.2,23661,6407,17254,3.6,13.4,-2182,-1.2,24.4,0,466,466,3263
1998,18,j) 21 to 25,2133,3787,94601,94741,134,3.5,320,8.2,12296,2264,10032,2.4,13,12576,4935,7641,5.2,13.3,-280,-0.3,26,0,96,96,775
1998,18,l) Left Censored,20274,40569,1427967,1422506,2136,5.2,2621,6.4,150440,42564,107876,3,10.6,139518,40755,98763,2.9,9.8,10922,0.8,19.6,0,808,808,7236
1998,19,a) 0,4848,4879,30881,15482,4840,198.4,0,0,30798,30798,0,198.9,198.9,0,0,0,0,0,30798,198.9,0,0,,,
1998,19,b) 1,3763,3877,27298,27305,21,0.5,1023,23.2,7562,1055,6507,3.9,27.7,7575,4808,2767,17.6,27.7,-13,0,55.4,0,803,803,3750
1998,19,c) 2,3343,3399,24197,24341,87,2.4,609,16.6,4447,502,3945,2.1,18.3,4734,2302,2432,9.5,19.4,-287,-1.1,36.6,0,466,466,1868
1998,19,d) 3,3048,3138,23403,23501,86,2.6,410,12.4,3919,424,3495,1.8,16.7,4114,1876,2238,8,17.5,-195,-0.8,33.4,0,318,318,1489
1998,19,e) 4,2739,2800,21541,21925,86,2.9,352,12,3325,501,2824,2.3,15.2,4093,1532,2561,7,18.7,-768,-3.5,30.4,0,279,279,1255
1998,19,f) 5,2276,2314,15856,16264,56,2.3,293,12,2270,279,1991,1.7,14,3085,1179,1906,7.2,19,-815,-5,28,0,232,232,950
1998,19,g) 6 to 10,9281,9827,99631,102009,263,2.6,968,9.5,12484,1956,10528,1.9,12.2,17240,6374,10866,6.2,16.9,-4756,-4.7,24.4,0,693,693,4209
1998,19,h) 11 to 15,7583,8858,132303,131881,283,3.1,677,7.5,15789,2674,13115,2,12,14945,5469,9476,4.1,11.3,844,0.7,22.6,0,458,458,2920
1998,19,i) 16 to 20,6072,7321,89815,89914,142,1.9,475,6.3,11280,1306,9974,1.5,12.5,11478,4768,6710,5.3,12.8,-198,-0.3,25,0,294,294,1651
1998,19,j) 21 to 25,1446,2448,40160,39777,91,3.7,141,5.7,4390,740,3650,1.9,11,3624,1190,2434,3,9.1,766,1.9,18.2,0,51,51,131
1998,19,l) Left Censored,13698,23490,686880,679341,981,4.1,1392,5.9,74241,15532,58709,2.3,10.9,59163,14346,44817,2.1,8.7,15078,2.2,17.4,0,540,540,3905
1998,20,a) 0,5069,5093,34034,17062,5060,198.7,0,0,33945,33945,0,199,199,0,0,0,0,0,33945,199,0,0,,,
1998,20,b) 1,3931,4006,29782,29446,23,0.5,1159,25,8366,498,7868,1.7,28.4,7694,4721,2973,16,26.1,672,2.3,52.2,0,932,932,3958
1998,20,c) 2,3361,3413,23194,24130,100,2.7,635,17.2,4893,771,4122,3.2,20.3,6765,3163,3602,13.1,28,-1872,-7.7,40.6,0,538,538,2691
1998,20,d) 3,2957,3021,23759,24898,100,3.1,510,15.8,4273,459,3814,1.8,17.2,6551,3783,2768,15.2,26.3,-2278,-9.1,34.4,0,405,405,3167
1998,20,e) 4,2525,2580,21368,21866,84,3,428,15.5,3652,649,3003,3,16.7,4647,2204,2443,10.1,21.3,-995,-4.6,33.4,0,337,337,1612
1998,20,f) 5,2227,2281,19673,19999,77,3.2,304,12.7,3489,815,2674,4.1,17.4,4140,1817,2323,9.1,20.7,-651,-3.3,34.8,0,230,230,1508
1998,20,g) 6 to 10,8716,9317,95871,97207,289,3,1001,10.3,15323,2904,12419,3,15.8,17994,8832,9162,9.1,18.5,-2671,-2.7,31.6,0,733,733,4256
1998,20,h) 11 to 15,7147,7902,99596,101075,231,2.8,676,8.3,12075,2256,9819,2.2,11.9,15032,5709,9323,5.6,14.9,-2957,-3,23.8,0,457,457,3050
1998,20,i) 16 to 20,5294,6150,79508,79841,146,2.3,439,7,10461,2361,8100,3,13.1,11126,3676,7450,4.6,13.9,-665,-0.8,26.2,0,267,267,1378
1998,20,j) 21 to 25,1220,2083,35273,34743,118,5.6,152,7.2,5226,2127,3099,6.1,15,4165,1328,2837,3.8,12,1061,3,24,0,50,50,269
1998,20,l) Left Censored,11147,20005,595362,589976,1121,5.6,1294,6.4,73280,18969,54311,3.2,12.4,62507,21515,40992,3.6,10.6,10773,1.8,21.2,0,433,433,4386
1998,21,a) 0,6383,6431,45493,22793,6395,198.9,0,0,45401,45401,0,199.2,199.2,0,0,0,0,0,45401,199.2,0,0,,,
1998,21,b) 1,4844,4943,35163,35999,21,0.4,1420,25,9278,324,8954,0.9,25.8,10950,6314,4636,17.5,30.4,-1672,-4.6,51.6,0,1179,1179,5538
1998,21,c) 2,4005,4135,35875,36556,124,2.8,812,18.1,7291,1010,6281,2.8,19.9,8653,4096,4557,11.2,23.7,-1362,-3.8,39.8,0,668,668,3473
1998,21,d) 3,3719,3841,33059,33989,103,2.5,625,15.2,5695,677,5018,2,16.8,7554,3932,3622,11.6,22.2,-1859,-5.4,33.6,0,512,512,3079
1998,21,e) 4,3139,3233,28738,29926,84,2.4,461,13.4,4523,666,3857,2.2,15.1,6899,3561,3338,11.9,23.1,-2376,-8,30.2,0,374,374,3022
1998,21,f) 5,2876,2988,28056,28462,89,2.8,356,11.4,4413,586,3827,2.1,15.5,5224,1837,3387,6.5,18.4,-811,-2.9,31,0,294,294,1555
1998,21,g) 6 to 10,11261,12098,129454,131167,339,2.7,1230,9.8,18937,3343,15594,2.5,14.4,22362,8190,14172,6.2,17,-3425,-2.6,28.8,0,924,924,6287
1998,21,h) 11 to 15,8858,9905,143182,144827,318,3.1,770,7.6,16125,4641,11484,3.2,11.1,19415,5899,13516,4.1,13.4,-3290,-2.3,22.2,0,501,501,2997
1998,21,i) 16 to 20,5642,6562,115281,116652,185,2.8,491,7.3,14228,2381,11847,2,12.2,16969,4638,12331,4,14.5,-2741,-2.3,24.4,0,308,308,2163
1998,21,j) 21 to 25,1287,2264,51755,50998,137,6,157,6.9,7606,2081,5525,4.1,14.9,6092,2445,3647,4.8,11.9,1514,3,23.8,0,67,67,414
1998,21,l) Left Censored,12122,23953,771735,769756,1400,5.8,1697,7,93883,30518,63365,4,12.2,89925,25528,64397,3.3,11.7,3958,0.5,23.4,0,475,475,2672
1998,22,a) 0,7155,7234,54236,27413,7190,198.8,0,0,53646,53646,0,195.7,195.7,0,0,0,0,0,53646,195.7,0,0,,,
1998,22,b) 1,5468,5558,48344,47939,14,0.2,1593,24.8,14473,1184,13289,2.5,30.2,13663,8323,5340,17.4,28.5,810,1.7,57,0,1300,1300,7232
1998,22,c) 2,4596,4663,41073,42405,151,3,937,18.5,9569,1649,7920,3.9,22.6,12233,7567,4666,17.8,28.8,-2664,-6.2,45.2,0,772,772,5244
1998,22,d) 3,4071,4152,46455,47213,120,2.7,646,14.6,9516,1150,8366,2.4,20.2,11032,4586,6446,9.7,23.4,-1516,-3.2,40.4,0,530,530,3721
1998,22,e) 4,3737,3872,38272,40210,73,1.8,550,13.4,6626,577,6049,1.4,16.5,10502,4645,5857,11.6,26.1,-3876,-9.6,33,0,443,443,4012
1998,22,f) 5,3220,3329,36506,37658,79,2.3,431,12.3,5867,491,5376,1.3,15.6,8170,4029,4141,10.7,21.7,-2303,-6.1,31.2,0,339,339,3450
1998,22,g) 6 to 10,11812,12672,151725,153939,372,2.8,1402,10.6,23596,4597,18999,3,15.3,28024,10891,17133,7.1,18.2,-4428,-2.9,30.6,0,1020,1020,7929
1998,22,h) 11 to 15,9973,11303,157713,158127,299,2.6,883,7.6,20693,2445,18248,1.5,13.1,21520,7791,13729,4.9,13.6,-827,-0.5,26.2,0,540,540,3958
1998,22,i) 16 to 20,7960,9506,150536,151909,220,2.3,650,6.7,19635,3667,15968,2.4,12.9,22381,6231,16150,4.1,14.7,-2746,-1.8,25.8,0,399,399,2719
1998,22,j) 21 to 25,1514,2490,41168,41241,86,3.4,170,6.7,5727,1098,4629,2.7,13.9,5872,2366,3506,5.7,14.2,-145,-0.3,27.8,0,71,71,541
1998,22,l) Left Censored,13096,25664,745057,738666,1410,5.5,1750,6.8,96684,24845,71839,3.4,13.1,83901,24951,58950,3.4,11.4,12783,1.7,22.8,0,508,508,4107
1998,23,a) 0,2913,2934,15312,7688,2909,198.3,0,0,15249,15249,0,198.3,198.3,0,0,0,0,0,15249,198.3,0,0,,,
1998,23,b) 1,2146,2170,11262,11534,0,0,545,22.1,2645,0,2645,0,22.9,3189,2005,1184,17.4,27.6,-544,-4.7,45.8,0,431,431,1752
1998,23,c) 2,1876,1920,13129,13035,51,2.5,325,15.7,3054,811,2243,6.2,23.4,2866,1583,1283,12.1,22,188,1.4,44,0,272,272,1395
1998,23,d) 3,1650,1663,9902,10140,50,2.8,244,13.8,1759,162,1597,1.6,17.3,2234,1254,980,12.4,22,-475,-4.7,34.6,0,196,196,1128
1998,23,e) 4,1324,1347,10248,10450,40,2.8,193,13.6,1648,161,1487,1.5,15.8,2051,791,1260,7.6,19.6,-403,-3.8,31.6,0,153,153,672
1998,23,f) 5,1143,1167,9065,9319,32,2.6,130,10.6,1374,190,1184,2,14.7,1882,818,1064,8.8,20.2,-508,-5.5,29.4,0,103,103,728
1998,23,g) 6 to 10,5030,5265,44867,44853,138,2.5,550,10,6988,1594,5394,3.6,15.6,6960,2878,4082,6.4,15.5,28,0.1,31,0,420,420,2323
1998,23,h) 11 to 15,4006,4433,47554,48173,133,2.9,346,7.6,5401,779,4622,1.6,11.2,6638,3051,3587,6.3,13.8,-1237,-2.6,22.4,0,246,246,1816
1998,23,i) 16 to 20,2465,2857,45234,44553,82,2.8,227,7.7,5443,556,4887,1.2,12.2,4080,1230,2850,2.8,9.2,1363,3,18.4,0,138,138,754
1998,23,j) 21 to 25,547,1118,18743,17860,124,11.4,71,6.5,3355,1062,2293,5.9,18.8,1588,652,936,3.7,8.9,1767,9.9,17.8,0,26,26,118
1998,23,l) Left Censored,4657,7805,224649,224884,380,4.8,549,7,20247,5257,14990,2.3,9,20716,5951,14765,2.6,9.2,-469,-0.2,18,0,191,191,1130
1998,24,a) 0,8866,8919,63522,31846,8853,198.5,0,0,63352,63352,0,198.9,198.9,0,0,0,0,0,63352,198.9,0,0,,,
1998,24,b) 1,7110,7217,53684,52752,17,0.2,1957,23.7,15379,611,14768,1.2,29.2,13514,8004,5510,15.2,25.6,1865,3.6,51.2,0,1534,1534,6794
1998,24,c) 2,5877,5982,44991,47012,181,2.8,1117,17.2,9800,1197,8603,2.5,20.8,13841,7427,6414,15.8,29.4,-4041,-8.6,41.6,0,872,872,6243
1998,24,d) 3,5383,5462,42655,43283,187,3.2,889,15.2,9130,1100,8030,2.5,21.1,10386,5357,5029,12.4,24,-1256,-2.9,42.2,0,682,682,4249
1998,24,e) 4,4553,4710,43151,44098,160,3.2,692,13.9,9171,932,8239,2.1,20.8,11065,5651,5414,12.8,25.1,-1894,-4.3,41.6,0,545,545,4445
1998,24,f) 5,4117,4248,43793,45629,139,3.1,540,12.1,6321,850,5471,1.9,13.9,9995,3832,6163,8.4,21.9,-3674,-8,27.8,0,437,437,2632
1998,24,g) 6 to 10,16884,17968,205007,208099,514,2.8,1925,10.3,33045,5227,27818,2.5,15.9,39228,13294,25934,6.4,18.9,-6183,-3,31.8,0,1405,1405,9420
1998,24,h) 11 to 15,12598,14224,196913,200055,441,3,1241,8.5,25650,5210,20440,2.6,12.8,31934,12269,19665,6.1,16,-6284,-3.2,25.6,0,775,775,6306
1998,24,i) 16 to 20,7627,8972,144432,143512,229,2.5,709,7.7,22032,5171,16861,3.6,15.4,20191,6823,13368,4.8,14.1,1841,1.3,28.2,0,416,416,3170
1998,24,j) 21 to 25,1730,3009,67674,67883,110,3.6,206,6.7,9437,2718,6719,4,13.9,9855,3028,6827,4.5,14.5,-418,-0.6,27.8,0,73,73,880
1998,24,l) Left Censored,15229,30206,1016316,1015009,1934,6.3,2645,8.7,122837,39868,82969,3.9,12.1,120223,43927,76296,4.3,11.8,2614,0.3,23.6,0,654,654,6572
1998,25,a) 0,11126,11171,74006,37098,11099,198.7,0,0,73817,73817,0,199,199,0,0,0,0,0,73817,199,0,0,,,
1998,25,b) 1,8850,8988,66455,64720,29,0.3,2213,21.8,21919,2011,19908,3.1,33.9,18449,10621,7828,16.4,28.5,3470,5.4,57,0,1688,1688,7931
1998,25,c) 2,7392,7483,59511,60122,164,2,1263,15.7,14275,1111,13164,1.8,23.7,15496,7448,8048,12.4,25.8,-1221,-2.1,47.4,0,1021,1021,6563
1998,25,d) 3,6742,6941,61042,62755,208,2.8,1039,14.1,12210,1495,10715,2.4,19.5,15636,5805,9831,9.3,24.9,-3426,-5.4,39,0,831,831,4991
1998,25,e) 4,5948,6060,55842,57472,170,2.7,806,12.6,10213,1009,9204,1.8,17.8,13473,4757,8716,8.3,23.4,-3260,-5.6,35.6,0,656,656,4028
1998,25,f) 5,4912,5045,47626,49007,126,2.4,532,10.1,7514,716,6798,1.5,15.3,10275,3805,6470,7.8,21,-2761,-5.7,30.6,0,423,423,2963
1998,25,g) 6 to 10,20723,22129,273223,277413,604,2.6,2083,9.1,38846,5580,33266,2,14,47226,16334,30892,5.9,17,-8380,-3,28,0,1509,1509,11552
1998,25,h) 11 to 15,17590,19505,300328,300267,618,3.1,1482,7.4,42516,8423,34093,2.8,14.2,42394,13861,28533,4.6,14.1,122,0.1,28.2,0,1007,1007,6896
1998,25,i) 16 to 20,11223,13447,238006,235749,357,2.6,831,6.1,36033,9273,26760,3.9,15.3,31518,8426,23092,3.6,13.4,4515,1.9,26.8,0,543,543,4451
1998,25,j) 21 to 25,2394,3984,115892,115159,176,4.3,307,7.6,12464,2511,9953,2.2,10.8,10998,2676,8322,2.3,9.6,1466,1.2,19.2,0,122,122,592
1998,25,l) Left Censored,25644,43811,1576447,1576228,2099,4.7,3216,7.2,180097,44865,135232,2.8,11.4,179658,53441,126217,3.4,11.4,439,0,22.8,0,1062,1062,8691
1998,26,a) 0,15399,15532,109201,54822,15413,198.5,0,0,108758,108758,0,198.4,198.4,0,0,0,0,0,108758,198.4,0,0,,,
1998,26,b) 1,12652,12928,105660,104166,40,0.3,3357,22.8,29745,1296,28449,1.2,28.6,26757,14861,11896,14.3,25.7,2988,2.9,51.4,0,2596,2596,10945
1998,26,c) 2,10997,11149,93906,98986,297,2.5,2074,17.2,18361,1333,17028,1.3,18.5,28521,13891,14630,14,28.8,-10160,-10.3,37,0,1671,1671,12082
1998,26,d) 3,9912,10110,85268,87877,284,2.6,1604,14.9,15085,1190,13895,1.4,17.2,20302,10186,10116,11.6,23.1,-5217,-5.9,34.4,0,1256,1256,8157
1998,26,e) 4,8424,8601,80493,83460,237,2.6,1190,13.1,14666,1936,12730,2.3,17.6,20600,7078,13522,8.5,24.7,-5934,-7.1,35.2,0,924,924,5505
1998,26,f) 5,7296,7532,69687,71443,205,2.6,990,12.5,12186,2412,9774,3.4,17.1,15697,7674,8023,10.7,22,-3511,-4.9,34.2,0,767,767,5376
1998,26,g) 6 to 10,29990,32080,358360,362028,867,2.6,3250,9.8,52633,7368,45265,2,14.5,59969,22835,37134,6.3,16.6,-7336,-2.1,29,0,2427,2427,16137
1998,26,h) 11 to 15,22937,26401,387679,388644,779,2.9,2080,7.7,55514,17354,38160,4.5,14.3,57443,16487,40956,4.2,14.8,-1929,-0.5,28.6,0,1421,1421,10275
1998,26,i) 16 to 20,15318,18254,297639,298319,467,2.5,1261,6.8,36433,5511,30922,1.8,12.2,37792,11303,26489,3.8,12.7,-1359,-0.5,24.4,0,768,768,6124
1998,26,j) 21 to 25,3324,5406,114551,113450,196,3.5,437,7.9,16942,4128,12814,3.6,14.9,14740,5229,9511,4.6,13,2202,1.9,26,0,149,149,962
1998,26,l) Left Censored,30310,58893,2173337,2165132,2981,5,4027,6.8,238090,62267,175823,2.9,11,221680,64051,157629,3,10.2,16410,0.8,20.4,0,1260,1260,10184
1998,27,a) 0,9468,9535,61978,31096,9479,198.8,0,0,61764,61764,0,198.6,198.6,0,0,0,0,0,61764,198.6,0,0,,,
1998,27,b) 1,7563,7666,49023,50104,33,0.4,1831,21.2,13301,873,12428,1.7,26.5,15462,10152,5310,20.3,30.9,-2161,-4.4,53,0,1352,1352,7262
1998,27,c) 2,6319,6426,46876,48279,169,2.4,1071,15.5,9226,966,8260,2,19.1,12031,6934,5097,14.4,24.9,-2805,-5.8,38.2,0,843,843,6023
1998,27,d) 3,5518,5623,43370,44009,157,2.6,786,13.2,8441,760,7681,1.7,19.2,9718,5093,4625,11.6,22.1,-1277,-2.9,38.4,0,613,613,4379
1998,27,e) 4,5028,5146,44019,44669,138,2.6,631,11.7,6819,654,6165,1.5,15.3,8119,3920,4199,8.8,18.2,-1300,-2.9,30.6,0,484,484,3255
1998,27,f) 5,4324,4591,43538,44068,185,3.9,510,10.7,7926,1788,6138,4.1,18,8986,4133,4853,9.4,20.4,-1060,-2.4,36,0,366,366,2062
1998,27,g) 6 to 10,17133,18262,193994,194837,530,2.8,1685,8.9,28155,3801,24354,2,14.5,29840,10341,19499,5.3,15.3,-1685,-0.8,29,0,1229,1229,7352
1998,27,h) 11 to 15,12599,14669,232194,231475,491,3.3,1088,7.3,31052,8284,22768,3.6,13.4,29613,9119,20494,3.9,12.8,1439,0.6,25.6,0,668,668,4577
1998,27,i) 16 to 20,8666,10318,174699,172124,283,2.7,707,6.7,26543,4316,22227,2.5,15.4,21393,6422,14971,3.7,12.4,5150,3,24.8,0,433,433,3269
1998,27,j) 21 to 25,2063,3273,72070,71557,97,2.9,202,6.1,9000,1341,7659,1.9,12.6,7973,2167,5806,3,11.1,1027,1.5,22.2,0,79,79,551
1998,27,l) Left Censored,17749,31912,1274362,1256482,1345,4.2,1903,5.9,162374,36561,125813,2.9,12.9,126614,32701,93913,2.6,10.1,35760,2.8,20.2,0,652,652,8768
1998,28,a) 0,4389,4429,26520,13321,4386,198.1,0,0,26399,26399,0,198.2,198.2,0,0,0,0,0,26399,198.2,0,0,,,
1998,28,b) 1,3342,3392,23785,24641,19,0.5,1082,27.3,6035,302,5733,1.2,24.5,7746,4747,2999,19.3,31.4,-1711,-6.9,49,0,880,880,4163
1998,28,c) 2,2781,2855,22330,23443,93,2.9,701,22.1,5091,312,4779,1.3,21.7,7316,4773,2543,20.4,31.2,-2225,-9.5,43.4,0,561,561,3901
1998,28,d) 3,2523,2587,20961,21645,75,2.7,454,16.3,3746,317,3429,1.5,17.3,5113,2674,2439,12.4,23.6,-1367,-6.3,34.6,0,372,372,2140
1998,28,e) 4,2234,2307,27559,27318,66,2.7,335,13.7,4821,382,4439,1.4,17.6,4338,1716,2622,6.3,15.9,483,1.7,31.8,0,276,276,1456
1998,28,f) 5,1912,1997,17583,18115,47,2.2,280,13.2,3335,533,2802,2.9,18.4,4398,1990,2408,11,24.3,-1063,-5.9,36.8,0,228,228,1284
1998,28,g) 6 to 10,6877,7356,78368,78457,209,2.7,814,10.6,13311,2993,10318,3.8,17,13490,5284,8206,6.7,17.2,-179,-0.2,34,0,631,631,3990
1998,28,h) 11 to 15,5740,6348,88673,88931,185,2.8,512,7.9,10185,1393,8792,1.6,11.5,10700,3899,6801,4.4,12,-515,-0.5,23,0,334,334,2493
1998,28,i) 16 to 20,4068,4924,82991,82884,156,3.1,384,7.6,10740,2507,8233,3,13,10526,3750,6776,4.5,12.7,214,0.3,25.4,0,242,242,1855
1998,28,j) 21 to 25,961,1437,33134,33015,65,4.5,102,7,4113,1189,2924,3.6,12.5,3875,1575,2300,4.8,11.7,238,0.8,23.4,0,56,56,207
1998,28,l) Left Censored,8059,15673,482769,481133,870,5.5,998,6.3,50666,12972,37694,2.7,10.5,47394,13183,34211,2.7,9.9,3272,0.6,19.8,0,337,337,1941
1998,29,a) 0,10181,10262,70715,35463,10183,198.5,0,0,70504,70504,0,198.8,198.8,0,0,0,0,0,70504,198.8,0,0,,,
1998,29,b) 1,7894,7997,54220,55407,38,0.4,2327,25.2,14606,989,13617,1.8,26.4,16980,10083,6897,18.2,30.6,-2374,-4.2,52.8,0,1863,1863,7629
1998,29,c) 2,6621,6765,51880,54182,194,2.6,1486,20,9202,1070,8132,2,17,13805,7631,6174,14.1,25.5,-4603,-8.5,34,0,1209,1209,6597
1998,29,d) 3,5993,6129,45280,46913,190,2.9,1045,15.9,7739,856,6883,1.8,16.5,11004,5092,5912,10.9,23.5,-3265,-7,33,0,861,861,4336
1998,29,e) 4,5443,5647,48683,50477,196,3.3,816,13.7,7643,921,6722,1.8,15.1,11231,4163,7068,8.2,22.2,-3588,-7.1,30.2,0,631,631,3268
1998,29,f) 5,4520,4738,40240,41698,152,3.1,635,12.7,6313,810,5503,1.9,15.1,9229,3816,5413,9.2,22.1,-2916,-7,30.2,0,515,515,3033
1998,29,g) 6 to 10,17886,19173,206897,211612,599,3,2129,10.7,28956,4497,24459,2.1,13.7,38385,14790,23595,7,18.1,-9429,-4.4,27.4,0,1579,1579,10149
1998,29,h) 11 to 15,14389,16139,228606,233196,473,2.9,1303,7.9,25467,5554,19913,2.4,10.9,34646,10974,23672,4.7,14.9,-9179,-4,21.8,0,890,890,6129
1998,29,i) 16 to 20,9367,11160,174771,175144,251,2.2,789,6.9,20209,3126,17083,1.8,11.5,20955,5931,15024,3.4,12,-746,-0.5,23,0,505,505,2670
1998,29,j) 21 to 25,2105,3601,75458,76345,140,3.8,241,6.6,7083,1610,5473,2.1,9.3,8856,1797,7059,2.4,11.6,-1773,-2.3,18.6,0,83,83,268
1998,29,l) Left Censored,19418,36847,1274719,1274454,1965,5.3,2527,6.8,138516,40771,97745,3.2,10.9,137986,36046,101940,2.8,10.8,530,0.1,21.6,0,747,747,5214
1998,30,a) 0,2611,2618,12414,6237,2597,198.4,0,0,12355,12355,0,198.1,198.1,0,0,0,0,0,12355,198.1,0,0,,,
1998,30,b) 1,1921,1934,10475,10730,2,0.1,588,26.1,2478,,,,23.1,2987,1754,1233,16.3,27.8,-509,-4.7,46.2,1,458,458,1493
1998,30,c) 2,1734,1755,9591,10060,60,3.2,301,16,1757,,,,17.5,2694,1215,1479,12.1,26.8,-937,-9.3,35,1,236,236,889
1998,30,d) 3,1496,1513,8802,9163,58,3.6,253,15.7,1484,265,1219,2.9,16.2,2205,1094,1111,11.9,24.1,-721,-7.9,32.4,0,206,206,935
1998,30,e) 4,1210,1236,8406,8480,35,2.7,178,13.6,1577,119,1458,1.4,18.6,1724,689,1035,8.1,20.3,-147,-1.7,37.2,0,145,145,556
1998,30,f) 5,1036,1062,6874,6985,41,3.7,141,12.6,1075,121,954,1.7,15.4,1296,500,796,7.2,18.6,-221,-3.2,30.8,0,109,109,398
1998,30,g) 6 to 10,3794,3960,31276,31780,151,3.7,475,11.5,4651,1059,3592,3.3,14.6,5659,2366,3293,7.4,17.8,-1008,-3.2,29.2,0,353,353,1491
1998,30,h) 11 to 15,2944,3301,33443,33689,150,4.4,325,9.6,4662,732,3930,2.2,13.8,5154,1999,3155,5.9,15.3,-492,-1.5,27.6,0,209,209,1037
1998,30,i) 16 to 20,2247,2546,27864,28199,62,2.4,199,7.6,3049,380,2669,1.3,10.8,3718,1135,2583,4,13.2,-669,-2.4,21.6,0,121,121,618
1998,30,j) 21 to 25,489,714,10108,10259,23,3.2,55,7.5,1287,273,1014,2.7,12.5,1588,455,1133,4.4,15.5,-301,-3,25,0,24,24,100
1998,30,l) Left Censored,3542,5882,112843,113165,307,5.2,398,6.7,12602,4338,8264,3.8,11.1,13246,5644,7602,5,11.7,-644,-0.6,22.2,0,147,147,906
1998,31,a) 0,3135,3168,20834,10444,3142,198.4,0,0,20781,20781,0,199,199,0,0,0,0,0,20781,199,0,0,,,
1998,31,b) 1,2480,2542,15295,15221,37,1.3,691,23.9,4255,822,3433,5.4,28,4107,2495,1612,16.4,27,148,1,54,0,552,552,2107
1998,31,c) 2,2073,2104,14476,15521,57,2.5,395,17.3,2263,146,2117,0.9,14.6,4352,2059,2293,13.3,28,-2089,-13.4,29.2,0,319,319,1825
1998,31,d) 3,1828,1872,13618,14302,59,3,291,14.6,2250,599,1651,4.2,15.7,3617,1730,1887,12.1,25.3,-1367,-9.6,31.4,0,234,234,1240
1998,31,e) 4,1651,1706,12898,13237,42,2.3,224,12.4,2123,249,1874,1.9,16,2800,1488,1312,11.2,21.2,-677,-5.2,32,0,183,183,1328
1998,31,f) 5,1488,1530,11775,12434,32,2,194,12,1680,111,1569,0.9,13.5,2998,1457,1541,11.7,24.1,-1318,-10.6,27,0,152,152,945
1998,31,g) 6 to 10,5897,6359,71805,70225,178,2.7,615,9.3,12766,1425,11341,2,18.2,9606,3655,5951,5.2,13.7,3160,4.5,27.4,0,441,441,2317
1998,31,h) 11 to 15,4856,5450,75614,76772,179,3.2,456,8.2,9782,2909,6873,3.8,12.7,12097,4944,7153,6.4,15.8,-2315,-3.1,25.4,0,296,296,1689
1998,31,i) 16 to 20,3660,4270,58271,57872,89,2,276,6.3,7410,712,6698,1.2,12.8,6611,2270,4341,3.9,11.4,799,1.4,22.8,0,162,162,737
1998,31,j) 21 to 25,863,1390,26755,26847,43,3,107,7.5,2887,579,2308,2.2,10.8,3070,1093,1977,4.1,11.4,-183,-0.6,21.6,0,40,40,162
1998,31,l) Left Censored,7974,13075,383547,383220,556,4.2,767,5.8,36513,8943,27570,2.3,9.5,35859,9956,25903,2.6,9.4,654,0.1,18.8,0,307,307,1813
1998,32,a) 0,4654,4686,37147,18660,4648,198.4,0,0,36974,36974,0,198.1,198.1,0,0,0,0,0,36974,198.1,0,0,,,
1998,32,b) 1,3302,3331,30053,30227,11,0.3,1045,26.9,9407,369,9038,1.2,31.1,9755,4994,4761,16.5,32.3,-348,-1.2,62.2,0,859,859,3869
1998,32,c) 2,2432,2486,35114,36912,95,3.5,571,20.9,4942,1022,3920,2.8,13.4,8537,4378,4159,11.9,23.1,-3595,-9.7,26.8,0,454,454,2677
1998,32,d) 3,2106,2165,27471,27980,97,4.2,422,18.1,4966,1327,3639,4.7,17.7,5984,2867,3117,10.2,21.4,-1018,-3.7,35.4,0,336,336,2370
1998,32,e) 4,1718,1781,23277,23576,65,3.4,280,14.8,4325,635,3690,2.7,18.3,4923,1661,3262,7,20.9,-598,-2.6,36.6,0,216,216,1301
1998,32,f) 5,1349,1394,21457,21276,47,3.2,202,13.7,3773,309,3464,1.5,17.7,3411,1428,1983,6.7,16,362,1.7,32,0,147,147,1097
1998,32,g) 6 to 10,5138,5552,78259,80141,210,3.6,667,11.5,12617,2182,10435,2.7,15.7,16381,5862,10519,7.3,20.4,-3764,-4.7,31.4,0,474,474,3495
1998,32,h) 11 to 15,3352,4072,70239,72377,193,4.6,361,8.7,10500,2956,7544,4.1,14.5,14776,4509,10267,6.2,20.4,-4276,-5.9,29,0,217,217,1425
1998,32,i) 16 to 20,2499,3046,83159,83859,132,4.2,251,8.1,7432,1066,6366,1.3,8.9,8831,1964,6867,2.3,10.5,-1399,-1.6,17.8,0,142,142,832
1998,32,j) 21 to 25,526,979,33260,32689,86,8.9,54,5.6,4639,966,3673,3,14.2,3497,477,3020,1.5,10.7,1142,3.5,21.4,0,23,23,241
1998,32,l) Left Censored,3711,7793,340475,336582,801,10.4,636,8.2,43495,13709,29786,4.1,12.9,35709,9270,26439,2.8,10.6,7786,2.3,21.2,0,139,139,2165
1998,33,a) 0,2677,2689,15165,7602,2671,198.7,0,0,15127,15127,0,199,199,0,0,0,0,0,15127,199,0,0,,,
1998,33,b) 1,2173,2197,13372,13536,2,0.1,547,21.9,3556,,,,26.3,3883,2436,1447,18,28.7,-327,-2.4,52.6,1,436,436,2135
1998,33,c) 2,1909,1945,15336,15202,45,2.2,308,14.8,3306,,,,21.7,3037,1313,1724,8.6,20,269,1.7,40,1,251,251,1176
1998,33,d) 3,1647,1660,12450,12503,47,2.7,220,12.6,2356,152,2204,1.2,18.8,2461,990,1471,7.9,19.7,-105,-0.9,37.6,0,177,177,851
1998,33,e) 4,1447,1472,11088,11417,44,2.9,156,10.2,1838,135,1703,1.2,16.1,2495,849,1646,7.4,21.9,-657,-5.8,32.2,0,131,131,726
1998,33,f) 5,1169,1187,10855,10784,36,2.9,135,10.9,1793,129,1664,1.2,16.6,1650,586,1064,5.4,15.3,143,1.3,30.6,0,114,114,504
1998,33,g) 6 to 10,4978,5257,54474,55115,155,2.9,488,9,7230,941,6289,1.7,13.1,8511,3234,5277,5.9,15.4,-1281,-2.3,26.2,0,365,365,2400
1998,33,h) 11 to 15,4127,4481,61270,61169,150,3.3,386,8.4,7714,1433,6281,2.3,12.6,7512,2435,5077,4,12.3,202,0.3,24.6,0,279,279,1666
1998,33,i) 16 to 20,2254,2561,35380,35498,76,2.9,191,7.3,4145,896,3249,2.5,11.7,4380,1309,3071,3.7,12.3,-235,-0.6,23.4,0,132,132,609
1998,33,j) 21 to 25,530,923,23584,21801,57,6.1,60,6.5,5752,2563,3189,11.8,26.4,2185,392,1793,1.8,10,3567,16.4,20,0,20,20,111
1998,33,l) Left Censored,4584,7895,254362,253493,430,5.4,666,8.3,29564,5945,23619,2.3,11.7,27826,11173,16653,4.4,11,1738,0.7,22,0,147,147,2918
1998,34,a) 0,17469,17543,106396,53364,17428,198.7,0,0,106064,106064,0,198.8,198.8,0,0,0,0,0,106064,198.8,0,0,,,
1998,34,b) 1,13891,14047,95935,93343,31,0.2,3479,21.8,29241,1980,27261,2.1,31.3,24056,13228,10828,14.2,25.8,5185,5.5,51.6,0,2710,2710,10692
1998,34,c) 2,11393,11546,82106,84989,326,2.6,2170,17.3,18891,2344,16547,2.8,22.2,24657,12243,12414,14.4,29,-5766,-6.8,44.4,0,1733,1733,10129
1998,34,d) 3,10101,10482,77996,80755,397,3.6,1584,14.3,16670,2267,14403,2.8,20.6,22187,8737,13450,10.8,27.5,-5517,-6.9,41.2,0,1243,1243,7429
1998,34,e) 4,8234,8354,66862,66797,273,3.1,1169,13.3,13765,1435,12330,2.1,20.6,13634,6116,7518,9.2,20.4,131,0.2,40.8,0,932,932,4912
1998,34,f) 5,7396,7507,67893,66576,217,2.7,983,12.5,16055,3599,12456,5.4,24.1,13421,5148,8273,7.7,20.2,2634,3.9,40.4,0,768,768,3964
1998,34,g) 6 to 10,30389,31490,312542,318644,945,2.9,3328,10.2,48125,7549,40576,2.4,15.1,60328,21543,38785,6.8,18.9,-12203,-3.8,30.2,0,2469,2469,15016
1998,34,h) 11 to 15,23388,25456,340037,342201,826,3.2,2132,8.2,45770,7172,38598,2.1,13.4,50097,15050,35047,4.4,14.6,-4327,-1.2,26.8,0,1453,1453,8979
1998,34,i) 16 to 20,15480,17063,256226,258727,423,2.4,1344,7.7,32860,7604,25256,2.9,12.7,37862,11948,25914,4.6,14.6,-5002,-1.9,25.4,0,925,925,6712
1998,34,j) 21 to 25,3362,4518,108137,107232,176,3.8,342,7.4,17949,4226,13723,3.9,16.7,16138,7248,8890,6.8,15,1811,1.7,30,0,159,159,2500
1998,34,l) Left Censored,31153,52647,1817974,1822822,2768,5.2,4321,8.1,227748,66612,161136,3.7,12.5,237445,83591,153854,4.6,13,-9697,-0.5,25,0,1540,1540,11172
1998,35,a) 0,3275,3295,22964,11535,3261,197.9,0,0,22859,22859,0,198.2,198.2,0,0,0,0,0,22859,198.2,0,0,,,
1998,35,b) 1,2496,2524,16813,17791,8,0.3,790,26.7,3921,113,3808,0.6,22,5877,3532,2345,19.9,33,-1956,-11,44,0,602,602,2975
1998,35,c) 2,2091,2125,15336,16549,67,2.9,491,20.9,2902,274,2628,1.7,17.5,5327,3108,2219,18.8,32.2,-2425,-14.7,35,0,403,403,2663
1998,35,d) 3,1925,1976,16093,16596,74,3.5,351,16.6,3590,1417,2173,8.5,21.6,4596,2270,2326,13.7,27.7,-1006,-6.1,43.2,0,270,270,1710
1998,35,e) 4,1704,1784,14105,14635,62,3.3,280,14.8,2513,401,2112,2.7,17.2,3572,1828,1744,12.5,24.4,-1059,-7.2,34.4,0,215,215,1341
1998,35,f) 5,1388,1432,13091,13548,50,3.3,215,14.2,2177,222,1955,1.6,16.1,3091,1650,1441,12.2,22.8,-914,-6.7,32.2,0,163,163,1279
1998,35,g) 6 to 10,5385,5779,56101,58269,216,3.6,695,11.5,7608,1429,6179,2.5,13.1,11944,4449,7495,7.6,20.5,-4336,-7.4,26.2,0,470,470,2925
1998,35,h) 11 to 15,4157,4771,67173,66660,190,3.9,405,8.3,10478,3654,6824,5.5,15.7,9451,3266,6185,4.9,14.2,1027,1.5,28.4,0,259,259,1511
1998,35,i) 16 to 20,3067,3541,45887,45871,107,2.9,283,7.8,6592,1474,5118,3.2,14.4,6560,2405,4155,5.2,14.3,32,0.1,28.6,0,171,171,812
1998,35,j) 21 to 25,662,1163,20092,19650,66,5.7,67,5.7,2776,836,1940,4.3,14.1,1892,604,1288,3.1,9.6,884,4.5,19.2,0,24,24,83
1998,35,l) Left Censored,4763,9042,233709,234764,529,5.8,682,7.5,27565,7697,19868,3.3,11.7,29675,10055,19620,4.3,12.6,-2110,-0.9,23.4,0,183,183,1572
1998,36,a) 0,36717,36890,226006,113433,36629,198.6,0,0,225147,225147,0,198.5,198.5,0,0,0,0,0,225147,198.5,0,0,,,
1998,36,b) 1,29286,29629,202604,199616,64,0.2,7497,22.3,62442,2469,59973,1.2,31.3,56465,31198,25267,15.6,28.3,5977,3,56.6,0,5952,5952,26611
1998,36,c) 2,23942,24201,173596,179739,677,2.6,4698,17.9,40125,3770,36355,2.1,22.3,52411,25254,27157,14.1,29.2,-12286,-6.9,44.6,0,3866,3866,21925
1998,36,d) 3,20613,21489,162158,166331,881,3.8,3666,16,33895,5795,28100,3.5,20.4,42240,19695,22545,11.8,25.4,-8345,-5,40.8,0,2832,2832,16036
1998,36,e) 4,17221,17429,148809,153145,487,2.6,2693,14.5,28029,4059,23970,2.7,18.3,36700,15373,21327,10,24,-8671,-5.7,36.6,0,2168,2168,12003
1998,36,f) 5,15180,15495,141057,143977,424,2.6,2154,13.2,25838,2781,23057,1.9,17.9,31680,12668,19012,8.8,22,-5842,-4.1,35.8,0,1772,1772,10092
1998,36,g) 6 to 10,63396,65641,639869,645759,1868,2.7,6961,10.2,99339,11177,88162,1.7,15.4,111119,41195,69924,6.4,17.2,-11780,-1.8,30.8,0,5316,5316,30422
1998,36,h) 11 to 15,48839,53017,691150,698272,1431,2.6,4416,8.1,83564,11074,72490,1.6,12,97809,30408,67401,4.4,14,-14245,-2,24,0,3182,3182,19880
1998,36,i) 16 to 20,31342,35796,536823,539169,821,2.2,2559,7,67102,11366,55736,2.1,12.4,71793,22041,49752,4.1,13.3,-4691,-0.9,24.8,0,1741,1741,11739
1998,36,j) 21 to 25,6320,9849,240504,238999,311,3.1,698,6.9,32902,7073,25829,3,13.8,29892,6750,23142,2.8,12.5,3010,1.3,25,0,338,338,1871
1998,36,l) Left Censored,67421,112104,3789704,3796224,5094,4.5,8324,7.3,459922,108802,351120,2.9,12.1,472961,143031,329930,3.8,12.5,-13039,-0.4,24.2,0,3370,3370,22810
1998,37,a) 0,15383,15517,103377,51813,15422,198.8,0,0,103128,103128,0,199,199,0,0,0,0,0,103128,199,0,0,,,
1998,37,b) 1,12030,12220,95767,90502,79,0.6,3543,25.2,35019,6908,28111,7.6,38.7,24489,14669,9820,16.2,27.1,10530,11.6,54.2,0,2841,2841,11897
1998,37,c) 2,9680,9985,78792,80785,304,2.8,1909,17.6,16504,2962,13542,3.7,20.4,20489,10077,10412,12.5,25.4,-3985,-5,40.8,0,1542,1542,8378
1998,37,d) 3,8418,8616,63966,65935,282,3.1,1366,14.9,11582,1579,10003,2.4,17.6,15519,7450,8069,11.3,23.5,-3937,-5.9,35.2,0,1086,1086,5915
1998,37,e) 4,7006,7252,65795,66842,225,2.9,1091,14.2,11256,1939,9317,2.9,16.8,13350,6310,7040,9.4,20,-2094,-3.2,33.6,0,869,869,5047
1998,37,f) 5,5827,6068,60529,61476,204,3.2,784,12.3,11016,2406,8610,3.9,17.9,12909,4915,7994,8,21,-1893,-3.1,35.8,0,640,640,3949
1998,37,g) 6 to 10,23997,25836,300351,305336,789,2.9,2777,10.3,45603,8858,36745,2.9,14.9,55573,25660,29913,8.4,18.2,-9970,-3.3,29.8,0,1982,1982,16463
1998,37,h) 11 to 15,20167,23011,306512,307990,735,3.1,1791,7.6,39775,6559,33216,2.1,12.9,42731,15684,27047,5.1,13.9,-2956,-1,25.8,0,1087,1087,6903
1998,37,i) 16 to 20,11674,14212,232553,233262,472,3.3,933,6.5,27980,7286,20694,3.1,12,29397,10507,18890,4.5,12.6,-1417,-0.6,24,0,588,591,3823
1998,37,j) 21 to 25,2539,4397,99035,97208,195,4.4,322,7.2,13925,3853,10072,4,14.3,10271,3441,6830,3.5,10.6,3654,3.7,21.2,0,104,104,548
1998,37,l) Left Censored,22327,48845,1779686,1781414,3345,6.8,4357,8.8,197027,58512,138515,3.3,11.1,200483,70776,129707,4,11.3,-3456,-0.2,22.2,0,922,922,6941
1998,38,a) 0,1194,1201,7838,3934,1194,198.8,0,0,7809,7809,0,198.5,198.5,0,0,0,0,0,7809,198.5,0,0,,,
1998,38,b) 1,962,987,6753,9256,13,1.2,228,20.7,1926,,,,20.8,6932,654,6278,7.1,74.9,-5006,-54.1,41.6,1,169,169,487
1998,38,c) 2,846,861,5408,6057,29,3.1,166,17.8,808,,,,13.3,2105,1341,764,22.1,34.8,-1297,-21.5,26.6,1,132,132,1254
1998,38,d) 3,698,700,4977,5423,27,3.6,123,16.4,589,95,494,1.8,10.9,1480,735,745,13.6,27.3,-891,-16.4,21.8,0,97,97,660
1998,38,e) 4,720,728,4345,4574,20,2.6,121,15.5,624,95,529,2.1,13.6,1081,593,488,13,23.6,-457,-10,27.2,0,106,106,566
1998,38,f) 5,634,637,5144,5108,12,1.8,70,10.5,908,33,875,0.6,17.8,835,406,429,7.9,16.3,73,1.5,32.6,0,58,58,357
1998,38,g) 6 to 10,2462,2597,24066,24218,91,3.4,252,9.4,3468,402,3066,1.7,14.3,3772,1563,2209,6.5,15.6,-304,-1.3,28.6,0,190,190,901
1998,38,h) 11 to 15,2169,2425,25285,25427,86,3.5,188,7.6,3306,683,2623,2.7,13,3590,1212,2378,4.8,14.1,-284,-1.1,26,0,112,112,522
1998,38,i) 16 to 20,1703,1912,22337,22546,40,2,141,7.2,2477,353,2124,1.6,11,2895,948,1947,4.2,12.8,-418,-1.8,22,0,87,87,451
1998,38,j) 21 to 25,385,548,9083,8985,21,3.8,35,6.3,1409,502,907,5.6,15.7,1212,332,880,3.7,13.5,197,2.2,27,0,14,14,92
1998,38,l) Left Censored,3512,5491,128751,127648,196,3.5,348,6.2,14526,3223,11303,2.5,11.4,12320,5054,7266,4,9.7,2206,1.7,19.4,0,124,124,1642
1998,39,a) 0,16483,16660,119109,59780,16547,198.6,0,0,118659,118659,0,198.5,198.5,0,0,0,0,0,118659,198.5,0,0,,,
1998,39,b) 1,13162,13456,109005,107916,71,0.5,3574,23.3,30398,2648,27750,2.5,28.2,28220,16420,11800,15.2,26.1,2178,2.1,52.2,0,2807,2807,13017
1998,39,c) 2,11249,11519,92133,95964,317,2.5,2116,17,18337,1728,16609,1.8,19.1,25998,14115,11883,14.7,27.1,-7661,-8,38.2,0,1716,1716,10711
1998,39,d) 3,10384,10626,85018,88278,238,2.1,1602,14.1,14792,1220,13572,1.4,16.8,21312,10669,10643,12.1,24.1,-6520,-7.3,33.6,0,1299,1299,9296
1998,39,e) 4,8994,9356,83457,85442,245,2.5,1239,12.6,14426,2043,12383,2.4,16.9,18395,8282,10113,9.7,21.5,-3969,-4.6,33.8,0,962,962,6449
1998,39,f) 5,7929,8316,80681,81300,230,2.6,965,11.1,14259,2333,11926,2.9,17.5,15496,6498,8998,8,19.1,-1237,-1.6,35,0,758,758,4672
1998,39,g) 6 to 10,32415,35067,405131,409942,958,2.6,3424,9.4,57791,9737,48054,2.4,14.1,67412,25838,41574,6.3,16.4,-9621,-2.3,28.2,0,2520,2520,16870
1998,39,h) 11 to 15,25655,29683,444917,445754,808,2.7,2261,7.4,55071,10257,44814,2.3,12.4,56744,19232,37512,4.3,12.7,-1673,-0.3,24.8,0,1432,1432,9541
1998,39,i) 16 to 20,18284,21918,338323,337534,563,2.5,1441,6.4,44819,8875,35944,2.6,13.3,43241,12260,30981,3.6,12.8,1578,0.5,25.6,0,891,892,5991
1998,39,j) 21 to 25,4092,7113,168131,165961,348,4.8,546,7.6,25995,6985,19010,4.2,15.7,21654,7252,14402,4.4,13,4341,2.7,26,0,183,183,1351
1998,39,l) Left Censored,40359,79407,2825467,2822308,3694,4.6,5341,6.7,325209,72683,252526,2.6,11.5,318890,105036,213854,3.7,11.3,6319,0.2,22.6,0,1612,1612,18283
1998,40,a) 0,6355,6430,41439,20778,6394,198.9,0,0,41323,41323,0,198.9,198.9,0,0,0,0,0,41323,198.9,0,0,,,
1998,40,b) 1,5013,5173,37364,38512,28,0.5,1551,25.9,9804,714,9090,1.9,25.5,12099,6509,5590,16.9,31.4,-2295,-5.9,51,0,1269,1269,5544
1998,40,c) 2,3933,4012,28468,30005,99,2.2,874,19.8,5798,668,5130,2.2,19.3,8872,4533,4339,15.1,29.6,-3074,-10.3,38.6,0,731,731,3438
1998,40,d) 3,3378,3446,27347,28673,110,3,655,17.6,4994,625,4369,2.2,17.4,7646,3902,3744,13.6,26.7,-2652,-9.3,34.8,0,534,534,3286
1998,40,e) 4,3076,3137,23479,25106,97,2.9,511,15.2,3548,369,3179,1.5,14.1,6801,3557,3244,14.2,27.1,-3253,-13,28.2,0,405,405,2696
1998,40,f) 5,2674,2783,25097,25145,96,3.3,386,13.2,4796,654,4142,2.6,19.1,4891,2322,2569,9.2,19.5,-95,-0.4,38.2,0,302,302,1710
1998,40,g) 6 to 10,10263,10833,110307,112445,305,2.7,1244,11,16681,1743,14938,1.6,14.8,20957,9851,11106,8.8,18.6,-4276,-3.8,29.6,0,918,918,6984
1998,40,h) 11 to 15,8607,9629,128679,128306,297,3,817,8.3,17291,2338,14953,1.8,13.5,16544,6751,9793,5.3,12.9,747,0.6,25.8,0,520,520,3410
1998,40,i) 16 to 20,6539,7627,110184,110247,262,3.4,569,7.3,13668,3468,10200,3.1,12.4,13794,3792,10002,3.4,12.5,-126,-0.1,24.8,0,331,333,1648
1998,40,j) 21 to 25,1238,2049,37017,36352,77,3.7,165,7.9,5731,1040,4691,2.9,15.8,4401,1826,2575,5,12.1,1330,3.7,24.2,0,60,60,234
1998,40,l) Left Censored,10450,20306,569504,561136,1073,5.2,1368,6.7,73175,19838,53337,3.5,13,56438,18519,37919,3.3,10.1,16737,2.9,20.2,0,423,423,2911
1998,41,a) 0,7889,7949,44611,22367,7882,198.3,0,0,44489,44489,0,198.9,198.9,0,0,0,0,0,44489,198.9,0,0,,,
1998,41,b) 1,6047,6131,38830,39180,13,0.2,1853,26,10118,709,9409,1.8,25.8,10817,6993,3824,17.8,27.6,-699,-1.8,51.6,0,1414,1414,5022
1998,41,c) 2,5252,5382,45795,47949,172,2.9,1095,18.7,6994,805,6189,1.7,14.6,11302,5460,5842,11.4,23.6,-4308,-9,29.2,0,874,874,4653
1998,41,d) 3,4771,4858,34568,35351,185,3.6,781,15.1,6591,1130,5461,3.2,18.6,8157,3548,4609,10,23.1,-1566,-4.5,37.2,0,593,593,2937
1998,41,e) 4,4119,4301,33811,34514,158,3.5,619,13.6,5812,669,5143,1.9,16.8,7218,3088,4130,8.9,20.9,-1406,-4.1,33.6,0,462,462,2149
1998,41,f) 5,3338,3444,27901,28782,112,3.1,447,12.4,5176,1033,4143,3.6,18,6937,3876,3061,13.5,24.1,-1761,-6.1,36,0,343,343,3503
1998,41,g) 6 to 10,12855,13618,136433,139057,435,3.1,1505,10.6,21147,3089,18058,2.2,15.2,26394,9989,16405,7.2,19,-5247,-3.8,30.4,0,1077,1077,7060
1998,41,h) 11 to 15,9153,10488,149318,151302,380,3.5,952,8.8,19927,5171,14756,3.4,13.2,23894,7953,15941,5.3,15.8,-3967,-2.6,26.4,0,589,589,4334
1998,41,i) 16 to 20,6799,7943,108780,109827,229,2.8,583,7.2,12800,2483,10317,2.3,11.7,14894,4255,10639,3.9,13.6,-2094,-1.9,23.4,0,373,373,2293
1998,41,j) 21 to 25,1428,2321,52268,52455,97,4.1,146,6.2,6477,1950,4527,3.7,12.3,6851,1789,5062,3.4,13.1,-374,-0.8,24.6,0,62,62,345
1998,41,l) Left Censored,10522,19973,619424,621537,1150,5.7,1655,8.2,75987,20125,55862,3.2,12.2,80212,26472,53740,4.3,12.9,-4225,-0.7,24.4,0,440,440,3903
1998,42,a) 0,17625,17793,120970,60681,17683,198.8,0,0,120578,120578,0,198.7,198.7,0,0,0,0,0,120578,198.7,0,0,,,
1998,42,b) 1,14296,14648,107428,105991,83,0.5,3405,20.7,30433,1892,28541,1.8,28.7,27559,15996,11563,15.1,26,2874,2.7,52,0,2684,2684,13363
1998,42,c) 2,11990,12322,103402,106061,346,2.6,2065,15.6,21378,2350,19028,2.2,20.2,26695,14661,12034,13.8,25.2,-5317,-5,40.4,0,1661,1661,11799
1998,42,d) 3,10951,11253,88104,89773,321,2.7,1616,13.6,15803,1519,14284,1.7,17.6,19141,7988,11153,8.9,21.3,-3338,-3.7,35.2,0,1274,1274,6387
1998,42,e) 4,9054,9329,80841,82513,218,2.2,1142,11.6,13051,1200,11851,1.5,15.8,16395,6934,9461,8.4,19.9,-3344,-4.1,31.6,0,939,939,6109
1998,42,f) 5,8190,8488,81179,81720,226,2.5,1011,11.4,12474,1210,11264,1.5,15.3,13555,5299,8256,6.5,16.6,-1081,-1.3,30.6,0,795,795,4202
1998,42,g) 6 to 10,38060,40362,406674,412295,993,2.4,3973,9.5,59306,10258,49048,2.5,14.4,70547,27855,42692,6.8,17.1,-11241,-2.7,28.8,0,2900,2900,20176
1998,42,h) 11 to 15,31058,34835,477752,477331,1055,3,2453,6.9,58074,11713,46361,2.5,12.2,57231,19363,37868,4.1,12,843,0.2,24,0,1703,1703,10961
1998,42,i) 16 to 20,20021,23382,366280,368080,566,2.4,1673,7,42555,8013,34542,2.2,11.6,46156,13892,32264,3.8,12.5,-3601,-0.9,23.2,0,1038,1038,6864
1998,42,j) 21 to 25,4501,7331,180918,179696,340,4.6,471,6.4,24347,6994,17353,3.9,13.5,21903,5287,16616,2.9,12.2,2444,1.3,24.4,0,186,186,1414
1998,42,l) Left Censored,44486,84250,2844107,2849230,4072,4.8,5892,6.9,305547,78142,227405,2.7,10.7,315793,98048,217745,3.4,11.1,-10246,-0.4,21.4,0,1942,1942,15071
1998,44,a) 0,1980,2002,12475,6256,1986,198.4,0,0,12438,12438,0,198.8,198.8,0,0,0,0,0,12438,198.8,0,0,,,
1998,44,b) 1,1541,1558,10941,10937,3,0.2,382,21.7,2708,224,2484,2,24.8,2700,1378,1322,12.6,24.7,8,0.1,49.4,0,301,301,1098
1998,44,c) 2,1323,1334,8792,9734,37,2.6,261,18,1852,199,1653,2,19,3736,1306,2430,13.4,38.4,-1884,-19.4,38,0,221,221,1156
1998,44,d) 3,1102,1114,8019,8177,29,2.4,170,14.3,1370,63,1307,0.8,16.8,1686,696,990,8.5,20.6,-316,-3.8,33.6,0,132,132,610
1998,44,e) 4,1012,1023,11737,12120,22,2,155,14.2,1461,165,1296,1.4,12.1,2226,844,1382,7,18.4,-765,-6.3,24.2,0,119,119,471
1998,44,f) 5,910,917,6228,6448,23,2.4,107,11.1,876,70,806,1.1,13.6,1315,572,743,8.9,20.4,-439,-6.8,27.2,0,88,88,517
1998,44,g) 6 to 10,3858,3999,41162,41052,95,2.3,388,9.4,6029,705,5324,1.7,14.7,5808,1664,4144,4.1,14.1,221,0.6,28.2,0,293,293,1231
1998,44,h) 11 to 15,3061,3257,37383,37554,96,2.9,231,6.9,4700,791,3909,2.1,12.5,5041,1171,3870,3.1,13.4,-341,-0.9,25,0,167,167,785
1998,44,i) 16 to 20,1932,2125,28815,28865,51,2.3,146,6.7,3456,684,2772,2.4,12,3555,1304,2251,4.5,12.3,-99,-0.3,24,0,102,102,392
1998,44,j) 21 to 25,492,636,12530,12321,17,2.6,42,6.5,1520,173,1347,1.4,12.3,1101,220,881,1.8,8.9,419,3.4,17.8,0,26,26,123
1998,44,l) Left Censored,4952,6945,222093,221097,253,3.6,531,7.5,23729,6144,17585,2.8,10.7,21737,6858,14879,3.1,9.8,1992,0.9,19.6,0,198,198,1809
1998,45,a) 0,7582,7619,52271,26207,7576,198.9,0,0,52128,52128,0,198.9,198.9,0,0,0,0,0,52128,198.9,0,0,,,
1998,45,b) 1,5600,5682,43833,43913,10,0.2,1750,26.4,11936,,,,27.2,12096,6952,5144,15.8,27.5,-160,-0.3,54.4,1,1432,1432,5942
1998,45,c) 2,4633,4732,43714,42251,139,2.7,985,19.1,14326,,,,33.9,11399,5512,5887,13,27,2927,6.9,54,1,810,810,4565
1998,45,d) 3,4049,4155,36218,37778,130,2.9,682,15.3,6119,809,5310,2.1,16.2,9239,4537,4702,12,24.5,-3120,-8.3,32.4,0,535,535,3103
1998,45,e) 4,3414,3550,34418,35817,120,3.2,525,14,6442,1070,5372,3,18,9239,4727,4512,13.2,25.8,-2797,-7.8,36,0,420,420,2707
1998,45,f) 5,2868,3016,29307,30656,108,3.4,406,12.9,4483,841,3642,2.7,14.6,7180,2734,4446,8.9,23.4,-2697,-8.8,29.2,0,334,334,2255
1998,45,g) 6 to 10,11526,12605,139972,143992,435,3.3,1370,10.5,21380,5021,16359,3.5,14.8,29420,11040,18380,7.7,20.4,-8040,-5.6,29.6,0,996,996,6165
1998,45,h) 11 to 15,9432,10896,152283,152639,349,3.1,833,7.5,20093,3500,16593,2.3,13.2,20805,7775,13030,5.1,13.6,-712,-0.4,26.4,0,535,535,3833
1998,45,i) 16 to 20,5594,6850,101668,102767,197,2.8,564,8,12149,1775,10374,1.7,11.8,14347,5420,8927,5.3,14,-2198,-2.2,23.6,0,332,332,1749
1998,45,j) 21 to 25,1226,2193,39667,37685,113,5.1,124,5.6,8035,2165,5870,5.7,21.3,4071,1099,2972,2.9,10.8,3964,10.5,21.6,0,44,44,153
1998,45,l) Left Censored,10897,22809,819424,811106,1409,6.1,1669,7.3,100268,29283,70985,3.6,12.4,83631,30131,53500,3.7,10.3,16637,2.1,20.6,0,407,407,4024
1998,46,a) 0,1673,1680,9006,4512,1667,198.5,0,0,8988,8988,0,199.2,199.2,0,0,0,0,0,8988,199.2,0,0,,,
1998,46,b) 1,1267,1287,7929,8326,1,0.1,360,24.3,1591,,,,19.1,2384,1393,991,16.7,28.6,-793,-9.5,38.2,1,294,294,1008
1998,46,c) 2,1081,1111,6921,7511,35,2.9,225,18.6,1245,,,,16.6,2425,1642,783,21.9,32.3,-1180,-15.7,33.2,1,174,174,1344
1998,46,d) 3,942,962,6521,6732,33,3.2,157,15.3,1050,124,926,1.8,15.6,1471,631,840,9.4,21.9,-421,-6.3,31.2,0,125,125,549
1998,46,e) 4,897,910,7083,7169,27,2.8,128,13.3,1041,177,864,2.5,14.5,1212,462,750,6.4,16.9,-171,-2.4,29,0,97,97,372
1998,46,f) 5,752,768,5305,5587,19,2.3,103,12.7,850,52,798,0.9,15.2,1413,721,692,12.9,25.3,-563,-10.1,30.4,0,83,83,587
1998,46,g) 6 to 10,2949,3101,27525,27721,99,3.1,358,11.1,3779,589,3190,2.1,13.6,4170,1854,2316,6.7,15,-391,-1.4,27.2,0,262,262,1237
1998,46,h) 11 to 15,2324,2583,38335,37264,84,3.2,206,7.8,6429,1095,5334,2.9,17.3,4287,1365,2922,3.7,11.5,2142,5.8,23,0,131,131,507
1998,46,i) 16 to 20,1668,1888,24209,24259,37,1.9,123,6.4,2832,353,2479,1.5,11.7,2932,811,2121,3.3,12.1,-100,-0.4,23.4,0,84,84,440
1998,46,j) 21 to 25,393,550,8227,8191,21,3.7,48,8.5,939,231,708,2.8,11.5,867,330,537,4,10.6,72,0.9,21.2,0,17,17,61
1998,46,l) Left Censored,3702,5814,144698,143239,234,4,360,6.1,14559,2949,11610,2.1,10.2,11641,3570,8071,2.5,8.1,2918,2.1,16.2,0,151,151,983
1998,47,a) 0,9505,9580,68790,34505,9509,198.5,0,0,68571,68571,0,198.7,198.7,0,0,0,0,0,68571,198.7,0,0,,,
1998,47,b) 1,7145,7327,58487,59912,35,0.4,2414,28.1,16878,1930,14948,3.2,28.2,19727,11281,8446,18.8,32.9,-2849,-4.7,56.4,0,2027,2027,9557
1998,47,c) 2,6195,6335,58074,61308,206,3,1413,20.3,11585,1903,9682,3.1,18.9,18053,10915,7138,17.8,29.4,-6468,-10.5,37.8,0,1166,1166,9528
1998,47,d) 3,5214,5357,48086,50442,183,3.2,974,16.9,9052,1764,7288,3.5,17.9,13764,6736,7028,13.4,27.3,-4712,-9.4,35.8,0,781,781,5747
1998,47,e) 4,4555,4683,42363,43672,147,3,699,14.1,6701,912,5789,2.1,15.3,9318,4236,5082,9.7,21.3,-2617,-6,30.6,0,559,559,3534
1998,47,f) 5,4102,4326,40997,42599,138,3,628,13.7,7184,1406,5778,3.3,16.9,10387,4270,6117,10,24.4,-3203,-7.5,33.8,0,499,499,3262
1998,47,g) 6 to 10,15680,16937,199329,200892,495,2.8,1923,10.9,30326,5544,24782,2.8,15.1,33452,12911,20541,6.4,16.7,-3126,-1.6,30.2,0,1407,1407,8252
1998,47,h) 11 to 15,13167,15173,223517,225208,466,3,1140,7.3,27013,7121,19892,3.2,12,30394,8625,21769,3.8,13.5,-3381,-1.5,24,0,729,729,4757
1998,47,i) 16 to 20,8112,9756,162194,161688,335,3.4,698,7,22392,4778,17614,3,13.8,21380,5850,15530,3.6,13.2,1012,0.6,26.4,0,403,404,2871
1998,47,j) 21 to 25,1946,4136,108351,106062,308,7.5,279,6.8,18914,8169,10745,7.7,17.8,14335,5513,8822,5.2,13.5,4579,4.3,27,0,95,95,811
1998,47,l) Left Censored,15989,34160,1263317,1253280,2121,6.2,2490,7.2,153590,44609,108981,3.6,12.3,133515,40896,92619,3.3,10.7,20075,1.6,21.4,0,731,731,6085
1998,48,a) 0,36390,36670,272473,136935,36402,198.5,0,0,271077,271077,0,198,198,0,0,0,0,0,271077,198,0,0,,,
1998,48,b) 1,27877,28552,249971,247951,150,0.5,8550,25.9,75604,4276,71328,1.7,30.5,71563,44307,27256,17.9,28.9,4041,1.6,57.8,0,6978,6978,36631
1998,48,c) 2,23408,24149,226765,234599,803,3,5410,20.4,57534,8399,49135,3.6,24.5,73202,42160,31042,18,31.2,-15668,-6.7,49,0,4461,4461,35117
1998,48,d) 3,20014,20711,194872,202190,687,3.1,3718,16.7,38439,5677,32762,2.8,19,53074,25537,27537,12.6,26.2,-14635,-7.2,38,0,2932,2932,21077
1998,48,e) 4,17448,18271,195284,196559,649,3.4,2749,14.2,43490,5318,38172,2.7,22.1,46039,20995,25044,10.7,23.4,-2549,-1.3,44.2,0,2201,2201,16711
1998,48,f) 5,15118,15914,169396,173497,527,3.1,2350,14,35007,3834,31173,2.2,20.2,43208,21824,21384,12.6,24.9,-8201,-4.7,40.4,0,1830,1830,18230
1998,48,g) 6 to 10,56904,62408,806102,806448,2179,3.4,7043,10.8,143339,27042,116297,3.4,17.8,144031,56569,87462,7,17.9,-692,-0.1,35.6,0,5058,5058,35013
1998,48,h) 11 to 15,42503,50212,763343,762571,1755,3.4,4268,8.3,110898,22414,88484,2.9,14.5,109353,35604,73749,4.7,14.3,1545,0.2,28.6,0,2689,2689,18509
1998,48,i) 16 to 20,31504,38412,613731,611660,1251,3.2,2994,7.6,90399,15747,74652,2.6,14.8,86258,29326,56932,4.8,14.1,4141,0.7,28.2,0,1684,1688,14223
1998,48,j) 21 to 25,5557,10410,214829,212615,572,5.4,911,8.6,36456,10630,25826,5,17.1,32028,10379,21649,4.9,15.1,4428,2,30.2,0,243,243,1726
1998,48,l) Left Censored,41102,104890,3690319,3661930,7919,7.5,8297,7.9,528621,171693,356928,4.7,14.4,471843,141468,330375,3.9,12.9,56778,1.5,25.8,0,1857,1857,19118
1998,49,a) 0,4933,4966,34650,17365,4934,198.7,0,0,34571,34571,0,199.1,199.1,0,0,0,0,0,34571,199.1,0,0,,,
1998,49,b) 1,3687,3748,29739,30366,11,0.3,1201,27.3,9770,,,,32.2,11023,6511,4512,21.4,36.3,-1253,-4.1,64.4,1,947,947,5179
1998,49,c) 2,3088,3165,39888,37436,89,2.6,687,19.8,13160,,,,35.2,8255,4392,3863,11.7,22.1,4905,13.1,44.2,1,557,557,3827
1998,49,d) 3,2441,2503,26204,27119,82,3,477,17.6,6043,467,5576,1.7,22.3,7873,3598,4275,13.3,29,-1830,-6.7,44.6,0,374,374,2618
1998,49,e) 4,2094,2181,22315,23198,77,3.3,362,15.6,4239,749,3490,3.2,18.3,6004,2970,3034,12.8,25.9,-1765,-7.6,36.6,0,282,282,2607
1998,49,f) 5,1657,1744,18746,19105,60,3.3,236,12.9,3215,458,2757,2.4,16.8,3932,1672,2260,8.8,20.6,-717,-3.8,33.6,0,186,186,1273
1998,49,g) 6 to 10,5931,6408,93262,95555,211,3.2,717,10.8,14248,2121,12127,2.2,14.9,18833,6625,12208,6.9,19.7,-4585,-4.8,29.8,0,493,493,3717
1998,49,h) 11 to 15,3807,4429,76592,77667,195,4.3,401,8.8,9932,1847,8085,2.4,12.8,12082,4062,8020,5.2,15.6,-2150,-2.8,25.6,0,222,222,1736
1998,49,i) 16 to 20,3037,3506,64928,65578,101,2.8,275,7.6,7504,810,6694,1.2,11.4,8803,2695,6108,4.1,13.4,-1299,-2,22.8,0,157,157,1389
1998,49,j) 21 to 25,722,1137,21733,21767,68,6,69,6.1,3067,1208,1859,5.5,14.1,3135,622,2513,2.9,14.4,-68,-0.3,28.2,0,25,25,136
1998,49,l) Left Censored,5138,10410,409002,409610,722,6.9,750,7.2,55768,19860,35908,4.8,13.6,56984,11835,45149,2.9,13.9,-1216,-0.3,27.2,0,190,190,1111
1998,50,a) 0,1443,1455,7459,3744,1445,198.6,0,0,7431,7431,0,198.5,198.5,0,0,0,0,0,7431,198.5,0,0,,,
1998,50,b) 1,1180,1192,5381,5692,2,0.1,305,22.4,1546,,,,27.2,2168,1229,939,21.6,38.1,-622,-10.9,54.4,1,237,237,733
1998,50,c) 2,974,982,6205,6515,20,1.9,176,16.6,1146,,,,17.6,1765,867,898,13.3,27.1,-619,-9.5,35.2,1,146,146,634
1998,50,d) 3,862,872,5829,6200,28,3,143,15.4,771,100,671,1.6,12.4,1515,763,752,12.3,24.4,-744,-12,24.8,0,124,124,638
1998,50,e) 4,814,839,5185,5384,28,3.2,94,10.8,724,116,608,2.2,13.4,1122,453,669,8.4,20.8,-398,-7.4,26.8,0,72,72,350
1998,50,f) 5,745,765,4749,4779,25,3.2,71,9,684,161,523,3.4,14.3,743,280,463,5.9,15.5,-59,-1.2,28.6,0,58,58,195
1998,50,g) 6 to 10,3141,3244,26238,26376,73,2.2,360,10.6,3744,213,3531,0.8,14.2,4020,1392,2628,5.3,15.2,-276,-1,28.4,0,281,281,1127
1998,50,h) 11 to 15,2533,2764,32115,32419,67,2.4,236,8.3,3306,307,2999,0.9,10.2,3914,1317,2597,4.1,12.1,-608,-1.9,20.4,0,169,169,957
1998,50,i) 16 to 20,1470,1642,19263,19013,45,2.7,115,6.8,2398,466,1932,2.5,12.6,1898,637,1261,3.4,10,500,2.6,20,0,78,78,324
1998,50,j) 21 to 25,321,473,10333,10481,17,3.6,29,6.1,804,103,701,1,7.7,1100,264,836,2.5,10.5,-296,-2.8,15.4,0,13,13,65
1998,50,l) Left Censored,2828,4253,114151,112752,164,3.8,358,8.2,12417,2937,9480,2.6,11,9619,3470,6149,3.1,8.5,2798,2.5,17,0,106,106,651
1998,51,a) 0,12489,12591,79925,40204,12503,198.6,0,0,79443,79443,0,197.6,197.6,0,0,0,0,0,79443,197.6,0,0,,,
1998,51,b) 1,9609,9767,68175,68736,46,0.4,2782,24.8,19196,2458,16738,3.6,27.9,20318,11993,8325,17.4,29.6,-1122,-1.7,55.8,0,2214,2214,10094
1998,51,c) 2,8034,8208,60485,63951,260,2.9,1513,17.1,12590,1268,11322,2,19.7,19522,8848,10674,13.8,30.5,-6932,-10.8,39.4,0,1179,1179,7082
1998,51,d) 3,7316,7545,59839,61393,235,2.9,1177,14.7,11550,1301,10249,2.1,18.8,14657,7415,7242,12.1,23.9,-3107,-5.1,37.6,0,926,926,6014
1998,51,e) 4,6149,6351,58783,59254,192,2.9,898,13.4,11038,1061,9977,1.8,18.6,11980,5078,6902,8.6,20.2,-942,-1.6,37.2,0,695,695,4102
1998,51,f) 5,5487,5686,49100,51452,181,3,735,12.3,7751,1331,6420,2.6,15.1,12455,5607,6848,10.9,24.2,-4704,-9.1,30.2,0,568,568,4778
1998,51,g) 6 to 10,22070,23537,260029,262200,698,2.9,2337,9.6,37397,5785,31612,2.2,14.3,41738,15025,26713,5.7,15.9,-4341,-1.6,28.6,0,1704,1704,10324
1998,51,h) 11 to 15,16914,19486,282570,283595,612,3.1,1628,8.1,39448,8070,31378,2.8,13.9,41497,14144,27353,5,14.6,-2049,-0.7,27.8,0,993,993,5845
1998,51,i) 16 to 20,10186,12385,224733,226242,369,2.9,949,7.5,29264,5686,23578,2.5,12.9,32282,10525,21757,4.7,14.3,-3018,-1.4,25.8,0,510,510,5047
1998,51,j) 21 to 25,2250,3972,78498,78636,150,3.7,249,6.2,11286,3203,8083,4.1,14.4,11561,2691,8870,3.4,14.7,-275,-0.3,28.8,0,93,93,422
1998,51,l) Left Censored,19091,43430,1420764,1414439,3280,7.5,3370,7.7,175703,59211,116492,4.2,12.4,163053,58707,104346,4.2,11.5,12650,0.9,23,0,764,764,5742
1998,53,a) 0,13489,13693,75418,37863,13559,198,0,0,75111,75111,0,198.4,198.4,0,0,0,0,0,75111,198.4,0,0,,,
1998,53,b) 1,10050,10194,65749,66295,22,0.2,3167,26.6,18830,953,17877,1.4,28.4,19921,11260,8661,17,30,-1091,-1.6,56.8,0,2420,2420,9249
1998,53,c) 2,8504,8669,60150,62243,329,3.5,1831,19.4,13145,1319,11826,2.1,21.1,17330,9054,8276,14.5,27.8,-4185,-6.7,42.2,0,1447,1447,7481
1998,53,d) 3,7297,7503,57020,57444,313,3.9,1358,16.9,12150,1241,10909,2.2,21.2,12997,6529,6468,11.4,22.6,-847,-1.4,42.4,0,1044,1044,5375
1998,53,e) 4,6429,6626,55046,54311,293,4.2,1081,15.4,14344,2839,11505,5.2,26.4,12874,5213,7661,9.6,23.7,1470,2.7,47.4,0,837,837,4000
1998,53,f) 5,5547,5805,44326,45498,235,3.9,808,13.3,7621,962,6659,2.1,16.8,9964,3931,6033,8.6,21.9,-2343,-5.1,33.6,0,619,619,3242
1998,53,g) 6 to 10,21221,22538,230505,232076,862,3.7,2565,11,37863,5692,32171,2.5,16.3,41005,15798,25207,6.8,17.7,-3142,-1.4,32.6,0,1816,1816,11087
1998,53,h) 11 to 15,15024,17220,243018,244681,668,3.8,1539,8.7,32351,7874,24477,3.2,13.2,35676,13190,22486,5.4,14.6,-3325,-1.4,26.4,0,929,929,6583
1998,53,i) 16 to 20,10411,12404,189648,189603,406,3.2,922,7.3,25106,4338,20768,2.3,13.2,25015,6636,18379,3.5,13.2,91,0,26.4,0,553,553,3676
1998,53,j) 21 to 25,2189,3644,74553,73909,186,5.1,253,6.9,11036,2542,8494,3.4,14.9,9748,3175,6573,4.3,13.2,1288,1.7,26.4,0,99,99,741
1998,53,l) Left Censored,15680,31405,976494,970348,1840,5.8,2285,7.2,120892,29057,91835,3,12.5,108600,33317,75283,3.4,11.2,12292,1.3,22.4,0,676,676,4537
1998,54,a) 0,2625,2637,15756,7927,2612,198.1,0,0,15658,15658,0,197.5,197.5,0,0,0,0,0,15658,197.5,0,0,,,
1998,54,b) 1,2112,2125,13483,13537,3,0.1,633,25.7,3696,188,3508,1.4,27.3,3804,2036,1768,15,28.1,-108,-0.8,54.6,0,516,516,1671
1998,54,c) 2,1737,1777,11979,13116,51,2.6,384,19.7,2176,290,1886,2.2,16.6,4450,2559,1891,19.5,33.9,-2274,-17.3,33.2,0,313,313,2123
1998,54,d) 3,1645,1672,11829,12144,57,3.2,279,15.6,2401,407,1994,3.4,19.8,3030,1395,1635,11.5,25,-629,-5.2,39.6,0,221,221,1190
1998,54,e) 4,1364,1399,9742,10000,53,3.6,205,13.9,1628,307,1321,3.1,16.3,2144,902,1242,9,21.4,-516,-5.1,32.6,0,164,164,746
1998,54,f) 5,1252,1278,10197,10602,33,2.5,165,12.3,1542,261,1281,2.5,14.5,2351,898,1453,8.5,22.2,-809,-7.7,29,0,134,134,804
1998,54,g) 6 to 10,5176,5452,49050,50187,156,2.8,537,9.5,6351,832,5519,1.7,12.7,8625,3128,5497,6.2,17.2,-2274,-4.5,25.4,0,394,394,2125
1998,54,h) 11 to 15,4227,4706,58322,59260,124,2.6,360,7.5,5696,939,4757,1.6,9.6,7571,2200,5371,3.7,12.8,-1875,-3.2,19.2,0,239,239,1431
1998,54,i) 16 to 20,2911,3415,43974,44284,88,2.5,213,6.1,4567,883,3684,2,10.3,5187,1150,4037,2.6,11.7,-620,-1.4,20.6,0,138,138,723
1998,54,j) 21 to 25,706,1220,22352,22002,36,2.9,66,5.3,2884,776,2108,3.5,13.1,2184,429,1755,1.9,9.9,700,3.2,19.8,0,37,37,124
1998,54,l) Left Censored,6643,11851,290671,291196,566,4.7,729,6.1,33970,10187,23783,3.5,11.7,35020,9818,25202,3.4,12,-1050,-0.3,23.4,0,251,251,1558
1998,55,a) 0,8763,8846,63448,31789,8787,198.7,0,0,63318,63318,0,199.2,199.2,0,0,0,0,0,63318,199.2,0,0,,,
1998,55,b) 1,7048,7131,49735,49037,29,0.4,1748,21.7,13996,1385,12611,2.8,28.5,12600,6663,5937,13.6,25.7,1396,2.8,51.4,0,1390,1390,5625
1998,55,c) 2,6116,6195,45922,47507,142,2.1,1004,15.1,9025,1133,7892,2.4,19,12195,6874,5321,14.5,25.7,-3170,-6.7,38,0,809,809,5977
1998,55,d) 3,5430,5580,42974,44015,137,2.3,837,14.1,6534,723,5811,1.6,14.8,8616,3873,4743,8.8,19.6,-2082,-4.8,29.6,0,665,665,3273
1998,55,e) 4,4888,5015,40025,40767,104,2,636,12,5840,533,5307,1.3,14.3,7323,3070,4253,7.5,18,-1483,-3.7,28.6,0,511,511,2625
1998,55,f) 5,4453,4582,40332,41038,128,2.7,506,10.6,5873,859,5014,2.1,14.3,7284,2594,4690,6.3,17.7,-1411,-3.4,28.6,0,390,390,2031
1998,55,g) 6 to 10,17663,18776,189342,191115,475,2.4,1674,8.6,25824,4270,21554,2.2,13.5,29370,12043,17327,6.3,15.4,-3546,-1.9,27,0,1231,1231,6664
1998,55,h) 11 to 15,13906,15846,241525,242044,378,2.3,1047,6.5,28333,3637,24696,1.5,11.7,29370,8610,20760,3.6,12.1,-1037,-0.4,23.4,0,705,705,4414
1998,55,i) 16 to 20,9368,11048,169381,170573,255,2.3,777,6.9,17599,3777,13822,2.2,10.3,19983,6382,13601,3.7,11.7,-2384,-1.4,20.6,0,489,489,3230
1998,55,j) 21 to 25,2169,3763,69296,69805,168,4.4,263,6.9,9035,2465,6570,3.5,12.9,10053,3133,6920,4.5,14.4,-1018,-1.5,25.8,0,116,116,855
1998,55,l) Left Censored,21091,36687,1340705,1335434,1582,4.3,2379,6.4,134512,27326,107186,2,10.1,123971,35039,88932,2.6,9.3,10541,0.8,18.6,0,865,865,7712
1998,56,a) 0,1419,1431,7473,3745,1419,198.3,0,0,7456,7456,0,199.1,199.1,0,0,0,0,0,7456,199.1,0,0,,,
1998,56,b) 1,1082,1094,5501,5766,4,0.3,290,23.2,1427,,,,24.7,1956,1245,711,21.6,33.9,-529,-9.2,49.4,1,217,217,754
1998,56,c) 2,959,989,5252,5449,52,4.9,214,20,1191,,,,21.9,1584,767,817,14.1,29.1,-393,-7.2,43.8,1,170,170,648
1998,56,d) 3,818,829,4914,5101,27,3.1,124,14.1,910,210,700,4.1,17.8,1284,537,747,10.5,25.2,-374,-7.4,35.6,0,92,92,379
1998,56,e) 4,749,760,5206,5345,24,3,103,12.9,814,60,754,1.1,15.2,1092,457,635,8.6,20.4,-278,-5.2,30.4,0,74,74,301
1998,56,f) 5,608,620,4568,4661,23,3.5,88,13.4,746,111,635,2.4,16,932,437,495,9.4,20,-186,-4,32,0,69,69,366
1998,56,g) 6 to 10,2122,2210,17082,17399,83,3.6,237,10.4,2457,356,2101,2,14.1,3090,1056,2034,6.1,17.8,-633,-3.7,28.2,0,162,162,753
1998,56,h) 11 to 15,1664,1877,19717,19887,68,3.5,175,9.1,2479,581,1898,2.9,12.5,2818,1056,1762,5.3,14.2,-339,-1.7,25,0,107,107,616
1998,56,i) 16 to 20,1506,1687,16389,16596,44,2.6,119,6.9,1956,201,1755,1.2,11.8,2370,727,1643,4.4,14.3,-414,-2.5,23.6,0,77,77,435
1998,56,j) 21 to 25,290,426,7071,7066,14,3.2,28,6.5,1468,654,814,9.3,20.8,1457,647,810,9.2,20.6,11,0.2,41.2,0,18,18,582
1998,56,l) Left Censored,2172,3468,63481,64217,173,5,237,6.8,7613,2107,5506,3.3,11.9,9084,3858,5226,6,14.1,-1471,-2.2,23.8,0,87,87,990
1999,01,a) 0,7120,7159,48269,24366,7111,198.7,0,0,47807,47807,0,196.2,196.2,0,0,0,0,0,47807,196.2,0,0,,,
1999,01,b) 1,5728,5872,49847,49038,117,1.7,1656,24.7,15279,2924,12355,6,31.2,13660,7696,5964,15.7,27.9,1619,3.3,55.8,0,1346,1346,5861
1999,01,c) 2,4798,4912,39737,41339,144,2.7,1095,20.3,8505,983,7522,2.4,20.6,11708,6667,5041,16.1,28.3,-3203,-7.7,41.2,0,871,871,5152
1999,01,d) 3,4205,4381,33181,34033,144,3,835,17.6,5669,811,4858,2.4,16.7,7372,3991,3381,11.7,21.7,-1703,-5,33.4,0,638,638,3186
1999,01,e) 4,3719,3835,32212,33125,122,3,595,14.6,5754,513,5241,1.5,17.4,7580,3519,4061,10.6,22.9,-1826,-5.5,34.8,0,454,454,2589
1999,01,f) 5,3351,3466,33653,34689,104,2.8,496,13.5,5490,676,4814,1.9,15.8,7561,4014,3547,11.6,21.8,-2071,-6,31.6,0,379,379,3483
1999,01,g) 6 to 10,12156,12981,145455,149708,346,2.5,1516,11.2,21025,2717,18308,1.8,14,29531,11116,18415,7.4,19.7,-8506,-5.7,28,0,1128,1128,8210
1999,01,h) 11 to 15,9956,11424,185448,186392,327,2.8,935,8,19880,4359,15521,2.3,10.7,21767,7611,14156,4.1,11.7,-1887,-1,21.4,0,618,618,4468
1999,01,i) 16 to 20,6040,7230,130021,131221,233,3.2,541,7.3,16217,4223,11994,3.2,12.4,18616,4419,14197,3.4,14.2,-2399,-1.8,24.8,0,370,370,2510
1999,01,j) 21 to 25,2576,4304,81547,80131,206,4.7,266,6.1,14494,7531,6963,9.4,18.1,11662,2231,9431,2.8,14.6,2832,3.5,29.2,0,129,129,694
1999,01,l) Left Censored,11556,24780,827378,828179,1398,5.6,1605,6.4,99296,34678,64618,4.2,12,100898,33043,67855,4,12.2,-1602,-0.2,24,0,460,460,3612
1999,02,a) 0,1271,1281,6067,3052,1272,198.6,0,0,6031,6031,0,197.6,197.6,0,0,0,0,0,6031,197.6,0,0,,,
1999,02,b) 1,1064,1090,7116,7017,24,1.9,320,25.6,2239,485,1754,6.9,31.9,2041,965,1076,13.8,29.1,198,2.8,58.2,0,230,230,748
1999,02,c) 2,855,862,5242,5445,25,2.6,180,19,1184,103,1081,1.9,21.7,1589,903,686,16.6,29.2,-405,-7.5,43.4,0,127,127,587
1999,02,d) 3,746,757,4429,4591,29,3.6,138,17,868,151,717,3.3,18.9,1191,626,565,13.6,25.9,-323,-7,37.8,0,98,98,441
1999,02,e) 4,658,671,4372,4404,19,2.7,104,14.5,804,40,764,0.9,18.3,867,346,521,7.9,19.7,-63,-1.4,36.6,0,73,73,250
1999,02,f) 5,571,581,4252,4356,22,3.6,85,13.8,901,258,643,5.9,20.7,1108,459,649,10.5,25.4,-207,-4.7,41.4,0,54,54,300
1999,02,g) 6 to 10,2218,2301,17681,18045,84,3.5,276,11.5,2594,304,2290,1.7,14.4,3322,1016,2306,5.6,18.4,-728,-4,28.8,0,191,191,650
1999,02,h) 11 to 15,1828,2106,26474,27107,66,3.1,159,7.4,2823,337,2486,1.2,10.4,4088,1091,2997,4,15.1,-1265,-4.7,20.8,0,111,111,659
1999,02,i) 16 to 20,1277,1507,17646,17690,46,3,111,7.2,2083,236,1847,1.3,11.8,2171,545,1626,3.1,12.3,-88,-0.5,23.6,0,76,76,328
1999,02,j) 21 to 25,502,770,11961,12025,40,5.2,50,6.4,1627,333,1294,2.8,13.5,1755,497,1258,4.1,14.6,-128,-1.1,27,0,24,24,210
1999,02,l) Left Censored,1632,3208,87478,88376,153,4.7,193,6,9142,2448,6694,2.8,10.3,10937,2821,8116,3.2,12.4,-1795,-2.1,20.6,0,42,42,299
1999,04,a) 0,9639,9732,77283,38762,9632,197.9,0,0,77042,77042,0,198.8,198.8,0,0,0,0,0,77042,198.8,0,0,,,
1999,04,b) 1,7350,7535,70651,68989,161,1.9,2130,24.8,23674,3309,20365,4.8,34.3,20349,11455,8894,16.6,29.5,3325,4.8,59,0,1700,1700,9603
1999,04,c) 2,6144,6310,56388,58887,211,3,1394,20.1,13746,1673,12073,2.8,23.3,18744,10407,8337,17.7,31.8,-4998,-8.5,46.6,0,1104,1104,8604
1999,04,d) 3,5204,5339,48815,51673,202,3.5,961,16.8,10580,1860,8720,3.6,20.5,16295,8248,8047,16,31.5,-5715,-11,41,0,744,744,6491
1999,04,e) 4,4553,4752,53491,54537,194,3.9,730,14.6,10561,1448,9113,2.7,19.4,12652,5855,6797,10.7,23.2,-2091,-3.8,38.8,0,556,556,4779
1999,04,f) 5,3996,4179,47047,46546,178,4.1,600,13.7,10930,1849,9081,4,23.5,9928,5270,4658,11.3,21.3,1002,2.2,42.6,0,444,444,3469
1999,04,g) 6 to 10,13510,14575,202283,209020,533,3.5,1825,12,32709,5960,26749,2.9,15.6,46182,17168,29014,8.2,22.1,-13473,-6.5,31.2,0,1310,1310,11674
1999,04,h) 11 to 15,10156,12064,194973,194305,555,4.5,1116,9,29022,6331,22691,3.3,14.9,27686,11299,16387,5.8,14.2,1336,0.7,28.4,0,683,683,6184
1999,04,i) 16 to 20,6603,8326,157302,156082,305,3.6,746,8.7,24483,7012,17471,4.5,15.7,22043,8030,14013,5.1,14.1,2440,1.6,28.2,0,371,371,2717
1999,04,j) 21 to 25,2128,3473,93679,92383,198,5.7,232,6.6,13827,3963,9864,4.3,15,11235,2318,8917,2.5,12.2,2592,2.8,24.4,0,86,86,571
1999,04,l) Left Censored,8028,20969,800465,793449,1882,9,1821,8.7,112882,38719,74163,4.9,14.2,98850,34039,64811,4.3,12.5,14032,1.7,25,0,295,295,2233
1999,05,a) 0,4589,4628,25861,12990,4592,198.4,0,0,25743,25743,0,198.2,198.2,0,0,0,0,0,25743,198.2,0,0,,,
1999,05,b) 1,3566,3706,30411,30513,83,2,1064,25.2,9792,2395,7397,7.8,32.1,9996,4608,5388,15.1,32.8,-204,-0.7,64.2,0,893,893,4085
1999,05,c) 2,2969,2997,22847,23686,86,2.6,680,20.6,4481,356,4125,1.5,18.9,6159,3661,2498,15.5,26,-1678,-7.1,37.8,0,561,561,2547
1999,05,d) 3,2538,2636,21548,21939,76,2.7,526,18.4,4224,684,3540,3.1,19.3,5006,2702,2304,12.3,22.8,-782,-3.5,38.6,0,426,426,2142
1999,05,e) 4,2439,2512,21350,22214,60,2.2,397,14.8,3111,278,2833,1.3,14,4838,2502,2336,11.3,21.8,-1727,-7.8,28,0,301,301,1957
1999,05,f) 5,2166,2243,18938,19508,56,2.4,311,13.1,3160,331,2829,1.7,16.2,4300,2357,1943,12.1,22,-1140,-5.8,32.4,0,239,239,1882
1999,05,g) 6 to 10,7668,8092,77337,77898,257,3,938,11.1,11909,2713,9196,3.5,15.3,13031,5296,7735,6.8,16.7,-1122,-1.4,30.6,0,682,682,3497
1999,05,h) 11 to 15,5966,6709,90550,90732,183,2.7,555,8,12111,2488,9623,2.7,13.3,12474,4973,7501,5.5,13.7,-363,-0.4,26.6,0,379,379,3212
1999,05,i) 16 to 20,4191,4937,73343,75271,142,2.8,425,8.4,8252,1546,6706,2.1,11,12107,4309,7798,5.7,16.1,-3855,-5.1,22,0,286,286,1999
1999,05,j) 21 to 25,1736,2357,55037,54503,70,2.9,174,7.2,6054,899,5155,1.6,11.1,4985,1831,3154,3.4,9.1,1069,2,18.2,0,92,92,551
1999,05,l) Left Censored,7513,14745,511942,513501,890,6,1089,7.3,57359,15588,41771,3,11.2,60476,20224,40252,3.9,11.8,-3117,-0.6,22.4,0,313,313,1850
1999,06,a) 0,60520,61019,409733,205910,60484,198.2,0,0,407647,407647,0,198,198,0,0,0,0,0,407647,198,0,0,,,
1999,06,b) 1,47237,48555,454873,438546,992,1.8,12714,23.1,148023,34502,113521,7.9,33.8,115369,61250,54119,14,26.3,32654,7.5,52.6,0,9762,9762,49415
1999,06,c) 2,38688,39508,383714,385048,1265,2.9,8049,18.7,103155,8238,94917,2.1,26.8,105823,60586,45237,15.7,27.5,-2668,-0.7,53.6,0,6268,6268,49202
1999,06,d) 3,33651,34411,330484,337283,1202,3.3,6135,16.6,67547,7332,60215,2.2,20,81144,41614,39530,12.3,24.1,-13597,-4.1,40,0,4698,4698,33089
1999,06,e) 4,28775,29877,326034,328533,1184,3.7,4646,14.7,64439,9650,54789,2.9,19.6,69436,32644,36792,9.9,21.1,-4997,-1.5,39.2,0,3463,3463,25181
1999,06,f) 5,24792,25747,304627,306517,990,3.7,3664,13.5,57544,9597,47947,3.1,18.8,61323,28427,32896,9.3,20,-3779,-1.2,37.6,0,2771,2771,21657
1999,06,g) 6 to 10,100338,107425,1300416,1324720,4179,3.7,12492,11.2,211909,32373,179536,2.4,16,260516,101879,158637,7.7,19.7,-48607,-3.7,32,0,8883,8883,68745
1999,06,h) 11 to 15,79394,91131,1442856,1440957,3624,3.9,8262,8.8,217228,50840,166388,3.5,15.1,213430,72917,140513,5.1,14.8,3798,0.3,29.6,0,5227,5227,37362
1999,06,i) 16 to 20,55343,66663,1208834,1205209,2212,3.2,5015,7.4,161523,38907,122616,3.2,13.4,154273,45536,108737,3.8,12.8,7250,0.6,25.6,0,2998,2998,20109
1999,06,j) 21 to 25,19286,29958,643818,649930,1335,4.4,2272,7.5,85740,22860,62880,3.5,13.2,97963,30861,67102,4.7,15.1,-12223,-1.9,26.4,0,1002,1002,7525
1999,06,l) Left Censored,66841,149420,5331505,5367663,10052,6.7,13576,9,710339,225767,484572,4.2,13.2,782654,280442,502212,5.2,14.6,-72315,-1.4,26.4,0,3265,3265,27932
1999,08,a) 0,11425,11511,67304,33747,11444,198.8,0,0,67114,67114,0,198.9,198.9,0,0,0,0,0,67114,198.9,0,0,,,
1999,08,b) 1,9134,9283,66981,66440,131,1.2,2470,23.5,20434,3696,16738,5.6,30.8,19351,10146,9205,15.3,29.1,1083,1.7,58.2,0,1904,1904,8476
1999,08,c) 2,7375,7496,58358,60794,249,3,1572,19.2,12790,1387,11403,2.3,21,17661,10656,7005,17.5,29.1,-4871,-8.1,42,0,1251,1251,8604
1999,08,d) 3,6272,6414,49763,50106,230,3.4,1110,16.2,9910,1390,8520,2.8,19.8,10596,5343,5253,10.7,21.1,-686,-1.3,39.6,0,859,859,4060
1999,08,e) 4,5611,5790,50167,50639,204,3.3,883,14.4,8845,1767,7078,3.5,17.5,9788,4403,5385,8.7,19.3,-943,-1.8,35,0,666,666,3395
1999,08,f) 5,5074,5229,45898,46532,210,3.8,726,13.2,8627,2010,6617,4.3,18.5,9894,4499,5395,9.7,21.3,-1267,-2.8,37,0,530,530,2817
1999,08,g) 6 to 10,16952,17997,197586,199386,636,3.4,1977,10.6,31869,6491,25378,3.3,16,35468,14453,21015,7.2,17.8,-3599,-1.8,32,0,1385,1385,9392
1999,08,h) 11 to 15,11565,13179,199900,199169,469,3.5,1216,9,30338,7156,23182,3.6,15.2,28876,10703,18173,5.4,14.5,1462,0.7,29,0,767,767,5660
1999,08,i) 16 to 20,7985,9851,180430,178732,461,4.6,884,8.8,31054,9247,21807,5.2,17.4,27658,11987,15671,6.7,15.5,3396,1.9,31,0,424,424,2817
1999,08,j) 21 to 25,2799,4307,94915,94469,190,4.3,343,7.8,14071,2764,11307,2.9,14.9,13179,5561,7618,5.9,14,892,0.9,28,0,135,135,642
1999,08,l) Left Censored,10811,23392,781525,779187,1885,8.1,1790,7.7,113531,40976,72555,5.3,14.6,108855,38223,70632,4.9,14,4676,0.6,28,0,414,414,5081
1999,09,a) 0,5264,5277,33200,16637,5249,198.9,0,0,33126,33126,0,199.1,199.1,0,0,0,0,0,33126,199.1,0,0,,,
1999,09,b) 1,4549,4665,36335,35976,104,2,1087,20.9,10130,2300,7830,6.4,28.2,9411,4481,4930,12.5,26.2,719,2,52.4,0,856,856,3711
1999,09,c) 2,3739,3790,28490,29037,109,2.7,675,16.5,5712,681,5031,2.3,19.7,6806,3557,3249,12.2,23.4,-1094,-3.7,39.4,0,533,533,2880
1999,09,d) 3,3365,3461,34243,35094,91,2.5,527,14.3,5127,571,4556,1.6,14.6,6829,3178,3651,9.1,19.5,-1702,-4.9,29.2,0,408,408,2349
1999,09,e) 4,3217,3319,28371,28329,98,2.8,447,12.8,5617,1067,4550,3.8,19.8,5533,2782,2751,9.8,19.5,84,0.3,39,0,353,353,2235
1999,09,f) 5,2813,2869,25753,26252,78,2.6,350,11.6,4704,1212,3492,4.6,17.9,5702,2815,2887,10.7,21.7,-998,-3.8,35.8,0,265,265,2091
1999,09,g) 6 to 10,11718,12176,129365,130463,307,2.4,1224,9.7,16980,2620,14360,2,13,19176,8302,10874,6.4,14.7,-2196,-1.7,26,0,913,913,5837
1999,09,h) 11 to 15,10477,11516,142568,144073,360,3,958,8.1,16568,3991,12577,2.8,11.5,19578,7555,12023,5.2,13.6,-3010,-2.1,23,0,633,633,3630
1999,09,i) 16 to 20,6568,7576,111425,110127,321,4.2,555,7.2,15569,4989,10580,4.5,14.1,12972,4460,8512,4,11.8,2597,2.3,23.6,0,360,360,2029
1999,09,j) 21 to 25,2515,3392,63847,63183,126,3.7,240,7,9711,2106,7605,3.3,15.4,8383,2444,5939,3.9,13.3,1328,2.1,26.6,0,131,131,952
1999,09,l) Left Censored,14438,24022,882390,880635,1195,4.9,1748,7.2,105438,27632,77806,3.1,12,101927,33682,68245,3.8,11.6,3511,0.4,23.2,0,598,598,5092
1999,10,a) 0,1733,1737,9806,4922,1722,198.3,0,0,9769,9769,0,198.5,198.5,0,0,0,0,0,9769,198.5,0,0,,,
1999,10,b) 1,1426,1448,10184,10585,21,1.3,299,18.7,2309,473,1836,4.5,21.8,3111,1663,1448,15.7,29.4,-802,-7.6,43.6,0,227,227,1494
1999,10,c) 2,1091,1107,7699,7713,31,2.6,201,16.8,1743,180,1563,2.3,22.6,1771,1026,745,13.3,23,-28,-0.4,45.2,0,154,154,839
1999,10,d) 3,930,957,8366,8911,21,2.1,143,14,1203,76,1127,0.9,13.5,2293,1276,1017,14.3,25.7,-1090,-12.2,27,0,107,107,836
1999,10,e) 4,882,901,7646,7766,18,1.9,124,12.9,1449,81,1368,1,18.7,1689,702,987,9,21.7,-240,-3,37.4,0,92,92,541
1999,10,f) 5,761,786,7225,7338,26,3.2,91,11.2,1319,173,1146,2.4,18,1545,608,937,8.3,21.1,-226,-3.1,36,0,68,68,386
1999,10,g) 6 to 10,2814,2909,27616,28094,80,2.7,302,10,4323,1075,3248,3.8,15.4,5279,1664,3615,5.9,18.8,-956,-3.4,30.8,0,224,224,1381
1999,10,h) 11 to 15,2029,2218,28476,29171,100,4.4,199,8.8,3520,786,2734,2.7,12.1,4909,1865,3044,6.4,16.8,-1389,-4.7,24.2,0,128,128,945
1999,10,i) 16 to 20,1259,1438,22389,21959,50,3.4,117,7.9,3241,973,2268,4.4,14.8,2380,1033,1347,4.7,10.8,861,4,21.6,0,62,62,263
1999,10,j) 21 to 25,565,822,29656,30755,44,5.3,54,6.5,2476,855,1621,2.8,8.1,4673,768,3905,2.5,15.2,-2197,-7.1,16.2,0,22,22,152
1999,10,l) Left Censored,3172,5615,190164,190994,376,6.6,520,9.2,23005,8277,14728,4.3,12,24665,7979,16686,4.2,12.9,-1660,-0.9,24,0,98,98,689
1999,11,a) 0,1031,1035,8571,4301,1028,198.6,0,0,8541,8541,0,198.6,198.6,0,0,0,0,0,8541,198.6,0,0,,,
1999,11,b) 1,880,894,9080,8856,25,2.5,197,19.9,2432,666,1766,7.5,27.5,1983,734,1249,8.3,22.4,449,5.1,44.8,0,150,150,605
1999,11,c) 2,808,825,7582,7928,21,2.4,142,16,1158,102,1056,1.3,14.6,1850,1160,690,14.6,23.3,-692,-8.7,29.2,0,103,103,727
1999,11,d) 3,681,690,6314,6133,27,3.7,112,15.3,1337,106,1231,1.7,21.8,974,451,523,7.4,15.9,363,5.9,31.8,0,86,86,353
1999,11,e) 4,622,641,7403,7355,24,3.6,92,13.7,1423,363,1060,4.9,19.3,1326,569,757,7.7,18,97,1.3,36,0,66,66,389
1999,11,f) 5,580,597,6132,5971,14,2.2,66,10.6,1160,83,1077,1.4,19.4,838,320,518,5.4,14,322,5.4,28,0,47,47,122
1999,11,g) 6 to 10,2341,2464,34141,34680,79,3.1,246,9.7,5083,1019,4064,2.9,14.7,6160,3586,2574,10.3,17.8,-1077,-3.1,29.4,0,175,175,1478
1999,11,h) 11 to 15,1984,2182,36392,37187,78,3.5,171,7.7,3829,814,3015,2.2,10.3,5418,1614,3804,4.3,14.6,-1589,-4.3,20.6,0,105,105,669
1999,11,i) 16 to 20,1496,1709,32249,32951,70,4,142,8.1,2919,720,2199,2.2,8.9,4324,2016,2308,6.1,13.1,-1405,-4.2,17.8,0,62,62,904
1999,11,j) 21 to 25,634,898,43962,44195,28,3,68,7.4,3889,576,3313,1.3,8.8,4354,780,3574,1.8,9.9,-465,-1.1,17.6,0,18,18,73
1999,11,l) Left Censored,3676,5900,214896,213758,406,6.8,520,8.7,27776,8690,19086,4.1,13,25501,8876,16625,4.2,11.9,2275,1.1,23.8,0,121,121,1033
1999,12,a) 0,37065,37433,199899,100409,37145,198.5,0,0,198981,198981,0,198.2,198.2,0,0,0,0,0,198981,198.2,0,0,,,
1999,12,b) 1,27950,28423,201744,203136,386,1.2,8462,25.8,62311,9967,52344,4.9,30.7,65094,39164,25930,19.3,32,-2783,-1.3,61.4,0,6694,6694,31703
1999,12,c) 2,22554,22953,197582,211639,718,2.8,5475,21.6,41899,3746,38153,1.8,19.8,70013,40811,29202,19.3,33.1,-28114,-13.3,39.6,0,4418,4418,27262
1999,12,d) 3,19534,19971,162083,167340,654,3,4004,18.5,40309,9576,30733,5.7,24.1,50822,25418,25404,15.2,30.4,-10513,-6.3,48.2,0,3175,3175,20292
1999,12,e) 4,17328,17767,153869,154994,638,3.4,3099,16.3,36044,4833,31211,3.1,23.3,38294,19820,18474,12.8,24.7,-2250,-1.4,46.6,0,2427,2427,13726
1999,12,f) 5,15682,16238,163327,162014,560,3.3,2433,14.2,37195,5709,31486,3.5,23,34569,15335,19234,9.5,21.3,2626,1.7,42.6,0,1868,1868,11517
1999,12,g) 6 to 10,57948,61703,675395,679754,1889,2.9,7607,11.8,134898,18046,116852,2.7,19.8,143616,67348,76268,9.9,21.1,-8718,-1.3,39.6,0,5586,5586,40123
1999,12,h) 11 to 15,38755,44529,744945,729469,1511,3.3,4398,9.6,159499,31253,128246,4.3,21.9,128547,43926,84621,6,17.6,30952,4.3,35.2,0,2833,2833,22952
1999,12,i) 16 to 20,23310,27804,442781,447414,916,3.2,2564,9,59638,15078,44560,3.4,13.3,68904,24145,44759,5.4,15.4,-9266,-2.1,26.6,0,1533,1533,11117
1999,12,j) 21 to 25,7862,13063,239199,238821,632,4.8,1090,8.2,38014,9261,28753,3.9,15.9,37260,13448,23812,5.6,15.6,754,0.3,31.2,0,438,438,2955
1999,12,l) Left Censored,28552,77350,2672751,2647653,6185,8,6517,8.4,398906,130112,268794,4.9,15.1,348710,140032,208678,5.3,13.2,50196,1.9,26.4,0,1424,1424,11833
1999,13,a) 0,16146,16241,121935,61235,16080,198,0,0,121400,121400,0,198.3,198.3,0,0,0,0,0,121400,198.3,0,0,,,
1999,13,b) 1,12735,12989,108175,106739,232,1.6,3578,24.2,33373,6051,27322,5.7,31.3,30500,16252,14248,15.2,28.6,2873,2.7,57.2,0,2844,2844,13501
1999,13,c) 2,10220,10464,85817,87255,351,3.1,2160,19,21677,3112,18565,3.6,24.8,24552,13755,10797,15.8,28.1,-2875,-3.3,49.6,0,1687,1687,11147
1999,13,d) 3,8717,8943,76283,78077,327,3.4,1683,17.5,15177,1603,13574,2.1,19.4,18765,9906,8859,12.7,24,-3588,-4.6,38.8,0,1270,1270,7368
1999,13,e) 4,7561,7890,79878,79171,252,3,1185,14.2,17451,1882,15569,2.4,22,16036,7544,8492,9.5,20.3,1415,1.7,40.6,0,881,881,5684
1999,13,f) 5,6713,6942,71136,73317,208,2.8,1010,13.8,11832,1584,10248,2.2,16.1,16193,8265,7928,11.3,22.1,-4361,-6,32.2,0,771,771,6589
1999,13,g) 6 to 10,23355,25094,308538,309050,814,3.1,2955,11.3,54953,14390,40563,4.7,17.8,55977,25386,30591,8.2,18.1,-1024,-0.3,35.6,0,2157,2157,17650
1999,13,h) 11 to 15,17477,20127,318126,320240,725,3.5,1757,8.5,45055,11609,33446,3.6,14.1,49283,18640,30643,5.8,15.4,-4228,-1.3,28.2,0,1095,1095,9529
1999,13,i) 16 to 20,10573,13180,228075,226144,473,3.5,992,7.4,33011,8643,24368,3.8,14.6,29149,8719,20430,3.9,12.9,3862,1.7,25.8,0,582,582,3561
1999,13,j) 21 to 25,4119,6513,154948,150308,329,5,570,8.6,30424,7382,23042,4.9,20.2,21144,8702,12442,5.8,14.1,9280,6.1,28.2,0,206,206,1336
1999,13,l) Left Censored,17969,44370,1744158,1723104,3061,6.9,3416,7.7,249408,72092,177316,4.2,14.5,207300,72251,135049,4.2,12,42108,2.5,24,0,705,705,6281
1999,15,a) 0,1695,1705,12024,6026,1695,198.8,0,0,11996,11996,0,199.1,199.1,0,0,0,0,0,11996,199.1,0,0,,,
1999,15,b) 1,1461,1493,14211,14173,29,1.7,370,22,3868,464,3404,3.3,27.3,3791,1455,2336,10.3,26.7,77,0.6,53.4,0,298,298,1226
1999,15,c) 2,1226,1235,9340,9632,42,3.1,237,17.7,1491,185,1306,1.9,15.5,2075,890,1185,9.2,21.5,-584,-6,31,0,195,195,702
1999,15,d) 3,1130,1183,9630,10062,33,2.6,195,15.4,1642,106,1536,1.1,16.3,2506,1502,1004,14.9,24.9,-864,-8.6,32.6,0,148,148,813
1999,15,e) 4,955,980,9416,9743,23,2.2,144,13.8,1583,230,1353,2.4,16.2,2237,1322,915,13.6,23,-654,-6.8,32.4,0,111,111,639
1999,15,f) 5,843,871,12902,13427,22,2.4,130,14.1,2918,1922,996,14.3,21.7,3967,682,3285,5.1,29.5,-1049,-7.8,43.4,0,103,103,453
1999,15,g) 6 to 10,3644,3921,40384,42014,112,2.7,477,11.6,4862,636,4226,1.5,11.6,8121,3801,4320,9,19.3,-3259,-7.7,23.2,0,363,363,3156
1999,15,h) 11 to 15,2918,3481,46171,47003,103,2.9,303,8.5,4791,854,3937,1.8,10.2,6455,2562,3893,5.5,13.7,-1664,-3.5,20.4,0,188,188,1506
1999,15,i) 16 to 20,2448,2913,35601,35783,93,3.1,185,6.2,3807,731,3076,2,10.6,4170,1862,2308,5.2,11.7,-363,-1.1,21.2,0,111,111,888
1999,15,j) 21 to 25,895,1362,22349,22929,36,2.6,70,5.1,1467,324,1143,1.4,6.4,2627,487,2140,2.1,11.5,-1160,-5.1,12.8,0,33,33,89
1999,15,l) Left Censored,3990,7447,203287,204288,357,4.7,585,7.7,20823,7934,12889,3.9,10.2,22824,6609,16215,3.2,11.2,-2001,-1,20.4,0,145,145,777
1999,16,a) 0,3087,3102,16414,8252,3071,198,0,0,16324,16324,0,197.8,197.8,0,0,0,0,0,16324,197.8,0,0,,,
1999,16,b) 1,2384,2436,20210,19129,48,1.7,690,24.7,6711,807,5904,4.2,35.1,4548,2420,2128,12.7,23.8,2163,11.3,47.6,0,525,525,1906
1999,16,c) 2,2084,2128,13945,15587,66,2.8,444,19.1,2632,296,2336,1.9,16.9,5915,4084,1831,26.2,37.9,-3283,-21,33.8,0,333,333,1895
1999,16,d) 3,1731,1779,12737,13465,59,3.1,305,16,2574,823,1751,6.1,19.1,4030,2476,1554,18.4,29.9,-1456,-10.8,38.2,0,214,214,1538
1999,16,e) 4,1493,1517,10099,10323,62,3.9,229,14.3,1965,220,1745,2.1,19,2413,1070,1343,10.4,23.4,-448,-4.4,38,0,179,179,787
1999,16,f) 5,1378,1418,11189,11275,60,4.1,182,12.3,2120,585,1535,5.2,18.8,2292,1001,1291,8.9,20.3,-172,-1.5,37.6,0,133,133,642
1999,16,g) 6 to 10,4578,4826,40939,41623,176,3.5,524,10.5,6118,817,5301,2,14.7,7485,2936,4549,7.1,18,-1367,-3.3,29.4,0,385,385,2160
1999,16,h) 11 to 15,3114,3505,47665,47990,145,4,312,8.7,6303,1210,5093,2.5,13.1,6952,2854,4098,5.9,14.5,-649,-1.4,26.2,0,208,208,2091
1999,16,i) 16 to 20,2162,2607,45433,45152,89,3.3,217,8.1,5659,1968,3691,4.4,12.5,5097,1884,3213,4.2,11.3,562,1.2,22.6,0,131,131,975
1999,16,j) 21 to 25,891,1256,23034,22987,51,4,72,5.7,2167,522,1645,2.3,9.4,2072,496,1576,2.2,9,95,0.4,18,0,34,34,187
1999,16,l) Left Censored,3688,7039,187465,186364,536,7.7,371,5.3,20761,6676,14085,3.6,11.1,18558,4848,13710,2.6,10,2203,1.1,20,0,112,112,712
1999,17,a) 0,19405,19559,127042,63963,19421,198.6,0,0,126159,126159,0,197.2,197.2,0,0,0,0,0,126159,197.2,0,0,,,
1999,17,b) 1,15918,16260,139160,136445,302,1.7,3886,21.4,41909,9027,32882,6.6,30.7,36478,17272,19206,12.7,26.7,5431,4,53.4,0,2930,2930,13937
1999,17,c) 2,13797,14279,112699,114821,366,2.4,2477,16.1,26040,2287,23753,2,22.7,30283,15288,14995,13.3,26.4,-4243,-3.7,45.4,0,1866,1866,10629
1999,17,d) 3,12252,12411,102737,104389,306,2.3,1923,14.5,18800,1378,17422,1.3,18,22104,10840,11264,10.4,21.2,-3304,-3.2,36,0,1424,1424,7623
1999,17,e) 4,11151,11519,103783,105376,367,3,1542,12.7,17400,1649,15751,1.6,16.5,20586,8628,11958,8.2,19.5,-3186,-3,33,0,1146,1146,6750
1999,17,f) 5,9845,10091,98547,100423,257,2.4,1277,12,16469,1876,14593,1.9,16.4,20221,8350,11871,8.3,20.1,-3752,-3.7,32.8,0,965,965,5802
1999,17,g) 6 to 10,38763,41044,470363,473482,1153,2.7,4158,9.8,68121,10134,57987,2.1,14.4,74360,29252,45108,6.2,15.7,-6239,-1.3,28.8,0,3000,3000,18939
1999,17,h) 11 to 15,30262,34018,541580,542339,954,2.7,2667,7.6,65547,11929,53618,2.2,12.1,67065,25423,41642,4.7,12.4,-1518,-0.3,24.2,0,1702,1702,11854
1999,17,i) 16 to 20,20312,23548,421859,422125,570,2.4,1669,6.9,49417,11608,37809,2.7,11.7,49949,14430,35519,3.4,11.8,-532,-0.1,23.4,0,1036,1036,6510
1999,17,j) 21 to 25,7988,11795,245216,244661,455,3.8,804,6.7,29146,7269,21877,3,11.9,28036,8317,19719,3.4,11.5,1110,0.4,23,0,394,394,3085
1999,17,l) Left Censored,40269,76496,2905985,2904965,3829,5,5445,7.1,329235,92538,236697,3.2,11.3,327196,100650,226546,3.5,11.3,2039,0,22.6,0,1695,1695,13277
1999,18,a) 0,9076,9155,62357,31320,9096,198.7,0,0,62075,62075,0,198.2,198.2,0,0,0,0,0,62075,198.2,0,0,,,
1999,18,b) 1,7573,7876,69788,69901,169,1.9,2075,23.4,21056,5480,15576,7.8,30.1,21282,10642,10640,15.2,30.4,-226,-0.3,60.2,0,1662,1662,9175
1999,18,c) 2,6411,6580,50009,52555,157,2.2,1294,18.1,10125,1621,8504,3.1,19.3,15216,9128,6088,17.4,29,-5091,-9.7,38.6,0,1028,1028,7456
1999,18,d) 3,5667,5851,55272,56081,143,2.3,959,15.3,9626,1029,8597,1.8,17.2,11244,5846,5398,10.4,20,-1618,-2.8,34.4,0,747,747,4422
1999,18,e) 4,5119,5303,46310,47830,150,2.7,821,14.6,7170,927,6243,1.9,15,10210,5473,4737,11.4,21.3,-3040,-6.3,30,0,639,639,4383
1999,18,f) 5,4588,4755,43710,44508,151,3,641,12.8,6814,991,5823,2.2,15.3,8409,3469,4940,7.8,18.9,-1595,-3.6,30.6,0,487,487,2480
1999,18,g) 6 to 10,18093,19624,225247,227232,545,2.7,2058,10.1,34266,5478,28788,2.4,15.1,38236,15163,23073,6.7,16.8,-3970,-1.7,30.2,0,1515,1515,10229
1999,18,h) 11 to 15,14168,16473,251011,253225,444,2.6,1225,7.3,28287,4577,23710,1.8,11.2,32714,9759,22955,3.9,12.9,-4427,-1.7,22.4,0,800,800,5273
1999,18,i) 16 to 20,9206,10752,178132,179314,266,2.4,712,6.5,18761,3236,15525,1.8,10.5,21125,6215,14910,3.5,11.8,-2364,-1.3,21,0,476,476,3236
1999,18,j) 21 to 25,3740,5745,130214,129647,220,3.8,400,6.9,16469,3691,12778,2.8,12.7,15335,5162,10173,4,11.8,1134,0.9,23.6,0,175,175,1175
1999,18,l) Left Censored,19454,39958,1443678,1440873,1908,4.7,2349,5.8,154954,37633,117321,2.6,10.8,149345,39170,110175,2.7,10.4,5609,0.4,20.8,0,708,708,6274
1999,19,a) 0,4500,4545,27826,13944,4515,198.7,0,0,27764,27764,0,199.1,199.1,0,0,0,0,0,27764,199.1,0,0,,,
1999,19,b) 1,3775,3846,29082,29563,60,1.4,1008,23.1,6945,1235,5710,4.2,23.5,7906,3761,4145,12.7,26.7,-961,-3.2,47,0,804,804,3139
1999,19,c) 2,3225,3320,25013,25895,98,2.7,638,17.8,5246,698,4548,2.7,20.3,7010,3952,3058,15.3,27.1,-1764,-6.8,40.6,0,492,492,2575
1999,19,d) 3,2953,3017,23720,23911,101,3.1,473,14.7,4125,708,3417,3,17.3,4506,2244,2262,9.4,18.8,-381,-1.5,34.6,0,366,366,1835
1999,19,e) 4,2756,2852,22945,23206,74,2.5,370,12.3,3791,550,3241,2.4,16.3,4313,1843,2470,7.9,18.6,-522,-2.3,32.6,0,287,287,1436
1999,19,f) 5,2489,2548,21952,22214,52,1.9,297,11.1,3061,379,2682,1.7,13.8,3584,1519,2065,6.8,16.1,-523,-2.3,27.6,0,223,223,961
1999,19,g) 6 to 10,9299,9838,88838,90937,275,2.7,962,9.4,12692,2789,9903,3.1,14,16890,8440,8450,9.3,18.6,-4198,-4.6,28,0,715,715,4643
1999,19,h) 11 to 15,7650,8744,135835,136126,225,2.5,602,6.7,13849,2249,11600,1.7,10.2,14430,4952,9478,3.6,10.6,-581,-0.4,20.4,0,393,393,2271
1999,19,i) 16 to 20,5622,6897,89525,90826,181,2.6,498,7.1,9969,2301,7668,2.5,11,12570,5030,7540,5.5,13.8,-2601,-2.8,22,0,317,317,1466
1999,19,j) 21 to 25,2515,3862,57889,58100,110,2.8,242,6.2,6354,1657,4697,2.9,10.9,6776,1897,4879,3.3,11.7,-422,-0.8,21.8,0,128,128,760
1999,19,l) Left Censored,13170,23146,705127,699677,1022,4.4,1297,5.6,79318,22869,56449,3.3,11.3,68417,16291,52126,2.3,9.8,10901,1.5,19.6,0,494,494,3273
1999,20,a) 0,4814,4849,30651,15371,4817,198.7,0,0,30561,30561,0,198.8,198.8,0,0,0,0,0,30561,198.8,0,0,,,
1999,20,b) 1,3989,4064,35468,34184,79,1.7,1030,22.5,11128,2188,8940,6.4,32.6,8560,4034,4526,11.8,25,2568,7.6,50,0,805,805,3385
1999,20,c) 2,3282,3353,28518,28999,88,2.4,716,19.5,6409,663,5746,2.3,22.1,7370,4338,3032,15,25.4,-961,-3.3,44.2,0,559,559,3539
1999,20,d) 3,2961,3005,22250,22606,75,2.3,474,14.8,4067,458,3609,2,18,4778,2604,2174,11.5,21.1,-711,-3.1,36,0,377,377,1753
1999,20,e) 4,2624,2699,22064,22693,93,3.3,423,14.8,3644,666,2978,2.9,16.1,4901,2031,2870,8.9,21.6,-1257,-5.5,32.2,0,352,352,1727
1999,20,f) 5,2260,2341,21283,21444,87,3.5,326,13.2,5030,2264,2766,10.6,23.5,5351,2330,3021,10.9,25,-321,-1.5,47,0,264,264,2090
1999,20,g) 6 to 10,8698,9236,94628,96178,289,3,1020,10.6,14392,2288,12104,2.4,15,17492,8833,8659,9.2,18.2,-3100,-3.2,30,0,752,752,6934
1999,20,h) 11 to 15,7066,7848,104753,104761,229,2.8,657,8.1,13513,3236,10277,3.1,12.9,13529,5110,8419,4.9,12.9,-16,0,25.8,0,451,451,2576
1999,20,i) 16 to 20,5201,6065,80852,81006,173,2.8,431,7,10665,2263,8402,2.8,13.2,10973,4313,6660,5.3,13.5,-308,-0.3,26.4,0,249,249,1717
1999,20,j) 21 to 25,2059,3119,50499,50767,97,3,231,7.2,7122,2022,5100,4,14,7658,2368,5290,4.7,15.1,-536,-1.1,28,0,75,75,285
1999,20,l) Left Censored,10716,19647,603926,601161,993,5,1344,6.8,71679,20638,51041,3.4,11.9,66149,23893,42256,4,11,5530,0.9,22,0,396,396,2858
1999,21,a) 0,5970,6022,40437,20361,5977,198.5,0,0,40153,40153,0,197.2,197.2,0,0,0,0,0,40153,197.2,0,0,,,
1999,21,b) 1,4965,5092,42062,42834,99,1.7,1363,23.7,12324,2168,10156,5.1,28.8,13867,7391,6476,17.3,32.4,-1543,-3.6,57.6,0,1117,1117,5968
1999,21,c) 2,4072,4165,31977,33091,99,2.2,850,18.7,6255,402,5853,1.2,18.9,8482,4476,4006,13.5,25.6,-2227,-6.7,37.8,0,694,694,3627
1999,21,d) 3,3474,3580,33003,34244,92,2.4,629,16.3,5184,475,4709,1.4,15.1,7666,4191,3475,12.2,22.4,-2482,-7.3,30.2,0,503,503,3613
1999,21,e) 4,3306,3439,30899,31832,109,3,511,14,4154,504,3650,1.6,13,6019,2596,3423,8.2,18.9,-1865,-5.9,26,0,409,409,2032
1999,21,f) 5,2829,2921,26534,27408,77,2.5,378,12.3,3563,505,3058,1.8,13,5311,2319,2992,8.5,19.4,-1748,-6.4,26,0,295,295,1702
1999,21,g) 6 to 10,11196,12005,125860,128338,356,2.9,1300,10.4,18627,3713,14914,2.9,14.5,23582,9656,13926,7.5,18.4,-4955,-3.9,29,0,953,953,5350
1999,21,h) 11 to 15,9019,10150,153727,155450,321,3.1,832,8,19278,3662,15616,2.4,12.4,22724,8122,14602,5.2,14.6,-3446,-2.2,24.8,0,535,535,3092
1999,21,i) 16 to 20,5540,6402,108373,109354,182,2.8,446,6.8,13034,3806,9228,3.5,11.9,14995,5344,9651,4.9,13.7,-1961,-1.8,23.8,0,280,280,1522
1999,21,j) 21 to 25,2244,3513,77183,75403,157,4.4,234,6.6,11739,4892,6847,6.5,15.6,8178,2871,5307,3.8,10.8,3561,4.8,21.6,0,113,113,694
1999,21,l) Left Censored,11603,23690,768030,771439,1293,5.4,1508,6.3,82099,24737,57362,3.2,10.6,88916,22038,66878,2.9,11.5,-6817,-0.9,21.2,0,451,451,3684
1999,22,a) 0,6522,6575,45253,22697,6529,198.6,0,0,45112,45112,0,198.8,198.8,0,0,0,0,0,45112,198.8,0,0,,,
1999,22,b) 1,5507,5724,52946,52921,154,2.4,1565,24.1,17410,4629,12781,8.7,32.9,17359,9203,8156,17.4,32.8,51,0.1,65.6,0,1239,1239,7698
1999,22,c) 2,4611,4695,43499,45668,141,2.8,976,19,8532,832,7700,1.8,18.7,12870,7232,5638,15.8,28.2,-4338,-9.5,37.4,0,770,770,4912
1999,22,d) 3,3989,4058,37102,38860,101,2.3,700,16.1,6228,874,5354,2.2,16,9743,4352,5391,11.2,25.1,-3515,-9.1,32,0,583,583,3674
1999,22,e) 4,3586,3668,38667,42156,96,2.5,563,14.4,5583,503,5080,1.2,13.2,12561,7513,5048,17.8,29.8,-6978,-16.6,26.4,0,441,441,6493
1999,22,f) 5,3359,3489,35073,36860,88,2.4,473,12.8,5811,1021,4790,2.8,15.8,9384,5162,4222,14,25.5,-3573,-9.7,31.6,0,367,367,3537
1999,22,g) 6 to 10,12116,12878,151643,154873,343,2.6,1317,9.9,22480,3683,18797,2.4,14.5,28939,9988,18951,6.4,18.7,-6459,-4.2,29,0,934,934,6275
1999,22,h) 11 to 15,9639,11007,162054,165043,344,3.1,840,7.5,19374,4953,14421,3,11.7,25352,10381,14971,6.3,15.4,-5978,-3.7,23.4,0,530,530,5529
1999,22,i) 16 to 20,7896,9452,148880,150552,263,2.7,701,7.2,17810,4832,12978,3.2,11.8,21154,7080,14074,4.7,14.1,-3344,-2.3,23.6,0,427,427,3032
1999,22,j) 21 to 25,2694,3928,67878,68133,169,4.2,269,6.8,9010,1822,7188,2.7,13.2,9520,3495,6025,5.1,14,-510,-0.8,26.4,0,135,135,1295
1999,22,l) Left Censored,12598,25465,765182,766388,1281,5,1628,6.4,87789,20644,67145,2.7,11.5,90201,25693,64508,3.4,11.8,-2412,-0.3,23,0,471,471,3317
1999,23,a) 0,2782,2793,14276,7163,2766,198.1,0,0,14226,14226,0,198.6,198.6,0,0,0,0,0,14226,198.6,0,0,,,
1999,23,b) 1,2337,2411,15589,15320,57,2.1,537,20.1,4461,1186,3275,7.7,29.1,3923,1852,2071,12.1,25.6,538,3.5,51.2,0,409,409,1585
1999,23,c) 2,1862,1885,10506,10717,56,2.8,318,15.7,1973,279,1694,2.6,18.4,2395,1321,1074,12.3,22.3,-422,-3.9,36.8,0,245,245,1052
1999,23,d) 3,1644,1685,12505,12821,53,2.9,289,16,2108,200,1908,1.6,16.4,2740,1514,1226,11.8,21.4,-632,-5,32.8,0,210,210,999
1999,23,e) 4,1491,1502,9826,9922,44,2.8,208,13.1,1772,110,1662,1.1,17.9,1963,1055,908,10.6,19.8,-191,-1.9,35.8,0,162,162,854
1999,23,f) 5,1238,1257,9210,9571,46,3.5,132,10.2,1375,153,1222,1.6,14.4,2096,1033,1063,10.8,21.9,-721,-7.5,28.8,0,105,105,840
1999,23,g) 6 to 10,4840,5050,42751,42954,142,2.7,482,9.2,6181,732,5449,1.7,14.4,6587,3074,3513,7.2,15.3,-406,-0.9,28.8,0,346,346,2004
1999,23,h) 11 to 15,4232,4645,53030,52792,157,3.3,363,7.6,7115,1133,5982,2.1,13.5,6638,2062,4576,3.9,12.6,477,0.9,25.2,0,252,252,1484
1999,23,i) 16 to 20,2409,2824,43665,44079,99,3.4,189,6.6,4373,545,3828,1.2,9.9,5201,1213,3988,2.8,11.8,-828,-1.9,19.8,0,123,123,878
1999,23,j) 21 to 25,961,1565,26212,25885,47,2.9,147,9.1,4351,1058,3293,4.1,16.8,3697,1248,2449,4.8,14.3,654,2.5,28.6,0,58,58,401
1999,23,l) Left Censored,4522,7769,227393,226840,412,5.3,489,6.3,22720,6069,16651,2.7,10,21613,5127,16486,2.3,9.5,1107,0.5,19,0,170,170,1289
1999,24,a) 0,8599,8653,54193,27207,8604,198.9,0,0,53973,53973,0,198.4,198.4,0,0,0,0,0,53973,198.4,0,0,,,
1999,24,b) 1,6997,7137,60017,60515,124,1.5,1770,22.1,18090,2498,15592,4.1,29.9,19086,11634,7452,19.2,31.5,-996,-1.6,59.8,0,1332,1332,8688
1999,24,c) 2,6087,6203,48265,50110,196,2.9,1163,17.3,9982,1339,8643,2.7,19.9,13672,7575,6097,15.1,27.3,-3690,-7.4,39.8,0,905,905,5075
1999,24,d) 3,5151,5227,42082,43591,144,2.6,849,15.2,7894,782,7112,1.8,18.1,10912,6028,4884,13.8,25,-3018,-6.9,36.2,0,640,640,4620
1999,24,e) 4,4817,4920,42259,42497,168,3.2,718,13.8,7961,1439,6522,3.4,18.7,8436,4156,4280,9.8,19.9,-475,-1.2,37.4,0,559,559,3458
1999,24,f) 5,4101,4252,40121,41231,136,3,581,13,6988,1150,5838,2.8,16.9,9207,3937,5270,9.5,22.3,-2219,-5.4,33.8,0,420,420,3032
1999,24,g) 6 to 10,16604,17659,203188,204545,521,2.8,1790,9.8,32766,5908,26858,2.9,16,35481,14433,21048,7.1,17.3,-2715,-1.3,32,0,1265,1265,9411
1999,24,h) 11 to 15,13003,14598,205187,208354,443,3,1197,8,25843,5903,19940,2.8,12.4,32176,11436,20740,5.5,15.4,-6333,-3,24.8,0,735,735,5403
1999,24,i) 16 to 20,7710,9046,144060,145630,286,3.1,663,7.2,20441,5123,15318,3.5,14,23580,11831,11749,8.1,16.2,-3139,-2.2,28,0,386,386,7896
1999,24,j) 21 to 25,2951,4553,99772,98040,197,4.3,292,6.3,17002,5087,11915,5.2,17.3,13538,4950,8588,5,13.8,3464,3.5,27.6,0,123,123,1591
1999,24,l) Left Censored,14531,29563,1012173,1015755,1680,5.6,2389,8,128838,41996,86842,4.1,12.7,136003,46577,89426,4.6,13.4,-7165,-0.7,25.4,0,578,578,6863
1999,25,a) 0,10650,10717,67131,33654,10638,198.5,0,0,66955,66955,0,199,199,0,0,0,0,0,66955,199,0,0,,,
1999,25,b) 1,8957,9096,75166,73712,135,1.3,2037,20.1,22870,4580,18290,6.2,31,19961,10457,9504,14.2,27.1,2909,3.9,54.2,0,1549,1549,8473
1999,25,c) 2,7611,7731,65548,64847,231,2.8,1424,17.1,17114,1638,15476,2.5,26.4,15712,8160,7552,12.6,24.2,1402,2.2,48.4,0,1082,1082,6592
1999,25,d) 3,6478,6556,53965,55973,160,2.3,1046,14.9,9894,675,9219,1.2,17.7,13910,7530,6380,13.5,24.9,-4016,-7.2,35.4,0,810,810,5574
1999,25,e) 4,6093,6341,61179,61755,197,3,791,11.9,11426,2549,8877,4.1,18.5,12577,4201,8376,6.8,20.4,-1151,-1.9,37,0,596,596,3425
1999,25,f) 5,5446,5549,53380,54333,129,2.2,617,10.6,8559,1071,7488,2,15.8,10465,4667,5798,8.6,19.3,-1906,-3.5,31.6,0,476,476,3651
1999,25,g) 6 to 10,19885,21097,239227,240872,519,2.4,2018,9.2,35185,5722,29463,2.4,14.6,38475,13968,24507,5.8,16,-3290,-1.4,29.2,0,1492,1492,9726
1999,25,h) 11 to 15,18139,20124,323112,326410,596,2.9,1627,7.9,36223,8196,28027,2.5,11.1,42818,16605,26213,5.1,13.1,-6595,-2,22.2,0,1026,1026,7801
1999,25,i) 16 to 20,11193,13203,259743,260784,353,2.6,1004,7.4,35602,9261,26341,3.6,13.7,37683,13295,24388,5.1,14.4,-2081,-0.7,27.4,0,595,595,4443
1999,25,j) 21 to 25,4209,6333,149743,150505,229,3.6,431,6.7,14737,3814,10923,2.5,9.8,16261,5217,11044,3.5,10.8,-1524,-1,19.6,0,188,188,1303
1999,25,l) Left Censored,24528,42840,1592072,1583107,1957,4.5,2975,6.9,210364,64220,146144,4.1,13.3,192433,57614,134819,3.6,12.2,17931,1.1,24.4,0,994,994,9541
1999,26,a) 0,14610,14725,100662,50561,14595,198.2,0,0,100202,100202,0,198.2,198.2,0,0,0,0,0,100202,198.2,0,0,,,
1999,26,b) 1,12229,12530,106927,106970,198,1.4,2954,21.1,26640,4506,22134,4.2,24.9,26726,12634,14092,11.8,25,-86,-0.1,49.8,0,2246,2246,9797
1999,26,c) 2,10913,11378,98917,102717,299,2.4,2011,16.4,19241,1901,17340,1.9,18.7,26840,13941,12899,13.6,26.1,-7599,-7.4,37.4,0,1563,1563,11518
1999,26,d) 3,9674,9810,89042,91321,259,2.5,1576,15,15388,1325,14063,1.5,16.9,19946,10885,9061,11.9,21.8,-4558,-4.9,33.8,0,1203,1203,8612
1999,26,e) 4,8939,9124,82348,83346,243,2.5,1196,12.4,15143,1782,13361,2.1,18.2,17138,7851,9287,9.4,20.6,-1995,-2.4,36.4,0,914,914,6403
1999,26,f) 5,7627,7852,78618,79565,246,3,984,12,14081,4673,9408,5.9,17.7,15975,6856,9119,8.6,20.1,-1894,-2.4,35.4,0,766,766,5650
1999,26,g) 6 to 10,29608,31574,341070,347159,871,2.7,3251,9.9,47267,7843,39424,2.3,13.6,59446,23072,36374,6.6,17.1,-12179,-3.5,27.2,0,2388,2388,16840
1999,26,h) 11 to 15,23162,26645,396432,404275,751,2.7,2156,7.9,50255,8510,41745,2.1,12.4,65943,19558,46385,4.8,16.3,-15688,-3.9,24.8,0,1451,1451,11666
1999,26,i) 16 to 20,15011,18003,298221,300828,475,2.6,1213,6.6,32765,7453,25312,2.5,10.9,37978,10547,27431,3.5,12.6,-5213,-1.7,21.8,0,727,727,5136
1999,26,j) 21 to 25,5866,8530,166746,167549,281,3.2,584,6.7,22055,4638,17417,2.8,13.2,23661,6450,17211,3.8,14.1,-1606,-0.9,26.4,0,289,289,2071
1999,26,l) Left Censored,28903,57848,2185103,2180839,2798,4.8,3793,6.5,264687,83971,180716,3.9,12.1,256159,72341,183818,3.3,11.7,8528,0.4,23.4,0,1235,1235,10904
1999,27,a) 0,9054,9153,57669,28912,9078,198.4,0,0,57515,57515,0,198.9,198.9,0,0,0,0,0,57515,198.9,0,0,,,
1999,27,b) 1,7663,7865,64664,63104,162,1.9,1716,19.7,17919,2716,15203,4.3,28.4,14799,7734,7065,12.3,23.5,3120,4.9,47,0,1254,1254,5933
1999,27,c) 2,6571,6715,50787,49885,227,3.2,1127,15.7,13399,5233,8166,10.5,26.9,11594,7028,4566,14.1,23.2,1805,3.7,46.4,0,831,831,5165
1999,27,d) 3,5664,5758,46074,47376,153,2.5,789,13,7947,780,7167,1.6,16.8,10551,5852,4699,12.4,22.3,-2604,-5.5,33.6,0,585,585,3886
1999,27,e) 4,5010,5116,43568,43337,142,2.6,628,11.7,7692,627,7065,1.4,17.7,7229,3526,3703,8.1,16.7,463,1,33.4,0,475,475,2957
1999,27,f) 5,4604,4743,43992,44076,156,3.2,570,11.5,7190,1289,5901,2.9,16.3,7358,3126,4232,7.1,16.7,-168,-0.4,32.6,0,395,395,2015
1999,27,g) 6 to 10,17245,18412,197415,198635,485,2.5,1746,9.2,27460,3793,23667,1.9,13.8,29900,11181,18719,5.6,15.1,-2440,-1.3,27.6,0,1225,1225,7328
1999,27,h) 11 to 15,12960,14914,225705,228553,398,2.6,1156,7.6,25517,4831,20686,2.1,11.2,31212,11320,19892,5,13.7,-5695,-2.5,22.4,0,728,728,5373
1999,27,i) 16 to 20,8341,9943,183711,182686,273,2.7,787,7.7,24094,4455,19639,2.4,13.2,22043,8235,13808,4.5,12.1,2051,1.1,24.2,0,411,411,3025
1999,27,j) 21 to 25,3571,5225,108216,107214,163,3.1,314,5.9,13646,3474,10172,3.2,12.7,11641,3424,8217,3.2,10.9,2005,1.8,21.8,0,141,141,679
1999,27,l) Left Censored,17090,31689,1290537,1286830,1683,5.3,1918,6,148170,49550,98620,3.9,11.5,140755,44947,95808,3.5,10.9,7415,0.6,21.8,0,567,567,5821
1999,28,a) 0,4358,4391,26998,13557,4368,199,0,0,26883,26883,0,198.3,198.3,0,0,0,0,0,26883,198.3,0,0,,,
1999,28,b) 1,3309,3406,25174,25677,59,1.5,1030,26.3,7476,1260,6216,4.9,29.1,8481,4733,3748,18.4,33,-1005,-3.9,58.2,0,845,845,3928
1999,28,c) 2,2782,2842,20895,22203,93,3,632,20.3,3884,594,3290,2.7,17.5,6500,3638,2862,16.4,29.3,-2616,-11.8,35,0,517,517,3085
1999,28,d) 3,2398,2462,20512,21477,85,3.2,477,18,3223,406,2817,1.9,15,5152,2765,2387,12.9,24,-1929,-9,30,0,364,364,2145
1999,28,e) 4,2210,2299,20579,20866,71,2.9,366,15,3774,873,2901,4.2,18.1,4347,1692,2655,8.1,20.8,-573,-2.7,36.2,0,296,296,1350
1999,28,f) 5,2000,2056,24731,25914,52,2.4,293,13.5,3712,285,3427,1.1,14.3,6077,2477,3600,9.6,23.5,-2365,-9.2,28.6,0,234,234,1350
1999,28,g) 6 to 10,6928,7367,78172,78598,215,2.8,898,11.6,12754,1759,10995,2.2,16.2,13606,5409,8197,6.9,17.3,-852,-1.1,32.4,0,680,680,4104
1999,28,h) 11 to 15,5691,6340,89836,91386,208,3.2,546,8.4,10216,1805,8411,2,11.2,13316,6221,7095,6.8,14.6,-3100,-3.4,22.4,0,348,348,3105
1999,28,i) 16 to 20,3999,4769,92242,89090,122,2.5,340,7,16966,2277,14689,2.6,19,10661,2749,7912,3.1,12,6305,7,24,0,228,228,1187
1999,28,j) 21 to 25,1610,2317,48223,46982,141,6.1,164,7,6872,3188,3684,6.8,14.6,4390,1705,2685,3.6,9.3,2482,5.3,18.6,0,80,80,534
1999,28,l) Left Censored,7713,15463,492439,495422,745,4.8,985,6.3,49442,12658,36784,2.6,10,55408,17728,37680,3.6,11.2,-5966,-1.2,20,0,341,341,2873
1999,29,a) 0,9863,9933,62197,31192,9853,198.4,0,0,62011,62011,0,198.8,198.8,0,0,0,0,0,62011,198.8,0,0,,,
1999,29,b) 1,7878,8072,65002,66189,144,1.6,2187,23.9,17612,4577,13035,6.9,26.6,19986,9308,10678,14.1,30.2,-2374,-3.6,53.2,0,1720,1720,7556
1999,29,c) 2,6663,6753,48479,51028,190,2.6,1394,18.9,10056,1152,8904,2.3,19.7,15154,6530,8624,12.8,29.7,-5098,-10,39.4,0,1085,1085,5185
1999,29,d) 3,5749,5875,49129,50493,160,2.5,1017,16.1,8069,636,7433,1.3,16,10797,5500,5297,10.9,21.4,-2728,-5.4,32,0,810,810,4087
1999,29,e) 4,5316,5459,44091,44596,144,2.5,816,14.1,7582,473,7109,1.1,17,8591,3909,4682,8.8,19.3,-1009,-2.3,34,0,673,673,3264
1999,29,f) 5,4851,5039,46366,47104,154,2.9,745,14,7483,1361,6122,2.9,15.9,8959,4433,4526,9.4,19,-1476,-3.1,31.8,0,600,600,3410
1999,29,g) 6 to 10,17731,19006,195207,198397,558,2.8,2140,10.8,27428,3951,23477,2,13.8,33808,13133,20675,6.6,17,-6380,-3.2,27.6,0,1590,1590,9113
1999,29,h) 11 to 15,14520,16205,232618,232179,538,3.2,1300,7.8,31628,8570,23058,3.7,13.6,30750,8783,21967,3.8,13.2,878,0.4,26.4,0,878,878,4708
1999,29,i) 16 to 20,9157,11091,201570,200000,276,2.4,822,7.2,24292,6527,17765,3.3,12.1,21151,6848,14303,3.4,10.6,3141,1.5,21.2,0,512,512,3021
1999,29,j) 21 to 25,3637,5501,107570,108038,210,3.8,389,7,11650,2177,9473,2,10.8,12585,3370,9215,3.1,11.6,-935,-0.8,21.6,0,178,178,1293
1999,29,l) Left Censored,18536,36365,1276796,1274146,1965,5.4,2459,6.7,151737,40743,110994,3.2,11.9,146436,52297,94139,4.1,11.5,5301,0.4,23,0,757,757,4560
1999,30,a) 0,2375,2390,11308,5675,2369,198.2,0,0,11266,11266,0,198.5,198.5,0,0,0,0,0,11266,198.5,0,0,,,
1999,30,b) 1,2034,2065,13108,12701,34,1.5,543,23.2,3733,862,2871,6.8,29.4,2918,1591,1327,12.5,23,815,6.4,46,0,421,421,1218
1999,30,c) 2,1655,1663,9801,10072,45,2.5,293,16.3,1979,171,1808,1.7,19.6,2520,1306,1214,13,25,-541,-5.4,39.2,0,227,227,924
1999,30,d) 3,1511,1534,9445,9507,45,2.7,258,15.7,1753,315,1438,3.3,18.4,1876,938,938,9.9,19.7,-123,-1.3,36.8,0,197,197,759
1999,30,e) 4,1327,1344,8500,8649,38,2.7,207,14.5,1375,186,1189,2.2,15.9,1673,810,863,9.4,19.3,-298,-3.4,31.8,0,153,153,588
1999,30,f) 5,1095,1117,8325,8375,38,3.2,162,13.8,1580,492,1088,5.9,18.9,1680,880,800,10.5,20.1,-100,-1.2,37.8,0,114,114,616
1999,30,g) 6 to 10,3837,3990,30459,31223,118,2.8,471,11.3,4200,414,3786,1.3,13.5,5728,2594,3134,8.3,18.3,-1528,-4.8,27,0,333,333,1852
1999,30,h) 11 to 15,2943,3252,34351,34427,110,3.3,252,7.6,4016,736,3280,2.1,11.7,4168,1322,2846,3.8,12.1,-152,-0.4,23.4,0,173,173,810
1999,30,i) 16 to 20,2186,2527,27961,28262,70,2.7,192,7.4,2888,522,2366,1.8,10.2,3490,1102,2388,3.9,12.3,-602,-2.1,20.4,0,118,118,555
1999,30,j) 21 to 25,860,1133,13628,13665,42,3.6,81,7,1536,239,1297,1.7,11.2,1610,524,1086,3.8,11.8,-74,-0.6,22.4,0,45,45,233
1999,30,l) Left Censored,3418,5833,116515,115398,299,5.1,366,6.2,14258,3408,10850,3,12.4,12024,3824,8200,3.3,10.4,2234,2,20.8,0,135,135,759
1999,31,a) 0,2990,3009,22668,11372,2986,198.5,0,0,22592,22592,0,198.7,198.7,0,0,0,0,0,22592,198.7,0,0,,,
1999,31,b) 1,2527,2605,21037,20548,55,1.9,576,20,6221,1147,5074,5.6,30.3,5242,2333,2909,11.4,25.5,979,4.8,51,0,434,434,1939
1999,31,c) 2,2142,2203,13400,14260,49,2.1,378,15.9,2370,190,2180,1.3,16.6,4089,2450,1639,17.2,28.7,-1719,-12.1,33.2,0,300,300,1723
1999,31,d) 3,1811,1843,13557,13964,53,2.7,312,15.8,2376,295,2081,2.1,17,3190,1686,1504,12.1,22.8,-814,-5.8,34,0,241,241,1392
1999,31,e) 4,1648,1688,13319,13435,47,2.6,226,12.7,2163,236,1927,1.8,16.1,2394,1020,1374,7.6,17.8,-231,-1.7,32.2,0,169,169,770
1999,31,f) 5,1507,1557,12769,12774,45,2.8,195,11.9,2244,317,1927,2.5,17.6,2253,1122,1131,8.8,17.6,-9,0,35.2,0,147,147,917
1999,31,g) 6 to 10,5871,6287,64838,67688,168,2.6,624,9.6,10398,3464,6934,5.1,15.4,16097,7523,8574,11.1,23.8,-5699,-8.4,30.8,0,436,436,6113
1999,31,h) 11 to 15,4794,5320,77145,76204,130,2.4,447,8.2,9992,2147,7845,2.8,13.1,8109,3015,5094,4,10.6,1883,2.5,21.2,0,293,293,1384
1999,31,i) 16 to 20,3516,4150,58301,57741,123,2.9,315,7.4,7903,1454,6449,2.5,13.7,6783,3001,3782,5.2,11.7,1120,2,23.4,0,189,189,977
1999,31,j) 21 to 25,1516,2228,41183,41021,91,4,134,6,4916,1324,3592,3.2,12,4591,1616,2975,3.9,11.2,325,0.8,22.4,0,74,74,390
1999,31,l) Left Censored,7688,12823,390662,389366,458,3.5,754,5.8,41356,9930,31426,2.6,10.6,38763,12554,26209,3.2,10,2593,0.6,20,0,299,299,4104
1999,32,a) 0,4766,4796,37055,18576,4766,198.7,0,0,36958,36958,0,199,199,0,0,0,0,0,36958,199,0,0,,,
1999,32,b) 1,3561,3641,36215,36014,71,1.7,1038,25,11782,2164,9618,6,32.7,11379,6447,4932,17.9,31.6,403,1.1,63.2,0,814,814,5029
1999,32,c) 2,2782,2816,29964,29960,95,3.1,598,19.5,7163,991,6172,3.3,23.9,7154,3807,3347,12.7,23.9,9,0,47.8,0,488,488,3260
1999,32,d) 3,2099,2157,34153,34244,84,3.6,399,17.2,4951,372,4579,1.1,14.5,5133,2535,2598,7.4,15,-182,-0.5,29,0,325,325,2132
1999,32,e) 4,1883,1961,26002,26821,82,4,292,14.1,3907,642,3265,2.4,14.6,5544,2313,3231,8.6,20.7,-1637,-6.1,29.2,0,218,218,1784
1999,32,f) 5,1543,1602,23401,23364,67,4,260,15.4,5143,1103,4040,4.7,22,5068,2299,2769,9.8,21.7,75,0.3,43.4,0,202,202,1762
1999,32,g) 6 to 10,5221,5632,78090,77691,237,4.1,686,11.7,14393,2616,11777,3.4,18.5,13594,5558,8036,7.2,17.5,799,1,35,0,500,500,3855
1999,32,h) 11 to 15,3444,4220,71217,71682,291,6.8,402,9.4,12760,4197,8563,5.9,17.8,13689,3971,9718,5.5,19.1,-929,-1.3,35.6,0,241,241,2231
1999,32,i) 16 to 20,2425,3027,87082,83728,119,3.8,261,8.4,15988,1485,14503,1.8,19.1,9279,1851,7428,2.2,11.1,6709,8,22.2,0,137,137,894
1999,32,j) 21 to 25,913,1480,65872,65556,104,7,124,8.3,8299,3265,5034,5,12.7,7666,2424,5242,3.7,11.7,633,1,23.4,0,46,46,226
1999,32,l) Left Censored,3604,8166,352670,345630,1019,12.8,644,8.1,51958,22325,29633,6.5,15,37877,11702,26175,3.4,11,14081,4,22,0,110,110,1513
1999,33,a) 0,2471,2487,13174,6612,2465,198.2,0,0,13124,13124,0,198.5,198.5,0,0,0,0,0,13124,198.5,0,0,,,
1999,33,b) 1,2132,2170,15471,15282,38,1.6,529,21.8,4338,1201,3137,7.9,28.4,3959,1986,1973,13,25.9,379,2.5,51.8,0,413,413,1609
1999,33,c) 2,1895,1911,12367,12616,52,2.5,320,15.6,2345,269,2076,2.1,18.6,2843,1380,1463,10.9,22.5,-498,-3.9,37.2,0,248,248,1033
1999,33,d) 3,1683,1710,14992,15023,50,2.7,267,14.6,2344,153,2191,1,15.6,2405,1088,1317,7.2,16,-61,-0.4,31.2,0,218,218,925
1999,33,e) 4,1491,1509,11817,12115,36,2.3,193,12.2,1811,252,1559,2.1,14.9,2406,873,1533,7.2,19.9,-595,-5,29.8,0,152,152,697
1999,33,f) 5,1326,1347,11192,11085,28,2,147,10.4,1965,226,1739,2,17.7,1751,763,988,6.9,15.8,214,1.9,31.6,0,114,114,584
1999,33,g) 6 to 10,4743,4994,52438,53329,113,2.2,489,9.4,6031,609,5422,1.1,11.3,7813,2707,5106,5.1,14.7,-1782,-3.4,22.6,0,351,351,1889
1999,33,h) 11 to 15,4366,4714,63724,63496,142,2.9,365,7.6,8081,1309,6772,2.1,12.7,7624,2594,5030,4.1,12,457,0.7,24,0,239,239,1438
1999,33,i) 16 to 20,2286,2594,41455,41635,63,2.4,162,6.1,4350,743,3607,1.8,10.4,4710,992,3718,2.4,11.3,-360,-0.9,20.8,0,103,103,438
1999,33,j) 21 to 25,891,1328,28934,29499,26,1.9,96,7.1,2771,222,2549,0.8,9.4,3901,1386,2515,4.7,13.2,-1130,-3.8,18.8,0,38,38,154
1999,33,l) Left Censored,4473,8018,255612,253483,531,6.7,437,5.5,27174,9050,18124,3.6,10.7,22916,5877,17039,2.3,9,4258,1.7,18,0,140,140,1962
1999,34,a) 0,16390,16452,95725,48190,16315,198.3,0,0,95070,95070,0,197.3,197.3,0,0,0,0,0,95070,197.3,0,0,,,
1999,34,b) 1,13973,14188,114474,114095,174,1.1,3286,20.7,31116,5890,25226,5.2,27.3,30358,13255,17103,11.6,26.6,758,0.7,53.2,0,2485,2485,10791
1999,34,c) 2,11916,12074,87408,88401,341,2.6,2235,17.1,20871,2115,18756,2.4,23.6,22856,12979,9877,14.7,25.9,-1985,-2.3,47.2,0,1736,1736,10256
1999,34,d) 3,10084,10221,77761,79655,311,2.9,1608,14.8,14502,2268,12234,2.8,18.2,18289,8785,9504,11,23,-3787,-4.8,36.4,0,1251,1251,6505
1999,34,e) 4,8967,9389,76380,77463,349,3.5,1407,14.2,14909,2849,12060,3.7,19.2,17075,7956,9119,10.3,22,-2166,-2.8,38.4,0,1012,1012,5776
1999,34,f) 5,7485,7619,66091,66246,233,2.9,953,11.9,11092,1419,9673,2.1,16.7,11401,4805,6596,7.3,17.2,-309,-0.5,33.4,0,736,736,3598
1999,34,g) 6 to 10,29413,30364,293694,297688,829,2.6,3287,10.4,44246,6157,38089,2.1,14.9,52234,20465,31769,6.9,17.5,-7988,-2.6,29.8,0,2484,2484,14268
1999,34,h) 11 to 15,24048,26291,363602,362254,897,3.3,2307,8.5,53246,11035,42211,3,14.7,50550,19107,31443,5.3,14,2696,0.7,28,0,1608,1608,11806
1999,34,i) 16 to 20,15406,17088,254344,254687,490,2.8,1270,7.3,34930,8961,25969,3.5,13.7,35615,10976,24639,4.3,14,-685,-0.3,27.4,0,854,854,5839
1999,34,j) 21 to 25,5766,7276,162364,165100,215,2.9,560,7.5,17446,4126,13320,2.5,10.6,22917,6674,16243,4,13.9,-5471,-3.3,21.2,0,304,304,1504
1999,34,l) Left Censored,29529,51103,1815798,1815948,2403,4.6,3935,7.6,221984,73279,148705,4,12.2,222285,66101,156184,3.6,12.2,-301,0,24.4,0,1410,1410,11497
1999,35,a) 0,3037,3048,17710,8930,3013,197.7,0,0,17560,17560,0,196.6,196.6,0,0,0,0,0,17560,196.6,0,0,,,
1999,35,b) 1,2466,2521,20642,21397,47,1.6,759,26.1,4638,766,3872,3.6,21.7,6147,3167,2980,14.8,28.7,-1509,-7,43.4,0,585,585,2272
1999,35,c) 2,2101,2125,15690,16241,81,3.5,472,20.3,3055,323,2732,2,18.8,4156,2348,1808,14.5,25.6,-1101,-6.8,37.6,0,345,345,1806
1999,35,d) 3,1804,1841,14353,14884,66,3.3,357,18,2320,350,1970,2.4,15.6,3382,1605,1777,10.8,22.7,-1062,-7.1,31.2,0,281,281,1351
1999,35,e) 4,1686,1735,14208,15188,52,2.8,289,15.6,2129,299,1830,2,14,4088,1599,2489,10.5,26.9,-1959,-12.9,28,0,225,225,1244
1999,35,f) 5,1546,1632,13354,13758,68,4,218,12.8,2119,481,1638,3.5,15.4,2927,998,1929,7.3,21.3,-808,-5.9,30.8,0,163,163,697
1999,35,g) 6 to 10,5400,5783,52830,55144,201,3.3,730,12.1,7595,1336,6259,2.4,13.8,12223,4773,7450,8.7,22.2,-4628,-8.4,27.6,0,511,511,3475
1999,35,h) 11 to 15,3999,4516,68354,69005,178,3.8,474,10.2,7698,1372,6326,2,11.2,8999,3336,5663,4.8,13,-1301,-1.8,22.4,0,287,287,1615
1999,35,i) 16 to 20,3056,3633,49383,49795,119,3.2,296,8,6492,1615,4877,3.2,13,7316,2246,5070,4.5,14.7,-824,-1.7,26,0,171,171,1248
1999,35,j) 21 to 25,1165,1739,28711,27844,63,3.6,99,5.6,4825,1845,2980,6.6,17.3,3090,658,2432,2.4,11.1,1735,6.2,22.2,0,41,41,183
1999,35,l) Left Censored,4570,9170,239888,239928,734,8.1,596,6.5,31369,12239,19130,5.1,13.1,31449,8982,22467,3.7,13.1,-80,0,26.2,0,185,185,1144
1999,36,a) 0,34509,34627,207002,103867,34376,198.6,0,0,206271,206271,0,198.6,198.6,0,0,0,0,0,206271,198.6,0,0,,,
1999,36,b) 1,29249,29742,228721,228603,376,1.1,7067,21.2,59486,8598,50888,3.8,26,59249,31929,27320,14,25.9,237,0.1,51.8,0,5488,5488,25799
1999,36,c) 2,24845,25194,185840,191075,676,2.5,4947,18.1,38068,4711,33357,2.5,19.9,48538,27449,21089,14.4,25.4,-10470,-5.5,39.8,0,3972,3972,22597
1999,36,d) 3,20837,21069,161385,165835,576,2.5,3630,16,29306,3842,25464,2.3,17.7,38205,19996,18209,12.1,23,-8899,-5.3,35.4,0,2912,2912,15330
1999,36,e) 4,18296,19375,157790,159620,809,4,2924,14.3,29344,4430,24914,2.8,18.4,33003,15932,17071,10,20.7,-3659,-2.3,36.8,0,2250,2250,12700
1999,36,f) 5,15488,15788,144241,147401,468,2.8,2128,12.8,26308,3031,23277,2.1,17.8,32627,13397,19230,9.1,22.1,-6319,-4.3,35.6,0,1716,1716,10105
1999,36,g) 6 to 10,61691,63901,615208,621996,1641,2.5,6696,10.1,89846,13590,76256,2.2,14.4,103423,45403,58020,7.3,16.6,-13577,-2.2,28.8,0,5146,5146,32096
1999,36,h) 11 to 15,49721,53782,712348,721321,1440,2.6,4538,8.2,77369,12939,64430,1.8,10.7,95315,33001,62314,4.6,13.2,-17946,-2.5,21.4,0,3118,3118,18905
1999,36,i) 16 to 20,31363,35686,554633,553088,938,2.6,2608,7.1,71230,17517,53713,3.2,12.9,68140,24838,43302,4.5,12.3,3090,0.6,24.6,0,1744,1744,11748
1999,36,j) 21 to 25,11337,15887,326429,334014,553,3.4,1173,7.2,36020,9470,26550,2.8,10.8,51190,16559,34631,5,15.3,-15170,-4.5,21.6,0,558,558,3489
1999,36,l) Left Censored,63818,109891,3777474,3787074,5383,4.8,7611,6.9,419939,115955,303984,3.1,11.1,439140,128168,310972,3.4,11.6,-19201,-0.5,22.2,0,3210,3210,26934
1999,37,a) 0,15284,15397,96857,48557,15296,198.7,0,0,96601,96601,0,198.9,198.9,0,0,0,0,0,96601,198.9,0,0,,,
1999,37,b) 1,12062,12381,104280,104119,223,1.6,3165,22.7,31777,8600,23177,8.3,30.5,31454,15656,15798,15,30.2,323,0.3,60.4,0,2496,2496,13197
1999,37,c) 2,10152,10320,79007,85718,285,2.5,2102,18.7,16938,1776,15162,2.1,19.8,30360,21371,8989,24.9,35.4,-13422,-15.6,39.6,0,1633,1633,19018
1999,37,d) 3,8536,8848,75320,75589,310,3.3,1409,15,15213,1727,13486,2.3,20.1,15750,8166,7584,10.8,20.8,-537,-0.7,40.2,0,1117,1117,5952
1999,37,e) 4,7496,7731,62543,63355,233,2.8,1121,13.7,11262,1243,10019,2,17.8,12885,6631,6254,10.5,20.3,-1623,-2.5,35.6,0,870,870,5446
1999,37,f) 5,6287,6548,61588,62257,203,2.9,885,12.8,10642,1719,8923,2.8,17.1,11980,5241,6739,8.4,19.2,-1338,-2.1,34.2,0,688,688,3593
1999,37,g) 6 to 10,23648,25306,294451,293389,723,2.8,2645,10.1,53796,16589,37207,5.7,18.3,51672,19730,31942,6.7,17.6,2124,0.7,35.2,0,1896,1896,12612
1999,37,h) 11 to 15,20494,23530,340952,339837,802,3.3,1794,7.5,45779,12834,32945,3.8,13.5,43548,15116,28432,4.4,12.8,2231,0.7,25.6,0,1164,1164,9508
1999,37,i) 16 to 20,11559,14015,234476,233533,397,2.8,963,6.7,29654,7109,22545,3,12.7,27768,9485,18283,4.1,11.9,1886,0.8,23.8,0,583,583,3584
1999,37,j) 21 to 25,4513,6991,141195,140200,357,5.1,488,6.9,20328,7702,12626,5.5,14.5,18338,5801,12537,4.1,13.1,1990,1.4,26.2,0,242,242,1661
1999,37,l) Left Censored,21364,48313,1790508,1791593,2921,6,3493,7.2,221648,58393,163255,3.3,12.4,223820,71879,151941,4,12.5,-2172,-0.1,24.8,0,833,833,7176
1999,38,a) 0,1046,1050,8203,4109,1040,198.1,0,0,8189,8189,0,199.3,199.3,0,0,0,0,0,8189,199.3,0,0,,,
1999,38,b) 1,975,996,7998,8073,20,1.8,215,19.6,1770,434,1336,5.4,21.9,1919,854,1065,10.6,23.8,-149,-1.9,43.8,0,165,165,731
1999,38,c) 2,838,845,5524,6131,18,2,150,16.4,755,89,666,1.5,12.3,1968,1111,857,18.1,32.1,-1213,-19.8,24.6,0,101,101,536
1999,38,d) 3,745,758,5165,5292,21,2.6,120,14.8,930,49,881,0.9,17.6,1184,538,646,10.2,22.4,-254,-4.8,35.2,0,101,101,465
1999,38,e) 4,618,621,4652,4815,17,2.6,102,15.4,745,238,507,4.9,15.5,1071,594,477,12.3,22.2,-326,-6.7,31,0,79,79,542
1999,38,f) 5,646,652,5189,5294,14,2,92,13.3,691,82,609,1.5,13.1,901,362,539,6.8,17,-210,-3.9,26.2,0,63,63,270
1999,38,g) 6 to 10,2502,2628,22040,22920,78,2.9,227,8.4,3238,672,2566,2.9,14.1,4998,1432,3566,6.2,21.8,-1760,-7.7,28.2,0,163,163,862
1999,38,h) 11 to 15,2140,2358,24298,25021,59,2.4,176,7.3,2501,535,1966,2.1,10,3946,1541,2405,6.2,15.8,-1445,-5.8,20,0,128,128,564
1999,38,i) 16 to 20,1652,1895,21875,22267,45,2.3,124,6.4,2091,466,1625,2.1,9.4,2875,807,2068,3.6,12.9,-784,-3.5,18.8,0,73,73,385
1999,38,j) 21 to 25,658,863,13205,13324,19,2.2,57,6.5,1221,190,1031,1.4,9.2,1459,290,1169,2.2,11,-238,-1.8,18.4,0,28,28,153
1999,38,l) Left Censored,3405,5421,128870,129156,199,3.6,263,4.8,10613,1823,8790,1.4,8.2,11184,3053,8131,2.4,8.7,-571,-0.5,16.4,0,107,107,558
1999,39,a) 0,15436,15565,113198,56734,15457,198.6,0,0,112928,112928,0,199,199,0,0,0,0,0,112928,199,0,0,,,
1999,39,b) 1,13119,13606,117028,117356,325,2.1,3184,21,31880,7335,24545,6.3,27.2,32536,15425,17111,13.1,27.7,-656,-0.5,54.4,0,2482,2482,12607
1999,39,c) 2,11329,11715,102905,105153,351,2.8,2103,16.7,20839,2637,18202,2.5,19.8,25334,14113,11221,13.4,24.1,-4495,-4.3,39.6,0,1613,1613,10688
1999,39,d) 3,9928,10186,88538,89896,279,2.6,1587,14.6,17566,1550,16016,1.7,19.5,20281,9081,11200,10.1,22.6,-2715,-3.1,39,0,1225,1225,6386
1999,39,e) 4,9394,9663,82795,83695,252,2.5,1196,11.8,14856,2029,12827,2.4,17.8,16656,7587,9069,9.1,19.9,-1800,-2.1,35.6,0,926,926,5548
1999,39,f) 5,8145,8519,82000,82611,249,2.8,1064,11.9,14146,2357,11789,2.9,17.1,15369,7009,8360,8.5,18.6,-1223,-1.5,34.2,0,798,798,5376
1999,39,g) 6 to 10,32083,34601,380043,386053,901,2.5,3392,9.5,50994,8078,42916,2.1,13.2,63013,24802,38211,6.4,16.3,-12019,-3.1,26.4,0,2420,2420,16933
1999,39,h) 11 to 15,26204,30179,468938,468835,850,2.8,2230,7.2,57944,11078,46866,2.4,12.4,57738,18092,39646,3.9,12.3,206,0.1,24.6,0,1439,1439,9611
1999,39,i) 16 to 20,17421,20966,343114,345024,484,2.3,1408,6.6,40828,9899,30929,2.9,11.8,44648,14180,30468,4.1,12.9,-3820,-1.1,23.6,0,897,897,7298
1999,39,j) 21 to 25,7188,10972,226592,227700,354,3.2,746,6.7,26241,6106,20135,2.7,11.5,28457,10099,18358,4.4,12.5,-2216,-1,23,0,363,363,2762
1999,39,l) Left Censored,38603,78259,2806879,2822411,3791,4.8,4973,6.3,302520,81010,221510,2.9,10.7,333585,100899,232686,3.6,11.8,-31065,-1.1,21.4,0,1550,1550,11242
1999,40,a) 0,6070,6100,37078,18608,6057,198.6,0,0,36941,36941,0,198.5,198.5,0,0,0,0,0,36941,198.5,0,0,,,
1999,40,b) 1,4818,4955,37629,38787,83,1.5,1442,25.3,10456,1731,8725,4.5,27,12771,7005,5766,18.1,32.9,-2315,-5.9,54,0,1159,1159,5633
1999,40,c) 2,4147,4316,35694,36206,143,3,967,20.4,8403,1956,6447,5.4,23.2,9426,5257,4169,14.5,26,-1023,-2.8,46.4,0,749,749,3943
1999,40,d) 3,3430,3503,25885,27060,101,2.7,596,15.9,4758,643,4115,2.4,17.6,7108,3212,3896,11.9,26.3,-2350,-8.7,35.2,0,481,481,2666
1999,40,e) 4,2970,3043,26068,26572,110,3.4,508,15.6,5077,829,4248,3.1,19.1,6085,3033,3052,11.4,22.9,-1008,-3.8,38.2,0,383,383,2300
1999,40,f) 5,2758,2849,22057,22762,126,4.2,414,13.8,4247,962,3285,4.2,18.7,5656,3138,2518,13.8,24.8,-1409,-6.1,37.4,0,321,321,2577
1999,40,g) 6 to 10,10271,10864,110706,112435,319,2.8,1275,11.2,17067,2505,14562,2.2,15.2,20524,8337,12187,7.4,18.3,-3457,-3.1,30.4,0,934,934,5771
1999,40,h) 11 to 15,8254,9217,124832,125922,308,3.3,794,8.4,15595,2602,12993,2.1,12.4,17775,5787,11988,4.6,14.1,-2180,-1.7,24.8,0,534,534,3267
1999,40,i) 16 to 20,6538,7732,121577,121837,220,2.8,550,7,17591,5931,11660,4.9,14.4,18110,4235,13875,3.5,14.9,-519,-0.5,28.8,0,351,351,1901
1999,40,j) 21 to 25,2200,3087,53489,53982,81,2.5,290,9.1,7696,1329,6367,2.5,14.3,8681,3263,5418,6,16.1,-985,-1.8,28.6,0,102,102,935
1999,40,l) Left Censored,9968,19969,559880,565873,1185,5.9,1466,7.3,66478,20236,46242,3.6,11.7,78463,26928,51535,4.8,13.9,-11985,-2.2,23.4,0,417,417,3650
1999,41,a) 0,7533,7581,38068,19120,7524,198.5,0,0,37896,37896,0,198.2,198.2,0,0,0,0,0,37896,198.2,0,0,,,
1999,41,b) 1,6071,6229,41491,42719,128,1.8,1722,24.3,11222,3083,8139,7.2,26.3,13678,6589,7089,15.4,32,-2456,-5.7,52.6,0,1307,1307,5341
1999,41,c) 2,5099,5183,35120,36482,175,3.1,1072,19,6703,791,5912,2.2,18.4,9426,5316,4110,14.6,25.8,-2723,-7.4,36.8,0,839,839,4350
1999,41,d) 3,4552,4689,45282,45597,160,3.2,829,16.5,7454,1559,5895,3.4,16.3,8083,4173,3910,9.2,17.7,-629,-1.4,32.6,0,627,627,3340
1999,41,e) 4,4256,4345,31823,33157,152,3.3,655,14.2,5659,922,4737,2.8,17.1,8326,3315,5011,10,25.1,-2667,-8,34.2,0,497,497,2733
1999,41,f) 5,3690,3881,31185,32425,135,3.3,548,13.4,4919,983,3936,3,15.2,7398,3643,3755,11.2,22.8,-2479,-7.6,30.4,0,407,407,3006
1999,41,g) 6 to 10,12838,13556,131184,134225,415,2.9,1574,11.1,19067,2846,16221,2.1,14.2,25148,10922,14226,8.1,18.7,-6081,-4.5,28.4,0,1143,1143,6475
1999,41,h) 11 to 15,9312,10517,140725,142024,370,3.4,960,8.9,19367,3654,15713,2.6,13.6,21964,7741,14223,5.5,15.5,-2597,-1.9,27.2,0,629,629,3477
1999,41,i) 16 to 20,6564,7896,120428,122170,260,3.2,630,7.8,14733,3870,10863,3.2,12.1,18216,7126,11090,5.8,14.9,-3483,-2.8,24.2,0,356,356,2403
1999,41,j) 21 to 25,2529,3679,70952,70998,162,4.3,258,6.9,9516,3160,6356,4.5,13.4,9608,3334,6274,4.7,13.5,-92,-0.1,26.8,0,113,113,606
1999,41,l) Left Censored,10032,19782,623673,621710,1228,6.2,1383,7,78758,22727,56031,3.7,12.7,74832,26793,48039,4.3,12,3926,0.7,24,0,405,405,4008
1999,42,a) 0,17000,17130,114647,57571,17000,198.5,0,0,114153,114153,0,198.3,198.3,0,0,0,0,0,114153,198.3,0,0,,,
1999,42,b) 1,14271,14758,126771,125325,385,2.4,3211,19.7,36636,11588,25048,9.2,29.2,33743,15093,18650,12,26.9,2893,2.3,53.8,0,2432,2432,12194
1999,42,c) 2,12372,12734,102650,103403,316,2.3,2184,16,22006,2758,19248,2.7,21.3,23511,12470,11041,12.1,22.7,-1505,-1.4,42.6,0,1672,1672,9784
1999,42,d) 3,10572,10892,95431,97581,293,2.5,1670,14.4,16345,1928,14417,2,16.8,20644,10874,9770,11.1,21.2,-4299,-4.4,33.6,0,1268,1268,7849
1999,42,e) 4,9920,10267,86559,87567,289,2.7,1299,12,15233,2459,12774,2.8,17.4,17249,7223,10026,8.2,19.7,-2016,-2.3,34.8,0,992,992,5621
1999,42,f) 5,8249,8532,78052,78829,217,2.4,979,11,12901,1953,10948,2.5,16.4,14455,6989,7466,8.9,18.3,-1554,-1.9,32.8,0,790,790,5830
1999,42,g) 6 to 10,36441,38578,386757,393150,999,2.5,3678,9.2,52097,8171,43926,2.1,13.3,64882,27417,37465,7,16.5,-12785,-3.2,26.6,0,2735,2735,18719
1999,42,h) 11 to 15,31834,35991,485266,488492,1166,3.2,2769,7.5,56297,12707,43590,2.6,11.5,62748,21723,41025,4.4,12.8,-6451,-1.3,23,0,1847,1847,12024
1999,42,i) 16 to 20,19501,22667,361260,361685,534,2.3,1588,6.8,43487,8154,35333,2.3,12,44338,15591,28747,4.3,12.3,-851,-0.3,24,0,1022,1022,7311
1999,42,j) 21 to 25,7771,11319,228149,235178,328,2.8,752,6.5,25445,4805,20640,2,10.8,39502,9342,30160,4,16.8,-14057,-6,21.6,0,393,393,3227
1999,42,l) Left Censored,42348,82062,2844141,2855457,3512,4.2,5771,6.9,293906,73535,220371,2.6,10.3,316540,90316,226224,3.2,11.1,-22634,-0.8,20.6,0,1978,1978,14779
1999,44,a) 0,1790,1798,8525,4272,1786,198.7,0,0,8507,8507,0,199.1,199.1,0,0,0,0,0,8507,199.1,0,0,,,
1999,44,b) 1,1566,1605,11299,11554,25,1.4,399,22.1,3099,735,2364,6.4,26.8,3608,1244,2364,10.8,31.2,-509,-4.4,53.6,0,311,311,1039
1999,44,c) 2,1320,1341,10856,10781,39,2.7,245,16.9,2144,180,1964,1.7,19.9,1994,924,1070,8.6,18.5,150,1.4,37,0,192,192,776
1999,44,d) 3,1121,1130,8600,8684,19,1.5,220,17.9,1639,108,1531,1.2,18.9,1807,969,838,11.2,20.8,-168,-1.9,37.8,0,176,176,699
1999,44,e) 4,997,1006,7641,7822,28,2.6,133,12.5,1305,219,1086,2.8,16.7,1666,831,835,10.6,21.3,-361,-4.6,33.4,0,93,93,472
1999,44,f) 5,918,930,12103,11874,30,3.1,126,12.9,1604,193,1411,1.6,13.5,1145,458,687,3.9,9.6,459,3.9,19.2,0,103,103,378
1999,44,g) 6 to 10,3710,3834,37578,37332,86,2.2,363,9.1,5989,850,5139,2.3,16,5497,2336,3161,6.3,14.7,492,1.3,29.4,0,265,265,1105
1999,44,h) 11 to 15,3202,3420,39350,39895,104,3,283,8.1,4151,699,3452,1.8,10.4,5240,1884,3356,4.7,13.1,-1089,-2.7,20.8,0,204,204,1458
1999,44,i) 16 to 20,1903,2080,30238,30234,51,2.4,163,7.6,4388,804,3584,2.7,14.5,4379,1400,2979,4.6,14.5,9,0,29,0,115,115,628
1999,44,j) 21 to 25,806,1003,18366,18181,34,3.3,64,6.3,1980,548,1432,3,10.9,1609,318,1291,1.7,8.8,371,2.1,17.6,0,44,44,124
1999,44,l) Left Censored,4735,6836,218147,220531,319,4.6,427,6.2,21147,5187,15960,2.4,9.6,25916,7816,18100,3.5,11.8,-4769,-2.2,19.2,0,221,221,1827
1999,45,a) 0,7511,7564,47452,23788,7517,198.8,0,0,47328,47328,0,199,199,0,0,0,0,0,47328,199,0,0,,,
1999,45,b) 1,5880,5977,56038,54137,92,1.4,1634,24,18460,3771,14689,7,34.1,14657,6973,7684,12.9,27.1,3803,7,54.2,0,1312,1312,5626
1999,45,c) 2,4753,4833,44157,43756,152,2.9,991,18.9,11924,4270,7654,9.8,27.3,11122,6248,4874,14.3,25.4,802,1.9,50.8,0,778,778,5139
1999,45,d) 3,4083,4170,42370,42852,139,3.1,680,15.3,6953,644,6309,1.5,16.2,7917,3887,4030,9.1,18.5,-964,-2.3,32.4,0,535,535,2975
1999,45,e) 4,3575,3659,35373,35829,120,3.1,607,15.5,7320,864,6456,2.4,20.4,8231,4872,3359,13.6,23,-911,-2.6,40.8,0,461,461,3481
1999,45,f) 5,3069,3213,35549,34879,107,3.2,431,12.8,6925,983,5942,2.8,19.9,5585,2307,3278,6.6,16,1340,3.9,32,0,313,313,1533
1999,45,g) 6 to 10,11418,12409,134568,135344,394,3.1,1340,10.4,19986,3074,16912,2.3,14.8,21538,9375,12163,6.9,15.9,-1552,-1.1,29.6,0,948,948,5812
1999,45,h) 11 to 15,9694,11294,167633,168940,401,3.5,879,7.6,21415,5106,16309,3,12.7,24029,7989,16040,4.7,14.2,-2614,-1.5,25.4,0,549,549,3647
1999,45,i) 16 to 20,5524,6647,103528,102124,234,3.5,470,7,14642,4157,10485,4.1,14.3,11834,3561,8273,3.5,11.6,2808,2.7,23.2,0,274,274,1718
1999,45,j) 21 to 25,2165,3488,52975,54334,218,6.2,284,8.1,7125,2114,5011,3.9,13.1,9843,3722,6121,6.9,18.1,-2718,-5,26.2,0,102,102,769
1999,45,l) Left Censored,10481,22632,819921,823642,1383,6.1,1569,6.9,86439,22736,63703,2.8,10.5,93881,21905,71976,2.7,11.4,-7442,-0.9,21,0,429,429,3417
1999,46,a) 0,1585,1591,8508,4271,1572,197.6,0,0,8474,8474,0,198.4,198.4,0,0,0,0,0,8474,198.4,0,0,,,
1999,46,b) 1,1309,1332,9086,8989,23,1.5,351,23.3,2331,417,1914,4.6,25.9,2136,1182,954,13.1,23.8,195,2.1,47.6,0,280,280,1001
1999,46,c) 2,1076,1086,7459,7659,25,2.1,208,17.5,1396,253,1143,3.3,18.2,1796,974,822,12.7,23.4,-400,-5.2,36.4,0,157,157,699
1999,46,d) 3,955,978,6657,6630,32,3.1,154,14.8,1362,231,1131,3.5,20.5,1307,578,729,8.7,19.7,55,0.8,39.4,0,100,100,438
1999,46,e) 4,847,870,6333,6417,15,1.6,105,11.5,799,126,673,2,12.5,966,367,599,5.7,15.1,-167,-2.6,25,0,81,81,302
1999,46,f) 5,818,832,6942,7035,20,2.3,104,11.9,910,69,841,1,12.9,1095,395,700,5.6,15.6,-185,-2.7,25.8,0,86,86,310
1999,46,g) 6 to 10,2954,3103,26856,27213,113,3.5,339,10.5,3452,778,2674,2.9,12.7,4166,1495,2671,5.5,15.3,-714,-2.6,25.4,0,240,240,985
1999,46,h) 11 to 15,2365,2580,37851,38304,66,2.5,191,7.2,3152,344,2808,0.9,8.2,4058,1428,2630,3.7,10.6,-906,-2.4,16.4,0,138,138,923
1999,46,i) 16 to 20,1567,1823,22796,23164,51,2.7,156,8.3,2788,937,1851,4,12,3523,1668,1855,7.2,15.2,-735,-3.2,24,0,100,100,880
1999,46,j) 21 to 25,697,923,14234,13827,62,6.7,66,7.1,2112,956,1156,6.9,15.3,1297,300,997,2.2,9.4,815,5.9,18.8,0,39,39,200
1999,46,l) Left Censored,3553,5726,144780,145197,229,4,336,5.8,14137,4142,9995,2.9,9.7,14970,4628,10342,3.2,10.3,-833,-0.6,19.4,0,141,141,627
1999,47,a) 0,8988,9108,66438,33348,9032,198.3,0,0,66181,66181,0,198.5,198.5,0,0,0,0,0,66181,198.5,0,0,,,
1999,47,b) 1,7234,7489,69187,67943,191,2.2,2164,25.3,22474,6416,16058,9.4,33.1,19985,10852,9133,16,29.4,2489,3.7,58.8,0,1773,1773,8745
1999,47,c) 2,5775,5941,51677,54462,159,2.4,1485,22.4,11513,1249,10264,2.3,21.1,17083,11084,5999,20.4,31.4,-5570,-10.3,42.2,0,1167,1167,8130
1999,47,d) 3,5329,5450,53351,54473,158,2.7,1018,17.3,8913,1253,7660,2.3,16.4,11156,5617,5539,10.3,20.5,-2243,-4.1,32.8,0,818,818,4377
1999,47,e) 4,4605,4742,44454,46010,181,3.6,788,15.6,8236,1182,7054,2.6,17.9,11348,6183,5165,13.4,24.7,-3112,-6.8,35.8,0,611,611,4761
1999,47,f) 5,4099,4234,40599,40717,138,3.1,585,13.1,7613,1967,5646,4.8,18.7,7848,3433,4415,8.4,19.3,-235,-0.6,37.4,0,435,435,2093
1999,47,g) 6 to 10,15535,16781,193007,197317,485,2.8,2022,11.5,27896,4937,22959,2.5,14.1,36516,16335,20181,8.3,18.5,-8620,-4.4,28.2,0,1413,1413,9946
1999,47,h) 11 to 15,13164,15210,228440,229523,506,3.2,1312,8.4,31427,7163,24264,3.1,13.7,33592,13862,19730,6,14.6,-2165,-0.9,27.4,0,807,807,4312
1999,47,i) 16 to 20,7860,9614,166827,165810,408,4.2,734,7.5,25840,9162,16678,5.5,15.6,23805,7659,16146,4.6,14.4,2035,1.2,28.8,0,429,429,2983
1999,47,j) 21 to 25,3397,5857,143298,142977,232,3.9,410,6.9,17124,5754,11370,4,12,16482,4497,11985,3.1,11.5,642,0.5,23,0,177,177,989
1999,47,l) Left Censored,15296,33855,1250375,1262250,2004,5.9,2357,6.9,141886,38881,103005,3.1,11.2,165635,51243,114392,4.1,13.1,-23749,-1.9,22.4,0,628,628,4915
1999,48,a) 0,34785,35151,253039,127182,34867,198.4,0,0,251715,251715,0,197.9,197.9,0,0,0,0,0,251715,197.9,0,0,,,
1999,48,b) 1,27511,28209,275649,274842,526,1.6,8388,25.9,84913,21860,63053,8,30.9,83298,46852,36446,17,30.3,1615,0.6,60.6,0,6806,6806,38909
1999,48,c) 2,23121,23797,229102,235706,672,2.6,5261,20.1,55917,6544,49373,2.8,23.7,69124,39210,29914,16.6,29.3,-13207,-5.6,47.4,0,4224,4224,30410
1999,48,d) 3,20084,20904,204168,213788,738,3.3,3894,17.3,39554,5176,34378,2.4,18.5,58793,32479,26314,15.2,27.5,-19239,-9,37,0,3074,3074,26116
1999,48,e) 4,17526,18292,182524,188112,692,3.6,3051,15.7,36827,5508,31319,2.9,19.6,48003,24586,23417,13.1,25.5,-11176,-5.9,39.2,0,2379,2379,20143
1999,48,f) 5,15495,16482,183753,189599,722,4.2,2459,14.2,34680,7405,27275,3.9,18.3,46371,23207,23164,12.2,24.5,-11691,-6.2,36.6,0,1897,1897,15034
1999,48,g) 6 to 10,57483,62777,774058,790939,2070,3.2,7456,11.4,129467,23337,106130,3,16.4,163229,69361,93868,8.8,20.6,-33762,-4.2,32.8,0,5275,5275,40228
1999,48,h) 11 to 15,41648,49462,786737,793948,1946,3.8,4355,8.6,115706,34924,80782,4.4,14.6,130128,45000,85128,5.7,16.4,-14422,-1.8,29.2,0,2704,2704,20477
1999,48,i) 16 to 20,31664,38609,637200,640056,1245,3.1,3061,7.7,94849,20953,73896,3.3,14.8,100562,32909,67653,5.1,15.7,-5713,-0.9,29.6,0,1740,1740,14279
1999,48,j) 21 to 25,9967,16267,337153,332283,728,4.4,1298,7.8,60171,17776,42395,5.3,18.1,50431,18072,32359,5.4,15.2,9740,2.9,30.4,0,506,506,3290
1999,48,l) Left Censored,39104,105131,3755098,3748515,7872,7.5,7958,7.6,536519,165535,370984,4.4,14.3,523354,176622,346732,4.7,14,13165,0.3,28,0,1868,1868,15076
1999,49,a) 0,4997,5017,32301,16217,4982,198.6,0,0,32168,32168,0,198.4,198.4,0,0,0,0,0,32168,198.4,0,0,,,
1999,49,b) 1,3735,3795,44442,44936,53,1.2,1145,26.2,9627,1140,8487,2.5,21.4,10615,6184,4431,13.8,23.6,-988,-2.2,42.8,0,888,888,4676
1999,49,c) 2,3058,3119,25415,27127,96,2.8,713,20.8,5886,684,5202,2.5,21.7,9309,6416,2893,23.7,34.3,-3423,-12.6,43.4,0,545,545,5642
1999,49,d) 3,2683,2767,37401,38780,100,3.4,497,16.7,6796,636,6160,1.6,17.5,9553,3312,6241,8.5,24.6,-2757,-7.1,35,0,392,392,2591
1999,49,e) 4,2139,2197,24928,25552,77,3.3,388,16.5,4624,520,4104,2,18.1,5872,2930,2942,11.5,23,-1248,-4.9,36.2,0,297,297,2244
1999,49,f) 5,1877,1940,21599,21965,64,3.1,305,14.8,4246,1018,3228,4.6,19.3,4977,2398,2579,10.9,22.7,-731,-3.4,38.6,0,212,212,1528
1999,49,g) 6 to 10,6114,6562,90987,91900,224,3.3,744,10.9,14793,2366,12427,2.6,16.1,16618,6587,10031,7.2,18.1,-1825,-2,32.2,0,534,534,4551
1999,49,h) 11 to 15,3869,4455,81175,83825,196,4.3,429,9.4,11111,3535,7576,4.2,13.3,16410,6099,10311,7.3,19.6,-5299,-6.3,26.6,0,243,243,2872
1999,49,i) 16 to 20,2907,3466,63322,63373,135,3.8,309,8.7,10484,3417,7067,5.4,16.5,10585,3609,6976,5.7,16.7,-101,-0.2,33,0,163,163,1898
1999,49,j) 21 to 25,1206,1745,35423,35014,71,4,116,6.6,4797,1920,2877,5.5,13.7,3979,1394,2585,4,11.4,818,2.3,22.8,0,57,57,448
1999,49,l) Left Censored,4974,10848,417555,414374,1082,10.2,661,6.2,50523,17441,33082,4.2,12.2,44161,14036,30125,3.4,10.7,6362,1.5,21.4,0,194,194,1640
1999,50,a) 0,1328,1335,6679,3356,1326,198.7,0,0,6647,6647,0,198.1,198.1,0,0,0,0,0,6647,198.1,0,0,,,
1999,50,b) 1,1178,1220,8051,7714,35,2.6,247,18.5,2227,562,1665,7.3,28.9,1552,820,732,10.6,20.1,675,8.8,40.2,0,198,198,736
1999,50,c) 2,1012,1025,5028,5203,26,2.3,190,17.1,1002,160,842,3.1,19.3,1351,713,638,13.7,26,-349,-6.7,38.6,0,146,146,582
1999,50,d) 3,872,880,5696,5956,21,2.3,123,13.2,861,79,782,1.3,14.5,1380,698,682,11.7,23.2,-519,-8.7,29,0,98,98,624
1999,50,e) 4,779,784,5767,5875,13,1.6,99,11.9,670,36,634,0.6,11.4,887,385,502,6.6,15.1,-217,-3.7,22.8,0,75,75,303
1999,50,f) 5,753,777,5020,5114,22,2.7,90,11.1,750,90,660,1.8,14.7,938,558,380,10.9,18.3,-188,-3.6,29.4,0,69,69,488
1999,50,g) 6 to 10,3085,3207,24929,25472,73,2.2,294,8.9,3245,258,2987,1,12.7,4330,1901,2429,7.5,17,-1085,-4.3,25.4,0,226,226,1442
1999,50,h) 11 to 15,2607,2819,32671,32485,100,3.5,235,8.1,4079,699,3380,2.2,12.6,3706,1170,2536,3.6,11.4,373,1.2,22.8,0,164,164,815
1999,50,i) 16 to 20,1490,1661,20429,20226,50,3,111,6.6,2646,875,1771,4.3,13.1,2239,598,1641,3,11.1,407,2,22.2,0,71,71,378
1999,50,j) 21 to 25,564,750,13469,13410,21,2.8,44,5.8,1405,95,1310,0.7,10.5,1286,539,747,4,9.6,119,0.9,19.2,0,24,24,409
1999,50,l) Left Censored,2743,4290,116155,115663,217,5.1,205,4.8,10618,2900,7718,2.5,9.2,9633,2305,7328,2,8.3,985,0.9,16.6,0,83,83,909
1999,51,a) 0,11750,11833,70268,35249,11754,198.7,0,0,70038,70038,0,198.7,198.7,0,0,0,0,0,70038,198.7,0,0,,,
1999,51,b) 1,9710,9948,77821,78203,191,1.7,2674,23.7,22475,4628,17847,5.9,28.7,23238,12313,10925,15.7,29.7,-763,-1,57.4,0,2061,2061,9603
1999,51,c) 2,8166,8317,62438,64064,245,2.7,1619,17.9,14270,1995,12275,3.1,22.3,17522,9798,7724,15.3,27.4,-3252,-5.1,44.6,0,1250,1250,7863
1999,51,d) 3,7016,7187,58597,59417,259,3.4,1240,16.1,13351,2999,10352,5,22.5,14991,7335,7656,12.3,25.2,-1640,-2.7,45,0,956,956,5548
1999,51,e) 4,6490,6714,55788,56905,195,2.7,998,14,9876,1140,8736,2,17.4,12110,6098,6012,10.7,21.3,-2234,-3.9,34.8,0,714,714,4483
1999,51,f) 5,5567,5742,60469,59132,174,2.9,742,12.3,12633,2043,10590,3.5,21.4,9958,4467,5491,7.6,16.8,2675,4.6,33.6,0,556,556,3311
1999,51,g) 6 to 10,21763,23110,253312,251590,706,2.9,2427,10.1,41442,6985,34457,2.8,16.5,37998,14174,23824,5.6,15.1,3444,1.4,30.2,0,1756,1756,9986
1999,51,h) 11 to 15,17568,20242,304905,306443,658,3.2,1557,7.5,39577,7388,32189,2.4,12.9,42652,14279,28373,4.7,13.9,-3075,-1,25.8,0,1003,1003,6228
1999,51,i) 16 to 20,10145,12293,227507,227321,419,3.3,867,6.9,28125,8610,19515,3.8,12.4,27752,7756,19996,3.4,12.2,373,0.2,24.4,0,478,478,3009
1999,51,j) 21 to 25,3859,6124,119900,117624,261,4.2,448,7.2,19101,5012,14089,4.3,16.2,14548,4892,9656,4.2,12.4,4553,3.8,24.8,0,169,169,1059
1999,51,l) Left Censored,18318,42879,1447803,1442674,2699,6.2,3359,7.8,178347,55384,122963,3.8,12.4,168089,53716,114373,3.7,11.7,10258,0.7,23.4,0,688,688,4863
1999,53,a) 0,13032,13123,78123,39178,13019,198.4,0,0,77890,77890,0,198.8,198.8,0,0,0,0,0,77890,198.8,0,0,,,
1999,53,b) 1,10130,10451,75062,74540,168,1.4,3177,26.3,23447,4604,18843,6.2,31.5,22402,11910,10492,16,30.1,1045,1.4,60.2,0,2348,2348,9119
1999,53,c) 2,8396,8541,61447,62966,302,3.2,1862,19.9,14040,1614,12426,2.6,22.3,17077,8694,8383,13.8,27.1,-3037,-4.8,44.6,0,1413,1413,7253
1999,53,d) 3,7338,7506,55501,57489,301,3.7,1434,17.7,10179,1350,8829,2.3,17.7,14155,7078,7077,12.3,24.6,-3976,-6.9,35.4,0,1103,1103,5439
1999,53,e) 4,6486,6673,61608,58965,247,3.5,1066,15.1,17153,7185,9968,12.2,29.1,11866,5443,6423,9.2,20.1,5287,9,40.2,0,789,789,3801
1999,53,f) 5,5723,5936,47813,50901,243,3.9,910,14.5,8878,1566,7312,3.1,17.4,15054,8445,6609,16.6,29.6,-6176,-12.2,34.8,0,667,667,6631
1999,53,g) 6 to 10,21354,22642,222074,224899,811,3.4,2724,11.5,35310,6036,29274,2.7,15.7,40959,15785,25174,7,18.2,-5649,-2.5,31.4,0,1908,1908,11023
1999,53,h) 11 to 15,15158,17298,239061,242991,703,4,1585,8.9,28922,4854,24068,2,11.9,36781,11598,25183,4.8,15.1,-7859,-3.2,23.8,0,996,996,6211
1999,53,i) 16 to 20,10108,12097,195049,196523,378,3,1048,8.4,24703,6044,18659,3.1,12.6,27651,9697,17954,4.9,14.1,-2948,-1.5,25.2,0,599,599,4199
1999,53,j) 21 to 25,3955,5901,108971,108547,244,4.1,452,7.5,15824,2928,12896,2.7,14.6,14975,5086,9889,4.7,13.8,849,0.8,27.6,0,200,200,1220
1999,53,l) Left Censored,14974,31036,997984,993338,1898,6.1,2249,7.2,122640,38111,84529,3.8,12.3,113348,35422,77926,3.6,11.4,9292,0.9,22.8,0,643,643,6130
1999,54,a) 0,2500,2518,13975,7026,2504,198.9,0,0,13899,13899,0,197.8,197.8,0,0,0,0,0,13899,197.8,0,0,,,
1999,54,b) 1,2029,2102,14605,15312,53,2.2,599,25.1,3912,751,3161,4.9,25.5,5325,2755,2570,18,34.8,-1413,-9.3,51,0,463,463,1726
1999,54,c) 2,1763,1777,11056,11747,43,2.2,372,19.1,2181,141,2040,1.2,18.6,3563,1728,1835,14.7,30.3,-1382,-11.7,37.2,0,303,303,1448
1999,54,d) 3,1539,1575,10921,11379,57,3.4,251,15,1710,264,1446,2.3,15,2626,1072,1554,9.4,23.1,-916,-8.1,30,0,192,192,891
1999,54,e) 4,1458,1488,10341,11100,40,2.5,232,14.7,1609,157,1452,1.4,14.5,3127,1474,1653,13.3,28.2,-1518,-13.7,29,0,197,197,1284
1999,54,f) 5,1232,1260,9720,9667,42,3.2,177,13.3,2037,605,1432,6.3,21.1,1930,850,1080,8.8,20,107,1.1,40,0,133,133,576
1999,54,g) 6 to 10,5098,5353,47475,48520,164,2.9,608,10.9,6137,794,5343,1.6,12.6,8226,3209,5017,6.6,17,-2089,-4.4,25.2,0,458,458,2435
1999,54,h) 11 to 15,4273,4707,59040,59976,126,2.6,344,7.1,6073,1601,4472,2.7,10.1,7945,2105,5840,3.5,13.2,-1872,-3.1,20.2,0,229,229,1296
1999,54,i) 16 to 20,2853,3280,40063,40577,80,2.4,224,6.7,3696,632,3064,1.6,9.1,4723,1351,3372,3.3,11.6,-1027,-2.5,18.2,0,148,148,810
1999,54,j) 21 to 25,1194,1891,33656,33384,82,4.3,132,6.9,4934,2284,2650,6.8,14.8,4390,1166,3224,3.5,13.2,544,1.6,26.4,0,51,51,236
1999,54,l) Left Censored,6374,11563,285766,289233,541,4.6,800,6.8,26606,7018,19588,2.4,9.2,33539,11212,22327,3.9,11.6,-6933,-2.4,18.4,0,240,240,1489
1999,55,a) 0,8312,8412,53282,26711,8360,198.8,0,0,53142,53142,0,199,199,0,0,0,0,0,53142,199,0,0,,,
1999,55,b) 1,7126,7329,64264,63441,157,1.9,1569,19.4,18707,5865,12842,9.2,29.5,17060,8169,8891,12.9,26.9,1647,2.6,53.8,0,1203,1203,5676
1999,55,c) 2,6151,6284,45740,47406,168,2.5,1031,15.3,8549,913,7636,1.9,18,11880,7280,4600,15.4,25.1,-3331,-7.1,36,0,779,779,5861
1999,55,d) 3,5457,5525,45291,45583,161,2.7,837,14.3,8228,864,7364,1.9,18.1,8812,4325,4487,9.5,19.3,-584,-1.2,36.2,0,644,644,3541
1999,55,e) 4,4958,5108,41750,42173,150,2.8,603,11.3,6787,1120,5667,2.7,16.1,7632,3061,4571,7.3,18.1,-845,-2,32.2,0,453,453,2321
1999,55,f) 5,4468,4645,40818,40515,174,3.6,528,10.9,7651,1465,6186,3.6,18.9,7044,2924,4120,7.2,17.4,607,1.5,34.8,0,419,419,2238
1999,55,g) 6 to 10,17669,18792,188820,190010,446,2.3,1744,9,25420,4855,20565,2.6,13.4,27799,10454,17345,5.5,14.6,-2379,-1.2,26.8,0,1305,1305,7643
1999,55,h) 11 to 15,14129,15928,234623,236789,370,2.3,1270,7.8,26855,3987,22868,1.7,11.3,31187,11759,19428,5,13.2,-4332,-1.9,22.6,0,847,847,5475
1999,55,i) 16 to 20,8938,10487,170738,171721,217,2,716,6.7,17527,2993,14534,1.7,10.2,19493,5252,14241,3.1,11.4,-1966,-1.2,20.4,0,457,457,2777
1999,55,j) 21 to 25,3826,5931,104631,104954,303,5.1,399,6.7,12621,3752,8869,3.6,12,13266,5418,7848,5.2,12.6,-645,-0.6,24,0,200,200,970
1999,55,l) Left Censored,20159,36015,1343282,1343629,1479,4.1,2199,6,130576,25781,104795,1.9,9.7,131271,34998,96273,2.6,9.8,-695,-0.1,19.4,0,832,832,7214
1999,56,a) 0,1303,1310,6079,3052,1303,198.9,0,0,6055,6055,0,198.4,198.4,0,0,0,0,0,6055,198.4,0,0,,,
1999,56,b) 1,1089,1115,6637,6834,22,1.7,307,24.1,1782,314,1468,4.6,26.1,2175,996,1179,14.6,31.8,-393,-5.7,52.2,0,218,218,773
1999,56,c) 2,911,921,4917,5220,25,2.5,191,19,943,97,846,1.9,18.1,1548,899,649,17.2,29.7,-605,-11.6,36.2,0,150,150,652
1999,56,d) 3,830,864,5173,5240,36,3.9,157,16.9,1036,150,886,2.9,19.8,1170,622,548,11.9,22.3,-134,-2.5,39.6,0,123,123,506
1999,56,e) 4,702,712,4799,4835,20,2.6,135,17.5,1226,116,1110,2.4,25.4,1298,709,589,14.7,26.8,-72,-1.4,50.8,0,106,106,560
1999,56,f) 5,663,676,5110,5161,24,3.3,108,15,940,292,648,5.7,18.2,1041,368,673,7.1,20.2,-101,-2,36.4,0,87,87,282
1999,56,g) 6 to 10,2212,2298,19563,19904,73,3.1,251,10.5,2577,260,2317,1.3,12.9,3259,1291,1968,6.5,16.4,-682,-3.5,25.8,0,180,180,934
1999,56,h) 11 to 15,1593,1745,19398,19308,50,2.8,165,9.1,2963,833,2130,4.3,15.3,2783,929,1854,4.8,14.4,180,0.9,28.8,0,115,115,589
1999,56,i) 16 to 20,1424,1677,16781,16840,56,3.3,136,7.9,2190,341,1849,2,13,2307,645,1662,3.8,13.7,-117,-0.7,26,0,80,80,398
1999,56,j) 21 to 25,545,717,10874,10849,29,4,56,7.7,1592,365,1227,3.4,14.7,1541,565,976,5.2,14.2,51,0.5,28.4,0,21,21,80
1999,56,l) Left Censored,2101,3446,65881,65538,201,5.8,227,6.6,8512,2014,6498,3.1,13,7825,2863,4962,4.4,11.9,687,1.1,23.8,0,82,82,469
2000,01,a) 0,6479,6554,38496,19387,6499,198.3,0,0,38219,38219,0,197.1,197.1,0,0,0,0,0,38219,197.1,0,0,,,
2000,01,b) 1,5336,5429,48545,48753,73,1.2,1719,27.3,15636,1789,13847,3.7,32.1,16052,8209,7843,16.8,32.9,-416,-0.8,64.2,0,1359,1359,6580
2000,01,c) 2,4814,4994,49945,49779,196,3.6,1041,19.2,12072,2849,9223,5.7,24.3,11739,5566,6173,11.2,23.6,333,0.7,47.2,0,834,834,4622
2000,01,d) 3,4165,4271,36826,38225,139,3,777,16.9,6594,838,5756,2.2,17.3,9391,4926,4465,12.9,24.6,-2797,-7.3,34.6,0,589,589,3246
2000,01,e) 4,3724,3894,30768,31854,117,2.8,601,14.5,5082,540,4542,1.7,16,7254,3835,3419,12,22.8,-2172,-6.8,32,0,459,459,2901
2000,01,f) 5,3323,3455,32708,32812,107,2.9,514,14.1,5777,887,4890,2.7,17.6,5985,2528,3457,7.7,18.2,-208,-0.6,35.2,0,389,389,1804
2000,01,g) 6 to 10,12226,12959,153021,153578,334,2.5,1540,11.4,25124,3630,21494,2.4,16.4,26238,10949,15289,7.1,17.1,-1114,-0.7,32.8,0,1105,1105,7808
2000,01,h) 11 to 15,9149,10579,169557,170869,374,3.4,926,8.5,19791,4431,15360,2.6,11.6,22415,7455,14960,4.4,13.1,-2624,-1.5,23.2,0,582,582,3943
2000,01,i) 16 to 20,6793,7901,136806,137315,214,2.6,600,7.4,17359,3785,13574,2.8,12.6,18378,6715,11663,4.9,13.4,-1019,-0.8,25.2,0,358,358,2490
2000,01,j) 21 to 25,3576,5708,116880,114995,240,4.1,408,7.1,19186,5115,14071,4.4,16.7,15415,4770,10645,4.1,13.4,3771,3.3,26.8,0,171,171,1135
2000,01,l) Left Censored,11003,24340,828888,827113,1288,5.2,1778,7.2,94941,23713,71228,2.9,11.5,91391,30184,61207,3.6,11,3550,0.5,22,0,462,462,2996
2000,02,a) 0,1270,1280,6911,3480,1257,196.4,0,0,6862,6862,0,197.2,197.2,0,0,0,0,0,6862,197.2,0,0,,,
2000,02,b) 1,927,953,6678,6380,17,1.5,337,30.1,2308,292,2016,4.6,36.2,1711,1037,674,16.3,26.8,597,9.4,53.6,0,212,212,729
2000,02,c) 2,880,922,6951,7009,46,4.6,200,19.9,1998,492,1506,7,28.5,2114,1022,1092,14.6,30.2,-116,-1.7,57,0,142,142,852
2000,02,d) 3,750,759,5326,5284,36,4.4,137,16.9,1320,345,975,6.5,25,1236,458,778,8.7,23.4,84,1.6,46.8,0,102,102,330
2000,02,e) 4,658,670,4283,4384,21,2.9,112,15.7,836,86,750,2,19.1,1037,516,521,11.8,23.7,-201,-4.6,38.2,0,79,79,363
2000,02,f) 5,599,618,4339,4365,33,5.1,91,14.1,913,119,794,2.7,20.9,964,535,429,12.3,22.1,-51,-1.2,41.8,0,54,54,376
2000,02,g) 6 to 10,2257,2359,18314,18506,101,4.1,280,11.4,3429,1006,2423,5.4,18.5,3813,1478,2335,8,20.6,-384,-2.1,37,0,179,179,942
2000,02,h) 11 to 15,1650,1807,24590,24605,42,2.2,188,10,3117,407,2710,1.7,12.7,3147,1172,1975,4.8,12.8,-30,-0.1,25.4,0,108,108,736
2000,02,i) 16 to 20,1368,1634,20570,19977,44,2.6,134,8,3611,360,3251,1.8,18.1,2424,786,1638,3.9,12.1,1187,6,24.2,0,68,68,438
2000,02,j) 21 to 25,689,1032,16122,15808,36,3.4,63,6,2464,580,1884,3.7,15.6,1836,336,1500,2.1,11.6,628,4,23.2,0,28,28,110
2000,02,l) Left Censored,1574,3116,88247,87956,213,6.7,306,9.7,13819,5465,8354,6.2,15.7,13237,6855,6382,7.8,15,582,0.7,30,0,39,39,506
2000,04,a) 0,9203,9280,65261,32764,9198,198.2,0,0,64994,64994,0,198.4,198.4,0,0,0,0,0,64994,198.4,0,0,,,
2000,04,b) 1,7364,7511,80262,78452,88,1,2192,25.4,21659,2335,19324,3,27.6,18038,10534,7504,13.4,23,3621,4.6,46,0,1607,1607,8205
2000,04,c) 2,6188,6435,71311,70767,289,4.1,1336,19.2,19447,5302,14145,7.5,27.5,18359,7817,10542,11,25.9,1088,1.6,51.8,0,1011,1011,6221
2000,04,d) 3,5239,5438,58085,57654,218,3.7,1094,18.6,14543,2340,12203,4.1,25.2,13680,6947,6733,12,23.7,863,1.5,47.4,0,805,805,4908
2000,04,e) 4,4589,4731,44452,46443,155,3.1,762,15.1,7603,1080,6523,2.3,16.4,11584,5510,6074,11.9,24.9,-3981,-8.5,32.8,0,567,567,3617
2000,04,f) 5,4045,4360,54236,53550,231,5.1,615,13.5,10784,1713,9071,3.2,20.1,9412,4587,4825,8.6,17.6,1372,2.5,35.2,0,462,462,3730
2000,04,g) 6 to 10,13840,14805,204240,206879,476,3.1,1905,12.3,33101,4940,28161,2.4,16,38378,15311,23067,7.4,18.6,-5277,-2.6,32,0,1325,1325,8868
2000,04,h) 11 to 15,9879,11585,198235,199018,441,3.7,1181,9.9,28779,8695,20084,4.4,14.5,30344,11021,19323,5.5,15.2,-1565,-0.7,29,0,722,722,4718
2000,04,i) 16 to 20,6832,8643,160890,159631,324,3.7,711,8,23418,5878,17540,3.7,14.7,20900,7205,13695,4.5,13.1,2518,1.6,26.2,0,408,408,3246
2000,04,j) 21 to 25,3086,4873,127367,127144,244,4.9,370,7.5,18858,5342,13516,4.2,14.8,18412,5353,13059,4.2,14.5,446,0.3,29,0,165,165,2347
2000,04,l) Left Censored,7721,21313,826985,815467,2048,9.7,1813,8.6,139587,52702,86885,6.5,17.1,116551,36472,80079,4.5,14.3,23036,2.8,28.6,0,268,268,3111
2000,05,a) 0,4310,4338,28514,14299,4309,198.7,0,0,28431,28431,0,198.8,198.8,0,0,0,0,0,28431,198.8,0,0,,,
2000,05,b) 1,3484,3545,25081,25542,37,0.9,1094,26.7,6637,889,5748,3.5,26,7558,4565,2993,17.9,29.6,-921,-3.6,52,0,822,822,3223
2000,05,c) 2,2929,3110,29366,29652,138,4.1,705,20.7,6866,2367,4499,8,23.2,7437,3363,4074,11.3,25.1,-571,-1.9,46.4,0,534,534,2503
2000,05,d) 3,2557,2586,23280,23133,69,2.5,484,17.3,5023,1750,3273,7.6,21.7,4728,2257,2471,9.8,20.4,295,1.3,40.8,0,355,355,1739
2000,05,e) 4,2210,2301,21287,21301,62,2.5,398,16.1,3804,377,3427,1.8,17.9,3831,2225,1606,10.4,18,-27,-0.1,35.8,0,288,288,1663
2000,05,f) 5,2175,2265,20907,21035,75,3.1,326,13.6,3472,469,3003,2.2,16.5,3727,1730,1997,8.2,17.7,-255,-1.2,33,0,239,239,1199
2000,05,g) 6 to 10,7853,8283,80443,81345,217,2.5,1010,11.7,12841,1786,11055,2.2,15.8,14645,6726,7919,8.3,18,-1804,-2.2,31.6,0,698,698,4726
2000,05,h) 11 to 15,5343,6017,87851,88178,174,2.8,547,8.8,11062,1937,9125,2.2,12.5,11716,4053,7663,4.6,13.3,-654,-0.8,25,0,357,357,2132
2000,05,i) 16 to 20,4477,5162,77566,76153,104,2,394,7.4,11515,1801,9714,2.4,15.1,8688,2783,5905,3.7,11.4,2827,3.7,22.8,0,226,226,1933
2000,05,j) 21 to 25,2460,3312,71846,70834,122,3.6,264,7.8,8868,1760,7108,2.5,12.5,6844,1821,5023,2.6,9.7,2024,2.8,19.4,0,142,142,819
2000,05,l) Left Censored,7152,14545,520213,515355,848,5.8,1040,7.1,58465,14192,44273,2.8,11.3,48749,15207,33542,3,9.5,9716,1.8,19,0,274,274,1634
2000,06,a) 0,61011,61515,425576,213679,61017,198.4,0,0,423795,423795,0,198.3,198.3,0,0,0,0,0,423795,198.3,0,0,,,
2000,06,b) 1,47065,48099,452703,431316,622,1.1,12872,23.6,153894,18180,135714,4.2,35.7,111119,61553,49566,14.3,25.8,42775,9.9,51.6,0,9403,9403,48565
2000,06,c) 2,40529,42349,469433,458604,2069,4.6,8013,17.7,133745,34485,99260,7.5,29.2,112087,54613,57474,11.9,24.4,21658,4.8,48.8,0,5930,5930,42475
2000,06,d) 3,33887,34712,378768,375340,1242,3.3,6054,16.3,85636,9787,75849,2.6,22.8,78780,42117,36663,11.2,21,6856,1.8,42,0,4483,4483,33681
2000,06,e) 4,29842,30578,325265,326362,1061,3.3,4919,15.1,65900,6665,59235,2,20.2,68093,33354,34739,10.2,20.9,-2193,-0.7,40.4,0,3604,3604,24594
2000,06,f) 5,25897,27002,315460,319551,952,3.3,3860,13.6,62492,6823,55669,2.1,19.6,70673,30409,40264,9.5,22.1,-8181,-2.5,39.2,0,2796,2796,22544
2000,06,g) 6 to 10,98125,104683,1300071,1316504,3796,3.5,12591,11.6,220273,37067,183206,2.8,16.7,253139,103288,149851,7.8,19.2,-32866,-2.5,33.4,0,8708,8708,66897
2000,06,h) 11 to 15,78462,89423,1452255,1446857,3636,4,8521,9.3,229200,58483,170717,4,15.8,218405,79007,139398,5.5,15.1,10795,0.7,30.2,0,5184,5184,38932
2000,06,i) 16 to 20,55963,68083,1202146,1202557,2229,3.2,5407,7.8,180970,46627,134343,3.9,15,181791,72008,109783,6,15.1,-821,-0.1,30,0,3074,3074,28041
2000,06,j) 21 to 25,27695,40851,954264,943826,1623,3.9,3254,7.8,130816,33198,97618,3.5,13.9,109940,35713,74227,3.8,11.6,20876,2.3,23.2,0,1501,1501,10169
2000,06,l) Left Censored,63472,146395,5350536,5332034,9201,6.2,12341,8.3,752507,219429,533078,4.1,14.1,715503,262314,453189,4.9,13.4,37004,0.7,26.8,0,2969,2969,24342
2000,08,a) 0,11421,11506,64964,32607,11415,198.4,0,0,64715,64715,0,198.5,198.5,0,0,0,0,0,64715,198.5,0,0,,,
2000,08,b) 1,8836,8998,67652,67548,109,1.1,2488,24.3,21054,2315,18739,3.4,31.2,20846,10409,10437,15.4,30.9,208,0.3,61.8,0,1807,1807,7929
2000,08,c) 2,7754,7956,64923,65635,327,3.8,1607,18.7,15745,3737,12008,5.7,24,17168,8557,8611,13,26.2,-1423,-2.2,48,0,1196,1196,6789
2000,08,d) 3,6427,6581,57178,57898,244,3.5,1140,16.2,11453,1458,9995,2.5,19.8,12893,6461,6432,11.2,22.3,-1440,-2.5,39.6,0,817,817,5019
2000,08,e) 4,5567,5702,50096,50050,168,2.8,896,14.8,9296,766,8530,1.5,18.6,9203,4348,4855,8.7,18.4,93,0.2,36.8,0,644,644,3185
2000,08,f) 5,5018,5201,48181,49093,185,3.4,784,14.3,8252,1540,6712,3.1,16.8,10076,4224,5852,8.6,20.5,-1824,-3.7,33.6,0,550,550,3051
2000,08,g) 6 to 10,17717,18644,199820,201390,574,3,2208,11.4,32545,6210,26335,3.1,16.2,35684,15733,19951,7.8,17.7,-3139,-1.5,32.4,0,1490,1490,10235
2000,08,h) 11 to 15,11303,12891,202610,204137,496,3.8,1153,8.7,27211,6427,20784,3.1,13.3,30265,10244,20021,5,14.8,-3054,-1.5,26.6,0,691,691,5274
2000,08,i) 16 to 20,8112,9980,184463,184238,347,3.4,860,8.4,25082,6398,18684,3.5,13.6,24631,9980,14651,5.4,13.4,451,0.2,26.8,0,470,470,2900
2000,08,j) 21 to 25,4070,5957,128162,128306,269,4.4,532,8.7,18989,6640,12349,5.2,14.8,19276,5537,13739,4.3,15,-287,-0.2,29.6,0,187,187,1212
2000,08,l) Left Censored,10328,23307,812051,796544,1823,7.8,1996,8.5,127021,39921,87100,5,15.9,96007,32575,63432,4.1,12.1,31014,3.8,24.2,0,374,374,3591
2000,09,a) 0,5252,5280,33372,16784,5233,198.2,0,0,33177,33177,0,197.7,197.7,0,0,0,0,0,33177,197.7,0,0,,,
2000,09,b) 1,4234,4291,36800,34588,68,1.4,1003,21,11724,1637,10087,4.7,33.9,7299,3310,3989,9.6,21.1,4425,12.8,42.2,0,757,757,2690
2000,09,c) 2,3988,4146,36144,35992,181,4.1,689,15.7,9031,3134,5897,8.7,25.1,8726,3305,5421,9.2,24.2,305,0.9,48.4,0,535,535,2678
2000,09,d) 3,3330,3393,27690,27972,118,3.3,525,14.6,5332,852,4480,3,19.1,5895,2760,3135,9.9,21.1,-563,-2,38.2,0,393,393,2145
2000,09,e) 4,3045,3129,34026,33892,92,2.8,415,12.6,5084,550,4534,1.6,15,4816,2351,2465,6.9,14.2,268,0.8,28.4,0,316,316,1749
2000,09,f) 5,2915,2999,27597,28355,71,2.2,386,12.2,5138,346,4792,1.2,18.1,6654,3810,2844,13.4,23.5,-1516,-5.4,36.2,0,265,265,1257
2000,09,g) 6 to 10,11290,11676,126138,126207,297,2.5,1162,9.6,18373,2485,15888,2,14.6,18511,6992,11519,5.5,14.7,-138,-0.1,29.2,0,856,856,4392
2000,09,h) 11 to 15,10382,11274,141224,143213,370,3.2,971,8.4,19047,4360,14687,3,13.3,23024,10565,12459,7.4,16.1,-3977,-2.8,26.6,0,604,604,3460
2000,09,i) 16 to 20,6878,7825,107723,108611,201,2.5,630,7.8,12437,1956,10481,1.8,11.5,14213,5880,8333,5.4,13.1,-1776,-1.6,23,0,347,347,2522
2000,09,j) 21 to 25,3551,4714,89044,88671,136,2.8,333,6.9,13333,3991,9342,4.5,15,12587,3747,8840,4.2,14.2,746,0.8,28.4,0,161,161,1174
2000,09,l) Left Censored,13844,23482,875332,881927,1155,4.9,1737,7.3,90512,25301,65211,2.9,10.3,103701,31102,72599,3.5,11.8,-13189,-1.5,20.6,0,528,528,3647
2000,10,a) 0,1822,1830,9704,4906,1818,198.7,0,0,9596,9596,0,195.6,195.6,0,0,0,0,0,9596,195.6,0,0,,,
2000,10,b) 1,1389,1398,9801,9731,10,0.6,327,20.9,2503,66,2437,0.7,25.7,2363,1596,767,16.4,24.3,140,1.4,48.6,0,231,231,1182
2000,10,c) 2,1213,1248,10590,10413,45,3.3,227,16.9,2816,678,2138,6.5,27,2462,1228,1234,11.8,23.6,354,3.4,47.2,0,164,164,842
2000,10,d) 3,953,969,7116,7396,25,2.4,159,15.4,1239,54,1185,0.7,16.8,1798,1160,638,15.7,24.3,-559,-7.5,33.6,0,129,129,849
2000,10,e) 4,833,861,8363,8368,22,2.4,113,12.5,1004,107,897,1.3,12,1013,506,507,6,12.1,-9,-0.1,24,0,86,86,451
2000,10,f) 5,814,839,7775,7709,31,3.6,95,10.9,1261,183,1078,2.4,16.4,1128,521,607,6.8,14.6,133,1.8,29.2,0,69,69,385
2000,10,g) 6 to 10,2792,2904,29227,29130,74,2.4,322,10.6,4809,454,4355,1.6,16.5,4614,2437,2177,8.4,15.8,195,0.7,31.6,0,230,230,1429
2000,10,h) 11 to 15,2027,2200,29116,29550,75,3.3,215,9.5,3983,958,3025,3.2,13.5,4850,2314,2536,7.8,16.4,-867,-2.9,27,0,124,124,864
2000,10,i) 16 to 20,1348,1544,24529,24844,46,2.9,114,7.2,3017,687,2330,2.8,12.1,3647,1119,2528,4.5,14.7,-630,-2.6,24.2,0,72,72,312
2000,10,j) 21 to 25,760,1032,33053,33261,39,3.7,93,8.8,3282,679,2603,2,9.9,3698,1378,2320,4.1,11.1,-416,-1.2,19.8,0,34,34,166
2000,10,l) Left Censored,3069,5658,200435,194461,493,8.7,481,8.5,37081,18825,18256,9.7,19.1,25133,7321,17812,3.8,12.9,11948,6.2,25.8,0,73,73,559
2000,11,a) 0,1016,1021,8425,4219,1014,198.6,0,0,8413,8413,0,199.4,199.4,0,0,0,0,0,8413,199.4,0,0,,,
2000,11,b) 1,830,838,8749,8681,16,1.7,194,20.7,2882,792,2090,9.1,33.2,2745,1384,1361,15.9,31.6,137,1.6,63.2,0,130,130,1099
2000,11,c) 2,799,824,7986,8255,55,6.4,118,13.8,1932,754,1178,9.1,23.4,2469,1438,1031,17.4,29.9,-537,-6.5,46.8,0,92,92,1211
2000,11,d) 3,726,744,7776,7977,22,2.8,110,14,1211,217,994,2.7,15.2,1612,540,1072,6.8,20.2,-401,-5,30.4,0,78,78,389
2000,11,e) 4,626,633,6519,6455,21,3.2,81,12.2,1932,396,1536,6.1,29.9,1803,773,1030,12,27.9,129,2,55.8,0,57,57,613
2000,11,f) 5,557,573,6761,7073,19,3.1,87,14.3,1070,142,928,2,15.1,1693,335,1358,4.7,23.9,-623,-8.8,30.2,0,59,59,237
2000,11,g) 6 to 10,2308,2417,34683,34594,66,2.6,245,9.8,5001,712,4289,2.1,14.5,4822,1809,3013,5.2,13.9,179,0.6,27.8,0,160,160,770
2000,11,h) 11 to 15,1893,2128,36483,36067,104,4.8,196,9,5582,1957,3625,5.4,15.5,4750,1469,3281,4.1,13.2,832,2.3,26.4,0,109,109,741
2000,11,i) 16 to 20,1570,1774,31228,31440,52,2.9,130,7.2,3243,668,2575,2.1,10.3,3667,1137,2530,3.6,11.7,-424,-1.4,20.6,0,68,68,401
2000,11,j) 21 to 25,866,1147,47271,48803,36,3.1,63,5.4,3786,579,3207,1.2,7.8,6851,607,6244,1.2,14,-3065,-6.2,15.6,0,17,17,95
2000,11,l) Left Censored,3551,5860,224596,219891,362,6.1,423,7.2,28552,8258,20294,3.8,13,19143,4668,14475,2.1,8.7,9409,4.3,17.4,0,89,89,592
2000,12,a) 0,35601,35850,195008,98043,35552,198.3,0,0,193931,193931,0,197.8,197.8,0,0,0,0,0,193931,197.8,0,0,,,
2000,12,b) 1,27635,28292,204282,200511,326,1,9055,27.5,68456,14640,53816,7.3,34.1,60914,36495,24419,18.2,30.4,7542,3.7,60.8,0,6854,6854,28958
2000,12,c) 2,23182,23832,197154,198195,988,3.8,5450,20.9,50864,9557,41307,4.8,25.7,52945,27894,25051,14.1,26.7,-2081,-1,51.4,0,4190,4190,22439
2000,12,d) 3,19261,19637,192886,195544,670,3.1,3932,18.5,39375,4956,34419,2.5,20.1,44690,26567,18123,13.6,22.9,-5315,-2.8,40.2,0,2984,2984,21169
2000,12,e) 4,17106,17594,164449,162932,553,2.9,2951,15.7,35081,6548,28533,4,21.5,32047,16569,15478,10.2,19.7,3034,1.8,39.4,0,2191,2191,12404
2000,12,f) 5,15259,15667,162758,157239,502,3,2574,15.4,43289,4095,39194,2.6,27.5,32251,16238,16013,10.3,20.5,11038,7,41,0,1846,1846,11248
2000,12,g) 6 to 10,57824,61084,736707,724121,1849,2.9,7931,12.4,173903,38984,134919,5.4,24,148730,82272,66458,11.4,20.5,25173,3.5,41,0,5502,5502,60266
2000,12,h) 11 to 15,38645,44235,769626,775168,1524,3.3,4570,10,122794,28462,94332,3.7,15.8,133878,46868,87010,6,17.3,-11084,-1.5,31.6,0,2785,2785,19860
2000,12,i) 16 to 20,24419,29201,451994,455791,926,3.1,2635,8.8,63157,13609,49548,3,13.9,70751,32299,38452,7.1,15.5,-7594,-1.6,27.8,0,1462,1462,9733
2000,12,j) 21 to 25,11055,17475,354671,349061,803,4.5,1371,7.7,57480,19551,37929,5.6,16.5,46260,17295,28965,5,13.3,11220,3.2,26.6,0,625,625,4501
2000,12,l) Left Censored,26997,76212,2716911,2697470,5754,7.5,7047,9.2,396043,141300,254743,5.2,14.7,357162,130691,226471,4.8,13.2,38881,1.5,26.4,0,1284,1284,11091
2000,13,a) 0,15689,15779,98916,49642,15661,198.5,0,0,98548,98548,0,198.5,198.5,0,0,0,0,0,98548,198.5,0,0,,,
2000,13,b) 1,12250,12441,120470,120260,132,0.9,3753,26.2,34319,5414,28905,4.5,28.5,33899,17481,16418,14.5,28.2,420,0.3,56.4,0,2802,2802,13826
2000,13,c) 2,10739,11096,104453,105704,459,3.8,2314,19.2,28273,7904,20369,7.5,26.7,30775,13001,17774,12.3,29.1,-2502,-2.4,53.4,0,1732,1732,9613
2000,13,d) 3,8758,8983,81837,83366,298,3.1,1751,18,19119,3608,15511,4.3,22.9,22177,13328,8849,16,26.6,-3058,-3.7,45.8,0,1287,1287,8365
2000,13,e) 4,7679,7878,73742,75255,254,3,1354,16.1,14245,2023,12222,2.7,18.9,17271,9298,7973,12.4,22.9,-3026,-4,37.8,0,917,917,6624
2000,13,f) 5,6734,7071,79028,79476,238,3.2,1062,14.2,15818,2619,13199,3.3,19.9,16714,7269,9445,9.1,21,-896,-1.1,39.8,0,766,766,5174
2000,13,g) 6 to 10,23797,25335,309296,313230,841,3.2,3068,11.6,50170,7812,42358,2.5,16,58037,23821,34216,7.6,18.5,-7867,-2.5,32,0,2084,2084,14256
2000,13,h) 11 to 15,16733,19597,341844,339018,843,4.2,1989,9.9,54243,13109,41134,3.9,16,48592,19989,28603,5.9,14.3,5651,1.7,28.6,0,1160,1160,9242
2000,13,i) 16 to 20,11395,13895,223316,223665,403,2.8,1084,7.6,30762,6790,23972,3,13.8,31460,12316,19144,5.5,14.1,-698,-0.3,27.6,0,607,607,3995
2000,13,j) 21 to 25,5710,8787,211713,210827,473,5.3,726,8.1,33379,13179,20200,6.3,15.8,31607,7792,23815,3.7,15,1772,0.8,30,0,309,309,2390
2000,13,l) Left Censored,17041,44272,1762753,1755398,3388,7.6,3582,8.1,246617,81651,164966,4.7,14,231906,90899,141007,5.2,13.2,14711,0.8,26.4,0,714,714,6457
2000,15,a) 0,1844,1876,11759,5902,1856,197.9,0,0,11715,11715,0,198.5,198.5,0,0,0,0,0,11715,198.5,0,0,,,
2000,15,b) 1,1346,1371,11843,11861,18,1.2,329,21.4,3006,270,2736,2.3,25.3,3042,2003,1039,16.9,25.6,-36,-0.3,50.6,0,256,256,1307
2000,15,c) 2,1264,1303,13467,13804,51,3.7,238,17.1,2441,536,1905,3.9,17.7,3115,1548,1567,11.2,22.6,-674,-4.9,35.4,0,179,179,991
2000,15,d) 3,1089,1102,9306,9254,33,2.8,168,14.4,1750,187,1563,2,18.9,1646,994,652,10.7,17.8,104,1.1,35.6,0,138,138,839
2000,15,e) 4,1014,1054,9938,9784,26,2.3,161,14.4,1910,238,1672,2.4,19.5,1602,882,720,9,16.4,308,3.1,32.8,0,114,114,598
2000,15,f) 5,877,901,9361,9394,30,3.2,111,11.8,1363,171,1192,1.8,14.5,1428,648,780,6.9,15.2,-65,-0.7,29,0,80,80,407
2000,15,g) 6 to 10,3549,3823,45673,45862,127,3.2,416,10.5,6426,1264,5162,2.8,14,6804,3722,3082,8.1,14.8,-378,-0.8,28,0,285,285,2138
2000,15,h) 11 to 15,2944,3433,44097,44280,110,3.1,295,8.4,5053,953,4100,2.2,11.4,5418,1793,3625,4,12.2,-365,-0.8,22.8,0,173,173,971
2000,15,i) 16 to 20,2329,2798,34396,33860,78,2.7,197,6.9,4961,1953,3008,5.8,14.7,3889,1525,2364,4.5,11.5,1072,3.2,23,0,118,118,585
2000,15,j) 21 to 25,1314,1880,33142,32761,32,1.7,80,4.2,3417,914,2503,2.8,10.4,2654,725,1929,2.2,8.1,763,2.3,16.2,0,30,30,147
2000,15,l) Left Censored,3836,7236,207546,205857,299,4.1,511,7,21001,5275,15726,2.6,10.2,17622,6810,10812,3.3,8.6,3379,1.6,17.2,0,124,124,565
2000,16,a) 0,2993,3025,17434,8770,2998,198.2,0,0,17329,17329,0,197.6,197.6,0,0,0,0,0,17329,197.6,0,0,,,
2000,16,b) 1,2354,2391,16122,16245,28,1,717,26.1,4392,439,3953,2.7,27,4638,2644,1994,16.3,28.6,-246,-1.6,54,0,525,525,2095
2000,16,c) 2,2014,2097,19612,19830,109,4.8,443,19.6,5368,1476,3892,7.4,27.1,5804,2231,3573,11.3,29.3,-436,-2.2,54.2,0,318,318,1522
2000,16,d) 3,1784,1833,14037,14055,55,2.8,348,17.6,2990,229,2761,1.6,21.3,3025,1638,1387,11.7,21.5,-35,-0.2,42.6,0,229,229,1169
2000,16,e) 4,1578,1629,12296,12531,65,3.8,215,12.6,2159,338,1821,2.7,17.2,2628,1342,1286,10.7,21,-469,-3.8,34.4,0,157,157,1043
2000,16,f) 5,1354,1377,9639,9724,50,3.5,191,13.2,1654,231,1423,2.4,17,1823,821,1002,8.4,18.7,-169,-1.7,34,0,138,138,644
2000,16,g) 6 to 10,4781,5006,43839,44105,178,3.4,645,12.3,7474,1770,5704,4,16.9,8006,3668,4338,8.3,18.2,-532,-1.3,33.8,0,427,427,2546
2000,16,h) 11 to 15,3018,3386,50637,50000,100,2.9,326,9.3,8477,2118,6359,4.2,17,7203,2499,4704,5,14.4,1274,2.6,28.8,0,196,196,1216
2000,16,i) 16 to 20,2163,2626,34895,34666,78,2.9,230,8.5,5388,1105,4283,3.2,15.5,4930,1636,3294,4.7,14.2,458,1.3,28.4,0,131,131,852
2000,16,j) 21 to 25,1275,1697,38073,37962,67,3.9,134,7.7,3454,1216,2238,3.2,9.1,3232,1040,2192,2.7,8.5,222,0.6,17,0,60,60,434
2000,16,l) Left Censored,3523,6923,186377,188159,401,5.7,531,7.6,21572,7545,14027,4,11.5,25136,6603,18533,3.5,13.4,-3564,-1.9,23,0,124,124,776
2000,17,a) 0,18828,18978,119205,59826,18824,198.4,0,0,118758,118758,0,198.5,198.5,0,0,0,0,0,118758,198.5,0,0,,,
2000,17,b) 1,15459,15787,136139,132165,226,1.3,3853,21.8,41799,5703,36096,4.3,31.6,33850,16878,16972,12.8,25.6,7949,6,51.2,0,2813,2813,12865
2000,17,c) 2,13888,14389,139667,138285,610,4,2389,15.6,35561,7599,27962,5.5,25.7,32797,15781,17016,11.4,23.7,2764,2,47.4,0,1797,1797,12907
2000,17,d) 3,12224,12759,108399,109782,409,3,1909,14.1,23890,3789,20101,3.5,21.8,26656,15462,11194,14.1,24.3,-2766,-2.5,43.6,0,1402,1402,13237
2000,17,e) 4,10961,11115,105084,104639,320,2.7,1620,13.8,20730,1829,18901,1.7,19.8,19840,9312,10528,8.9,19,890,0.8,38,0,1181,1181,7313
2000,17,f) 5,10116,10454,105258,105147,297,2.7,1334,12.2,18574,1934,16640,1.8,17.7,18351,7821,10530,7.4,17.5,223,0.2,35,0,967,967,5561
2000,17,g) 6 to 10,38472,40453,480012,483248,1004,2.4,4297,10.2,74717,11160,63557,2.3,15.5,81190,34568,46622,7.2,16.8,-6473,-1.3,31,0,3027,3027,22313
2000,17,h) 11 to 15,29342,33079,531089,531707,983,2.9,2724,8,68976,14399,54577,2.7,13,70211,21811,48400,4.1,13.2,-1235,-0.2,26,0,1738,1738,11550
2000,17,i) 16 to 20,21318,24750,448985,448037,620,2.4,1747,6.9,54084,10363,43721,2.3,12.1,52188,17823,34365,4,11.6,1896,0.5,23.2,0,1042,1042,8449
2000,17,j) 21 to 25,11061,15587,321537,321677,507,3.2,1095,6.9,40834,9092,31742,2.8,12.7,41113,13738,27375,4.3,12.8,-279,-0.1,25.4,0,538,538,3389
2000,17,l) Left Censored,38461,74958,2908677,2901303,4474,5.9,5989,7.9,371273,109541,261732,3.8,12.8,356527,123152,233375,4.2,12.3,14746,0.5,24.6,0,1549,1549,12259
2000,18,a) 0,8681,8766,58245,29229,8692,198.3,0,0,58033,58033,0,198.5,198.5,0,0,0,0,0,58033,198.5,0,0,,,
2000,18,b) 1,7067,7218,62140,62002,102,1.2,1950,23.8,18041,4502,13539,7.3,29.1,17765,8830,8935,14.2,28.7,276,0.4,57.4,0,1516,1516,6888
2000,18,c) 2,6492,6891,73582,71531,347,4.7,1295,17.6,17976,4216,13760,5.9,25.1,13873,6406,7467,9,19.4,4103,5.7,38.8,0,985,985,5096
2000,18,d) 3,5586,5782,48298,48504,164,2.7,989,16,9423,1281,8142,2.6,19.4,9835,4989,4846,10.3,20.3,-412,-0.9,38.8,0,774,774,3791
2000,18,e) 4,5048,5179,54774,54857,118,2.1,753,13.7,8758,769,7989,1.4,16,8923,4439,4484,8.1,16.3,-165,-0.3,32,0,568,568,3328
2000,18,f) 5,4600,4797,44596,45382,144,2.9,663,13.1,6573,863,5710,1.9,14.5,8144,4348,3796,9.6,17.9,-1571,-3.4,29,0,482,482,3434
2000,18,g) 6 to 10,18071,19315,215703,217503,467,2.3,2006,10,31054,4069,26985,1.9,14.3,34654,14001,20653,6.4,15.9,-3600,-1.6,28.6,0,1396,1396,9315
2000,18,h) 11 to 15,13273,15525,252532,253053,412,2.6,1295,8.1,29136,4871,24265,1.9,11.5,30177,10684,19493,4.2,11.9,-1041,-0.4,23,0,842,842,5610
2000,18,i) 16 to 20,10009,11838,190760,190817,266,2.2,794,6.6,22276,3105,19171,1.6,11.7,22389,6775,15614,3.6,11.7,-113,0,23.4,0,478,478,2993
2000,18,j) 21 to 25,5184,7444,166295,164843,232,3,578,7.6,21681,4995,16686,3,13.2,18778,7085,11693,4.3,11.4,2903,1.8,22.8,0,260,260,1660
2000,18,l) Left Censored,18566,39137,1464775,1455322,2102,5.3,2986,7.5,173547,51035,122512,3.5,11.9,154642,50136,104506,3.4,10.6,18905,1.3,21.2,0,723,723,10431
2000,19,a) 0,4421,4441,27888,14046,4402,198.2,0,0,27684,27684,0,197.1,197.1,0,0,0,0,0,27684,197.1,0,0,,,
2000,19,b) 1,3550,3653,46559,39465,71,1.7,923,22.5,22404,2395,20009,6.1,56.8,8216,3974,4242,10.1,20.8,14188,36,41.6,0,694,694,2897
2000,19,c) 2,3266,3386,26894,27179,137,3.8,595,16.5,6365,2290,4075,8.4,23.4,6935,3178,3757,11.7,25.5,-570,-2.1,46.8,0,451,451,2696
2000,19,d) 3,2859,2970,25234,25110,91,2.9,431,13.7,4783,1264,3519,5,19,4534,1996,2538,7.9,18.1,249,0.9,36.2,0,341,341,1512
2000,19,e) 4,2635,2699,23124,23180,62,2.2,381,13.3,3618,267,3351,1.2,15.6,3729,1726,2003,7.4,16.1,-111,-0.5,31.2,0,280,280,1272
2000,19,f) 5,2474,2577,21621,22271,62,2.3,345,12.7,3412,428,2984,1.9,15.3,4711,2696,2015,12.1,21.2,-1299,-5.9,30.6,0,261,261,2320
2000,19,g) 6 to 10,9377,9847,90641,91400,240,2.3,1015,9.9,13479,3474,10005,3.8,14.7,14996,5611,9385,6.1,16.4,-1517,-1.7,29.4,0,713,713,3671
2000,19,h) 11 to 15,6977,7946,129736,129830,216,2.6,644,7.9,13323,1860,11463,1.4,10.3,13510,5310,8200,4.1,10.4,-187,-0.1,20.6,0,424,424,2406
2000,19,i) 16 to 20,6042,7224,96500,94955,156,2.1,484,6.6,12990,3367,9623,3.5,13.7,9899,3287,6612,3.5,10.4,3091,3.3,20.8,0,297,297,1588
2000,19,j) 21 to 25,3498,5301,81294,81089,125,2.3,264,4.9,8354,2056,6298,2.5,10.3,7944,2585,5359,3.2,9.8,410,0.5,19.6,0,153,153,1257
2000,19,l) Left Censored,12623,22602,703998,701625,1036,4.5,1524,6.7,72948,21083,51865,3,10.4,68201,21323,46878,3,9.7,4747,0.7,19.4,0,460,460,2861
2000,20,a) 0,4736,4765,29652,14901,4723,198.2,0,0,29503,29503,0,198,198,0,0,0,0,0,29503,198,0,0,,,
2000,20,b) 1,3742,3821,31419,32192,62,1.4,1046,24.1,7316,1374,5942,4.3,22.7,8861,4768,4093,14.8,27.5,-1545,-4.8,45.4,0,794,794,3530
2000,20,c) 2,3427,3554,34828,34911,167,4.4,665,17.5,8859,2904,5955,8.3,25.4,9024,3472,5552,9.9,25.8,-165,-0.4,50.8,0,495,495,2852
2000,20,d) 3,2912,3001,27160,27428,129,4.1,480,15.1,4605,939,3666,3.4,16.8,5140,2516,2624,9.2,18.7,-535,-1.9,33.6,0,354,354,2023
2000,20,e) 4,2668,2724,21896,22249,76,2.7,375,13.1,4115,641,3474,2.9,18.5,4821,2257,2564,10.1,21.7,-706,-3.2,37,0,284,284,1605
2000,20,f) 5,2328,2403,20748,21360,68,2.7,366,14.3,3441,809,2632,3.8,16.1,4664,2515,2149,11.8,21.8,-1223,-5.7,32.2,0,276,276,1486
2000,20,g) 6 to 10,8650,9084,94117,94635,233,2.5,1041,11,13435,2206,11229,2.3,14.2,14470,6174,8296,6.5,15.3,-1035,-1.1,28.4,0,710,710,4352
2000,20,h) 11 to 15,6525,7350,95071,95994,206,2.7,669,8.8,11495,2586,8909,2.7,12,13340,4697,8643,4.9,13.9,-1845,-1.9,24,0,436,436,2345
2000,20,i) 16 to 20,5496,6312,85982,86052,154,2.4,480,7.4,11678,1952,9726,2.3,13.6,11818,4117,7701,4.8,13.7,-140,-0.1,27.2,0,275,275,1518
2000,20,j) 21 to 25,2872,4241,67475,67797,230,5.4,297,6.9,9189,3531,5658,5.2,13.6,9832,3234,6598,4.8,14.5,-643,-0.9,27.2,0,149,149,785
2000,20,l) Left Censored,10204,19238,604544,604707,1013,5.2,1402,7.2,73537,25875,47662,4.3,12.2,73865,23547,50318,3.9,12.2,-328,0,24.4,0,380,380,2592
2000,21,a) 0,5646,5684,37318,18730,5648,198.7,0,0,37177,37177,0,198.5,198.5,0,0,0,0,0,37177,198.5,0,0,,,
2000,21,b) 1,4650,4769,42335,41706,84,1.6,1292,23.9,14072,2429,11643,5.8,33.7,12813,7195,5618,17.3,30.7,1259,3,61.4,0,1008,1008,5999
2000,21,c) 2,4257,4448,39704,40752,186,3.9,808,17,8023,2068,5955,5.1,19.7,10118,4988,5130,12.2,24.8,-2095,-5.1,39.4,0,652,652,4037
2000,21,d) 3,3532,3645,30942,31403,113,2.9,621,15.9,5697,664,5033,2.1,18.1,6618,3462,3156,11,21.1,-921,-3,36.2,0,503,503,3088
2000,21,e) 4,3091,3208,31954,32506,101,3,479,14.1,5704,1806,3898,5.6,17.5,6807,3403,3404,10.5,20.9,-1103,-3.4,35,0,359,359,2554
2000,21,f) 5,2925,3057,30261,30576,71,2.2,456,14,4674,636,4038,2.1,15.3,5304,2315,2989,7.6,17.3,-630,-2,30.6,0,336,336,1672
2000,21,g) 6 to 10,11058,11728,122751,123670,280,2.3,1283,10.5,20239,3566,16673,2.9,16.4,22076,8997,13079,7.3,17.9,-1837,-1.5,32.8,0,933,933,6497
2000,21,h) 11 to 15,8352,9498,152927,151689,263,2.7,809,8.3,20824,4263,16561,2.8,13.7,18348,7234,11114,4.8,12.1,2476,1.6,24.2,0,511,511,4010
2000,21,i) 16 to 20,6209,7077,110812,109960,166,2.3,511,7,14647,2685,11962,2.4,13.3,12943,4827,8116,4.4,11.8,1704,1.5,23.6,0,306,306,2656
2000,21,j) 21 to 25,3125,4593,101938,101901,160,3.4,344,7.3,13169,4686,8483,4.6,12.9,13095,4429,8666,4.3,12.9,74,0,25.8,0,154,154,1206
2000,21,l) Left Censored,11062,23453,801521,794376,1405,6,1684,7.1,92588,29675,62913,3.7,11.7,78297,22473,55824,2.8,9.9,14291,1.8,19.8,0,470,470,2956
2000,22,a) 0,6257,6342,51948,26099,6286,198.2,0,0,51699,51699,0,198.1,198.1,0,0,0,0,0,51699,198.1,0,0,,,
2000,22,b) 1,4942,5042,43637,44105,67,1.2,1515,26.1,11601,1628,9973,3.7,26.3,12536,7185,5351,16.3,28.4,-935,-2.1,52.6,0,1160,1160,5679
2000,22,c) 2,4672,4929,50207,51363,193,3.6,958,18,10513,2683,7830,5.2,20.5,12824,5724,7100,11.1,25,-2311,-4.5,41,0,761,761,4486
2000,22,d) 3,3986,4061,39783,41631,126,2.9,764,17.5,6013,672,5341,1.6,14.4,9708,4992,4716,12,23.3,-3695,-8.9,28.8,0,557,557,3948
2000,22,e) 4,3501,3563,34946,36044,86,2.3,584,15.3,5052,678,4374,1.9,14,7249,3306,3943,9.2,20.1,-2197,-6.1,28,0,426,426,2339
2000,22,f) 5,3179,3256,35440,36777,80,2.3,496,14.3,4657,692,3965,1.9,12.7,7330,3259,4071,8.9,19.9,-2673,-7.2,25.4,0,366,366,2421
2000,22,g) 6 to 10,12514,13254,153529,156535,316,2.3,1465,10.6,23963,2677,21286,1.7,15.3,29975,11420,18555,7.3,19.1,-6012,-3.8,30.6,0,1004,1004,7176
2000,22,h) 11 to 15,8693,9991,158177,156124,343,3.3,908,8.8,26297,9119,17178,5.8,16.8,22191,8281,13910,5.3,14.2,4106,2.6,28.4,0,557,557,4492
2000,22,i) 16 to 20,8150,9576,142644,144679,251,2.6,682,7,16402,2601,13801,1.8,11.3,20472,6382,14090,4.4,14.1,-4070,-2.8,22.6,0,371,371,2486
2000,22,j) 21 to 25,4052,5653,98674,99992,191,3.3,417,7.2,13330,4125,9205,4.1,13.3,15965,4278,11687,4.3,16,-2635,-2.7,26.6,0,168,168,1873
2000,22,l) Left Censored,11988,25222,760499,765683,1592,6.3,1856,7.3,95147,30699,64448,4,12.4,105514,36643,68871,4.8,13.8,-10367,-1.4,24.8,0,454,454,13343
2000,23,a) 0,2623,2649,16490,8261,2637,199.1,0,0,16459,16459,0,199.2,199.2,0,0,0,0,0,16459,199.2,0,0,,,
2000,23,b) 1,2191,2221,14027,14049,28,1.1,575,22.9,3754,439,3315,3.1,26.7,3798,2182,1616,15.5,27,-44,-0.3,53.4,0,405,405,1681
2000,23,c) 2,2011,2120,14543,14934,93,4.1,366,16.2,3299,1028,2271,6.9,22.1,4081,1799,2282,12,27.3,-782,-5.2,44.2,0,278,278,1571
2000,23,d) 3,1655,1680,10262,10384,47,2.6,249,14,1638,184,1454,1.8,15.8,1882,915,967,8.8,18.1,-244,-2.3,31.6,0,188,188,755
2000,23,e) 4,1496,1534,11489,11824,48,3,197,12.3,1779,190,1589,1.6,15,2449,1195,1254,10.1,20.7,-670,-5.7,30,0,136,136,793
2000,23,f) 5,1327,1352,10477,10148,44,3.1,192,13.5,2364,157,2207,1.5,23.3,1705,705,1000,6.9,16.8,659,6.5,33.6,0,158,158,553
2000,23,g) 6 to 10,4707,4898,42885,43144,127,2.5,476,9.4,6513,716,5797,1.7,15.1,7030,3049,3981,7.1,16.3,-517,-1.2,30.2,0,351,351,2233
2000,23,h) 11 to 15,4304,4683,52672,52249,155,3.2,354,7.4,6399,756,5643,1.4,12.2,5553,2047,3506,3.9,10.6,846,1.6,21.2,0,247,247,1545
2000,23,i) 16 to 20,2562,3061,46738,46539,95,3.1,198,6.4,5008,1351,3657,2.9,10.8,4610,1370,3240,2.9,9.9,398,0.9,19.8,0,122,122,602
2000,23,j) 21 to 25,1369,2005,35184,34582,83,4.1,156,7.6,4944,1896,3048,5.5,14.3,3740,1433,2307,4.1,10.8,1204,3.5,21.6,0,80,80,316
2000,23,l) Left Censored,4352,7637,230283,228266,354,4.6,479,6.2,24691,6586,18105,2.9,10.8,20656,6976,13680,3.1,9,4035,1.8,18,0,135,135,991
2000,24,a) 0,8228,8296,48322,24384,8217,198.1,0,0,47876,47876,0,196.3,196.3,0,0,0,0,0,47876,196.3,0,0,,,
2000,24,b) 1,6880,7014,59714,56975,103,1.3,1651,21.1,19588,3147,16441,5.5,34.4,14109,7695,6414,13.5,24.8,5479,9.6,49.6,0,1222,1222,6080
2000,24,c) 2,6076,6296,64973,64518,276,4.1,1106,16.5,15781,3381,12400,5.2,24.5,14870,5331,9539,8.3,23,911,1.5,46,0,819,819,3743
2000,24,d) 3,5319,5412,47055,47330,162,2.8,922,15.9,9842,1428,8414,3,20.8,10391,5136,5255,10.9,22,-549,-1.2,41.6,0,643,643,3429
2000,24,e) 4,4599,4666,40578,41202,130,2.6,703,14.2,6867,532,6335,1.3,16.7,8115,4041,4074,9.8,19.7,-1248,-3,33.4,0,520,520,3180
2000,24,f) 5,4345,4456,40705,40472,140,3,603,12.9,7829,966,6863,2.4,19.3,7363,3517,3846,8.7,18.2,466,1.1,36.4,0,432,432,2451
2000,24,g) 6 to 10,16277,17238,200182,199655,485,2.7,1855,10.4,32988,4367,28621,2.2,16.5,31933,13285,18648,6.7,16,1055,0.5,32,0,1235,1235,8319
2000,24,h) 11 to 15,12897,14390,217468,215591,458,3.1,1362,9.2,33601,8814,24787,4.1,15.6,29848,11561,18287,5.4,13.8,3753,1.8,27.6,0,815,815,5382
2000,24,i) 16 to 20,8145,9610,152494,151044,284,2.9,738,7.5,22538,5386,17152,3.6,14.9,19637,7030,12607,4.7,13,2901,1.9,26,0,398,398,2541
2000,24,j) 21 to 25,4073,5977,127301,127357,219,3.6,403,6.6,17908,5117,12791,4,14.1,18019,4688,13331,3.7,14.1,-111,0,28.2,0,196,196,1512
2000,24,l) Left Censored,13817,29121,1030676,1021572,1857,6.3,2319,7.9,140375,44082,96293,4.3,13.7,122166,44461,77705,4.4,12,18209,1.7,24,0,557,557,5476
2000,25,a) 0,10364,10459,65986,33131,10356,198,0,0,65711,65711,0,198.3,198.3,0,0,0,0,0,65711,198.3,0,0,,,
2000,25,b) 1,8560,8709,73772,70464,115,1.2,2005,20.6,23828,2797,21031,4,33.8,17212,9961,7251,14.1,24.4,6616,9.4,48.8,0,1482,1482,7507
2000,25,c) 2,7864,8080,86137,80183,349,4.1,1323,15.4,27656,4700,22956,5.9,34.5,15748,7218,8530,9,19.6,11908,14.9,39.2,0,1012,1012,5936
2000,25,d) 3,6770,6866,62126,63487,209,2.9,1084,14.9,13578,1540,12038,2.4,21.4,16300,10058,6242,15.8,25.7,-2722,-4.3,42.8,0,777,777,7949
2000,25,e) 4,5899,5987,55724,54871,194,3.1,776,12.4,11327,1194,10133,2.2,20.6,9621,3913,5708,7.1,17.5,1706,3.1,35,0,575,575,3217
2000,25,f) 5,5579,5758,59073,59899,177,2.9,757,12.5,9997,855,9142,1.4,16.7,11649,6619,5030,11.1,19.4,-1652,-2.7,33.4,0,504,504,2915
2000,25,g) 6 to 10,19940,21016,241987,242440,532,2.5,1973,9.1,38088,4572,33516,1.9,15.7,38994,17344,21650,7.2,16.1,-906,-0.4,31.4,0,1411,1411,10508
2000,25,h) 11 to 15,18029,20012,315646,312691,783,3.8,1599,7.8,47282,10553,36729,3.4,15.1,41371,16430,24941,5.3,13.2,5911,1.9,26.4,0,1006,1006,8067
2000,25,i) 16 to 20,11763,14088,290930,289836,498,3.5,976,6.8,41704,13871,27833,4.8,14.4,39516,15872,23644,5.5,13.6,2188,0.8,27.2,0,537,537,3813
2000,25,j) 21 to 25,5882,8371,191875,190487,269,3.2,614,7.2,22442,5053,17389,2.7,11.8,19665,6434,13231,3.4,10.3,2777,1.5,20.6,0,272,272,1542
2000,25,l) Left Censored,23419,41848,1586639,1584940,2131,5,2983,7.1,202232,57799,144433,3.6,12.8,198834,59583,139251,3.8,12.5,3398,0.3,25,0,959,959,7233
2000,26,a) 0,14471,14606,98083,49335,14460,198,0,0,97496,97496,0,197.6,197.6,0,0,0,0,0,97496,197.6,0,0,,,
2000,26,b) 1,11652,11972,115917,107203,241,1.8,2826,21.2,41512,5253,36259,4.9,38.7,24084,13366,10718,12.5,22.5,17428,16.2,45,0,2022,2022,8921
2000,26,c) 2,10637,11073,105662,105952,456,3.9,1874,15.9,22873,5039,17834,4.8,21.6,23452,11189,12263,10.6,22.1,-579,-0.5,43.2,0,1400,1400,9276
2000,26,d) 3,9670,10142,93050,96096,282,2.6,1525,14.2,15996,2324,13672,2.4,16.6,22088,9534,12554,9.9,23,-6092,-6.4,33.2,0,1124,1124,7099
2000,26,e) 4,8714,8858,89987,89187,213,2.3,1185,12.7,18487,967,17520,1.1,20.7,16887,8506,8381,9.5,18.9,1600,1.8,37.8,0,893,893,6716
2000,26,f) 5,8097,8272,78974,79942,213,2.5,1045,12,12734,1126,11608,1.4,15.9,14669,6142,8527,7.7,18.3,-1935,-2.4,31.8,0,757,757,4807
2000,26,g) 6 to 10,29472,31077,351391,351979,771,2.4,3334,10.3,56680,6933,49747,2,16.1,57855,23578,34277,6.7,16.4,-1175,-0.3,32.2,0,2286,2286,16251
2000,26,h) 11 to 15,22502,25746,384414,386000,696,2.6,2135,8.1,50681,9874,40807,2.6,13.1,53853,19526,34327,5.1,14,-3172,-0.9,26.2,0,1338,1338,10545
2000,26,i) 16 to 20,15747,18875,309042,313484,467,2.4,1321,6.8,36983,6899,30084,2.2,11.8,45867,17064,28803,5.4,14.6,-8884,-2.8,23.6,0,715,715,7327
2000,26,j) 21 to 25,8329,11686,220524,221194,407,3.4,783,6.6,29605,9051,20554,4.1,13.4,30945,8229,22716,3.7,14,-1340,-0.6,26.8,0,417,417,2591
2000,26,l) Left Censored,27458,56290,2167448,2178730,2906,5.1,4596,8,253907,75808,178099,3.5,11.7,276471,103981,172490,4.8,12.7,-22564,-1,23.4,0,1141,1141,10504
2000,27,a) 0,8851,8913,55219,27717,8827,198.1,0,0,55004,55004,0,198.4,198.4,0,0,0,0,0,55004,198.4,0,0,,,
2000,27,b) 1,7280,7467,62773,60645,113,1.4,1706,20.5,17759,2553,15206,4.2,29.3,13503,7194,6309,11.9,22.3,4256,7,44.6,0,1187,1187,5541
2000,27,c) 2,6656,6946,63381,63800,311,4.2,1186,16.1,13769,3574,10195,5.6,21.6,14608,5952,8656,9.3,22.9,-839,-1.3,43.2,0,841,841,4993
2000,27,d) 3,5838,6002,47854,49320,168,2.6,883,13.9,8506,1308,7198,2.7,17.2,11437,4387,7050,8.9,23.2,-2931,-6,34.4,0,652,652,3530
2000,27,e) 4,5159,5249,44016,44684,138,2.5,635,11.5,7469,568,6901,1.3,16.7,8804,3687,5117,8.3,19.7,-1335,-3,33.4,0,452,452,2594
2000,27,f) 5,4582,4678,43621,43212,105,2.1,536,11,7480,519,6961,1.2,17.3,6662,2412,4250,5.6,15.4,818,1.9,30.8,0,381,381,1876
2000,27,g) 6 to 10,17492,18569,203556,204133,447,2.3,1897,9.8,29716,4306,25410,2.1,14.6,30870,13477,17393,6.6,15.1,-1154,-0.5,29.2,0,1263,1263,8744
2000,27,h) 11 to 15,12610,14401,217566,217653,372,2.5,1131,7.7,28370,5924,22446,2.7,13,28544,10751,17793,4.9,13.1,-174,-0.1,26,0,684,684,5507
2000,27,i) 16 to 20,8825,10554,207251,205782,261,2.4,710,6.6,24718,3869,20849,1.9,12,21779,6676,15103,3.2,10.6,2939,1.4,21.2,0,402,402,2672
2000,27,j) 21 to 25,4963,7003,143860,142560,282,4,413,5.8,18823,5892,12931,4.1,13.2,16222,3987,12235,2.8,11.4,2601,1.8,22.8,0,222,222,2043
2000,27,l) Left Censored,16362,31234,1296631,1290073,1501,4.8,1983,6.3,150161,35687,114474,2.8,11.6,137045,35215,101830,2.7,10.6,13116,1,21.2,0,564,564,6754
2000,28,a) 0,3857,3926,25281,12687,3895,198.4,0,0,25188,25188,0,198.5,198.5,0,0,0,0,0,25188,198.5,0,0,,,
2000,28,b) 1,3233,3305,25540,26458,52,1.3,1103,28.6,8059,2612,5447,9.9,30.5,9895,5266,4629,19.9,37.4,-1836,-6.9,61,0,876,876,3972
2000,28,c) 2,2760,2879,25697,27122,114,3.6,619,19.8,5121,1212,3909,4.5,18.9,7971,3102,4869,11.4,29.4,-2850,-10.5,37.8,0,465,465,2161
2000,28,d) 3,2332,2388,18340,19557,57,2.2,509,19.5,2696,156,2540,0.8,13.8,5129,2754,2375,14.1,26.2,-2433,-12.4,27.6,0,373,373,1905
2000,28,e) 4,2123,2185,20417,20478,68,2.9,352,15.2,4027,363,3664,1.8,19.7,4148,2014,2134,9.8,20.3,-121,-0.6,39.4,0,259,259,1382
2000,28,f) 5,1986,2081,19344,20001,72,3.3,298,13.6,2781,375,2406,1.9,13.9,4094,1992,2102,10,20.5,-1313,-6.6,27.8,0,216,216,1590
2000,28,g) 6 to 10,7091,7532,80995,84092,241,3.1,927,11.8,11335,2888,8447,3.4,13.5,17529,7176,10353,8.5,20.8,-6194,-7.3,27,0,632,632,3297
2000,28,h) 11 to 15,5050,5669,87607,87317,212,3.6,537,9.2,11703,2993,8710,3.4,13.4,11123,3902,7221,4.5,12.7,580,0.7,25.4,0,361,361,2441
2000,28,i) 16 to 20,4380,5058,81238,81472,135,2.6,385,7.4,11027,1348,9679,1.7,13.5,11494,5248,6246,6.4,14.1,-467,-0.6,27,0,209,209,1287
2000,28,j) 21 to 25,2287,3159,66897,66638,121,3.8,230,7.2,7260,2010,5250,3,10.9,6742,1575,5167,2.4,10.1,518,0.8,20.2,0,125,125,596
2000,28,l) Left Censored,7363,15487,495485,496618,903,5.8,980,6.3,47397,12491,34906,2.5,9.5,49663,13358,36305,2.7,10,-2266,-0.5,19,0,288,288,2746
2000,29,a) 0,9629,9683,59750,29998,9610,198.5,0,0,59505,59505,0,198.4,198.4,0,0,0,0,0,59505,198.4,0,0,,,
2000,29,b) 1,7699,7864,63910,62683,129,1.4,2113,23.7,19072,3274,15798,5.2,30.4,16618,9311,7307,14.9,26.5,2454,3.9,53,0,1623,1623,7621
2000,29,c) 2,6732,7032,66669,65703,354,4.7,1356,18,16711,5402,11309,8.2,25.4,14778,6912,7866,10.5,22.5,1933,2.9,45,0,1075,1075,5877
2000,29,d) 3,5811,5927,47140,48096,207,3.3,1043,16.4,9901,2044,7857,4.2,20.6,11812,5617,6195,11.7,24.6,-1911,-4,41.2,0,805,805,4648
2000,29,e) 4,5034,5143,47240,47686,141,2.6,876,15.9,8328,701,7627,1.5,17.5,9219,4574,4645,9.6,19.3,-891,-1.8,35,0,651,651,3188
2000,29,f) 5,4808,4943,42109,42938,140,2.7,670,12.9,6424,716,5708,1.7,15,8081,3594,4487,8.4,18.8,-1657,-3.8,30,0,504,504,2648
2000,29,g) 6 to 10,17649,18738,195246,197223,468,2.4,2181,11.1,28619,3073,25546,1.6,14.5,32572,13310,19262,6.7,16.5,-3953,-2,29,0,1575,1575,9282
2000,29,h) 11 to 15,13876,15669,237725,236333,539,3.4,1360,8.5,34186,10876,23310,4.6,14.5,31402,12110,19292,5.1,13.3,2784,1.2,26.6,0,888,888,6175
2000,29,i) 16 to 20,9821,11743,201184,202971,295,2.5,847,7,23772,6132,17640,3,11.7,27346,8720,18626,4.3,13.5,-3574,-1.8,23.4,0,504,504,3320
2000,29,j) 21 to 25,5137,7445,146675,145178,276,3.7,503,6.7,19238,5069,14169,3.5,13.3,16244,5575,10669,3.8,11.2,2994,2.1,22.4,0,256,256,1546
2000,29,l) Left Censored,17601,35603,1263895,1270873,1978,5.5,2724,7.6,143704,37234,106470,2.9,11.3,157660,45294,112366,3.6,12.4,-13956,-1.1,22.6,0,737,737,4819
2000,30,a) 0,2356,2376,10936,5491,2358,198.5,0,0,10891,10891,0,198.3,198.3,0,0,0,0,0,10891,198.3,0,0,,,
2000,30,b) 1,1840,1867,10951,11088,20,0.9,517,24.3,2602,338,2264,3,23.5,2875,1466,1409,13.2,25.9,-273,-2.4,47,0,381,381,1125
2000,30,c) 2,1754,1797,13720,13369,72,3.7,327,17,3701,1266,2435,9.5,27.7,2999,1399,1600,10.5,22.4,702,5.3,44.8,0,234,234,943
2000,30,d) 3,1439,1458,9957,9896,53,3.4,266,17,2281,423,1858,4.3,23,2159,1166,993,11.8,21.8,122,1.2,43.6,0,199,199,804
2000,30,e) 4,1348,1376,9259,9316,56,3.8,223,15.3,1581,171,1410,1.8,17,1694,847,847,9.1,18.2,-113,-1.2,34,0,153,153,648
2000,30,f) 5,1199,1216,8359,8432,35,2.7,166,13,1271,77,1194,0.9,15.1,1417,658,759,7.8,16.8,-146,-1.7,30.2,0,118,118,482
2000,30,g) 6 to 10,4002,4101,32510,32986,154,3.6,471,11,4482,550,3932,1.7,13.6,5433,2272,3161,6.9,16.5,-951,-2.9,27.2,0,339,339,1627
2000,30,h) 11 to 15,2752,3024,32500,32934,77,2.5,261,8.4,3835,490,3345,1.5,11.6,4703,1977,2726,6,14.3,-868,-2.7,23.2,0,160,160,716
2000,30,i) 16 to 20,2196,2525,28180,27947,71,2.7,224,8.6,4035,1120,2915,4,14.4,3569,1467,2102,5.2,12.8,466,1.6,25.6,0,140,140,797
2000,30,j) 21 to 25,1271,1752,20872,20738,142,8.2,110,6.3,3380,1377,2003,6.6,16.3,3112,704,2408,3.4,15,268,1.3,30,0,65,65,383
2000,30,l) Left Censored,3259,5697,117296,116786,255,4.4,369,6.4,12095,2200,9895,1.9,10.4,11075,2906,8169,2.5,9.5,1020,0.9,19,0,124,124,633
2000,31,a) 0,2925,2945,16664,8355,2922,198.4,0,0,16618,16618,0,198.9,198.9,0,0,0,0,0,16618,198.9,0,0,,,
2000,31,b) 1,2391,2440,26251,24488,41,1.5,587,21.5,8034,3763,4271,15.4,32.8,4507,2491,2016,10.2,18.4,3527,14.4,36.8,0,414,414,1848
2000,31,c) 2,2215,2322,20417,20451,109,4.4,368,15,5623,1287,4336,6.3,27.5,5690,3258,2432,15.9,27.8,-67,-0.3,55,0,277,277,2955
2000,31,d) 3,1884,1952,14163,14214,50,2.4,303,14.6,2320,389,1931,2.7,16.3,2422,1215,1207,8.5,17,-102,-0.7,32.6,0,218,218,952
2000,31,e) 4,1645,1679,12714,13176,53,3,216,12.3,1796,185,1611,1.4,13.6,2719,1323,1396,10,20.6,-923,-7,27.2,0,165,165,1016
2000,31,f) 5,1494,1540,13654,13484,47,2.9,187,11.6,2200,248,1952,1.8,16.3,1859,758,1101,5.6,13.8,341,2.5,27.6,0,121,121,461
2000,31,g) 6 to 10,5852,6164,57289,58001,150,2.3,653,10.2,7806,1295,6511,2.2,13.5,9229,3571,5658,6.2,15.9,-1423,-2.4,27,0,441,441,2230
2000,31,h) 11 to 15,4508,5089,85510,85620,144,2.8,398,7.6,10404,1854,8550,2.2,12.2,10623,3427,7196,4,12.4,-219,-0.2,24.4,0,246,246,1820
2000,31,i) 16 to 20,3726,4360,58522,59755,152,3.4,294,6.6,7983,2925,5058,4.9,13.4,10448,3231,7217,5.4,17.5,-2465,-4.1,26.8,0,167,167,926
2000,31,j) 21 to 25,2074,2904,48933,48760,71,2.4,206,6.9,6474,1838,4636,3.8,13.3,6127,2052,4075,4.2,12.6,347,0.7,25.2,0,102,102,508
2000,31,l) Left Censored,7364,12682,395851,394738,622,4.9,772,6.1,43794,13404,30390,3.4,11.1,41568,12999,28569,3.3,10.5,2226,0.6,21,0,255,255,4237
2000,32,a) 0,4657,4675,33705,16917,4644,198.7,0,0,33576,33576,0,198.5,198.5,0,0,0,0,0,33576,198.5,0,0,,,
2000,32,b) 1,3581,3646,39525,38721,51,1.2,1144,27.1,12059,842,11217,2.2,31.1,10451,6370,4081,16.5,27,1608,4.1,54,0,868,868,5085
2000,32,c) 2,2990,3095,42277,39096,150,4.5,669,19.9,15424,2240,13184,5.7,39.5,9062,4147,4915,10.6,23.2,6362,16.3,46.4,0,542,542,3506
2000,32,d) 3,2363,2396,27151,28239,68,2.6,482,18.5,4968,414,4554,1.5,17.6,7143,3686,3457,13.1,25.3,-2175,-7.7,35.2,0,365,365,2711
2000,32,e) 4,1856,1923,32979,33589,67,3.3,321,15.7,4739,436,4303,1.3,14.1,5959,2104,3855,6.3,17.7,-1220,-3.6,28.2,0,225,225,1681
2000,32,f) 5,1652,1742,26201,25811,71,3.8,296,16,4594,1023,3571,4,17.8,3813,1531,2282,5.9,14.8,781,3,29.6,0,199,199,835
2000,32,g) 6 to 10,5250,5553,81441,83112,177,3,756,12.9,14171,1702,12469,2,17.1,17514,6418,11096,7.7,21.1,-3343,-4,34.2,0,540,540,4493
2000,32,h) 11 to 15,3476,4252,76395,74809,226,5.2,487,11.1,14059,2818,11241,3.8,18.8,10886,4019,6867,5.4,14.6,3173,4.2,29.2,0,244,244,1691
2000,32,i) 16 to 20,2417,3032,67533,67498,157,5.1,290,9.4,9439,3103,6336,4.6,14,9368,3100,6268,4.6,13.9,71,0.1,27.8,0,159,159,1340
2000,32,j) 21 to 25,1331,2069,80282,75970,131,6.3,163,7.8,15635,2758,12877,3.6,20.6,7010,1687,5323,2.2,9.2,8625,11.4,18.4,0,69,69,358
2000,32,l) Left Censored,3519,8366,389400,385480,899,10.8,749,9,51034,23202,27832,6,13.2,43194,14405,28789,3.7,11.2,7840,2,22.4,0,101,101,849
2000,33,a) 0,2414,2426,13910,6989,2400,197.9,0,0,13843,13843,0,198.1,198.1,0,0,0,0,0,13843,198.1,0,0,,,
2000,33,b) 1,1982,2012,14586,13792,34,1.5,474,21.1,4503,667,3836,4.8,32.6,2914,1708,1206,12.4,21.1,1589,11.5,42.2,0,358,358,1435
2000,33,c) 2,1873,1934,15267,15377,68,3.3,293,14.3,3404,962,2442,6.3,22.1,3623,1154,2469,7.5,23.6,-219,-1.5,44.2,0,213,213,953
2000,33,d) 3,1682,1698,12562,12480,39,2.2,265,14.7,2525,241,2284,1.9,20.2,2361,1196,1165,9.6,18.9,164,1.3,37.8,0,205,205,945
2000,33,e) 4,1527,1554,15343,15073,33,2,198,12.1,2787,107,2680,0.7,18.5,2247,897,1350,6,14.9,540,3.6,29.8,0,149,149,739
2000,33,f) 5,1361,1379,11592,11718,36,2.5,173,12,1951,152,1799,1.3,16.6,2203,1012,1191,8.6,18.8,-252,-2.2,33.2,0,134,134,808
2000,33,g) 6 to 10,4776,4966,49693,50037,102,2,493,9.6,7760,1220,6540,2.4,15.5,8448,3553,4895,7.1,16.9,-688,-1.4,31,0,349,349,2540
2000,33,h) 11 to 15,4320,4682,64976,65113,155,3.2,391,8.2,7601,1164,6437,1.8,11.7,7874,2443,5431,3.8,12.1,-273,-0.4,23.4,0,251,251,1261
2000,33,i) 16 to 20,2456,2790,51843,49615,70,2.5,203,7.1,10457,1782,8675,3.6,21.1,6000,1537,4463,3.1,12.1,4457,9,24.2,0,113,113,720
2000,33,j) 21 to 25,1274,1770,35698,36058,75,4.2,137,7.6,4678,1259,3419,3.5,13,5397,1820,3577,5,15,-719,-2,26,0,59,59,439
2000,33,l) Left Censored,4302,7920,254607,254281,491,6.2,589,7.4,26350,8039,18311,3.2,10.4,25699,8858,16841,3.5,10.1,651,0.3,20.2,0,139,139,1391
2000,34,a) 0,15785,15853,84172,42246,15726,198.4,0,0,83852,83852,0,198.5,198.5,0,0,0,0,0,83852,198.5,0,0,,,
2000,34,b) 1,13116,13253,98100,96443,119,0.8,3155,21.2,29565,3168,26397,3.3,30.7,26251,13393,12858,13.9,27.2,3314,3.5,54.4,0,2255,2255,10191
2000,34,c) 2,12209,12517,103591,105881,443,3.3,2057,15.4,23938,5385,18553,5.1,22.6,28517,14714,13803,13.9,26.9,-4579,-4.3,45.2,0,1559,1559,12495
2000,34,d) 3,10449,10623,85824,86940,327,2.9,1779,15.7,17590,2573,15017,3,20.2,19821,10753,9068,12.4,22.8,-2231,-2.6,40.4,0,1355,1355,8836
2000,34,e) 4,9024,9160,79697,78653,251,2.6,1299,13.4,15659,2555,13104,3.2,19.9,13571,5428,8143,6.9,17.3,2088,2.6,34.6,0,976,976,4020
2000,34,f) 5,8165,8528,83101,79669,334,3.7,1212,13.5,21307,1655,19652,2.1,26.7,14442,6507,7935,8.2,18.1,6865,8.6,36.2,0,821,821,3922
2000,34,g) 6 to 10,28880,29720,301245,301164,785,2.5,3281,10.6,46891,5821,41070,1.9,15.6,46729,17359,29370,5.8,15.5,162,0.1,31,0,2333,2333,12591
2000,34,h) 11 to 15,23891,25909,342490,344116,735,2.8,2295,8.6,45921,8179,37742,2.4,13.3,49173,19717,29456,5.7,14.3,-3252,-1,26.6,0,1499,1499,8752
2000,34,i) 16 to 20,15709,17602,289470,289759,568,3.1,1566,8.7,38857,9849,29008,3.4,13.4,39435,12729,26706,4.4,13.6,-578,-0.2,26.8,0,903,903,5540
2000,34,j) 21 to 25,8075,10032,212773,210803,340,3.3,725,7.1,26266,7658,18608,3.6,12.5,22326,7174,15152,3.4,10.6,3940,1.9,21.2,0,422,422,2874
2000,34,l) Left Censored,27986,50370,1824913,1820927,3186,6.3,3940,7.8,257504,81035,176469,4.5,14.1,249533,90024,159509,4.9,13.7,7971,0.4,27.4,0,1326,1326,11823
2000,35,a) 0,2907,2924,16916,8500,2904,198.6,0,0,16832,16832,0,198,198,0,0,0,0,0,16832,198,0,0,,,
2000,35,b) 1,2275,2298,16801,17170,20,0.7,740,27.7,4478,889,3589,5.2,26.1,5215,2811,2404,16.4,30.4,-737,-4.3,52.2,0,545,545,2199
2000,35,c) 2,2069,2158,20759,20720,116,5,474,20.3,5127,1955,3172,9.4,24.7,5049,2566,2483,12.4,24.4,78,0.3,48.8,0,370,370,1773
2000,35,d) 3,1836,1871,14130,14948,99,5,352,17.6,2443,454,1989,3,16.3,4079,1609,2470,10.8,27.3,-1636,-11,32.6,0,242,242,1089
2000,35,e) 4,1587,1618,15001,14674,46,2.7,272,15.7,3446,174,3272,1.2,23.5,2792,1508,1284,10.3,19,654,4.5,38,0,184,184,939
2000,35,f) 5,1484,1541,13333,13843,62,3.8,255,15.6,2480,298,2182,2.2,17.9,3500,1842,1658,13.3,25.3,-1020,-7.4,35.8,0,192,192,955
2000,35,g) 6 to 10,5480,5849,54923,55724,184,3,720,11.8,9206,1508,7698,2.7,16.5,10808,4463,6345,8,19.4,-1602,-2.9,33,0,490,490,3116
2000,35,h) 11 to 15,3825,4292,65440,65196,157,3.5,466,10.5,8452,1028,7424,1.6,13,7964,3129,4835,4.8,12.2,488,0.8,24.4,0,276,276,1579
2000,35,i) 16 to 20,3123,3754,48759,50577,168,4.4,277,7.3,6386,1715,4671,3.4,12.6,10021,4718,5303,9.3,19.8,-3635,-7.2,25.2,0,160,160,3167
2000,35,j) 21 to 25,1652,2436,38420,38710,159,6.5,192,7.8,5989,2589,3400,6.7,15.5,6568,2290,4278,5.9,17,-579,-1.5,31,0,97,97,471
2000,35,l) Left Censored,4343,8989,237734,237988,553,6.1,742,8.2,28886,10585,18301,4.4,12.1,29394,9830,19564,4.1,12.4,-508,-0.3,24.2,0,177,177,1146
2000,36,a) 0,34506,34625,204330,102504,34396,198.7,0,0,203652,203652,0,198.7,198.7,0,0,0,0,0,203652,198.7,0,0,,,
2000,36,b) 1,27413,27676,212076,208826,209,0.7,6811,21.9,63665,7751,55914,3.7,30.5,57164,31261,25903,15,27.4,6501,3.1,54.8,0,5054,5054,25145
2000,36,c) 2,25091,25829,217826,217032,955,3.4,4722,17,53362,12598,40764,5.8,24.6,51774,25787,25987,11.9,23.9,1588,0.7,47.8,0,3666,3666,20724
2000,36,d) 3,21767,22127,178604,181076,650,2.7,3713,15.7,34536,3895,30641,2.2,19.1,39480,20850,18630,11.5,21.8,-4944,-2.7,38.2,0,2838,2838,15894
2000,36,e) 4,18639,18909,158130,159395,521,2.6,2708,13.6,27139,3870,23269,2.4,17,29669,13774,15895,8.6,18.6,-2530,-1.6,34,0,2069,2069,10792
2000,36,f) 5,16479,17491,154468,156113,521,2.8,2415,13.1,28031,2022,26009,1.3,18,31321,15822,15499,10.1,20.1,-3290,-2.1,36,0,1692,1692,11593
2000,36,g) 6 to 10,60412,62457,627964,631694,1574,2.4,6726,10.3,90604,10332,80272,1.6,14.3,98063,39567,58496,6.3,15.5,-7459,-1.2,28.6,0,4909,4909,27148
2000,36,h) 11 to 15,49283,53131,716847,721440,1498,2.7,4502,8.2,82705,15899,66806,2.2,11.5,91892,39197,52695,5.4,12.7,-9187,-1.2,23,0,2949,2949,17599
2000,36,i) 16 to 20,32893,37293,566425,566817,905,2.4,2760,7.2,66604,12995,53609,2.3,11.8,67387,26242,41145,4.6,11.9,-783,-0.1,23.6,0,1743,1743,16243
2000,36,j) 21 to 25,15994,21552,440080,434952,719,3.3,1457,6.6,58172,14043,44129,3.2,13.4,47915,15684,32231,3.6,11,10257,2.4,22,0,798,798,4095
2000,36,l) Left Censored,60543,107969,3812081,3798157,5801,5.3,7864,7.2,471360,132035,339325,3.5,12.4,443512,140633,302879,3.7,11.7,27848,0.7,23.4,0,2813,2813,21515
2000,37,a) 0,14151,14282,88786,44504,14184,198.6,0,0,88565,88565,0,199,199,0,0,0,0,0,88565,199,0,0,,,
2000,37,b) 1,11817,12042,98081,96491,152,1.1,3348,24.4,31512,4139,27373,4.3,32.7,28332,15366,12966,15.9,29.4,3180,3.3,58.8,0,2548,2548,12098
2000,37,c) 2,10203,10683,104701,103698,465,4,2114,18.4,25342,8075,17267,7.8,24.4,23336,10485,12851,10.1,22.5,2006,1.9,45,0,1603,1603,8134
2000,37,d) 3,8872,9071,77096,78083,285,2.9,1531,15.8,14899,2133,12766,2.7,19.1,16873,8499,8374,10.9,21.6,-1974,-2.5,38.2,0,1141,1141,6825
2000,37,e) 4,7516,7820,71366,72421,230,2.8,1247,15,13502,1622,11880,2.2,18.6,15612,7778,7834,10.7,21.6,-2110,-3,37.2,0,909,909,5697
2000,37,f) 5,6723,6985,60780,61723,235,3.2,989,13.4,11102,1924,9178,3.1,18,12988,6343,6645,10.3,21,-1886,-3,36,0,726,726,4451
2000,37,g) 6 to 10,23533,25020,293037,294863,652,2.5,2871,11,44367,6521,37846,2.2,15,48019,19530,28489,6.6,16.3,-3652,-1.3,30,0,1950,1950,12923
2000,37,h) 11 to 15,18560,21212,337971,337892,683,3.1,1872,8.6,44284,9020,35264,2.7,13.1,44127,16651,27476,4.9,13.1,157,0,26.2,0,1135,1135,8101
2000,37,i) 16 to 20,13510,16227,246502,247742,466,2.8,1188,7.2,31233,9026,22207,3.6,12.6,33713,12433,21280,5,13.6,-2480,-1,25.2,0,625,625,4214
2000,37,j) 21 to 25,6418,9547,195930,195223,361,3.7,612,6.3,24013,6266,17747,3.2,12.3,22599,6455,16144,3.3,11.6,1414,0.7,23.2,0,291,291,1987
2000,37,l) Left Censored,20336,47913,1784176,1785042,2844,5.9,3376,7,205717,60044,145673,3.4,11.5,207449,68417,139032,3.8,11.6,-1732,-0.1,23,0,823,823,7207
2000,38,a) 0,1068,1072,7432,3731,1061,197.9,0,0,7403,7403,0,198.4,198.4,0,0,0,0,0,7403,198.4,0,0,,,
2000,38,b) 1,820,835,7077,7173,14,1.5,217,23,1917,534,1383,7.4,26.7,2108,1098,1010,15.3,29.4,-191,-2.7,53.4,0,164,164,885
2000,38,c) 2,835,871,8309,8195,34,3.6,156,16.7,2103,559,1544,6.8,25.7,1875,847,1028,10.3,22.9,228,2.8,45.8,0,120,120,769
2000,38,d) 3,756,777,5757,5606,41,5.1,106,13.1,1432,489,943,8.7,25.5,1129,644,485,11.5,20.1,303,5.4,40.2,0,82,82,471
2000,38,e) 4,666,678,4648,4868,20,2.8,95,13.2,811,61,750,1.3,16.7,1251,772,479,15.9,25.7,-440,-9,33.4,0,72,72,337
2000,38,f) 5,562,565,4814,4913,12,2,69,11.6,639,47,592,1,13,836,423,413,8.6,17,-197,-4,26,0,50,50,355
2000,38,g) 6 to 10,2502,2590,21955,22078,68,2.5,293,10.8,2826,371,2455,1.7,12.8,3072,1192,1880,5.4,13.9,-246,-1.1,25.6,0,214,214,937
2000,38,h) 11 to 15,1949,2146,22588,23481,42,1.9,190,8.6,1904,187,1717,0.8,8.1,3690,1519,2171,6.5,15.7,-1786,-7.6,16.2,0,118,118,831
2000,38,i) 16 to 20,1722,1978,21209,21369,43,2.1,129,6.4,2606,522,2084,2.4,12.2,2926,997,1929,4.7,13.7,-320,-1.5,24.4,0,83,83,627
2000,38,j) 21 to 25,920,1204,18317,18284,29,2.4,73,6,1748,151,1597,0.8,9.6,1682,426,1256,2.3,9.2,66,0.4,18.4,0,50,50,269
2000,38,l) Left Censored,3273,5311,131422,130657,195,3.6,288,5.4,12813,2808,10005,2.1,9.8,11283,2533,8750,1.9,8.6,1530,1.2,17.2,0,116,116,564
2000,39,a) 0,14897,15006,110525,55415,14896,198.5,0,0,110220,110220,0,198.9,198.9,0,0,0,0,0,110220,198.9,0,0,,,
2000,39,b) 1,12218,12538,120367,117868,211,1.5,3137,22.3,36018,8314,27704,7.1,30.6,31019,15528,15491,13.2,26.3,4999,4.3,52.6,0,2381,2381,11851
2000,39,c) 2,11383,12008,115977,116229,505,4,2005,15.7,26222,5897,20325,5.1,22.6,26726,12225,14501,10.5,23,-504,-0.4,45.2,0,1542,1542,10401
2000,39,d) 3,10018,10484,103060,102574,361,3.3,1604,14.4,21861,3852,18009,3.8,21.3,20888,10390,10498,10.1,20.4,973,0.9,40.8,0,1209,1209,7785
2000,39,e) 4,8944,9232,87033,87809,278,2.9,1229,12.7,15325,1823,13502,2.1,17.5,16877,7764,9113,8.8,19.2,-1552,-1.7,35,0,920,920,5705
2000,39,f) 5,8514,8793,83131,83072,210,2.3,1064,11.5,15531,2800,12731,3.4,18.7,15413,6392,9021,7.7,18.6,118,0.1,37.2,0,815,815,4699
2000,39,g) 6 to 10,31868,34109,388030,383391,828,2.3,3377,9.5,72569,8932,63637,2.3,18.9,63291,24504,38787,6.4,16.5,9278,2.4,33,0,2418,2418,15790
2000,39,h) 11 to 15,25268,29120,481768,481069,800,2.7,2372,7.9,64877,11651,53226,2.4,13.5,63479,23598,39881,4.9,13.2,1398,0.3,26.4,0,1488,1488,10248
2000,39,i) 16 to 20,18122,21785,345982,344268,539,2.4,1514,6.8,44149,9391,34758,2.7,12.8,40720,13167,27553,3.8,11.8,3429,1,23.6,0,895,895,5830
2000,39,j) 21 to 25,10181,14742,299139,295567,553,3.7,912,6.1,42369,11502,30867,3.9,14.3,35224,11694,23530,4,11.9,7145,2.4,23.8,0,445,445,2581
2000,39,l) Left Censored,36826,76903,2834733,2825465,3966,5.1,5474,7.1,331445,90654,240791,3.2,11.7,312910,95851,217059,3.4,11.1,18535,0.6,22.2,0,1443,1443,12066
2000,40,a) 0,5716,5787,38129,19142,5736,198.2,0,0,37974,37974,0,198.4,198.4,0,0,0,0,0,37974,198.4,0,0,,,
2000,40,b) 1,4586,4674,37361,37739,69,1.3,1427,26.5,11105,2569,8536,6.8,29.4,11861,6748,5113,17.9,31.4,-756,-2,58.8,0,1079,1079,4858
2000,40,c) 2,4047,4241,39164,38205,190,4.1,874,19,11100,3072,8028,8,29.1,9182,4621,4561,12.1,24,1918,5.1,48,0,691,691,3879
2000,40,d) 3,3576,3753,34274,34736,134,3.3,709,17.6,7827,1047,6780,3,22.5,8750,4910,3840,14.1,25.2,-923,-2.7,45,0,521,521,3245
2000,40,e) 4,2981,3059,24178,24982,83,2.5,532,16.2,4440,731,3709,2.9,17.8,6047,3089,2958,12.4,24.2,-1607,-6.4,35.6,0,404,404,2348
2000,40,f) 5,2688,2787,26277,26534,97,3.3,389,13.3,4360,471,3889,1.8,16.4,4873,2451,2422,9.2,18.4,-513,-2,32.8,0,282,282,1873
2000,40,g) 6 to 10,10381,10920,108811,109062,289,2.5,1276,11.2,17725,3810,13915,3.5,16.3,18226,8233,9993,7.5,16.7,-501,-0.4,32.6,0,886,886,4699
2000,40,h) 11 to 15,7422,8277,123959,125364,297,3.5,791,9.3,15224,3142,12082,2.5,12.1,18033,5136,12897,4.1,14.4,-2809,-2.3,24.2,0,487,487,2742
2000,40,i) 16 to 20,7008,8103,114960,116332,189,2.3,657,7.9,12828,2419,10409,2.1,11,15571,6397,9174,5.5,13.4,-2743,-2.4,22,0,347,347,1893
2000,40,j) 21 to 25,3214,4362,78203,77448,154,3.5,295,6.7,9655,2057,7598,2.7,12.5,8145,2362,5783,3,10.5,1510,2,21,0,160,160,838
2000,40,l) Left Censored,9451,19683,569267,565948,1072,5.4,1445,7.3,71661,22412,49249,4,12.7,65022,18887,46135,3.3,11.5,6639,1.2,23,0,377,377,2531
2000,41,a) 0,6908,6962,37637,18894,6908,198.4,0,0,37487,37487,0,198.4,198.4,0,0,0,0,0,37487,198.4,0,0,,,
2000,41,b) 1,5800,5889,37006,37367,68,1,1678,24.9,9934,1409,8525,3.8,26.6,10655,5808,4847,15.5,28.5,-721,-1.9,53.2,0,1231,1231,4442
2000,41,c) 2,5156,5377,39268,39989,262,4.5,1061,18.3,9116,3157,5959,7.9,22.8,10558,4723,5835,11.8,26.4,-1442,-3.6,45.6,0,782,782,3699
2000,41,d) 3,4425,4517,33134,34146,158,3.3,838,17.3,6059,1081,4978,3.2,17.7,8083,4103,3980,12,23.7,-2024,-6,35.4,0,622,622,3139
2000,41,e) 4,4035,4173,43558,44459,123,2.8,649,14.6,5993,1010,4983,2.3,13.5,7794,3414,4380,7.7,17.5,-1801,-4,27,0,470,470,2688
2000,41,f) 5,3798,3898,31589,32402,129,3.1,583,14.1,5511,411,5100,1.3,17,7137,3694,3443,11.4,22,-1626,-5,34,0,405,405,2505
2000,41,g) 6 to 10,13466,14254,134881,136633,521,3.5,1726,11.6,22529,5769,16760,4.2,16.5,26033,11592,14441,8.5,19.1,-3504,-2.6,33,0,1143,1143,6959
2000,41,h) 11 to 15,8937,10010,130013,130055,348,3.4,874,8.5,18422,3070,15352,2.4,14.2,18506,6172,12334,4.7,14.2,-84,0,28.4,0,553,553,3441
2000,41,i) 16 to 20,6556,7937,131637,133403,234,2.9,655,8,15474,3801,11673,2.8,11.6,19005,7245,11760,5.4,14.2,-3531,-2.6,23.2,0,369,369,2840
2000,41,j) 21 to 25,3618,5025,91762,91989,190,3.7,368,7.2,10220,2355,7865,2.6,11.1,10673,3432,7241,3.7,11.6,-453,-0.5,22.2,0,173,173,806
2000,41,l) Left Censored,9596,19397,624462,625590,1073,5.5,1542,7.9,77676,24532,53144,3.9,12.4,79931,26937,52994,4.3,12.8,-2255,-0.4,24.8,0,371,371,2680
2000,42,a) 0,16486,16600,121729,61055,16465,198.4,0,0,121348,121348,0,198.8,198.8,0,0,0,0,0,121348,198.8,0,0,,,
2000,42,b) 1,13765,14025,121617,117493,175,1.1,3107,19.9,34768,4875,29893,4.1,29.6,26519,13738,12781,11.7,22.6,8249,7,45.2,0,2342,2342,11179
2000,42,c) 2,12521,13183,129471,127368,510,3.7,2013,14.4,30487,7774,22713,6.1,23.9,26280,10483,15797,8.2,20.6,4207,3.3,41.2,0,1536,1536,7692
2000,42,d) 3,11105,11487,99273,100708,329,2.7,1575,13,17040,2273,14767,2.3,16.9,19909,9299,10610,9.2,19.8,-2869,-2.9,33.8,0,1215,1215,6856
2000,42,e) 4,9594,9915,90306,92305,257,2.5,1268,12.2,14301,1915,12386,2.1,15.5,18298,7722,10576,8.4,19.8,-3997,-4.3,31,0,940,940,5362
2000,42,f) 5,9097,9413,87094,86914,215,2.2,1072,10.9,15515,1018,14497,1.2,17.9,15155,5812,9343,6.7,17.4,360,0.5,34.8,0,785,785,4193
2000,42,g) 6 to 10,34799,36684,380894,383165,850,2.2,3646,9.6,55374,8278,47096,2.2,14.5,59916,23708,36208,6.2,15.6,-4542,-1.1,29,0,2627,2627,16764
2000,42,h) 11 to 15,30816,34437,464027,464472,904,2.6,2756,7.8,58634,11921,46713,2.6,12.6,59523,23408,36115,5,12.8,-889,-0.2,25.2,0,1828,1828,12092
2000,42,i) 16 to 20,20938,24559,383924,386004,627,2.5,1693,6.7,44798,9697,35101,2.5,11.6,48957,16046,32911,4.2,12.7,-4159,-1.1,23.2,0,1034,1034,7970
2000,42,j) 21 to 25,10977,15269,305835,304792,518,3.3,1002,6.5,44417,16953,27464,5.6,14.6,42330,11168,31162,3.7,13.9,2087,0.7,27.8,0,500,500,3090
2000,42,l) Left Censored,40350,80565,2855665,2846815,4275,5.3,5816,7.2,338408,105002,233406,3.7,11.9,320707,102205,218502,3.6,11.3,17701,0.6,22.6,0,1691,1691,13500
2000,44,a) 0,1715,1728,13723,6880,1713,198.3,0,0,13686,13686,0,198.9,198.9,0,0,0,0,0,13686,198.9,0,0,,,
2000,44,b) 1,1431,1449,9470,9119,13,0.8,346,21.3,3008,262,2746,2.9,33,2305,1255,1050,13.8,25.3,703,7.7,50.6,0,263,263,1031
2000,44,c) 2,1365,1420,10455,10681,64,4.2,231,15.3,2321,612,1709,5.7,21.7,2772,1020,1752,9.5,26,-451,-4.3,43.4,0,178,178,897
2000,44,d) 3,1169,1192,11144,11012,40,3.2,189,14.9,1943,179,1764,1.6,17.6,1679,723,956,6.6,15.2,264,2.4,30.4,0,139,139,546
2000,44,e) 4,1015,1024,8209,8372,31,2.9,136,12.6,1390,254,1136,3,16.6,1715,615,1100,7.3,20.5,-325,-3.9,33.2,0,97,97,498
2000,44,f) 5,907,915,7098,7187,28,2.9,116,12.1,1058,141,917,2,14.7,1235,547,688,7.6,17.2,-177,-2.5,29.4,0,91,91,473
2000,44,g) 6 to 10,3582,3673,36091,38239,96,2.5,364,9.6,5141,369,4772,1,13.4,9436,5690,3746,14.9,24.7,-4295,-11.3,26.8,0,266,266,5055
2000,44,h) 11 to 15,3229,3469,42420,41897,117,3.3,278,7.8,5874,1320,4554,3.2,14,4828,1849,2979,4.4,11.5,1046,2.5,23,0,175,175,896
2000,44,i) 16 to 20,1972,2218,31356,32075,57,2.5,187,8.2,3361,617,2744,1.9,10.5,4798,1720,3078,5.4,15,-1437,-4.5,21,0,125,125,568
2000,44,j) 21 to 25,1134,1360,24801,24995,32,2.3,78,5.6,2108,317,1791,1.3,8.4,2496,721,1775,2.9,10,-388,-1.6,16.8,0,48,48,325
2000,44,l) Left Censored,4565,6663,213202,214268,340,5.1,457,6.8,27858,8672,19186,4,13,29989,12200,17789,5.7,14,-2131,-1,26,0,160,160,1239
2000,45,a) 0,6958,7018,45414,22871,6962,198.4,0,0,45086,45086,0,197.1,197.1,0,0,0,0,0,45086,197.1,0,0,,,
2000,45,b) 1,5708,5814,49800,48312,78,1.2,1742,26.1,16180,2270,13910,4.7,33.5,13203,8032,5171,16.6,27.3,2977,6.2,54.6,0,1316,1316,6208
2000,45,c) 2,4982,5122,53389,54273,211,3.8,1024,18.5,13402,4152,9250,7.7,24.7,15170,7045,8125,13,28,-1768,-3.3,49.4,0,780,780,5672
2000,45,d) 3,4124,4201,42204,42903,140,3.1,770,17.1,7422,779,6643,1.8,17.3,8819,3964,4855,9.2,20.6,-1397,-3.3,34.6,0,602,602,3114
2000,45,e) 4,3604,3702,45037,43629,109,2.8,592,15,10487,525,9962,1.2,24,7670,3903,3767,8.9,17.6,2817,6.4,35.2,0,453,453,3201
2000,45,f) 5,3252,3341,35425,35420,104,3,439,12.5,6532,681,5851,1.9,18.4,6521,3065,3456,8.7,18.4,11,0,36.8,0,323,323,2421
2000,45,g) 6 to 10,11478,12276,141333,141432,319,2.5,1395,10.9,22506,3041,19465,2.2,15.9,22703,8865,13838,6.3,16.1,-197,-0.2,31.8,0,972,972,6023
2000,45,h) 11 to 15,8913,10579,164909,164328,409,3.8,907,8.4,24238,4965,19273,3,14.7,23075,8366,14709,5.1,14,1163,0.7,28,0,549,549,3412
2000,45,i) 16 to 20,6283,7421,110216,111311,190,2.5,626,8.2,13124,2192,10932,2,11.8,15314,6576,8738,5.9,13.8,-2190,-2,23.6,0,316,316,2274
2000,45,j) 21 to 25,3029,4635,76570,77304,208,4.4,370,7.8,10851,3705,7146,4.8,14,12319,5188,7131,6.7,15.9,-1468,-1.9,28,0,139,139,757
2000,45,l) Left Censored,10013,22461,818448,818886,1350,6,1539,6.8,88103,25618,62485,3.1,10.8,88979,27782,61197,3.4,10.9,-876,-0.1,21.6,0,362,362,2368
2000,46,a) 0,1500,1514,9400,4724,1502,198.4,0,0,9353,9353,0,198,198,0,0,0,0,0,9353,198,0,0,,,
2000,46,b) 1,1263,1277,8437,8520,12,0.8,315,22,1978,159,1819,1.9,23.2,2144,1193,951,14,25.2,-166,-2,46.4,0,227,227,992
2000,46,c) 2,1104,1139,8470,8717,45,3.6,227,18.4,2068,450,1618,5.2,23.7,2561,1554,1007,17.8,29.4,-493,-5.7,47.4,0,163,163,1369
2000,46,d) 3,959,973,8091,7733,32,3.1,142,13.8,1993,213,1780,2.8,25.8,1276,754,522,9.8,16.5,717,9.3,33,0,103,103,628
2000,46,e) 4,857,873,5780,6044,30,3.2,139,15,807,78,729,1.3,13.4,1334,641,693,10.6,22.1,-527,-8.7,26.8,0,104,104,470
2000,46,f) 5,775,796,6694,6693,20,2.4,92,11,1304,85,1219,1.3,19.5,1301,800,501,12,19.4,3,0.1,38.8,0,63,63,331
2000,46,g) 6 to 10,3046,3157,30040,29558,87,2.7,337,10.3,5279,775,4504,2.6,17.9,4315,1587,2728,5.4,14.6,964,3.3,29.2,0,244,244,1180
2000,46,h) 11 to 15,2159,2330,32632,34784,57,2.4,222,9.2,3726,1249,2477,3.6,10.7,8029,1362,6667,3.9,23.1,-4303,-12.4,21.4,0,153,153,874
2000,46,i) 16 to 20,1702,2002,22477,22601,50,2.4,140,6.8,2590,611,1979,2.7,11.5,2837,1118,1719,4.9,12.6,-247,-1.1,23,0,84,84,499
2000,46,j) 21 to 25,958,1238,19542,19788,28,2.2,73,5.8,2062,364,1698,1.8,10.4,2554,1077,1477,5.4,12.9,-492,-2.5,20.8,0,45,45,168
2000,46,l) Left Censored,3439,5627,148568,146459,232,4.1,320,5.6,15810,3161,12649,2.2,10.8,11592,4083,7509,2.8,7.9,4218,2.9,15.8,0,105,105,547
2000,47,a) 0,8155,8247,57927,29064,8185,198.5,0,0,57726,57726,0,198.6,198.6,0,0,0,0,0,57726,198.6,0,0,,,
2000,47,b) 1,6733,6986,68254,67346,163,2,2203,27.4,23066,6034,17032,9,34.2,21250,10613,10637,15.8,31.6,1816,2.6,63.2,0,1750,1750,8827
2000,47,c) 2,6077,6427,67165,67991,325,4.7,1348,19.4,16604,4059,12545,6,24.4,18256,9675,8581,14.2,26.9,-1652,-2.5,48.8,0,1044,1044,7451
2000,47,d) 3,4942,5111,48967,49941,203,3.7,1031,18.7,9845,1464,8381,2.9,19.7,11792,6860,4932,13.7,23.6,-1947,-3.9,39.4,0,766,766,4391
2000,47,e) 4,4651,4769,48655,51032,162,3.2,832,16.3,9362,1589,7773,3.1,18.3,14115,9160,4955,17.9,27.7,-4753,-9.4,36.6,0,605,605,4800
2000,47,f) 5,4121,4252,44864,44633,129,2.9,626,13.9,7899,982,6917,2.2,17.7,7437,2938,4499,6.6,16.7,462,1,33.4,0,453,453,2036
2000,47,g) 6 to 10,15466,16670,198469,198692,589,3.4,1941,11.2,33300,7895,25405,4,16.8,33745,13212,20533,6.6,17,-445,-0.2,33.6,0,1363,1363,8643
2000,47,h) 11 to 15,11962,13855,222662,218666,484,3.4,1287,9,36514,7701,28813,3.5,16.7,28521,10484,18037,4.8,13,7993,3.7,26,0,782,782,5108
2000,47,i) 16 to 20,9023,10709,167960,170247,286,2.6,783,7.1,21084,4865,16219,2.9,12.4,25659,7900,17759,4.6,15.1,-4575,-2.7,24.8,0,415,415,2731
2000,47,j) 21 to 25,4709,7801,196358,191132,524,6.7,647,8.2,36569,13236,23333,6.9,19.1,26116,10240,15876,5.4,13.7,10453,5.4,27.4,0,210,210,1323
2000,47,l) Left Censored,14611,33467,1250974,1250387,2053,6.1,2465,7.3,155712,44650,111062,3.6,12.5,154538,53727,100811,4.3,12.4,1174,0.1,24.8,0,560,560,3737
2000,48,a) 0,33538,33887,238912,119933,33615,198.4,0,0,237959,237959,0,198.4,198.4,0,0,0,0,0,237959,198.4,0,0,,,
2000,48,b) 1,26493,27093,253183,251891,350,1.1,8024,25.8,79049,11121,67928,4.4,31.4,76465,44317,32148,17.6,30.4,2584,1,60.8,0,6072,6072,34959
2000,48,c) 2,23069,24158,262263,262615,1176,4.5,5103,19.5,65330,17157,48173,6.5,24.9,66034,33932,32102,12.9,25.1,-704,-0.2,49.8,0,3932,3932,27139
2000,48,d) 3,19915,20618,211661,219396,690,3.1,3890,17.5,44538,8104,36434,3.7,20.3,60008,34163,25845,15.6,27.4,-15470,-7.1,40.6,0,2954,2954,25858
2000,48,e) 4,17582,18441,196621,200125,618,3.1,3106,15.8,38010,5100,32910,2.5,19,45018,22856,22162,11.4,22.5,-7008,-3.5,38,0,2265,2265,17037
2000,48,f) 5,15589,16414,176406,179629,622,3.6,2528,14.6,33352,4467,28885,2.5,18.6,39798,19873,19925,11.1,22.2,-6446,-3.6,37.2,0,1825,1825,15446
2000,48,g) 6 to 10,58240,63303,799237,807463,1922,2.9,7646,11.6,133508,26082,107426,3.2,16.5,149960,64153,85807,7.9,18.6,-16452,-2.1,33,0,5273,5273,38437
2000,48,h) 11 to 15,39302,46588,804356,800267,1822,3.8,4366,9.1,126955,30038,96917,3.8,15.9,118777,41491,77286,5.2,14.8,8178,1.1,29.6,0,2647,2647,20519
2000,48,i) 16 to 20,33104,39960,651442,653136,1317,3.2,3248,7.9,100024,23975,76049,3.7,15.3,103412,41955,61457,6.4,15.8,-3388,-0.5,30.6,0,1756,1756,12150
2000,48,j) 21 to 25,14735,22874,474748,469924,1102,4.7,1805,7.8,72909,22704,50205,4.8,15.5,63262,18372,44890,3.9,13.5,9647,2,27,0,759,759,4416
2000,48,l) Left Censored,37028,104111,3817276,3784869,7769,7.4,9139,8.7,572758,182871,389887,4.8,15.1,507943,180462,327481,4.8,13.4,64815,1.7,26.8,0,1685,1685,12538
2000,49,a) 0,4725,4759,31012,15555,4728,198.7,0,0,30914,30914,0,198.7,198.7,0,0,0,0,0,30914,198.7,0,0,,,
2000,49,b) 1,3770,3816,30971,31750,32,0.7,1178,26.7,8586,962,7624,3,27,10143,5547,4596,17.5,31.9,-1557,-4.9,54,0,904,904,4572
2000,49,c) 2,3124,3212,40297,41515,136,3.9,700,20,6696,1390,5306,3.3,16.1,9131,4445,4686,10.7,22,-2435,-5.9,32.2,0,536,536,3594
2000,49,d) 3,2681,2744,24659,25017,120,4.1,495,16.9,4985,846,4139,3.4,19.9,5701,2982,2719,11.9,22.8,-716,-2.9,39.8,0,360,360,2305
2000,49,e) 4,2383,2477,30796,30904,91,3.5,382,14.6,5626,795,4831,2.6,18.2,5841,2678,3163,8.7,18.9,-215,-0.7,36.4,0,272,272,2049
2000,49,f) 5,1934,1991,25919,25843,67,3.2,287,13.7,5406,1033,4373,4,20.9,5253,2077,3176,8,20.3,153,0.6,40.6,0,193,193,1334
2000,49,g) 6 to 10,6403,6844,90118,90713,191,2.7,822,11.5,15981,1903,14078,2.1,17.6,17171,7323,9848,8.1,18.9,-1190,-1.3,35.2,0,576,576,4864
2000,49,h) 11 to 15,3870,4474,92628,93461,171,3.7,410,8.9,12736,3429,9307,3.7,13.6,14401,4492,9909,4.8,15.4,-1665,-1.8,27.2,0,248,248,2481
2000,49,i) 16 to 20,2850,3373,61802,61898,125,3.6,265,7.7,9194,1920,7274,3.1,14.9,9385,2820,6565,4.6,15.2,-191,-0.3,29.8,0,140,140,1333
2000,49,j) 21 to 25,1693,2385,45899,46634,93,3.8,166,6.8,4794,1133,3661,2.4,10.3,6264,1682,4582,3.6,13.4,-1470,-3.1,20.6,0,78,78,531
2000,49,l) Left Censored,4760,11018,431081,426560,967,8.8,810,7.4,57157,17647,39510,4.1,13.4,48115,14363,33752,3.4,11.3,9042,2.1,22.6,0,180,180,1280
2000,50,a) 0,1297,1307,6898,3454,1300,198.9,0,0,6888,6888,0,199.4,199.4,0,0,0,0,0,6888,199.4,0,0,,,
2000,50,b) 1,1071,1082,6475,6574,8,0.7,251,20.8,1643,100,1543,1.5,25,1840,1221,619,18.6,28,-197,-3,50,0,178,178,1084
2000,50,c) 2,1028,1079,7430,7733,32,2.8,165,14.4,1326,274,1052,3.5,17.1,1931,1010,921,13.1,25,-605,-7.9,34.2,0,127,127,889
2000,50,d) 3,900,912,4929,4962,26,2.7,138,14.3,875,87,788,1.8,17.6,941,497,444,10,19,-66,-1.4,35.2,0,106,106,430
2000,50,e) 4,799,806,5552,5608,23,2.7,93,11,807,100,707,1.8,14.4,919,447,472,8,16.4,-112,-2,28.8,0,66,66,307
2000,50,f) 5,711,716,5930,5879,15,2,88,11.7,802,64,738,1.1,13.6,699,324,375,5.5,11.9,103,1.7,23.8,0,64,64,252
2000,50,g) 6 to 10,2973,3075,23133,22994,68,2.1,274,8.6,3729,861,2868,3.7,16.2,3450,1153,2297,5,15,279,1.2,30,0,210,210,942
2000,50,h) 11 to 15,2619,2793,27477,27338,87,3.1,206,7.2,3459,649,2810,2.4,12.7,3181,1103,2078,4,11.6,278,1.1,23.2,0,129,129,586
2000,50,i) 16 to 20,1683,1922,28026,27662,58,3,116,5.9,3255,390,2865,1.4,11.8,2526,602,1924,2.2,9.1,729,2.7,18.2,0,72,72,340
2000,50,j) 21 to 25,788,1006,17818,17650,35,3.4,62,6.1,2002,367,1635,2.1,11.3,1666,366,1300,2.1,9.4,336,1.9,18.8,0,37,37,236
2000,50,l) Left Censored,2646,4216,118768,118177,182,4.3,269,6.3,13336,3409,9927,2.9,11.3,12154,3533,8621,3,10.3,1182,1,20.6,0,94,94,399
2000,51,a) 0,11631,11736,69433,34889,11654,198.6,0,0,69088,69088,0,198,198,0,0,0,0,0,69088,198,0,0,,,
2000,51,b) 1,9130,9317,73430,70960,139,1.3,2530,23.9,24042,4659,19383,6.6,33.9,19101,10160,8941,14.3,26.9,4941,7,53.8,0,1908,1908,8157
2000,51,c) 2,8399,8764,79119,77974,455,4.9,1602,17.2,20336,5403,14933,6.9,26.1,18045,7835,10210,10,23.1,2291,3,46.2,0,1198,1198,5855
2000,51,d) 3,7227,7389,65886,63649,249,3.2,1199,15.3,16075,3033,13042,4.8,25.3,11601,5753,5848,9,18.2,4474,7.1,36.4,0,890,890,4523
2000,51,e) 4,6273,6456,60397,60447,209,3.1,928,13.6,11377,1205,10172,2,18.8,11476,5469,6007,9,19,-99,-0.2,37.6,0,693,693,3626
2000,51,f) 5,5926,6137,56334,56243,203,3.2,820,12.7,10626,903,9723,1.6,18.9,10443,5015,5428,8.9,18.6,183,0.3,37.2,0,594,594,3483
2000,51,g) 6 to 10,21700,22935,276456,272862,625,2.6,2411,10.1,48409,9497,38912,3.5,17.7,41220,15647,25573,5.7,15.1,7189,2.6,30.2,0,1645,1645,9494
2000,51,h) 11 to 15,16871,19501,308507,303727,679,3.4,1643,8.2,53950,14896,39054,4.9,17.8,44389,15926,28463,5.2,14.6,9561,3.2,29.2,0,960,960,6327
2000,51,i) 16 to 20,11140,13311,239478,238748,382,2.8,969,7.1,29981,6188,23793,2.6,12.6,28520,10034,18486,4.2,11.9,1461,0.7,23.8,0,515,515,3327
2000,51,j) 21 to 25,5419,8145,166021,163743,320,3.9,592,7.1,24918,8077,16841,4.9,15.2,20361,7439,12922,4.5,12.4,4557,2.8,24.8,0,236,236,1561
2000,51,l) Left Censored,17446,42345,1452804,1445755,2753,6.5,3253,7.6,192889,61891,130998,4.3,13.3,178790,67781,111009,4.7,12.4,14099,0.9,24.8,0,688,688,5215
2000,53,a) 0,12281,12353,72202,36214,12233,198.1,0,0,71977,71977,0,198.8,198.8,0,0,0,0,0,71977,198.8,0,0,,,
2000,53,b) 1,9856,10057,84174,80817,127,1.1,3035,26.2,25341,2887,22454,3.6,31.4,18626,9835,8791,12.2,23,6715,8.4,46,0,2187,2187,7433
2000,53,c) 2,8626,9053,74226,73954,484,5,1860,19.1,19244,5943,13301,8,26,18700,9089,9611,12.3,25.3,544,0.7,50.6,0,1396,1396,6719
2000,53,d) 3,7329,7501,60766,61099,304,3.8,1368,17,12860,1503,11357,2.5,21,13526,6141,7385,10.1,22.1,-666,-1.1,42,0,1000,1000,4788
2000,53,e) 4,6477,6626,54353,55318,235,3.3,1110,15.7,10316,963,9353,1.7,18.6,12246,6266,5980,11.3,22.1,-1930,-3.5,37.2,0,769,769,4294
2000,53,f) 5,5756,5896,54729,57648,214,3.4,976,15.6,8946,1372,7574,2.4,15.5,14784,5926,8858,10.3,25.6,-5838,-10.1,31,0,674,674,4119
2000,53,g) 6 to 10,22058,23261,223006,225677,766,3.1,2972,12.2,35583,4941,30642,2.2,15.8,40924,16407,24517,7.3,18.1,-5341,-2.3,31.6,0,1949,1949,10137
2000,53,h) 11 to 15,14110,15876,225542,226430,564,3.5,1526,9.3,31048,4684,26364,2.1,13.7,32824,11740,21084,5.2,14.5,-1776,-0.8,27.4,0,961,961,6578
2000,53,i) 16 to 20,10543,12750,219451,218665,394,3,1107,8.4,29154,7305,21849,3.3,13.3,27582,9636,17946,4.4,12.6,1572,0.7,25.2,0,616,616,3591
2000,53,j) 21 to 25,5485,7824,144141,142518,328,4.1,618,7.8,21192,6115,15077,4.3,14.9,17945,6057,11888,4.2,12.6,3247,2.3,25.2,0,280,280,1631
2000,53,l) Left Censored,14243,30615,1013933,1006435,1821,5.9,2347,7.6,137309,41439,95870,4.1,13.6,122314,38279,84035,3.8,12.2,14995,1.4,24.4,0,539,552,5069
2000,54,a) 0,2343,2367,12838,6455,2344,198.1,0,0,12766,12766,0,197.8,197.8,0,0,0,0,0,12766,197.8,0,0,,,
2000,54,b) 1,1916,1954,13790,13776,22,1,551,24.6,4030,789,3241,5.7,29.3,4002,2388,1614,17.3,29.1,28,0.2,58.2,0,415,415,2020
2000,54,c) 2,1706,1860,15062,14941,104,5.2,358,18,3674,1497,2177,10,24.6,3432,1468,1964,9.8,23,242,1.6,46,0,280,280,1202
2000,54,d) 3,1556,1567,10713,10864,47,2.8,252,15.1,2114,122,1992,1.1,19.5,2415,1172,1243,10.8,22.2,-301,-2.7,39,0,181,181,840
2000,54,e) 4,1361,1395,10574,10826,39,2.6,223,15,1804,215,1589,2,16.7,2307,1194,1113,11,21.3,-503,-4.6,33.4,0,172,172,912
2000,54,f) 5,1297,1335,10031,10219,32,2.3,194,13.7,1681,368,1313,3.6,16.4,2057,1002,1055,9.8,20.1,-376,-3.7,32.8,0,144,144,816
2000,54,g) 6 to 10,4941,5147,44918,45258,136,2.5,618,11.5,7570,1215,6355,2.7,16.7,8250,3729,4521,8.2,18.2,-680,-1.5,33.4,0,417,417,2392
2000,54,h) 11 to 15,3960,4383,63231,62523,112,2.5,361,8,8844,3185,5659,5.1,14.1,7428,2783,4645,4.5,11.9,1416,2.2,23.8,0,246,246,1573
2000,54,i) 16 to 20,3166,3548,41587,42170,86,2.4,250,6.9,4076,801,3275,1.9,9.7,5242,1860,3382,4.4,12.4,-1166,-2.7,19.4,0,139,139,975
2000,54,j) 21 to 25,1643,2524,40405,40429,149,5.9,157,6.2,4684,1273,3411,3.1,11.6,4731,1090,3641,2.7,11.7,-47,-0.1,23.2,0,70,70,398
2000,54,l) Left Censored,6116,11328,289162,287159,569,5,760,6.7,30681,8922,21759,3.1,10.7,26675,6874,19801,2.4,9.3,4006,1.4,18.6,0,229,229,1009
2000,55,a) 0,8206,8245,49385,24855,8178,198.4,0,0,49061,49061,0,197.4,197.4,0,0,0,0,0,49061,197.4,0,0,,,
2000,55,b) 1,6761,7001,60793,58035,86,1.1,1510,19.5,17812,3331,14481,5.7,30.7,12295,6496,5799,11.2,21.2,5517,9.5,42.4,0,1114,1114,4792
2000,55,c) 2,6169,6486,61668,62021,279,4,1082,15.7,13639,4311,9328,7,22,14345,6659,7686,10.7,23.1,-706,-1.1,44,0,808,808,4672
2000,55,d) 3,5481,5649,44044,44331,192,3.2,815,13.7,7746,1052,6694,2.4,17.5,8320,4230,4090,9.5,18.8,-574,-1.3,35,0,606,606,3187
2000,55,e) 4,4946,5007,43960,44589,107,2,624,11.9,6491,574,5917,1.3,14.6,7749,3230,4519,7.2,17.4,-1258,-2.8,29.2,0,466,466,2403
2000,55,f) 5,4550,4710,42340,42163,126,2.6,526,10.7,6766,660,6106,1.6,16,6412,2832,3580,6.7,15.2,354,0.8,30.4,0,381,381,2161
2000,55,g) 6 to 10,17623,18660,190267,191102,422,2.2,1841,9.5,26694,3861,22833,2,14,28364,11325,17039,5.9,14.8,-1670,-0.8,28,0,1314,1314,7694
2000,55,h) 11 to 15,13452,15282,221925,224533,359,2.3,1238,7.9,27238,3842,23396,1.7,12.1,32453,13774,18679,6.1,14.5,-5215,-2.4,24.2,0,849,849,5237
2000,55,i) 16 to 20,9514,11071,179416,179850,282,2.5,736,6.5,19066,3614,15452,2,10.6,19934,5758,14176,3.2,11.1,-868,-0.5,21.2,0,456,456,2764
2000,55,j) 21 to 25,5283,7801,145064,141421,325,4.1,549,6.9,22065,7934,14131,5.6,15.6,14778,4415,10363,3.1,10.4,7287,5.2,20.8,0,268,268,1579
2000,55,l) Left Censored,19238,35451,1352656,1349284,1780,5,2248,6.3,135304,37623,97681,2.8,10,128560,36651,91909,2.7,9.5,6744,0.5,19,0,758,758,6303
2000,56,a) 0,1331,1334,6609,3320,1318,197.6,0,0,6579,6579,0,198.2,198.2,0,0,0,0,0,6579,198.2,0,0,,,
2000,56,b) 1,1009,1027,6250,6132,13,1.1,284,24.3,1947,459,1488,7.5,31.8,1710,942,768,15.4,27.9,237,3.9,55.8,0,207,207,742
2000,56,c) 2,954,990,7257,7136,55,5.2,172,16.3,1837,603,1234,8.5,25.7,1595,717,878,10,22.4,242,3.3,44.8,0,126,126,603
2000,56,d) 3,807,823,4893,4926,37,4.2,142,16.3,968,213,755,4.3,19.7,1034,513,521,10.4,21,-66,-1.3,39.4,0,107,107,402
2000,56,e) 4,754,787,5152,5172,17,2.1,97,11.8,932,145,787,2.8,18,972,415,557,8,18.8,-40,-0.8,36,0,69,69,323
2000,56,f) 5,646,655,4730,4781,24,3.5,87,12.7,700,68,632,1.4,14.6,801,342,459,7.2,16.8,-101,-2.2,29.2,0,62,62,292
2000,56,g) 6 to 10,2323,2391,18931,19347,77,3.1,291,11.7,2975,490,2485,2.5,15.4,3807,1352,2455,7,19.7,-832,-4.3,30.8,0,210,210,1061
2000,56,h) 11 to 15,1515,1649,21022,21325,45,2.7,147,8.7,2247,204,2043,1,10.5,2853,907,1946,4.3,13.4,-606,-2.9,21,0,100,100,537
2000,56,i) 16 to 20,1392,1617,16500,16249,47,2.8,129,7.8,2452,412,2040,2.5,15.1,1949,752,1197,4.6,12,503,3.1,24,0,79,79,371
2000,56,j) 21 to 25,799,1041,14322,14013,40,3.8,58,5.5,2180,447,1733,3.2,15.6,1562,463,1099,3.3,11.1,618,4.5,22.2,0,33,33,139
2000,56,l) Left Censored,2010,3385,65924,65953,165,4.8,227,6.6,7653,1899,5754,2.9,11.6,7710,2827,4883,4.3,11.7,-57,-0.1,23.2,0,54,54,225
2001,01,a) 0,6053,6142,36655,18564,6089,198.3,0,0,36182,36182,0,194.9,194.9,0,0,0,0,0,36182,194.9,0,0,,,
2001,01,b) 1,4890,5010,38780,38894,70,1.2,1609,27.8,11266,1742,9524,4.5,29,11494,6215,5279,16,29.6,-228,-0.6,58,0,1218,1220,4878
2001,01,c) 2,4474,4617,41522,45034,195,3.9,1025,20.4,8549,1952,6597,4.3,19,15573,9273,6300,20.6,34.6,-7024,-15.6,38,0,774,774,7376
2001,01,d) 3,4189,4430,44526,47240,214,4.6,794,16.9,8561,2190,6371,4.6,18.1,13988,6680,7308,14.1,29.6,-5427,-11.5,36.2,0,622,622,5642
2001,01,e) 4,3698,3809,34797,35896,117,2.9,618,15.3,5668,918,4750,2.6,15.8,7866,3385,4481,9.4,21.9,-2198,-6.1,31.6,0,442,442,2397
2001,01,f) 5,3296,3433,27737,29242,111,3.1,548,15.1,4353,1042,3311,3.6,14.9,7363,3419,3944,11.7,25.2,-3010,-10.3,29.8,0,379,379,2463
2001,01,g) 6 to 10,12247,12976,144367,150590,371,2.7,1713,12.6,18320,2582,15738,1.7,12.2,30766,13343,17423,8.9,20.4,-12446,-8.2,24.4,0,1138,1138,7337
2001,01,h) 11 to 15,8828,10051,164157,166016,290,2.8,1038,10,21074,5690,15384,3.4,12.7,24791,7443,17348,4.5,14.9,-3717,-2.2,25.4,0,642,642,4139
2001,01,i) 16 to 20,7026,8517,144099,146366,309,3.6,642,7.4,16011,3811,12200,2.6,10.9,20546,6714,13832,4.6,14,-4535,-3.1,21.8,0,332,332,3214
2001,01,j) 21 to 25,4391,6626,133563,134112,277,4.1,564,8.3,16283,5198,11085,3.9,12.1,17380,4732,12648,3.5,13,-1097,-0.9,24.2,0,214,214,1506
2001,01,l) Left Censored,10852,24414,792777,814720,1484,6,1795,7.3,74240,24187,50053,3,9.1,118125,30862,87263,3.8,14.5,-43885,-5.4,18.2,0,436,436,3608
2001,02,a) 0,1175,1182,5930,3122,1161,196.4,0,0,5617,5617,0,179.9,179.9,0,0,0,0,0,5617,179.9,0,0,,,
2001,02,b) 1,952,970,7443,7620,13,1.2,322,28.6,2555,874,1681,11.5,33.5,2908,1471,1437,19.3,38.2,-353,-4.7,67,0,177,177,685
2001,02,c) 2,760,792,6241,6440,33,3.8,193,22.2,1414,176,1238,2.7,22,1812,983,829,15.3,28.1,-398,-6.1,44,0,124,124,759
2001,02,d) 3,780,831,6834,6761,57,6.5,145,16.6,1718,517,1201,7.6,25.4,1571,544,1027,8,23.2,147,2.2,46.4,0,89,89,384
2001,02,e) 4,672,683,5040,5186,33,4.6,116,16.1,917,160,757,3.1,17.7,1209,451,758,8.7,23.3,-292,-5.6,35.4,0,65,65,307
2001,02,f) 5,592,601,3917,4129,18,2.8,96,15.1,594,121,473,2.9,14.4,1017,446,571,10.8,24.6,-423,-10.2,28.8,0,63,63,311
2001,02,g) 6 to 10,2204,2296,16374,17268,87,3.6,311,13,2545,261,2284,1.5,14.7,4332,1963,2369,11.4,25.1,-1787,-10.4,29.4,0,197,197,1345
2001,02,h) 11 to 15,1632,1743,23846,23965,52,2.9,194,10.7,2664,304,2360,1.3,11.1,2901,970,1931,4,12.1,-237,-1,22.2,0,107,107,563
2001,02,i) 16 to 20,1394,1636,19813,20092,39,2.3,156,9.2,2493,401,2092,2,12.4,3051,997,2054,5,15.2,-558,-2.8,24.8,0,78,78,444
2001,02,j) 21 to 25,895,1335,24456,23413,78,5.8,93,6.9,4677,1722,2955,7.4,20,2591,862,1729,3.7,11.1,2086,8.9,22.2,0,32,32,127
2001,02,l) Left Censored,1622,3274,92185,90381,293,9.1,206,6.4,12875,3438,9437,3.8,14.2,9266,2563,6703,2.8,10.3,3609,3.9,20.6,0,40,40,331
2001,04,a) 0,9165,9281,72790,36663,9218,198.6,0,0,72255,72255,0,197.1,197.1,0,0,0,0,0,72255,197.1,0,0,,,
2001,04,b) 1,7123,7261,68994,67154,90,1.1,2110,25.5,20593,2627,17966,3.9,30.7,16913,9644,7269,14.4,25.2,3680,5.5,50.4,0,1524,1526,7411
2001,04,c) 2,6276,6459,78302,79086,277,4,1370,19.6,16485,3524,12961,4.5,20.8,18053,8494,9559,10.7,22.8,-1568,-2,41.6,0,1003,1003,6142
2001,04,d) 3,5387,5712,67992,70149,288,4.8,1039,17.1,15463,3394,12069,4.8,22,19776,8097,11679,11.5,28.2,-4313,-6.2,44,0,757,757,6581
2001,04,e) 4,4633,4833,51724,54632,171,3.3,829,16.1,8455,1256,7199,2.3,15.5,14270,5356,8914,9.8,26.1,-5815,-10.6,31,0,581,581,3913
2001,04,f) 5,4119,4261,42699,45292,143,3.2,663,14.7,6901,1247,5654,2.8,15.2,12086,4152,7934,9.2,26.7,-5185,-11.5,30.4,0,464,464,2970
2001,04,g) 6 to 10,14265,15213,201300,207975,498,3.1,2006,12.6,29513,5039,24474,2.4,14.2,42863,15370,27493,7.4,20.6,-13350,-6.4,28.4,0,1277,1277,8549
2001,04,h) 11 to 15,9651,11227,195158,196344,403,3.5,1184,10.2,28741,10174,18567,5.2,14.6,31113,12673,18440,6.5,15.8,-2372,-1.2,29.2,0,662,662,5853
2001,04,i) 16 to 20,7002,9110,173974,175173,598,6.5,836,9.1,25613,8436,17177,4.8,14.6,28011,11685,16326,6.7,16,-2398,-1.4,29.2,0,379,379,3655
2001,04,j) 21 to 25,4124,6313,159905,156681,352,5.5,460,7.2,24784,6838,17946,4.4,15.8,18335,6630,11705,4.2,11.7,6449,4.1,23.4,0,187,187,1413
2001,04,l) Left Censored,7949,21981,826138,829210,2224,10.2,1937,8.9,124974,47085,77889,5.7,15.1,131117,46036,85081,5.6,15.8,-6143,-0.7,30.2,0,262,262,3024
2001,05,a) 0,4137,4204,23755,11939,4173,198.5,0,0,23632,23632,0,197.9,197.9,0,0,0,0,0,23632,197.9,0,0,,,
2001,05,b) 1,3240,3302,23979,26312,42,1.1,1077,28.2,5933,577,5356,2.2,22.5,10599,6123,4476,23.3,40.3,-4666,-17.8,45,0,790,790,4790
2001,05,c) 2,2898,2984,22587,23707,97,3,683,20.9,4316,780,3536,3.3,18.2,6556,3115,3441,13.1,27.7,-2240,-9.5,36.4,0,497,497,2178
2001,05,d) 3,2558,2789,26201,27330,156,5.3,486,16.5,5154,2331,2823,8.5,18.9,7411,2013,5398,7.4,27.1,-2257,-8.2,37.8,0,354,354,1529
2001,05,e) 4,2239,2265,19185,21332,66,2.7,412,17,2872,327,2545,1.5,13.5,7165,3633,3532,17,33.6,-4293,-20.1,27,0,290,290,1635
2001,05,f) 5,2007,2097,20073,20741,88,4,320,14.5,3044,606,2438,2.9,14.7,4380,1632,2748,7.9,21.1,-1336,-6.4,29.4,0,229,229,1156
2001,05,g) 6 to 10,8008,8492,82494,84957,277,3.1,1031,11.7,11189,2268,8921,2.7,13.2,16114,5464,10650,6.4,19,-4925,-5.8,26.4,0,664,664,3641
2001,05,h) 11 to 15,5252,5897,78808,80364,183,3,612,10.1,8962,1912,7050,2.4,11.2,12074,4192,7882,5.2,15,-3112,-3.8,22.4,0,389,389,2672
2001,05,i) 16 to 20,4505,5136,75597,77206,169,3.2,393,7.5,8801,2322,6479,3,11.4,12018,3764,8254,4.9,15.6,-3217,-4.2,22.8,0,206,206,1251
2001,05,j) 21 to 25,3054,4177,90164,90597,188,4.4,329,7.8,9471,2466,7005,2.7,10.5,10337,2106,8231,2.3,11.4,-866,-0.9,21,0,178,179,882
2001,05,l) Left Censored,7134,14690,520716,522214,834,5.7,905,6.2,56679,13512,43167,2.6,10.9,59674,16264,43410,3.1,11.4,-2995,-0.5,21.8,0,237,237,1371
2001,06,a) 0,61356,61977,401003,201654,61460,198.3,0,0,398699,398699,0,197.7,197.7,0,0,0,0,0,398699,197.7,0,0,,,
2001,06,b) 1,47468,48395,463500,445573,564,1,13694,24.9,154186,17660,136526,4,34.6,118332,60991,57341,13.7,26.6,35854,8,53.2,0,9547,9551,45110
2001,06,c) 2,40044,41481,434901,440747,1817,4.1,8640,19.3,111287,19811,91476,4.5,25.2,122979,60260,62719,13.7,27.9,-11692,-2.7,50.4,0,6187,6187,43608
2001,06,d) 3,35503,37877,469548,468118,1976,4.9,6588,16.5,110474,31829,78645,6.8,23.6,107613,48706,58907,10.4,23,2861,0.6,46,0,4695,4695,37930
2001,06,e) 4,29987,30842,352491,363019,1068,3.3,5240,16,64304,7797,56507,2.1,17.7,85362,39674,45688,10.9,23.5,-21058,-5.8,35.4,0,3654,3654,25405
2001,06,f) 5,26640,27534,321460,325213,1050,3.6,4435,15.3,60396,8010,52386,2.5,18.6,67902,31101,36801,9.6,20.9,-7506,-2.3,37.2,0,3079,3079,21419
2001,06,g) 6 to 10,96278,102413,1334672,1348081,3678,3.4,13651,12.8,224101,48222,175879,3.6,16.6,250919,104658,146261,7.8,18.6,-26818,-2,33.2,0,8881,8882,66305
2001,06,h) 11 to 15,77709,88270,1403656,1427660,3321,3.6,9511,10.4,194617,33694,160923,2.4,13.6,242626,81158,161468,5.7,17,-48009,-3.4,27.2,0,5585,5585,39327
2001,06,i) 16 to 20,56098,68778,1273986,1277234,2865,4.1,6166,8.8,189751,52663,137088,4.1,14.9,196246,61937,134309,4.8,15.4,-6495,-0.5,29.8,0,3194,3204,22606
2001,06,j) 21 to 25,35797,50967,1115672,1124623,2085,4,4214,8.1,151235,35674,115561,3.2,13.4,169136,72048,97088,6.4,15,-17901,-1.6,26.8,0,1984,1997,13060
2001,06,l) Left Censored,64523,150097,5440551,5431562,11269,7.5,10795,7.2,709568,226102,483466,4.2,13.1,691590,204254,487336,3.8,12.7,17978,0.4,25.4,0,2809,2818,23405
2001,08,a) 0,11449,11540,62071,31364,11449,198.4,0,0,61414,61414,0,195.8,195.8,0,0,0,0,0,61414,195.8,0,0,,,
2001,08,b) 1,8871,9024,67946,66190,103,1,2587,25.2,22022,2668,19354,4,33.3,18509,10564,7945,16,28,3513,5.3,56,0,1792,1795,8219
2001,08,c) 2,7487,7688,62178,64371,302,3.6,1652,19.8,13136,2460,10676,3.8,20.4,17521,8967,8554,13.9,27.2,-4385,-6.8,40.8,0,1175,1175,6764
2001,08,d) 3,6814,7112,62879,63931,368,4.9,1243,16.5,13705,3922,9783,6.1,21.4,15809,7476,8333,11.7,24.7,-2104,-3.3,42.8,0,880,880,4964
2001,08,e) 4,5726,5885,53339,56461,212,3.4,970,15.5,7837,918,6919,1.6,13.9,14080,6740,7340,11.9,24.9,-6243,-11,27.8,0,676,676,5142
2001,08,f) 5,5049,5199,49014,50122,178,3.3,741,13.6,8660,1524,7136,3,17.3,10875,5142,5733,10.3,21.7,-2215,-4.4,34.6,0,514,514,3255
2001,08,g) 6 to 10,18279,19239,202076,206448,686,3.4,2403,12,31566,5380,26186,2.6,15.3,40310,16072,24238,7.8,19.5,-8744,-4.2,30.6,0,1576,1576,9768
2001,08,h) 11 to 15,11204,12711,199019,201331,425,3.2,1292,9.9,27985,8113,19872,4,13.9,32609,11937,20672,5.9,16.2,-4624,-2.3,27.8,0,741,741,6151
2001,08,i) 16 to 20,8290,10425,200862,198723,800,7.6,1045,9.9,44545,22246,22299,11.2,22.4,40266,18946,21320,9.5,20.3,4279,2.1,40.6,0,449,449,2805
2001,08,j) 21 to 25,5256,7496,155263,155400,379,5,554,7.3,21184,7296,13888,4.7,13.6,21457,6256,15201,4,13.8,-273,-0.2,27.2,0,269,269,1614
2001,08,l) Left Censored,10452,23981,839330,827802,1987,8.3,1825,7.6,133356,38174,95182,4.6,16.1,110301,31460,78841,3.8,13.3,23055,2.8,26.6,0,379,380,2971
2001,09,a) 0,4939,4979,29852,15012,4919,197.6,0,0,29680,29680,0,197.7,197.7,0,0,0,0,0,29680,197.7,0,0,,,
2001,09,b) 1,4195,4270,36573,35068,58,1.2,1068,22.4,12099,1129,10970,3.2,34.5,9088,4162,4926,11.9,25.9,3011,8.6,51.8,0,727,727,2732
2001,09,c) 2,3643,3722,35946,36502,124,3.1,703,17.6,7303,1232,6071,3.4,20,8415,4259,4156,11.7,23.1,-1112,-3.1,40,0,516,516,3506
2001,09,d) 3,3594,3805,35192,35420,173,4.4,535,13.5,5948,1414,4534,4,16.8,6403,2442,3961,6.9,18.1,-455,-1.3,33.6,0,378,378,1739
2001,09,e) 4,3003,3066,26706,27254,88,2.7,436,13.5,3910,625,3285,2.3,14.3,5006,2048,2958,7.5,18.4,-1096,-4.1,28.6,0,309,309,1462
2001,09,f) 5,2746,2796,34403,35055,81,2.7,402,13.6,3842,502,3340,1.4,11,5146,2174,2972,6.2,14.7,-1304,-3.7,22,0,289,289,1738
2001,09,g) 6 to 10,11098,11496,124165,127452,266,2.2,1282,10.7,14658,2790,11868,2.2,11.5,21232,8077,13155,6.3,16.7,-6574,-5.2,23,0,881,881,5511
2001,09,h) 11 to 15,10023,10798,134987,136151,303,2.7,1027,9.2,16281,4942,11339,3.6,12,18608,6249,12359,4.6,13.7,-2327,-1.7,24,0,630,630,3376
2001,09,i) 16 to 20,7159,8196,115377,116507,267,3.2,615,7.4,12798,2463,10335,2.1,11,15057,4645,10412,4,12.9,-2259,-1.9,22,0,360,361,2433
2001,09,j) 21 to 25,4499,5811,100523,103107,190,3.2,410,6.9,11500,3231,8269,3.1,11.2,16667,5990,10677,5.8,16.2,-5167,-5,22.4,0,190,190,1459
2001,09,l) Left Censored,13763,23896,886183,885044,1654,6.9,1626,6.8,110297,37471,72826,4.2,12.5,108018,37996,70022,4.3,12.2,2279,0.3,24.4,0,476,476,3560
2001,10,a) 0,1596,1607,7643,3881,1585,197.3,0,0,7524,7524,0,193.9,193.9,0,0,0,0,0,7524,193.9,0,0,,,
2001,10,b) 1,1487,1498,9773,9642,19,1.1,346,20.8,2879,123,2756,1.3,29.9,2616,1604,1012,16.6,27.1,263,2.8,54.2,0,237,237,1230
2001,10,c) 2,1191,1207,9377,9579,47,3.6,235,18.1,1947,256,1691,2.7,20.3,2350,1099,1251,11.5,24.5,-403,-4.2,40.6,0,168,168,876
2001,10,d) 3,1093,1142,9105,9888,57,4.8,177,14.8,1331,409,922,4.1,13.5,2896,1466,1430,14.8,29.3,-1565,-15.8,27,0,132,132,1323
2001,10,e) 4,848,872,6726,7014,26,2.8,130,14.1,1028,133,895,1.9,14.7,1604,829,775,11.8,22.9,-576,-8.2,29.4,0,94,94,562
2001,10,f) 5,767,794,7660,8025,25,3,102,12.3,889,66,823,0.8,11.1,1618,969,649,12.1,20.2,-729,-9.1,22.2,0,65,65,700
2001,10,g) 6 to 10,2879,3004,30557,31740,78,2.5,351,11.2,3457,662,2795,2.1,10.9,5822,2974,2848,9.4,18.3,-2365,-7.4,21.8,0,223,223,1299
2001,10,h) 11 to 15,2048,2206,25834,26418,74,3.3,202,8.9,3044,940,2104,3.6,11.5,4212,1364,2848,5.2,15.9,-1168,-4.4,23,0,126,126,944
2001,10,i) 16 to 20,1424,1639,27491,27780,65,3.9,133,8,2773,387,2386,1.4,10,3350,1002,2348,3.6,12.1,-577,-2.1,20,0,67,68,566
2001,10,j) 21 to 25,918,1208,35721,35303,44,3.6,102,8.3,3243,570,2673,1.6,9.2,2407,681,1726,1.9,6.8,836,2.4,13.6,0,40,40,269
2001,10,l) Left Censored,3210,5981,209620,206126,566,9.6,405,6.9,33793,10474,23319,5.1,16.4,26804,5778,21026,2.8,13,6989,3.4,26,0,76,76,597
2001,11,a) 0,1020,1023,8523,4274,1013,198,0,0,8498,8498,0,198.8,198.8,0,0,0,0,0,8498,198.8,0,0,,,
2001,11,b) 1,839,853,9814,9215,20,2.1,187,20,3442,532,2910,5.8,37.4,2244,813,1431,8.8,24.4,1198,13,48.8,0,117,117,571
2001,11,c) 2,750,757,8816,8793,37,4.7,122,15.3,1966,362,1604,4.1,22.4,1919,613,1306,7,21.8,47,0.6,43.6,0,79,79,364
2001,11,d) 3,732,770,8371,8119,50,6.3,101,12.7,1927,670,1257,8.3,23.7,1423,508,915,6.3,17.5,504,6.2,35,0,70,70,319
2001,11,e) 4,662,676,7032,7425,26,3.7,99,13.9,1025,94,931,1.3,13.8,1810,883,927,11.9,24.4,-785,-10.6,27.6,0,58,58,663
2001,11,f) 5,570,577,6545,6643,17,2.8,84,13.9,1156,338,818,5.1,17.4,1351,884,467,13.3,20.3,-195,-2.9,34.8,0,60,60,650
2001,11,g) 6 to 10,2283,2400,36314,36194,85,3.4,265,10.7,4952,1680,3272,4.6,13.7,4711,1800,2911,5,13,241,0.7,26,0,162,162,1007
2001,11,h) 11 to 15,1847,2067,35345,34959,95,4.5,184,8.7,5452,2413,3039,6.9,15.6,4680,1599,3081,4.6,13.4,772,2.2,26.8,0,94,94,577
2001,11,i) 16 to 20,1624,1840,33246,33853,74,3.9,163,8.7,4171,911,3260,2.7,12.3,5385,2629,2756,7.8,15.9,-1214,-3.6,24.6,0,72,74,459
2001,11,j) 21 to 25,1073,1404,46259,48899,69,4.9,80,5.7,5290,1125,4165,2.3,10.8,10569,2746,7823,5.6,21.6,-5279,-10.8,21.6,0,27,27,60
2001,11,l) Left Censored,3535,5896,228451,227774,365,6.2,423,7.2,26924,8541,18383,3.7,11.8,25571,8828,16743,3.9,11.2,1353,0.6,22.4,0,95,95,856
2001,12,a) 0,36445,36882,198653,100042,36543,198.2,0,0,197223,197223,0,197.1,197.1,0,0,0,0,0,197223,197.1,0,0,,,
2001,12,b) 1,26899,27352,197650,194931,260,0.8,8775,27.8,65642,15830,49812,8.1,33.7,60204,37263,22941,19.1,30.9,5438,2.8,61.8,0,6275,6276,27706
2001,12,c) 2,23189,23988,209589,206885,985,3.8,5430,20.8,66307,11139,55168,5.4,32.1,60899,35244,25655,17,29.4,5408,2.7,58.8,0,3905,3905,27935
2001,12,d) 3,20053,20944,185908,191812,1093,4.9,4059,18.2,40894,12180,28714,6.3,21.3,52702,26301,26401,13.7,27.5,-11808,-6.2,42.6,0,2931,2931,17744
2001,12,e) 4,17033,17412,159336,177842,570,3.1,2982,16.1,32237,6565,25672,3.7,18.1,69249,25464,43785,14.3,38.9,-37012,-20.8,36.2,0,2096,2096,12045
2001,12,f) 5,15238,15817,178972,173065,557,3.3,2555,15.3,55499,3263,52236,1.9,32.1,43686,16218,27468,9.4,25.2,11813,6.9,50.4,0,1790,1790,11842
2001,12,g) 6 to 10,57401,60614,719796,730582,2003,3.2,8125,12.8,153089,63014,90075,8.6,21,174660,62886,111774,8.6,23.9,-21571,-2.9,42,0,5305,5306,35060
2001,12,h) 11 to 15,39112,44166,724470,724785,1499,3.3,4605,10.1,110745,20578,90167,2.8,15.3,111375,44989,66386,6.2,15.4,-630,-0.1,30.6,0,2688,2688,17977
2001,12,i) 16 to 20,25439,30695,602989,600575,1174,3.7,2883,9.2,85162,13993,71169,2.3,14.2,80335,30638,49697,5.1,13.4,4827,0.8,26.8,0,1446,1448,11025
2001,12,j) 21 to 25,14113,20905,415779,416897,1100,5.2,1841,8.7,58829,18726,40103,4.5,14.1,61064,24442,36622,5.9,14.6,-2235,-0.5,28.2,0,795,799,4560
2001,12,l) Left Censored,27184,78474,2840391,2796822,6490,8.3,6054,7.7,448627,132611,316016,4.7,16,361489,100943,260546,3.6,12.9,87138,3.1,25.8,0,1103,1113,8540
2001,13,a) 0,14988,15155,92423,46687,15032,198.4,0,0,91472,91472,0,195.9,195.9,0,0,0,0,0,91472,195.9,0,0,,,
2001,13,b) 1,12125,12285,100716,99095,133,0.9,3612,25.8,33114,5880,27234,5.9,33.4,29872,16882,12990,17,30.1,3242,3.3,60.2,0,2570,2572,13311
2001,13,c) 2,10365,10641,113270,115560,472,4.1,2335,20.3,26631,4508,22123,3.9,23,31210,15839,15371,13.7,27,-4579,-4,46,0,1675,1675,12388
2001,13,d) 3,9326,9781,101054,102674,456,4.4,1813,17.4,20959,5868,15091,5.7,20.4,24199,10253,13946,10,23.6,-3240,-3.2,40.8,0,1281,1281,7957
2001,13,e) 4,7749,7958,76405,79423,294,3.5,1394,16.5,13505,1958,11547,2.5,17,19541,9407,10134,11.8,24.6,-6036,-7.6,34,0,989,989,5653
2001,13,f) 5,6894,7118,70390,71752,269,3.6,1096,14.6,12198,2675,9523,3.7,17,14921,6674,8247,9.3,20.8,-2723,-3.8,34,0,747,747,4387
2001,13,g) 6 to 10,24407,26282,314810,322638,936,3.4,3305,12.1,48383,11161,37222,3.5,15,64039,28720,35319,8.9,19.8,-15656,-4.8,30,0,2151,2151,18758
2001,13,h) 11 to 15,16246,18871,314420,321182,664,3.4,1915,9.8,36788,8667,28121,2.7,11.5,50312,15434,34878,4.8,15.7,-13524,-4.2,23,0,1072,1073,6863
2001,13,i) 16 to 20,12127,14711,257516,260458,594,4,1252,8.3,34645,8348,26297,3.2,13.3,40528,11481,29047,4.4,15.6,-5883,-2.3,26.6,0,601,601,4381
2001,13,j) 21 to 25,7158,10729,245744,246021,617,5.7,948,8.7,33399,13870,19529,5.6,13.6,33952,11783,22169,4.8,13.8,-553,-0.2,27.2,0,347,347,1907
2001,13,l) Left Censored,17007,44843,1739612,1757509,3641,8.1,3610,8.1,216239,81418,134821,4.6,12.3,252034,71642,180392,4.1,14.3,-35795,-2,24.6,0,629,629,5589
2001,15,a) 0,1832,1853,17368,8811,1840,198.6,0,0,17115,17115,0,194.2,194.2,0,0,0,0,0,17115,194.2,0,0,,,
2001,15,b) 1,1495,1544,12363,12097,25,1.5,363,21.2,3428,430,2998,3.6,28.3,2896,1562,1334,12.9,23.9,532,4.4,47.8,0,272,274,975
2001,15,c) 2,1165,1207,11986,12099,43,3.3,222,17.2,2436,590,1846,4.9,20.1,2661,1312,1349,10.8,22,-225,-1.9,40.2,0,155,155,934
2001,15,d) 3,1121,1181,12293,12842,52,4.2,180,14.5,2044,376,1668,2.9,15.9,3142,1521,1621,11.8,24.5,-1098,-8.6,31.8,0,126,126,1202
2001,15,e) 4,965,980,8842,9108,20,1.9,153,14.7,1234,103,1131,1.1,13.5,1765,961,804,10.6,19.4,-531,-5.9,27,0,110,110,848
2001,15,f) 5,924,955,9604,9834,21,2.1,125,12.5,1242,54,1188,0.5,12.6,1701,921,780,9.4,17.3,-459,-4.7,25.2,0,91,91,753
2001,15,g) 6 to 10,3562,3761,46538,46982,112,2.9,375,9.7,4896,528,4368,1.1,10.4,5784,2266,3518,4.8,12.3,-888,-1.9,20.8,0,244,244,1469
2001,15,h) 11 to 15,2838,3266,41586,41797,102,3,309,9.2,4352,772,3580,1.8,10.4,4773,1901,2872,4.5,11.4,-421,-1,20.8,0,159,159,1155
2001,15,i) 16 to 20,2361,2857,40384,40440,104,3.6,195,6.7,4708,587,4121,1.5,11.6,4819,2175,2644,5.4,11.9,-111,-0.3,23.2,0,110,110,586
2001,15,j) 21 to 25,1690,2390,35165,36474,131,5.4,183,7.6,3710,906,2804,2.5,10.2,6328,3404,2924,9.3,17.3,-2618,-7.1,20.4,0,62,62,2026
2001,15,l) Left Censored,3844,7355,213352,212141,392,5.3,409,5.6,22988,7710,15278,3.6,10.8,20565,4802,15763,2.3,9.7,2423,1.1,19.4,0,101,101,344
2001,16,a) 0,2964,2992,16323,8203,2964,198.1,0,0,16241,16241,0,198,198,0,0,0,0,0,16241,198,0,0,,,
2001,16,b) 1,2304,2359,20500,19047,38,1.4,703,26.1,7387,570,6817,3,38.8,4481,2615,1866,13.7,23.5,2906,15.3,47,0,461,461,1831
2001,16,c) 2,1981,2036,14764,15263,80,3.6,444,20.1,3179,693,2486,4.5,20.8,4177,2209,1968,14.5,27.4,-998,-6.6,41.6,0,299,299,1593
2001,16,d) 3,1756,1865,17187,18378,104,5.3,352,17.8,2624,915,1709,5,14.3,5006,1974,3032,10.7,27.2,-2382,-12.9,28.6,0,232,232,1572
2001,16,e) 4,1583,1627,12714,13409,67,3.9,289,16.7,1680,319,1361,2.4,12.5,3069,1572,1497,11.7,22.9,-1389,-10.4,25,0,190,190,1085
2001,16,f) 5,1429,1471,15133,16307,48,3.1,228,14.7,1722,224,1498,1.4,10.6,4069,1232,2837,7.6,25,-2347,-14.4,21.2,0,141,141,876
2001,16,g) 6 to 10,4788,4946,41909,43439,152,2.9,718,13.8,6421,878,5543,2,14.8,9480,3909,5571,9,21.8,-3059,-7,29.6,0,422,422,2212
2001,16,h) 11 to 15,3020,3387,43068,44211,114,3.3,365,10.4,5468,1242,4226,2.8,12.4,7754,3114,4640,7,17.5,-2286,-5.1,24.8,0,197,197,1634
2001,16,i) 16 to 20,2219,2725,37063,37547,135,4.8,268,9.6,4810,1780,3030,4.7,12.8,5777,2175,3602,5.8,15.4,-967,-2.6,25.6,0,123,123,569
2001,16,j) 21 to 25,1559,2042,47290,46379,78,3.7,183,8.8,5822,1480,4342,3.2,12.6,3999,996,3003,2.1,8.6,1823,4,17.2,0,92,92,494
2001,16,l) Left Censored,3607,7051,198731,192682,595,8.4,655,9.3,33156,14736,18420,7.6,17.2,21057,6696,14361,3.5,10.9,12099,6.3,21.8,0,123,124,1129
2001,17,a) 0,17913,18040,111039,55875,17874,198.2,0,0,110329,110329,0,197.5,197.5,0,0,0,0,0,110329,197.5,0,0,,,
2001,17,b) 1,15000,15279,120132,119344,177,1,3897,22.7,33308,5633,27675,4.7,27.9,31732,17356,14376,14.5,26.6,1576,1.3,53.2,0,2709,2711,12322
2001,17,c) 2,13342,13762,132439,133442,515,3.5,2574,17.4,30774,7831,22943,5.9,23.1,32781,15108,17673,11.3,24.6,-2007,-1.5,46.2,0,1881,1882,11870
2001,17,d) 3,12387,13045,135125,136240,607,4.4,1974,14.4,26862,7267,19595,5.3,19.7,29091,11628,17463,8.5,21.4,-2229,-1.7,39.4,0,1437,1437,8636
2001,17,e) 4,10947,11498,105764,108796,315,2.6,1675,13.8,18418,2260,16158,2.1,16.9,24482,11080,13402,10.2,22.5,-6064,-5.6,33.8,0,1149,1149,7213
2001,17,f) 5,9962,10133,96970,100004,300,2.8,1360,12.8,15350,2940,12410,2.9,15.3,21418,8127,13291,8.1,21.4,-6068,-6.1,30.6,0,946,946,5786
2001,17,g) 6 to 10,38634,40651,455938,469430,1154,2.7,4544,10.8,61486,10997,50489,2.3,13.1,88470,31587,56883,6.7,18.8,-26984,-5.7,26.2,0,2935,2935,19760
2001,17,h) 11 to 15,28684,32047,525024,525994,860,2.6,2974,9,66378,13691,52687,2.6,12.6,68319,23605,44714,4.5,13,-1941,-0.4,25.2,0,1790,1790,11596
2001,17,i) 16 to 20,21889,25553,480229,486101,738,2.8,2048,7.8,56286,12643,43643,2.6,11.6,68029,22623,45406,4.7,14,-11743,-2.4,23.2,0,1117,1117,8631
2001,17,j) 21 to 25,13980,19115,385981,390494,610,3.1,1362,7,42543,10913,31630,2.8,10.9,51569,14041,37528,3.6,13.2,-9026,-2.3,21.8,0,666,669,4535
2001,17,l) Left Censored,37660,74953,2833901,2879143,4355,5.8,5201,6.9,306858,101694,205164,3.5,10.7,397342,109669,287673,3.8,13.8,-90484,-3.1,21.4,0,1461,1477,12707
2001,18,a) 0,8296,8463,53008,26766,8377,198,0,0,52484,52484,0,196.1,196.1,0,0,0,0,0,52484,196.1,0,0,,,
2001,18,b) 1,6740,6876,61904,60598,81,1,1980,25.3,21362,1856,19506,3.1,35.3,18749,8961,9788,14.8,30.9,2613,4.4,61.8,0,1448,1453,6813
2001,18,c) 2,6062,6271,56500,59259,230,3.4,1204,17.9,11927,4040,7887,6.8,20.1,17445,7467,9978,12.6,29.4,-5518,-9.3,40.2,0,902,902,5815
2001,18,d) 3,5677,6134,69123,71184,291,4.5,1049,16.2,13663,5132,8531,7.2,19.2,17784,7771,10013,10.9,25,-4121,-5.8,38.4,0,753,753,6432
2001,18,e) 4,4950,5156,43868,46455,141,2.6,814,14.9,6739,818,5921,1.8,14.5,11912,4467,7445,9.6,25.6,-5173,-11.1,29,0,612,612,3536
2001,18,f) 5,4486,4625,51523,52946,132,2.7,723,14.7,7065,1136,5929,2.1,13.3,9910,4711,5199,8.9,18.7,-2845,-5.4,26.6,0,485,485,3302
2001,18,g) 6 to 10,17886,19121,203756,210853,481,2.4,2109,10.6,26084,3375,22709,1.6,12.4,40277,18825,21452,8.9,19.1,-14193,-6.7,24.8,0,1405,1405,10667
2001,18,h) 11 to 15,13030,15111,242631,248979,429,2.8,1389,8.9,26707,7283,19424,2.9,10.7,39403,12659,26744,5.1,15.8,-12696,-5.1,21.4,0,793,793,5383
2001,18,i) 16 to 20,10324,12239,193677,197286,325,2.6,1024,8.1,23866,3122,20744,1.6,12.1,31084,9432,21652,4.8,15.8,-7218,-3.7,24.2,0,520,523,3651
2001,18,j) 21 to 25,6576,9168,190899,192377,326,3.5,600,6.5,21877,7842,14035,4.1,11.4,24832,6281,18551,3.3,12.9,-2955,-1.5,22.8,0,292,293,1702
2001,18,l) Left Censored,18267,39156,1422726,1448785,2298,5.8,2809,7.1,138827,39926,98901,2.8,9.6,190945,49832,141113,3.4,13.2,-52118,-3.6,19.2,0,665,665,6416
2001,19,a) 0,4017,4054,24346,12253,4012,197.9,0,0,24187,24187,0,197.4,197.4,0,0,0,0,0,24187,197.4,0,0,,,
2001,19,b) 1,3494,3540,26479,27172,35,0.9,941,23.6,6122,588,5534,2.2,22.5,7508,3671,3837,13.5,27.6,-1386,-5.1,45,0,640,640,2604
2001,19,c) 2,3051,3201,26029,36233,143,4.2,606,17.7,4876,2063,2813,5.7,13.5,25284,2654,22630,7.3,69.8,-20408,-56.3,27,0,405,405,1881
2001,19,d) 3,2855,2991,24949,25824,115,3.6,506,15.9,4268,1420,2848,5.5,16.5,6018,2378,3640,9.2,23.3,-1750,-6.8,33,0,357,357,2001
2001,19,e) 4,2552,2647,23256,24266,52,1.9,391,13.9,3227,282,2945,1.2,13.3,5247,2295,2952,9.5,21.6,-2020,-8.3,26.6,0,266,266,1780
2001,19,f) 5,2349,2420,20723,21949,56,2.2,353,13.8,2582,402,2180,1.8,11.8,5033,2492,2541,11.4,22.9,-2451,-11.1,23.6,0,267,267,2217
2001,19,g) 6 to 10,9358,9853,92357,94018,245,2.4,1161,11.3,12779,3399,9380,3.6,13.6,16100,5635,10465,6,17.1,-3321,-3.5,27.2,0,784,784,3566
2001,19,h) 11 to 15,6773,7609,119653,121286,173,2.2,661,8.4,10343,2862,7481,2.4,8.5,13609,4484,9125,3.7,11.2,-3266,-2.7,17,0,413,413,2175
2001,19,i) 16 to 20,5959,7226,100877,103808,245,3.3,546,7.4,8953,2073,6880,2,8.6,14814,4164,10650,4,14.3,-5861,-5.7,17.2,0,293,293,1592
2001,19,j) 21 to 25,4377,6415,93870,95104,172,2.6,396,6.1,8188,2008,6180,2.1,8.6,10656,2293,8363,2.4,11.2,-2468,-2.6,17.2,0,194,195,855
2001,19,l) Left Censored,12504,22626,694745,701299,1084,4.8,1522,6.7,64233,16662,47571,2.4,9.2,77340,20606,56734,2.9,11,-13107,-1.8,18.4,0,471,471,3647
2001,20,a) 0,4517,4574,26534,13366,4540,198.5,0,0,26337,26337,0,197,197,0,0,0,0,0,26337,197,0,0,,,
2001,20,b) 1,3632,3682,28162,28923,43,1,1127,26.7,7380,1662,5718,5.7,25.5,8902,4577,4325,15.8,30.8,-1522,-5.3,51,0,806,806,3385
2001,20,c) 2,3153,3271,25255,27185,128,3.6,691,19.5,5007,1367,3640,5,18.4,8867,4987,3880,18.3,32.6,-3860,-14.2,36.8,0,495,495,2249
2001,20,d) 3,3038,3203,32864,33612,169,5,516,15.3,5993,2282,3711,6.8,17.8,7489,2350,5139,7,22.3,-1496,-4.5,35.6,0,384,384,1684
2001,20,e) 4,2564,2651,23772,25628,85,3,456,16.1,3334,423,2911,1.7,13,7045,2310,4735,9,27.5,-3711,-14.5,26,0,309,309,1771
2001,20,f) 5,2423,2484,20821,21311,70,2.7,330,12.7,3264,469,2795,2.2,15.3,4244,1753,2491,8.2,19.9,-980,-4.6,30.6,0,229,229,1343
2001,20,g) 6 to 10,8695,9155,92060,94825,296,3.1,1146,12,12093,2469,9624,2.6,12.8,17622,7449,10173,7.9,18.6,-5529,-5.8,25.6,0,757,757,4897
2001,20,h) 11 to 15,6268,6938,91183,93592,177,2.5,663,9.3,9009,1425,7584,1.5,9.6,13827,4483,9344,4.8,14.8,-4818,-5.2,19.2,0,414,414,2676
2001,20,i) 16 to 20,5571,6503,85532,88140,212,3.2,524,7.9,9533,2332,7201,2.6,10.8,14749,6079,8670,6.9,16.7,-5216,-5.9,21.6,0,283,283,4045
2001,20,j) 21 to 25,3597,5165,83158,83723,211,4,379,7.2,10915,3334,7581,4,13,12045,4271,7774,5.1,14.4,-1130,-1.4,26,0,173,173,1148
2001,20,l) Left Censored,10162,19321,594830,600866,1044,5.4,1307,6.7,56722,16889,39833,2.8,9.4,68795,17640,51155,2.9,11.4,-12073,-2,18.8,0,355,356,2425
2001,21,a) 0,5350,5392,34031,17111,5360,198.8,0,0,33840,33840,0,197.8,197.8,0,0,0,0,0,33840,197.8,0,0,,,
2001,21,b) 1,4386,4469,34319,35910,60,1.2,1287,25.3,8554,1040,7514,2.9,23.8,11735,7050,4685,19.6,32.7,-3181,-8.9,47.6,0,954,955,5722
2001,21,c) 2,3968,4105,38678,40263,158,3.6,820,18.5,6953,1593,5360,4,17.3,10123,4773,5350,11.9,25.1,-3170,-7.8,34.6,0,595,595,3490
2001,21,d) 3,3725,3953,39385,39775,174,4.2,667,15.9,7668,2219,5449,5.6,19.3,8448,3613,4835,9.1,21.2,-780,-1.9,38.6,0,502,502,2882
2001,21,e) 4,3111,3283,28020,29769,84,2.4,537,15.4,3631,452,3179,1.5,12.2,7129,3355,3774,11.3,23.9,-3498,-11.7,24.4,0,401,401,2757
2001,21,f) 5,2790,2901,29507,30750,85,2.8,411,13.5,3705,444,3261,1.4,12,6191,2880,3311,9.4,20.1,-2486,-8.1,24,0,298,298,2137
2001,21,g) 6 to 10,11054,11731,123167,126707,289,2.4,1347,11,16870,2305,14565,1.8,13.3,23949,9487,14462,7.5,18.9,-7079,-5.6,26.6,0,927,927,5605
2001,21,h) 11 to 15,8241,9260,148125,149817,236,2.5,824,8.6,17561,2867,14694,1.9,11.7,20944,6185,14759,4.1,14,-3383,-2.3,23.4,0,496,496,2927
2001,21,i) 16 to 20,6534,7601,119728,121910,233,3,524,6.8,12730,4120,8610,3.4,10.4,17093,5262,11831,4.3,14,-4363,-3.6,20.8,0,254,256,2204
2001,21,j) 21 to 25,3870,5464,115514,116078,197,3.5,410,7.4,12227,2664,9563,2.3,10.5,13354,3143,10211,2.7,11.5,-1127,-1,21,0,200,203,1163
2001,21,l) Left Censored,11020,23409,785914,795454,1404,6,1635,7,81955,22090,59865,2.8,10.3,101035,29696,71339,3.7,12.7,-19080,-2.4,20.6,0,352,353,2085
2001,22,a) 0,6082,6176,43931,22135,6100,197.5,0,0,43592,43592,0,196.9,196.9,0,0,0,0,0,43592,196.9,0,0,,,
2001,22,b) 1,4855,4988,54751,52937,64,1.1,1411,24.9,16100,1613,14487,3,30.4,12471,6601,5870,12.5,23.6,3629,6.8,47.2,0,1011,1012,4754
2001,22,c) 2,4193,4324,40435,42225,170,3.6,914,19.5,10364,3512,6852,8.3,24.5,13943,6161,7782,14.6,33,-3579,-8.5,49,0,669,669,4883
2001,22,d) 3,4140,4426,47829,48982,210,4.5,730,15.6,8834,1985,6849,4.1,18,11140,3692,7448,7.5,22.7,-2306,-4.7,36,0,527,527,2618
2001,22,e) 4,3599,3667,38113,38690,115,3,545,14.1,7119,1422,5697,3.7,18.4,8272,3449,4823,8.9,21.4,-1153,-3,36.8,0,391,391,2641
2001,22,f) 5,3183,3259,36321,37169,106,3.1,454,13.3,4790,1000,3790,2.7,12.9,6485,3000,3485,8.1,17.4,-1695,-4.5,25.8,0,300,300,1812
2001,22,g) 6 to 10,12499,13220,149822,154225,357,2.6,1568,11.4,19117,2225,16892,1.4,12.4,27923,11391,16532,7.4,18.1,-8806,-5.7,24.8,0,1098,1098,8429
2001,22,h) 11 to 15,8475,9526,156226,159650,270,2.7,919,9.4,16664,4073,12591,2.6,10.4,23512,7305,16207,4.6,14.7,-6848,-4.3,20.8,0,505,505,3695
2001,22,i) 16 to 20,8151,9591,135309,136968,307,3.1,717,7.3,15474,2316,13158,1.7,11.3,18792,5444,13348,4,13.7,-3318,-2.4,22.6,0,383,384,2426
2001,22,j) 21 to 25,5078,7012,130585,131568,287,4,541,7.6,14220,4033,10187,3.1,10.8,16185,4285,11900,3.3,12.3,-1965,-1.5,21.6,0,265,265,1609
2001,22,l) Left Censored,11924,25291,745478,754059,1510,5.9,1923,7.6,89188,27507,61681,3.6,11.8,106352,31020,75332,4.1,14.1,-17164,-2.3,23.6,0,415,415,3067
2001,23,a) 0,2559,2577,12728,6406,2551,198,0,0,12644,12644,0,197.4,197.4,0,0,0,0,0,12644,197.4,0,0,,,
2001,23,b) 1,2072,2114,15461,15735,20,0.8,550,23.1,4061,684,3377,4.3,25.8,4609,1783,2826,11.3,29.3,-548,-3.5,51.6,0,352,352,1344
2001,23,c) 2,1913,1963,12877,13389,93,4.5,351,16.8,2440,824,1616,6.2,18.2,3463,1792,1671,13.4,25.9,-1023,-7.7,36.4,0,238,238,1391
2001,23,d) 3,1786,1934,14101,14259,109,5.4,289,14.3,2502,962,1540,6.7,17.5,2817,952,1865,6.7,19.8,-315,-2.3,35,0,208,208,642
2001,23,e) 4,1474,1502,9312,9684,33,2.1,223,14,1280,65,1215,0.7,13.2,2024,986,1038,10.2,20.9,-744,-7.7,26.4,0,171,171,825
2001,23,f) 5,1365,1401,10326,10857,50,3.4,195,13.3,1383,156,1227,1.4,12.7,2444,987,1457,9.1,22.5,-1061,-9.8,25.4,0,131,131,748
2001,23,g) 6 to 10,4757,4970,41836,42615,136,2.6,554,10.7,5552,556,4996,1.3,13,7110,2995,4115,7,16.7,-1558,-3.7,26,0,392,392,2039
2001,23,h) 11 to 15,4118,4438,50773,52565,124,2.7,431,9.4,4802,870,3932,1.7,9.1,8386,2241,6145,4.3,16,-3584,-6.9,18.2,0,287,287,1594
2001,23,i) 16 to 20,2746,3351,47032,47114,190,5.6,251,7.4,4735,1364,3371,2.9,10.1,4898,1610,3288,3.4,10.4,-163,-0.3,20.2,0,134,134,767
2001,23,j) 21 to 25,1752,2476,44448,43600,114,4.5,181,7.2,6281,1942,4339,4.5,14.4,4584,1327,3257,3,10.5,1697,3.9,21,0,65,65,336
2001,23,l) Left Censored,4404,7767,233863,233500,398,5.1,431,5.5,24895,8547,16348,3.7,10.7,24170,7091,17079,3,10.4,725,0.3,20.8,0,139,142,708
2001,24,a) 0,8316,8362,49995,25132,8281,198.1,0,0,49727,49727,0,197.9,197.9,0,0,0,0,0,49727,197.9,0,0,,,
2001,24,b) 1,6543,6655,49492,48850,71,0.9,1715,22.9,14750,1747,13003,3.6,30.2,13465,7455,6010,15.3,27.6,1285,2.6,55.2,0,1171,1171,5703
2001,24,c) 2,5972,6150,59058,59109,229,3.5,1110,16.9,13892,3209,10683,5.4,23.5,13993,7258,6735,12.3,23.7,-101,-0.2,47,0,792,792,6089
2001,24,d) 3,5422,5721,58752,61701,297,5,889,14.8,12025,3598,8427,5.8,19.5,17923,9139,8784,14.8,29,-5898,-9.5,39,0,622,622,6175
2001,24,e) 4,4818,4913,47036,47245,201,3.9,762,14.8,9231,1474,7757,3.1,19.5,9648,4480,5168,9.5,20.4,-417,-0.9,39,0,532,532,3093
2001,24,f) 5,4196,4271,40323,40519,144,3.2,579,13,6637,1652,4985,4.1,16.4,7028,3259,3769,8,17.3,-391,-0.9,32.8,0,388,388,2286
2001,24,g) 6 to 10,16238,17197,198622,201138,514,2.9,1965,11,29521,5010,24511,2.5,14.7,34552,14699,19853,7.3,17.2,-5031,-2.5,29.4,0,1232,1232,8857
2001,24,h) 11 to 15,12973,14372,217078,218107,517,3.5,1250,8.5,29407,8358,21049,3.8,13.5,31465,9906,21559,4.5,14.4,-2058,-0.9,27,0,711,711,5325
2001,24,i) 16 to 20,8741,10375,163132,164176,377,3.6,735,7,19608,3655,15953,2.2,11.9,21696,5557,16139,3.4,13.2,-2088,-1.3,23.8,0,383,385,1991
2001,24,j) 21 to 25,5154,7240,150221,151647,280,3.8,549,7.5,18284,5370,12914,3.5,12.1,21136,7734,13402,5.1,13.9,-2852,-1.8,24.2,0,235,235,1947
2001,24,l) Left Censored,13695,29214,1041727,1039153,2046,7,2304,7.9,124774,42599,82175,4.1,12,119625,37057,82568,3.6,11.5,5149,0.5,23,0,478,482,4412
2001,25,a) 0,9770,9840,65175,33031,9758,198.3,0,0,64289,64289,0,194.6,194.6,0,0,0,0,0,64289,194.6,0,0,,,
2001,25,b) 1,8395,8551,70181,68246,107,1.1,2008,21.1,22323,3613,18710,5.3,32.7,18453,9023,9430,13.2,27,3870,5.7,54,0,1379,1379,7018
2001,25,c) 2,7462,7672,71977,72712,274,3.4,1343,16.4,16445,2998,13447,4.1,22.6,17914,8916,8998,12.3,24.6,-1469,-2,45.2,0,987,987,6664
2001,25,d) 3,7010,7299,79633,82788,315,4.1,1110,14.5,17057,3721,13336,4.5,20.6,23367,13472,9895,16.3,28.2,-6310,-7.6,41.2,0,790,790,12258
2001,25,e) 4,6111,6209,61690,62407,203,3.1,905,13.8,10953,1158,9795,1.9,17.6,12387,5843,6544,9.4,19.8,-1434,-2.2,35.2,0,636,636,4517
2001,25,f) 5,5398,5484,52957,54194,160,2.8,693,12.1,8406,651,7755,1.2,15.5,10879,4418,6461,8.2,20.1,-2473,-4.6,31,0,514,514,3706
2001,25,g) 6 to 10,20296,21210,246367,249204,571,2.6,2357,10.7,36482,6050,30432,2.4,14.6,42156,17355,24801,7,16.9,-5674,-2.3,29.2,0,1594,1594,11014
2001,25,h) 11 to 15,17208,19210,306653,308934,588,3,1745,8.8,37620,8214,29406,2.7,12.2,42181,15100,27081,4.9,13.7,-4561,-1.5,24.4,0,1016,1016,6288
2001,25,i) 16 to 20,12457,14704,289300,290845,462,3.1,1125,7.5,35437,9373,26064,3.2,12.2,38527,12323,26204,4.2,13.2,-3090,-1,24.4,0,593,597,4272
2001,25,j) 21 to 25,7539,10379,249885,246863,358,3.4,695,6.6,34226,6577,27649,2.7,13.9,28181,7820,20361,3.2,11.4,6045,2.5,22.8,0,302,302,1474
2001,25,l) Left Censored,25062,43973,1593275,1595813,3060,7,2979,6.8,196222,53561,142661,3.4,12.3,201297,52817,148480,3.3,12.6,-5075,-0.3,24.6,0,910,910,9694
2001,26,a) 0,13709,13795,98621,49566,13653,197.9,0,0,98111,98111,0,197.9,197.9,0,0,0,0,0,98111,197.9,0,0,,,
2001,26,b) 1,11274,11477,98663,97618,123,0.9,3243,24.9,29019,4619,24400,4.7,29.7,26929,14512,12417,14.9,27.6,2090,2.1,55.2,0,2204,2208,10236
2001,26,c) 2,10066,10462,101782,108157,400,3.6,1955,17.5,20159,5368,14791,5,18.6,32909,13740,19169,12.7,30.4,-12750,-11.8,37.2,0,1412,1412,11225
2001,26,d) 3,9442,9995,99515,103282,434,4.1,1540,14.7,18250,5470,12780,5.3,17.7,25783,10638,15145,10.3,25,-7533,-7.3,35.4,0,1083,1083,6979
2001,26,e) 4,8540,9018,84406,88816,251,2.6,1438,15,12427,1793,10634,2,14,21246,10351,10895,11.7,23.9,-8819,-9.9,28,0,984,984,7898
2001,26,f) 5,7820,7951,81099,85587,201,2.4,1164,13.9,9781,924,8857,1.1,11.4,18757,7745,11012,9,21.9,-8976,-10.5,22.8,0,801,801,5971
2001,26,g) 6 to 10,29453,30988,325175,343163,849,2.6,3669,11.4,43333,8881,34452,2.6,12.6,79309,25970,53339,7.6,23.1,-35976,-10.5,25.2,0,2383,2383,15920
2001,26,h) 11 to 15,22300,25161,351296,364998,717,2.8,2358,9.1,38852,11454,27398,3.1,10.6,66256,19105,47151,5.2,18.2,-27404,-7.6,21.2,0,1383,1383,8324
2001,26,i) 16 to 20,16395,19864,329607,333505,647,3.2,1485,7.3,41034,10203,30831,3.1,12.3,48829,16468,32361,4.9,14.6,-7795,-2.3,24.6,0,762,764,6237
2001,26,j) 21 to 25,10406,14280,255230,259184,444,3.1,1027,7.1,31266,9742,21524,3.8,12.1,39173,10038,29135,3.9,15.1,-7907,-3,24.2,0,469,469,3360
2001,26,l) Left Censored,26938,56740,2145240,2164265,3588,6.3,3856,6.8,253773,71548,182225,3.3,11.7,291824,89068,202756,4.1,13.5,-38051,-1.8,23.4,0,1001,1002,11602
2001,27,a) 0,8772,8848,52583,26391,8781,198.5,0,0,52384,52384,0,198.5,198.5,0,0,0,0,0,52384,198.5,0,0,,,
2001,27,b) 1,7159,7275,54771,54607,91,1.1,1725,21.3,14840,1884,12956,3.5,27.2,14512,8129,6383,14.9,26.6,328,0.6,53.2,0,1147,1147,5637
2001,27,c) 2,6352,6602,61770,62236,258,3.7,1150,16.4,11695,2269,9426,3.6,18.8,12626,6402,6224,10.3,20.3,-931,-1.5,37.6,0,798,798,5164
2001,27,d) 3,5922,6302,61043,61989,317,4.8,941,14.3,11788,4285,7503,6.9,19,13680,6237,7443,10.1,22.1,-1892,-3.1,38,0,621,621,4813
2001,27,e) 4,5247,5411,46117,47028,155,2.7,774,13.6,7736,898,6838,1.9,16.4,9557,4401,5156,9.4,20.3,-1821,-3.9,32.8,0,512,512,2779
2001,27,f) 5,4734,4821,44148,44213,119,2.4,593,11.8,6936,547,6389,1.2,15.7,7066,3122,3944,7.1,16,-130,-0.3,31.4,0,420,420,2318
2001,27,g) 6 to 10,17666,18628,196171,201545,506,2.6,1973,10.2,26123,4480,21643,2.2,13,36870,14377,22493,7.1,18.3,-10747,-5.3,26,0,1232,1232,8893
2001,27,h) 11 to 15,12410,14125,207072,209059,415,2.9,1216,8.4,24430,5228,19202,2.5,11.7,28403,9368,19035,4.5,13.6,-3973,-1.9,23.4,0,745,745,5622
2001,27,i) 16 to 20,9172,11304,227065,229727,495,4.3,813,7.1,31452,12064,19388,5.3,13.7,36775,12289,24486,5.3,16,-5323,-2.3,27.4,0,438,441,3861
2001,27,j) 21 to 25,6234,8586,168460,168965,321,3.7,569,6.5,20649,6189,14460,3.7,12.2,21659,6636,15023,3.9,12.8,-1010,-0.6,24.4,0,273,273,2211
2001,27,l) Left Censored,16271,31887,1285006,1293247,2236,7,2044,6.4,135546,45514,90032,3.5,10.5,152030,40490,111540,3.1,11.8,-16484,-1.3,21,0,496,498,4888
2001,28,a) 0,3720,3745,23862,11984,3723,198.8,0,0,23757,23757,0,198.2,198.2,0,0,0,0,0,23757,198.2,0,0,,,
2001,28,b) 1,2887,2995,22329,23558,46,1.3,974,28.2,5620,556,5064,2.4,23.9,8078,5172,2906,22,34.3,-2458,-10.4,47.8,0,712,712,3730
2001,28,c) 2,2677,2767,24679,25531,101,3.3,660,21.7,5960,1581,4379,6.2,23.3,7664,3602,4062,14.1,30,-1704,-6.7,46.6,0,491,491,3097
2001,28,d) 3,2389,2537,22855,24539,109,4,470,17.3,3911,1172,2739,4.8,15.9,7278,2531,4747,10.3,29.7,-3367,-13.8,31.8,0,334,334,1734
2001,28,e) 4,2054,2106,16958,17665,80,3.6,378,16.8,2626,431,2195,2.4,14.9,4040,1920,2120,10.9,22.9,-1414,-8,29.8,0,272,272,1459
2001,28,f) 5,1885,1943,21084,22078,57,2.8,319,15.5,2502,294,2208,1.3,11.3,4490,1491,2999,6.8,20.3,-1988,-9,22.6,0,223,223,1104
2001,28,g) 6 to 10,7158,7632,78907,82100,247,3.1,1018,12.8,10020,1574,8446,1.9,12.2,16405,6264,10141,7.6,20,-6385,-7.8,24.4,0,671,671,3864
2001,28,h) 11 to 15,4807,5319,79248,82648,143,2.6,604,10.9,8863,1383,7480,1.7,10.7,15662,6834,8828,8.3,19,-6799,-8.3,21.4,0,371,371,2658
2001,28,i) 16 to 20,4404,5110,72489,74699,198,3.8,433,8.3,8884,1666,7218,2.2,11.9,13304,3962,9342,5.3,17.8,-4420,-5.9,23.8,0,248,248,1761
2001,28,j) 21 to 25,2858,3825,84181,86178,158,4,435,11,9524,3177,6347,3.7,11.1,13517,4081,9436,4.7,15.7,-3993,-4.6,22.2,0,155,155,1034
2001,28,l) Left Censored,7261,15516,472706,484483,872,5.6,1073,6.9,42634,12217,30417,2.5,8.8,66188,18126,48062,3.7,13.7,-23554,-4.9,17.6,0,276,276,1441
2001,29,a) 0,8741,8841,52136,26403,8764,198.3,0,0,51467,51467,0,194.9,194.9,0,0,0,0,0,51467,194.9,0,0,,,
2001,29,b) 1,7406,7512,57881,58583,88,1,2263,26.3,16090,3048,13042,5.2,27.5,17493,9283,8210,15.8,29.9,-1403,-2.4,55,0,1610,1611,7256
2001,29,c) 2,6471,6702,59729,61574,262,3.6,1443,19.8,12374,2572,9802,4.2,20.1,16063,7846,8217,12.7,26.1,-3689,-6,40.2,0,1063,1063,6164
2001,29,d) 3,5862,6247,62024,64158,283,4.3,1090,16.5,12314,4637,7677,7.2,19.2,16581,6635,9946,10.3,25.8,-4267,-6.6,38.4,0,823,823,4998
2001,29,e) 4,5112,5246,45767,46254,147,2.6,874,15.6,8636,1049,7587,2.3,18.7,9609,4289,5320,9.3,20.8,-973,-2.1,37.4,0,635,635,3199
2001,29,f) 5,4545,4673,45976,46856,147,3,671,13.7,7435,1604,5831,3.4,15.9,9194,3368,5826,7.2,19.6,-1759,-3.7,31.8,0,483,483,2392
2001,29,g) 6 to 10,17834,18943,194419,199080,569,2.9,2274,11.5,27086,4723,22363,2.4,13.6,36408,13805,22603,6.9,18.3,-9322,-4.7,27.2,0,1531,1531,9277
2001,29,h) 11 to 15,13140,14772,206816,211906,434,2.8,1440,9.5,24864,5192,19672,2.5,11.7,35044,11208,23836,5.3,16.5,-10180,-4.8,23.4,0,881,881,5604
2001,29,i) 16 to 20,10409,12495,222287,226755,387,3,986,7.7,21538,4834,16704,2.1,9.5,30473,11221,19252,4.9,13.4,-8935,-3.9,19,0,517,517,3935
2001,29,j) 21 to 25,6412,9066,178412,178573,352,3.8,605,6.6,21071,6233,14838,3.5,11.8,21393,5747,15646,3.2,12,-322,-0.2,23.6,0,297,297,1867
2001,29,l) Left Censored,17481,35814,1258115,1262009,1945,5.4,2271,6.3,139898,41744,98154,3.3,11.1,147687,40332,107355,3.2,11.7,-7789,-0.6,22.2,0,619,620,4981
2001,30,a) 0,2303,2309,9878,4988,2282,197.7,0,0,9780,9780,0,196.1,196.1,0,0,0,0,0,9780,196.1,0,0,,,
2001,30,b) 1,1851,1881,11003,11022,18,0.8,515,24.2,2980,188,2792,1.7,27,3017,1770,1247,16.1,27.4,-37,-0.4,54,0,326,326,1165
2001,30,c) 2,1573,1614,10123,10530,63,3.6,322,18.5,1843,349,1494,3.3,17.5,2657,1343,1314,12.8,25.2,-814,-7.7,35,0,226,226,980
2001,30,d) 3,1582,1635,13215,13434,63,3.7,235,13.7,2179,415,1764,3.1,16.2,2617,901,1716,6.7,19.5,-438,-3.3,32.4,0,148,148,689
2001,30,e) 4,1305,1321,9830,9871,41,3,186,13.4,1692,223,1469,2.3,17.1,1773,898,875,9.1,18,-81,-0.9,34.2,0,128,128,595
2001,30,f) 5,1204,1224,8658,9001,36,2.8,199,15.3,1071,91,980,1,11.9,1756,931,825,10.3,19.5,-685,-7.6,23.8,0,133,133,646
2001,30,g) 6 to 10,4218,4328,33308,34341,127,2.8,489,10.9,4174,431,3743,1.3,12.2,6239,2061,4178,6,18.2,-2065,-6,24.4,0,322,322,1317
2001,30,h) 11 to 15,2723,2946,29645,30025,82,2.7,249,8.3,3423,395,3028,1.3,11.4,4183,1155,3028,3.8,13.9,-760,-2.5,22.8,0,154,154,659
2001,30,i) 16 to 20,2185,2509,26992,27707,120,4.7,254,9.9,2865,723,2142,2.6,10.3,4295,1288,3007,4.6,15.5,-1430,-5.2,20.6,0,132,132,771
2001,30,j) 21 to 25,1587,2161,28467,28332,70,3.2,149,6.8,3434,806,2628,2.8,12.1,3164,760,2404,2.7,11.2,270,0.9,22.4,0,81,82,453
2001,30,l) Left Censored,3321,5884,119402,119107,379,6.5,365,6.2,14678,5729,8949,4.8,12.3,14088,3221,10867,2.7,11.8,590,0.5,23.6,0,102,102,850
2001,31,a) 0,2863,2896,17158,8602,2869,198.1,0,0,17112,17112,0,198.9,198.9,0,0,0,0,0,17112,198.9,0,0,,,
2001,31,b) 1,2349,2381,15138,15844,25,0.9,587,22.1,3554,336,3218,2.1,22.4,4965,2428,2537,15.3,31.3,-1411,-8.9,44.8,0,389,389,1672
2001,31,c) 2,2051,2114,24528,25326,91,4,426,18.7,3668,767,2901,3,14.5,5263,2669,2594,10.5,20.8,-1595,-6.3,29,0,286,286,1814
2001,31,d) 3,1969,2115,24077,23112,110,5,316,14.3,7586,4483,3103,19.4,32.8,5656,2284,3372,9.9,24.5,1930,8.3,49,0,223,223,1507
2001,31,e) 4,1717,1784,12759,13530,38,2,220,11.8,1691,115,1576,0.8,12.5,3232,1861,1371,13.8,23.9,-1541,-11.4,25,0,146,146,591
2001,31,f) 5,1473,1506,11400,12071,36,2.3,224,14.1,1110,89,1021,0.7,9.2,2451,1334,1117,11.1,20.3,-1341,-11.1,18.4,0,151,151,855
2001,31,g) 6 to 10,5806,6070,55370,57045,165,2.6,711,11.3,7505,1277,6228,2.2,13.2,10855,4519,6336,7.9,19,-3350,-5.8,26.4,0,464,464,2703
2001,31,h) 11 to 15,4332,4896,73129,75096,157,3.1,431,8.6,8240,2706,5534,3.6,11,12173,4397,7776,5.9,16.2,-3933,-5.2,22,0,231,231,1375
2001,31,i) 16 to 20,3815,4504,68565,69897,160,3.5,327,7.1,7672,2683,4989,3.8,11,10335,2917,7418,4.2,14.8,-2663,-3.8,22,0,168,168,1206
2001,31,j) 21 to 25,2624,3532,56452,57128,92,2.6,238,6.6,7043,1509,5534,2.6,12.3,8395,3073,5322,5.4,14.7,-1352,-2.4,24.6,0,115,115,604
2001,31,l) Left Censored,7407,12926,388389,391904,717,5.5,810,6.3,38326,13357,24969,3.4,9.8,45355,13107,32248,3.3,11.6,-7029,-1.8,19.6,0,235,235,1128
2001,32,a) 0,4567,4603,30689,15382,4574,198.7,0,0,30615,30615,0,199,199,0,0,0,0,0,30615,199,0,0,,,
2001,32,b) 1,3455,3499,34172,33971,47,1.1,1223,29.9,10745,1417,9328,4.2,31.6,10343,6060,4283,17.8,30.4,402,1.2,60.8,0,938,940,4978
2001,32,c) 2,2937,3033,35654,36842,148,4.4,777,23.3,8006,1301,6705,3.5,21.7,10382,5086,5296,13.8,28.2,-2376,-6.5,43.4,0,570,570,4085
2001,32,d) 3,2525,2669,45489,43863,145,5,577,20.1,11345,1650,9695,3.8,25.9,8093,3185,4908,7.3,18.5,3252,7.4,37,0,434,434,2649
2001,32,e) 4,2036,2083,26013,26504,76,3.4,413,18.4,5319,1082,4237,4.1,20.1,6300,2632,3668,9.9,23.8,-981,-3.7,40.2,0,308,308,2256
2001,32,f) 5,1646,1717,31674,31178,69,3.8,288,15.8,5885,2551,3334,8.2,18.9,4892,1964,2928,6.3,15.7,993,3.2,31.4,0,213,213,1556
2001,32,g) 6 to 10,5436,5776,86981,90236,221,3.7,814,13.5,10923,2091,8832,2.3,12.1,17433,7149,10284,7.9,19.3,-6510,-7.2,24.2,0,549,549,5022
2001,32,h) 11 to 15,3542,4186,73228,74694,170,3.9,470,10.9,10837,2253,8584,3,14.5,13768,4680,9088,6.3,18.4,-2931,-3.9,29,0,275,275,3014
2001,32,i) 16 to 20,2411,3176,65493,67529,168,5.2,285,8.8,8588,2948,5640,4.4,12.7,12659,4767,7892,7.1,18.7,-4071,-6,25.4,0,119,119,833
2001,32,j) 21 to 25,1684,2579,94281,95711,168,6.5,207,8,7961,2606,5355,2.7,8.3,10821,1850,8971,1.9,11.3,-2860,-3,16.6,0,85,85,516
2001,32,l) Left Censored,3652,8599,391196,391188,892,10.4,802,9.4,48054,17379,30675,4.4,12.3,48038,13060,34978,3.3,12.3,16,0,24.6,0,91,91,1046
2001,33,a) 0,2334,2366,13635,6856,2337,197.5,0,0,13558,13558,0,197.8,197.8,0,0,0,0,0,13558,197.8,0,0,,,
2001,33,b) 1,1934,1957,13063,13491,22,1,490,22.4,3125,289,2836,2.1,23.2,3980,2183,1797,16.2,29.5,-855,-6.3,46.4,0,330,330,1652
2001,33,c) 2,1696,1733,14455,14490,47,2.5,341,18.2,3248,743,2505,5.1,22.4,3317,1702,1615,11.7,22.9,-69,-0.5,44.8,0,253,253,1359
2001,33,d) 3,1668,1741,15730,15407,63,3.4,251,13.7,3201,706,2495,4.6,20.8,2555,1220,1335,7.9,16.6,646,4.2,33.2,0,187,187,930
2001,33,e) 4,1500,1519,11782,12150,39,2.4,230,14.3,1691,158,1533,1.3,13.9,2427,992,1435,8.2,20,-736,-6.1,27.8,0,172,172,741
2001,33,f) 5,1350,1365,12962,14061,28,1.9,217,14.9,1537,93,1444,0.7,10.9,3735,2080,1655,14.8,26.6,-2198,-15.7,21.8,0,153,153,1846
2001,33,g) 6 to 10,4902,5063,50007,51022,128,2.4,516,9.8,6238,833,5405,1.6,12.2,8268,3100,5168,6.1,16.2,-2030,-4,24.4,0,371,371,2104
2001,33,h) 11 to 15,4197,4532,59044,60529,162,3.5,395,8.5,7014,1228,5786,2,11.6,9984,3567,6417,5.9,16.5,-2970,-4.9,23.2,0,251,251,1370
2001,33,i) 16 to 20,2676,3012,48699,49930,108,3.5,254,8.2,6074,2471,3603,4.9,12.2,8536,3110,5426,6.2,17.1,-2462,-4.9,24.4,0,142,142,1082
2001,33,j) 21 to 25,1589,2191,43383,43196,115,5.2,146,6.6,5434,1929,3505,4.5,12.6,5059,1651,3408,3.8,11.7,375,0.9,23.4,0,73,73,417
2001,33,l) Left Censored,4299,7966,271703,266833,450,5.6,549,6.9,34233,7299,26934,2.7,12.8,24492,6433,18059,2.4,9.2,9741,3.6,18.4,0,131,132,1102
2001,34,a) 0,15504,15606,100592,50522,15489,198.5,0,0,100141,100141,0,198.2,198.2,0,0,0,0,0,100141,198.2,0,0,,,
2001,34,b) 1,12528,12650,92602,89955,99,0.7,3297,23.1,29098,5029,24069,5.6,32.3,23803,13043,10760,14.5,26.5,5295,5.8,53,0,2277,2278,9543
2001,34,c) 2,11429,11637,100175,99526,415,3.3,2101,16.9,22289,3713,18576,3.7,22.4,20991,8487,12504,8.5,21.1,1298,1.3,42.2,0,1498,1498,6621
2001,34,d) 3,10873,11274,102568,102714,486,4.1,1759,14.8,21948,5771,16177,5.6,21.4,22239,9883,12356,9.6,21.7,-291,-0.3,42.8,0,1261,1261,7746
2001,34,e) 4,9482,9678,84771,85474,295,2.9,1345,13.2,14902,2601,12301,3,17.4,16307,7029,9278,8.2,19.1,-1405,-1.7,34.8,0,968,968,5207
2001,34,f) 5,8246,8400,76569,78374,284,3.2,1151,13.1,12880,1379,11501,1.8,16.4,16489,7016,9473,9,21,-3609,-4.6,32.8,0,827,827,5789
2001,34,g) 6 to 10,29342,30337,313173,319985,890,2.8,3645,11.5,46614,7077,39537,2.2,14.6,60238,28089,32149,8.8,18.8,-13624,-4.2,29.2,0,2363,2363,20337
2001,34,h) 11 to 15,23403,25213,328453,333971,718,2.8,2366,9.1,42725,7789,34936,2.3,12.8,53760,17739,36021,5.3,16.1,-11035,-3.3,25.6,0,1500,1500,9352
2001,34,i) 16 to 20,16207,18255,298809,303448,525,2.8,1496,8,32013,7127,24886,2.3,10.5,41290,12107,29183,4,13.6,-9277,-3.1,21,0,903,903,5928
2001,34,j) 21 to 25,10290,12588,258215,260097,448,3.5,940,7.3,28109,7326,20783,2.8,10.8,31872,10465,21407,4,12.3,-3763,-1.5,21.6,0,525,525,2852
2001,34,l) Left Censored,27760,50931,1850330,1838963,3613,7.1,3851,7.6,259622,92937,166685,5.1,14.1,236888,68848,168040,3.7,12.9,22734,1.2,25.8,0,1224,1224,11847
2001,35,a) 0,2939,2979,18394,9242,2944,197.7,0,0,18304,18304,0,198.1,198.1,0,0,0,0,0,18304,198.1,0,0,,,
2001,35,b) 1,2240,2267,15062,15649,24,0.9,675,26,4001,551,3450,3.5,25.6,5175,3024,2151,19.3,33.1,-1174,-7.5,51.2,0,470,470,1742
2001,35,c) 2,1916,1951,14339,15584,82,3.9,445,21,2301,567,1734,3.6,14.8,4790,2520,2270,16.2,30.7,-2489,-15.9,29.6,0,302,302,2110
2001,35,d) 3,1789,1916,21024,20873,106,5.2,357,17.6,4524,1540,2984,7.4,21.7,4221,1719,2502,8.2,20.2,303,1.5,40.4,0,242,242,1332
2001,35,e) 4,1642,1684,13761,13922,62,3.5,270,15.2,2467,302,2165,2.2,17.7,2789,1254,1535,9,20,-322,-2.3,35.4,0,195,195,983
2001,35,f) 5,1422,1455,13233,14117,58,3.8,241,15.7,2324,504,1820,3.6,16.5,4092,1739,2353,12.3,29,-1768,-12.5,33,0,156,156,1183
2001,35,g) 6 to 10,5469,5837,56064,57152,193,3.2,815,13.3,8242,1262,6980,2.2,14.4,10418,4576,5842,8,18.2,-2176,-3.8,28.8,0,488,488,2613
2001,35,h) 11 to 15,3743,4147,65902,66075,137,3.2,439,10.3,9029,1470,7559,2.2,13.7,9375,3350,6025,5.1,14.2,-346,-0.5,27.4,0,267,267,2206
2001,35,i) 16 to 20,3121,3848,50606,50506,212,5.5,307,7.9,7911,2533,5378,5,15.7,7710,2586,5124,5.1,15.3,201,0.4,30.6,0,140,140,837
2001,35,j) 21 to 25,2133,3115,46154,46445,190,6.1,209,6.7,5379,1209,4170,2.6,11.6,5961,1748,4213,3.8,12.8,-582,-1.2,23.2,0,103,103,753
2001,35,l) Left Censored,4360,8932,234189,237375,570,6.3,792,8.8,31569,10634,20935,4.5,13.3,37940,12272,25668,5.2,16,-6371,-2.7,26.6,0,134,134,1008
2001,36,a) 0,33596,33769,192259,96788,33507,198.4,0,0,190943,190943,0,197.3,197.3,0,0,0,0,0,190943,197.3,0,0,,,
2001,36,b) 1,27315,27571,201309,203250,209,0.7,7251,23.3,59351,7674,51677,3.8,29.2,63232,35026,28206,17.2,31.1,-3881,-1.9,58.4,0,5157,5157,27871
2001,36,c) 2,23577,23991,199156,203829,803,3.1,4606,17.8,41752,8847,32905,4.3,20.5,51097,25890,25207,12.7,25.1,-9345,-4.6,41,0,3399,3399,21397
2001,36,d) 3,22259,23180,204688,209395,976,4,3672,15,36197,8348,27849,4,17.3,45611,19141,26470,9.1,21.8,-9414,-4.5,34.6,0,2660,2660,15309
2001,36,e) 4,19455,19817,170662,175560,565,2.7,3003,14.3,27487,3521,23966,2,15.7,37282,17651,19631,10.1,21.2,-9795,-5.5,31.4,0,2201,2201,14154
2001,36,f) 5,16795,17079,150025,154477,484,2.7,2431,13.5,20725,2813,17912,1.8,13.4,29628,12849,16779,8.3,19.2,-8903,-5.8,26.8,0,1825,1825,9951
2001,36,g) 6 to 10,60637,62713,635640,654635,1515,2.3,7709,11.7,90011,12445,77566,1.9,13.7,128001,55590,72411,8.5,19.6,-37990,-5.9,27.4,0,4941,4941,28609
2001,36,h) 11 to 15,48505,51923,688326,697064,1346,2.5,4477,8.4,75332,14609,60723,2.1,10.8,92807,29431,63376,4.2,13.3,-17475,-2.5,21.6,0,2844,2844,17047
2001,36,i) 16 to 20,34498,38903,581765,589100,978,2.5,3026,7.6,60161,10127,50034,1.7,10.2,74830,28075,46755,4.8,12.7,-14669,-2.5,20.4,0,1734,1738,11942
2001,36,j) 21 to 25,20319,26844,527472,532908,827,3,1873,6.9,58049,16139,41910,3,10.9,68921,17997,50924,3.4,12.9,-10872,-2,21.8,0,1061,1061,6148
2001,36,l) Left Censored,61658,110088,3807483,3825420,7331,6.7,7680,7,418813,125211,293602,3.3,10.9,454687,132958,321729,3.5,11.9,-35874,-1,21.8,0,2619,2635,21681
2001,37,a) 0,14180,14292,87739,44142,14178,198.4,0,0,87194,87194,0,197.5,197.5,0,0,0,0,0,87194,197.5,0,0,,,
2001,37,b) 1,11026,11313,86858,87965,172,1.3,3163,24.7,24141,3726,20415,4.2,27.4,26355,14229,12126,16.2,30,-2214,-2.6,54.8,0,2267,2268,11460
2001,37,c) 2,10086,10394,91935,94962,413,3.7,2097,18.7,19502,3898,15604,4.1,20.5,25555,12536,13019,13.2,26.9,-6053,-6.4,41,0,1561,1561,9500
2001,37,d) 3,9034,9643,102344,103519,501,4.9,1581,15.6,21976,8626,13350,8.3,21.2,24326,9190,15136,8.9,23.5,-2350,-2.3,42.4,0,1166,1166,6424
2001,37,e) 4,7858,8090,72425,74653,303,3.5,1357,15.8,12254,1799,10455,2.4,16.4,16710,8193,8517,11,22.4,-4456,-6,32.8,0,927,929,4953
2001,37,f) 5,6766,7113,71312,71669,244,3.3,1030,13.8,18360,4466,13894,6.2,25.6,19074,11284,7790,15.7,26.6,-714,-1,51.2,0,712,712,5488
2001,37,g) 6 to 10,23826,25318,275772,281993,734,2.8,3061,11.6,39598,7467,32131,2.6,14,52040,20945,31095,7.4,18.5,-12442,-4.5,28,0,1978,1978,12289
2001,37,h) 11 to 15,17968,20437,323656,326323,654,3.1,1909,9.1,40135,8601,31534,2.6,12.3,45469,15733,29736,4.8,13.9,-5334,-1.6,24.6,0,1114,1114,6493
2001,37,i) 16 to 20,14470,17323,265348,270390,570,3.2,1392,7.9,30925,8054,22871,3,11.4,41010,13343,27667,4.9,15.2,-10085,-3.8,22.8,0,671,671,3437
2001,37,j) 21 to 25,8008,11540,235622,236249,480,4.1,891,7.6,27958,8237,19721,3.5,11.8,29212,9408,19804,4,12.4,-1254,-0.6,23.6,0,405,408,2280
2001,37,l) Left Censored,20346,48463,1823535,1814287,3326,6.9,3433,7.1,255438,72155,183283,4,14.1,236941,68126,168815,3.8,13.1,18497,1,26.2,0,692,693,4558
2001,38,a) 0,997,1004,6307,3165,996,198.4,0,0,6285,6285,0,198.6,198.6,0,0,0,0,0,6285,198.6,0,0,,,
2001,38,b) 1,849,860,7150,7300,10,1,225,23.3,1652,100,1552,1.4,22.6,1952,1161,791,15.9,26.7,-300,-4.1,45.2,0,144,144,941
2001,38,c) 2,701,725,6299,6708,30,3.9,144,18.5,989,386,603,5.8,14.7,1807,802,1005,12,26.9,-818,-12.2,29.4,0,102,102,600
2001,38,d) 3,726,783,7985,8150,40,4.8,130,15.7,1713,807,906,9.9,21,2042,646,1396,7.9,25.1,-329,-4.1,42,0,105,105,560
2001,38,e) 4,686,708,5362,5561,14,1.9,90,12.1,818,274,544,4.9,14.7,1216,371,845,6.7,21.9,-398,-7.2,29.4,0,71,71,317
2001,38,f) 5,596,608,4114,4270,11,1.7,85,13.2,539,22,517,0.5,12.6,851,302,549,7.1,19.9,-312,-7.3,25.2,0,58,58,217
2001,38,g) 6 to 10,2459,2535,22208,22838,57,2.2,254,9.7,2341,148,2193,0.6,10.3,3601,1525,2076,6.7,15.8,-1260,-5.5,20.6,0,183,183,922
2001,38,h) 11 to 15,1882,2044,20908,21710,46,2.2,168,8,1608,234,1374,1.1,7.4,3212,1349,1863,6.2,14.8,-1604,-7.4,14.8,0,103,103,969
2001,38,i) 16 to 20,1694,1953,20719,20886,65,3.3,153,7.7,2302,742,1560,3.6,11,2636,611,2025,2.9,12.6,-334,-1.6,22,0,79,79,352
2001,38,j) 21 to 25,1196,1506,21315,21694,28,1.8,88,5.7,1693,365,1328,1.7,7.8,2450,395,2055,1.8,11.3,-757,-3.5,15.6,0,45,45,174
2001,38,l) Left Censored,3300,5425,132849,132515,291,5.4,302,5.6,13093,4392,8701,3.3,9.9,12425,3030,9395,2.3,9.4,668,0.5,18.8,0,110,110,839
2001,39,a) 0,14148,14290,95517,47995,14166,198.3,0,0,95045,95045,0,198,198,0,0,0,0,0,95045,198,0,0,,,
2001,39,b) 1,11693,11945,106593,107958,183,1.4,3237,24,28873,5079,23794,4.7,26.7,31602,15875,15727,14.7,29.3,-2729,-2.6,53.4,0,2298,2298,12257
2001,39,c) 2,10525,10939,111513,114411,398,3.4,2013,17.2,23150,6317,16833,5.5,20.2,28945,14346,14599,12.5,25.3,-5795,-5.1,40.4,0,1497,1497,9991
2001,39,d) 3,10022,10827,109922,112579,554,4.9,1707,15,22430,9065,13365,8.1,19.9,27743,9995,17748,8.9,24.6,-5313,-4.7,39.8,0,1280,1280,6982
2001,39,e) 4,8922,9414,87428,93695,266,2.7,1403,14.1,12201,1815,10386,1.9,13,24735,10647,14088,11.4,26.4,-12534,-13.4,26,0,991,991,7761
2001,39,f) 5,8045,8332,85097,87372,197,2.2,1148,13.1,12667,1412,11255,1.6,14.5,17217,7028,10189,8,19.7,-4550,-5.2,29,0,837,837,5225
2001,39,g) 6 to 10,32068,34203,377899,388167,883,2.5,3586,10.1,47532,7523,40009,1.9,12.2,68068,23125,44943,6,17.5,-20536,-5.3,24.4,0,2358,2358,14272
2001,39,h) 11 to 15,24728,28119,423997,436542,732,2.5,2571,8.9,46004,9810,36194,2.2,10.5,71093,23756,47337,5.4,16.3,-25089,-5.8,21,0,1514,1514,10297
2001,39,i) 16 to 20,18668,22810,397172,400681,760,3.3,1578,6.8,43534,10104,33430,2.5,10.9,50551,14848,35703,3.7,12.6,-7017,-1.7,21.8,0,837,838,5842
2001,39,j) 21 to 25,12795,18014,348082,352259,637,3.5,1241,6.8,43902,16399,27503,4.7,12.5,52256,13834,38422,3.9,14.8,-8354,-2.3,25,0,567,573,3919
2001,39,l) Left Censored,36187,77105,2765503,2807491,4319,5.6,4880,6.3,286797,83817,202980,3,10.2,370772,96736,274036,3.4,13.2,-83975,-3,20.4,0,1244,1258,11544
2001,40,a) 0,5580,5638,34609,17535,5566,197.4,0,0,34148,34148,0,194.7,194.7,0,0,0,0,0,34148,194.7,0,0,,,
2001,40,b) 1,4359,4449,35243,36465,33,0.6,1367,26.7,9391,852,8539,2.3,25.8,11834,6715,5119,18.4,32.5,-2443,-6.7,51.6,0,975,975,5315
2001,40,c) 2,3861,3986,33824,38366,146,3.4,866,20,7032,1926,5106,5,18.3,16116,10613,5503,27.7,42,-9084,-23.7,36.6,0,646,646,3227
2001,40,d) 3,3544,3793,42160,41527,179,4.5,653,16.3,10323,2420,7903,5.8,24.9,9057,3337,5720,8,21.8,1266,3.1,43.6,0,476,476,2587
2001,40,e) 4,3147,3342,30561,32561,133,3.7,580,16.3,4759,902,3857,2.8,14.6,8759,4645,4114,14.3,26.9,-4000,-12.3,29.2,0,392,392,2511
2001,40,f) 5,2674,2760,23965,24973,73,2.5,409,14.1,3304,348,2956,1.4,13.2,5320,2049,3271,8.2,21.3,-2016,-8.1,26.4,0,282,282,1479
2001,40,g) 6 to 10,10310,10851,102684,105567,360,3.2,1339,11.9,14259,2721,11538,2.6,13.5,20025,7855,12170,7.4,19,-5766,-5.5,27,0,872,872,5080
2001,40,h) 11 to 15,7208,7937,117573,119628,202,2.5,814,9.9,17119,2170,14949,1.8,14.3,21229,9621,11608,8,17.7,-4110,-3.4,28.6,0,487,487,3127
2001,40,i) 16 to 20,7030,8194,122384,123318,281,3.4,625,7.5,14102,3302,10800,2.7,11.4,15969,3727,12242,3,12.9,-1867,-1.5,22.8,0,343,344,1599
2001,40,j) 21 to 25,4126,5716,104928,103097,301,5.2,454,7.9,16913,5104,11809,5,16.4,13250,4067,9183,3.9,12.9,3663,3.5,25.8,0,208,209,1091
2001,40,l) Left Censored,9362,19656,555006,558676,1128,5.7,1391,7,61988,20574,41414,3.7,11.1,69328,21609,47719,3.9,12.4,-7340,-1.3,22.2,0,416,416,3210
2001,41,a) 0,6728,6770,34452,17280,6717,198.4,0,0,34345,34345,0,198.8,198.8,0,0,0,0,0,34345,198.8,0,0,,,
2001,41,b) 1,5368,5452,35659,36519,66,1.1,1570,25.3,9108,1193,7915,3.3,24.9,10828,5720,5108,15.7,29.7,-1720,-4.8,49.8,0,1053,1055,3765
2001,41,c) 2,4945,5073,34548,35626,218,4,1047,19.1,7318,1759,5559,4.9,20.5,9474,4801,4673,13.5,26.6,-2156,-6.1,41,0,769,769,3594
2001,41,d) 3,4558,4832,38437,38917,246,4.8,795,15.6,8067,2275,5792,5.8,20.7,9026,3678,5348,9.5,23.2,-959,-2.5,41.4,0,565,565,2419
2001,41,e) 4,3917,4022,31596,32452,173,4.1,700,16.4,5353,791,4562,2.4,16.5,7064,3611,3453,11.1,21.8,-1711,-5.3,33,0,488,488,2753
2001,41,f) 5,3573,3716,41344,42282,127,3.2,610,15.5,4533,752,3781,1.8,10.7,6408,2912,3496,6.9,15.2,-1875,-4.5,21.4,0,426,426,2006
2001,41,g) 6 to 10,13564,14267,131856,134450,498,3.3,1839,12.4,19993,4500,15493,3.3,14.9,25181,10163,15018,7.6,18.7,-5188,-3.8,29.8,0,1207,1207,6832
2001,41,h) 11 to 15,9123,10148,125831,129532,321,3.1,1052,10,15630,3860,11770,3,12.1,23031,7637,15394,5.9,17.8,-7401,-5.7,24.2,0,623,623,4335
2001,41,i) 16 to 20,6560,8066,134054,136226,365,4.5,596,7.3,15713,3866,11847,2.8,11.5,20056,4764,15292,3.5,14.7,-4343,-3.2,23,0,306,307,1741
2001,41,j) 21 to 25,4646,6323,115309,114881,243,3.8,468,7.3,13570,3594,9976,3.1,11.8,12714,3197,9517,2.8,11.1,856,0.7,22.2,0,224,232,1061
2001,41,l) Left Censored,10225,20406,619627,623322,1795,8.9,1420,7,77130,23290,53840,3.7,12.4,84520,19427,65093,3.1,13.6,-7390,-1.2,24.8,0,320,321,2149
2001,42,a) 0,16026,16131,102683,51535,16015,198.6,0,0,102297,102297,0,198.5,198.5,0,0,0,0,0,102297,198.5,0,0,,,
2001,42,b) 1,13455,13672,118028,119790,148,1,3067,20.3,35535,8530,27005,7.1,29.7,39059,16531,22528,13.8,32.6,-3524,-2.9,59.4,0,2134,2137,13433
2001,42,c) 2,12011,12370,109613,113714,409,3.1,2125,16.1,20483,4463,16020,3.9,18,28685,13629,15056,12,25.2,-8202,-7.2,36,0,1554,1554,9196
2001,42,d) 3,11311,12190,126206,127248,567,4.5,1621,12.8,23700,7580,16120,6,18.6,25784,8840,16944,6.9,20.3,-2084,-1.7,37.2,0,1172,1172,6783
2001,42,e) 4,10001,10400,92393,95762,289,2.6,1438,13.1,13980,1834,12146,1.9,14.6,20718,10023,10695,10.5,21.6,-6738,-7,29.2,0,1054,1054,7296
2001,42,f) 5,8736,9068,86602,88586,245,2.6,1155,12.2,12024,1710,10314,1.9,13.6,15991,7027,8964,7.9,18.1,-3967,-4.5,27.2,0,846,846,5316
2001,42,g) 6 to 10,34335,36189,371387,382564,921,2.5,3860,10.3,47772,8525,39247,2.2,12.5,70126,27491,42635,7.2,18.3,-22354,-5.8,25,0,2620,2620,18780
2001,42,h) 11 to 15,30144,33101,420634,426801,897,2.6,2882,8.5,49532,12238,37294,2.9,11.6,61866,20361,41505,4.8,14.5,-12334,-2.9,23.2,0,1808,1808,11745
2001,42,i) 16 to 20,21881,26173,436936,442525,722,2.7,1965,7.3,43410,11025,32385,2.5,9.8,54587,18554,36033,4.2,12.3,-11177,-2.5,19.6,0,1060,1060,8163
2001,42,j) 21 to 25,13815,18759,360015,363035,676,3.6,1256,6.6,41512,11663,29849,3.2,11.4,47552,14635,32917,4,13.1,-6040,-1.7,22.8,0,642,644,4987
2001,42,l) Left Censored,39867,81334,2864673,2863430,5024,6.2,5316,6.5,340429,111109,229320,3.9,11.9,337943,99082,238861,3.5,11.8,2486,0.1,23.6,0,1520,1521,12147
2001,44,a) 0,1689,1696,8524,4269,1687,198.9,0,0,8510,8510,0,199.3,199.3,0,0,0,0,0,8510,199.3,0,0,,,
2001,44,b) 1,1381,1397,13024,13334,9,0.6,339,21.7,1905,93,1812,0.7,14.3,2525,1171,1354,8.8,18.9,-620,-4.6,28.6,0,253,253,911
2001,44,c) 2,1247,1267,8682,8942,40,2.9,225,16.6,1744,311,1433,3.5,19.5,2264,818,1446,9.1,25.3,-520,-5.8,39,0,163,163,593
2001,44,d) 3,1231,1300,9839,10085,65,4.8,185,13.6,1756,576,1180,5.7,17.4,2248,723,1525,7.2,22.3,-492,-4.9,34.8,0,130,130,535
2001,44,e) 4,1040,1060,9622,10391,30,2.7,170,15.1,1199,73,1126,0.7,11.5,2736,1327,1409,12.8,26.3,-1537,-14.8,23,0,121,121,1106
2001,44,f) 5,943,946,7557,7826,33,3.4,112,11.4,976,94,882,1.2,12.5,1514,554,960,7.1,19.3,-538,-6.8,25,0,90,90,468
2001,44,g) 6 to 10,3571,3659,34970,36091,99,2.6,397,10.5,4121,446,3675,1.2,11.4,6362,2153,4209,6,17.6,-2241,-6.2,22.8,0,280,280,1618
2001,44,h) 11 to 15,3131,3344,40615,41101,78,2.3,299,8.7,4303,670,3633,1.6,10.5,5275,1999,3276,4.9,12.8,-972,-2.3,21,0,185,185,742
2001,44,i) 16 to 20,2072,2307,32576,32756,60,2.5,171,7.3,3666,697,2969,2.1,11.2,4025,1296,2729,4,12.3,-359,-1.1,22.4,0,107,107,524
2001,44,j) 21 to 25,1415,1691,29415,29621,45,2.6,114,6.6,3243,1259,1984,4.3,10.9,3655,684,2971,2.3,12.3,-412,-1.4,21.8,0,56,56,299
2001,44,l) Left Censored,4506,6683,213067,213975,377,5.6,449,6.7,21628,6559,15069,3.1,10.1,23443,4708,18735,2.2,11,-1815,-0.9,20.2,0,164,164,946
2001,45,a) 0,6696,6759,43930,22086,6705,198.4,0,0,43688,43688,0,197.8,197.8,0,0,0,0,0,43688,197.8,0,0,,,
2001,45,b) 1,5383,5507,48768,48956,64,1,1588,25.3,13264,2743,10521,5.6,27.1,13640,7574,6066,15.5,27.9,-376,-0.8,54.2,0,1150,1150,5781
2001,45,c) 2,4742,4879,49202,49366,190,3.6,1153,21.6,11804,1968,9836,4,23.9,12132,6207,5925,12.6,24.6,-328,-0.7,47.8,0,838,838,4885
2001,45,d) 3,4307,4495,49501,51361,211,4.4,854,17.8,10092,3658,6434,7.1,19.6,13811,4919,8892,9.6,26.9,-3719,-7.3,39.2,0,647,647,3962
2001,45,e) 4,3600,3666,36871,39515,101,2.6,671,17.1,4756,539,4217,1.4,12,10043,4589,5454,11.6,25.4,-5287,-13.4,24,0,468,471,3405
2001,45,f) 5,3196,3293,30693,37879,87,2.5,521,14.9,3959,425,3534,1.1,10.5,18330,2545,15785,6.7,48.4,-14371,-37.9,21,0,385,385,1881
2001,45,g) 6 to 10,11671,12435,146094,149105,411,3.2,1572,12.1,21005,3022,17983,2,14.1,27027,10582,16445,7.1,18.1,-6022,-4,28.2,0,1042,1042,6757
2001,45,h) 11 to 15,8467,9920,152924,155310,320,3.1,983,9.6,18993,4845,14148,3.1,12.2,23764,7635,16129,4.9,15.3,-4771,-3.1,24.4,0,587,587,3391
2001,45,i) 16 to 20,6681,7995,117117,119641,243,3,652,8,12483,3029,9454,2.5,10.4,17530,5297,12233,4.4,14.7,-5047,-4.3,20.8,0,343,345,2190
2001,45,j) 21 to 25,3870,5716,97455,97579,258,4.5,426,7.4,13159,3590,9569,3.7,13.5,13407,4085,9322,4.2,13.7,-248,-0.2,27,0,191,191,1037
2001,45,l) Left Censored,9978,22624,812913,818863,1460,6.4,1618,7.1,86603,25770,60833,3.1,10.6,98502,29035,69467,3.5,12,-11899,-1.4,21.2,0,353,353,3068
2001,46,a) 0,1466,1486,9034,4575,1461,196.6,0,0,8919,,,,195,0,0,0,0,0,8919,195,0,1,,,
2001,46,b) 1,1185,1208,12750,11059,14,1,319,23.4,5997,255,5742,2.3,54.2,2614,1249,1365,11.3,23.6,3383,30.6,47.2,0,211,211,1018
2001,46,c) 2,1076,1097,7621,8052,34,2.9,218,18.4,1199,263,936,3.3,14.9,2061,1106,955,13.7,25.6,-862,-10.7,29.8,0,154,154,891
2001,46,d) 3,981,1021,7923,8225,45,4.2,173,16,1485,585,900,7.1,18.1,2088,946,1142,11.5,25.4,-603,-7.3,36.2,0,123,123,638
2001,46,e) 4,862,887,7711,7917,36,3.9,131,14.1,1502,268,1234,3.4,19,1914,774,1140,9.8,24.2,-412,-5.2,38,0,87,87,563
2001,46,f) 5,783,800,5336,5655,24,2.9,107,12.8,645,164,481,2.9,11.4,1282,514,768,9.1,22.7,-637,-11.3,22.8,0,72,72,397
2001,46,g) 6 to 10,3017,3139,27196,28588,78,2.4,343,10.5,2723,450,2273,1.6,9.5,5506,2120,3386,7.4,19.3,-2783,-9.8,19,0,220,220,1183
2001,46,h) 11 to 15,2101,2270,39267,37585,56,2.4,215,9.2,7555,,,,20.1,4190,981,3209,2.6,11.1,3365,9,22.2,1,145,145,654
2001,46,i) 16 to 20,1758,2039,22106,22474,60,2.9,174,8.3,2151,416,1735,1.9,9.6,2887,945,1942,4.2,12.8,-736,-3.2,19.2,0,82,82,390
2001,46,j) 21 to 25,1180,1504,21181,21857,34,2.2,114,7.4,2027,591,1436,2.7,9.3,3378,1438,1940,6.6,15.5,-1351,-6.2,18.6,0,55,56,318
2001,46,l) Left Censored,3494,5747,152557,151916,306,5.3,331,5.8,15842,6147,9695,4,10.4,14560,2927,11633,1.9,9.6,1282,0.8,19.2,0,102,102,557
2001,47,a) 0,7893,7987,53903,27076,7915,198.2,0,0,53654,53654,0,198.2,198.2,0,0,0,0,0,53654,198.2,0,0,,,
2001,47,b) 1,6051,6191,55083,56420,78,1.1,2126,29.5,16427,1914,14513,3.4,29.1,19100,11026,8074,19.5,33.9,-2673,-4.8,58.2,0,1613,1614,8327
2001,47,c) 2,5574,5854,60293,64317,241,3.8,1381,21.6,12611,2105,10506,3.3,19.6,20658,10539,10119,16.4,32.1,-8047,-12.5,39.2,0,1033,1033,8602
2001,47,d) 3,5224,5674,62090,64365,296,4.9,1058,17.5,11895,4430,7465,6.9,18.5,16444,7099,9345,11,25.5,-4549,-7,37,0,799,799,5394
2001,47,e) 4,4412,4621,46802,48363,195,4,752,15.4,8606,2294,6312,4.7,17.8,11728,4311,7417,8.9,24.2,-3122,-6.4,35.6,0,546,546,3156
2001,47,f) 5,4115,4272,45426,47539,131,2.9,683,15.1,7751,2171,5580,4.6,16.3,11977,6181,5796,13,25.2,-4226,-8.9,32.6,0,483,483,3559
2001,47,g) 6 to 10,15530,16700,193976,199861,546,3.1,2063,11.9,27168,4438,22730,2.2,13.6,38937,16525,22412,8.3,19.5,-11769,-5.9,27.2,0,1372,1372,8934
2001,47,h) 11 to 15,11581,13403,213557,220067,445,3.2,1271,9.2,24627,5590,19037,2.5,11.2,37646,15534,22112,7.1,17.1,-13019,-5.9,22.4,0,757,757,10533
2001,47,i) 16 to 20,9466,11305,174369,177676,370,3.2,890,7.7,17833,3942,13891,2.2,10,24447,7455,16992,4.2,13.8,-6614,-3.8,20,0,428,429,2988
2001,47,j) 21 to 25,5761,9205,216720,217093,598,6.4,787,8.5,33908,10029,23879,4.6,15.6,34653,11656,22997,5.4,16,-745,-0.4,31.2,0,280,283,1684
2001,47,l) Left Censored,14325,33289,1238306,1247788,1996,6,2498,7.5,144188,41361,102827,3.3,11.6,163151,44262,118889,3.5,13.1,-18963,-1.5,23.2,0,588,589,4909
2001,48,a) 0,33510,33882,250215,126554,33623,198.5,0,0,247323,247323,0,195.4,195.4,0,0,0,0,0,247323,195.4,0,0,,,
2001,48,b) 1,25628,26227,232075,234792,317,1.1,7987,26.6,67587,9553,58034,4.1,28.8,73020,39780,33240,16.9,31.1,-5433,-2.3,57.6,0,5906,5921,31250
2001,48,c) 2,22279,23078,244106,248713,949,3.8,5074,20.2,57876,12149,45727,4.9,23.3,67089,34234,32855,13.8,27,-9213,-3.7,46.6,0,3740,3740,26416
2001,48,d) 3,20085,21561,250596,254454,1154,5.1,3813,16.7,51597,14906,36691,5.9,20.3,59313,27816,31497,10.9,23.3,-7716,-3,40.6,0,2840,2840,19963
2001,48,e) 4,17618,18402,210269,211024,654,3.4,3071,15.7,46608,6613,39995,3.1,22.1,48118,22188,25930,10.5,22.8,-1510,-0.7,44.2,0,2180,2180,14784
2001,48,f) 5,15721,16581,180918,192048,574,3.3,2609,14.9,27199,4345,22854,2.3,14.2,49458,26317,23141,13.7,25.8,-22259,-11.6,28.4,0,1819,1820,12273
2001,48,g) 6 to 10,58594,63512,794290,810245,2152,3.3,8110,12.3,124260,23821,100439,2.9,15.3,156172,63468,92704,7.8,19.3,-31912,-4,30.6,0,5280,5280,40129
2001,48,h) 11 to 15,38759,45581,764557,781204,1716,3.7,4628,9.9,107697,28689,79008,3.7,13.8,140992,60770,80222,7.8,18,-33295,-4.2,27.6,0,2592,2592,19801
2001,48,i) 16 to 20,35678,43588,752520,758559,1630,3.7,3585,8.1,107981,28481,79500,3.8,14.2,120058,38409,81649,5.1,15.8,-12077,-1.6,28.4,0,1865,1871,12879
2001,48,j) 21 to 25,16868,26083,514091,516112,1315,5,2119,8,73078,25010,48068,4.8,14.2,77120,27661,49459,5.4,14.9,-4042,-0.7,28.4,0,889,889,5034
2001,48,l) Left Censored,37569,107048,3871813,3856552,8919,8.4,7840,7.4,554210,202607,351603,5.3,14.4,523687,166530,357157,4.3,13.6,30523,0.8,27.2,0,1544,1549,13704
2001,49,a) 0,4969,5012,30431,15327,4958,197.8,0,0,30209,30209,0,197.1,197.1,0,0,0,0,0,30209,197.1,0,0,,,
2001,49,b) 1,3626,3670,30062,30778,24,0.6,1113,26.4,8185,294,7891,1,26.6,9616,5200,4416,16.9,31.2,-1431,-4.6,53.2,0,778,780,4060
2001,49,c) 2,3137,3204,31567,31208,127,3.6,767,21.8,8923,789,8134,2.5,28.6,8205,4103,4102,13.1,26.3,718,2.3,52.6,0,545,545,3055
2001,49,d) 3,2671,2782,27595,28308,128,4.3,563,18.9,5038,1407,3631,5,17.8,6464,3322,3142,11.7,22.8,-1426,-5,35.6,0,390,390,2492
2001,49,e) 4,2362,2429,22699,23868,88,3.4,425,16.4,3562,495,3067,2.1,14.9,5900,3080,2820,12.9,24.7,-2338,-9.8,29.8,0,294,294,2070
2001,49,f) 5,2092,2194,28757,29893,65,2.8,382,16.3,4120,803,3317,2.7,13.8,6391,3259,3132,10.9,21.4,-2271,-7.6,27.6,0,252,252,2195
2001,49,g) 6 to 10,6738,7151,87649,92779,242,3.2,906,12.2,12087,2324,9763,2.5,13,22346,11510,10836,12.4,24.1,-10259,-11.1,26,0,607,607,8953
2001,49,h) 11 to 15,3892,4478,84124,88403,161,3.5,442,9.6,13150,5070,8080,5.7,14.9,21707,8675,13032,9.8,24.6,-8557,-9.7,29.8,0,249,249,1947
2001,49,i) 16 to 20,2865,3518,70682,70330,212,6,304,8.6,11796,3698,8098,5.3,16.8,11092,4539,6553,6.5,15.8,704,1,31.6,0,151,151,955
2001,49,j) 21 to 25,2129,2923,56450,56669,114,3.8,222,7.5,7330,1605,5725,2.8,12.9,7768,2923,4845,5.2,13.7,-438,-0.8,25.8,0,98,99,858
2001,49,l) Left Censored,4807,10944,439976,441940,1014,9.2,1200,10.9,61787,18659,43128,4.2,14,65714,19790,45924,4.5,14.9,-3927,-0.9,28,0,159,161,1164
2001,50,a) 0,1174,1181,5829,2946,1169,198,0,0,5767,5767,0,195.8,195.8,0,0,0,0,0,5767,195.8,0,0,,,
2001,50,b) 1,1080,1100,6882,6646,21,1.7,227,18.9,2145,764,1381,11.5,32.3,1672,857,815,12.9,25.2,473,7.1,50.4,0,165,165,698
2001,50,c) 2,922,943,5929,6196,32,3.2,173,17.1,1068,219,849,3.5,17.2,1601,839,762,13.5,25.8,-533,-8.6,34.4,0,123,123,724
2001,50,d) 3,920,976,7236,7331,33,3.2,139,13.6,1206,251,955,3.4,16.5,1395,757,638,10.3,19,-189,-2.5,33,0,96,96,582
2001,50,e) 4,830,843,4669,4809,25,2.8,101,11.5,608,54,554,1.1,12.6,888,383,505,8,18.5,-280,-5.9,25.2,0,76,76,309
2001,50,f) 5,728,734,5249,5384,14,1.8,91,11.8,623,31,592,0.6,11.6,893,412,481,7.7,16.6,-270,-5,23.2,0,64,64,248
2001,50,g) 6 to 10,2932,3041,23817,24183,90,2.9,272,8.7,3171,579,2592,2.4,13.1,3903,1296,2607,5.4,16.1,-732,-3,26.2,0,191,191,973
2001,50,h) 11 to 15,2570,2693,25516,25834,65,2.3,244,8.8,2926,633,2293,2.5,11.3,3562,1189,2373,4.6,13.8,-636,-2.5,22.6,0,149,149,707
2001,50,i) 16 to 20,1793,2087,32282,31735,49,2.3,135,6.4,3582,609,2973,1.9,11.3,2487,673,1814,2.1,7.8,1095,3.5,15.6,0,83,83,353
2001,50,j) 21 to 25,1023,1276,21014,21100,44,3.4,73,5.7,1926,459,1467,2.2,9.1,2097,425,1672,2,9.9,-171,-0.8,18.2,0,37,37,140
2001,50,l) Left Censored,2674,4281,121185,120397,208,4.8,235,5.5,11475,2832,8643,2.4,9.5,9898,2701,7197,2.2,8.2,1577,1.3,16.4,0,100,100,665
2001,51,a) 0,11499,11612,67251,33779,11523,198.5,0,0,66945,66945,0,198.2,198.2,0,0,0,0,0,66945,198.2,0,0,,,
2001,51,b) 1,9149,9332,70958,69599,137,1.3,2542,24.1,23017,3993,19024,5.7,33.1,20299,10813,9486,15.5,29.2,2718,3.9,58.4,0,1776,1778,8135
2001,51,c) 2,7888,8139,70619,71754,343,3.9,1561,17.9,17176,4823,12353,6.7,23.9,19445,8974,10471,12.5,27.1,-2269,-3.2,47.8,0,1087,1087,6383
2001,51,d) 3,7526,7997,77641,78906,445,5.3,1215,14.5,15606,5469,10137,6.9,19.8,18135,6597,11538,8.4,23,-2529,-3.2,39.6,0,858,858,4712
2001,51,e) 4,6440,6608,60526,61877,214,3.1,1041,14.9,10599,1090,9509,1.8,17.1,13301,5124,8177,8.3,21.5,-2702,-4.4,34.2,0,741,741,3595
2001,51,f) 5,5702,5885,59333,60639,177,2.9,813,13.2,9111,1462,7649,2.4,15,11723,4938,6785,8.1,19.3,-2612,-4.3,30,0,577,577,3871
2001,51,g) 6 to 10,21956,23216,274691,278796,660,2.7,2594,10.8,38236,6144,32092,2.2,13.7,46445,17328,29117,6.2,16.7,-8209,-3,27.4,0,1686,1686,11598
2001,51,h) 11 to 15,16525,18656,287801,291785,580,3,1696,8.8,40067,9376,30691,3.2,13.7,48034,14084,33950,4.8,16.5,-7967,-2.8,27.4,0,980,980,5955
2001,51,i) 16 to 20,11948,14646,260021,263024,505,3.4,1056,7.1,30893,8547,22346,3.2,11.7,36899,10057,26842,3.8,14,-6006,-2.3,23.4,0,508,509,3794
2001,51,j) 21 to 25,6912,9949,190986,193397,332,3.3,695,6.9,21419,5166,16253,2.7,11.1,26241,7734,18507,4,13.6,-4822,-2.5,22.2,0,297,298,1611
2001,51,l) Left Censored,17477,42739,1488607,1481618,2938,6.9,3217,7.5,208738,76796,131942,5.2,14.1,194760,52776,141984,3.6,13.1,13978,1,26.2,0,597,598,5148
2001,53,a) 0,11901,11983,63017,31721,11881,198.3,0,0,62592,62592,0,197.3,197.3,0,0,0,0,0,62592,197.3,0,0,,,
2001,53,b) 1,9387,9542,68669,70030,111,1,2927,26.7,19831,3225,16606,4.6,28.3,22552,11153,11399,15.9,32.2,-2721,-3.9,56.6,0,1982,1986,8131
2001,53,c) 2,8333,8609,75908,80049,393,4.2,1893,20.3,18152,6438,11714,8,22.7,26434,13344,13090,16.7,33,-8282,-10.3,45.4,0,1353,1353,11514
2001,53,d) 3,7556,8043,73684,73988,394,4.6,1426,16.7,15612,4183,11429,5.7,21.1,16220,6946,9274,9.4,21.9,-608,-0.8,42.2,0,982,982,4800
2001,53,e) 4,6504,6672,58231,60083,266,3.8,1151,16.3,10425,1133,9292,1.9,17.4,14129,6972,7157,11.6,23.5,-3704,-6.1,34.8,0,763,763,5437
2001,53,f) 5,5786,5918,50376,52510,211,3.4,984,15.7,7974,1795,6179,3.4,15.2,12241,4896,7345,9.3,23.3,-4267,-8.1,30.4,0,668,668,3513
2001,53,g) 6 to 10,21643,22712,220410,227736,836,3.5,3064,12.9,31117,5815,25302,2.6,13.7,45769,19027,26742,8.4,20.1,-14652,-6.4,27.4,0,1904,1904,12439
2001,53,h) 11 to 15,14597,16218,214551,219816,611,3.7,1690,10.1,25903,6201,19702,2.8,11.8,36432,11904,24528,5.4,16.6,-10529,-4.8,23.6,0,959,959,7048
2001,53,i) 16 to 20,10677,13164,228740,231660,636,4.7,1165,8.7,32619,8005,24614,3.5,14.1,38458,9311,29147,4,16.6,-5839,-2.5,28.2,0,596,596,3466
2001,53,j) 21 to 25,6982,9677,174210,175071,404,4.1,769,7.8,20958,5341,15617,3.1,12,22680,7631,15049,4.4,13,-1722,-1,24,0,319,323,1881
2001,53,l) Left Censored,14367,31385,1018439,1018294,2333,7.5,2179,7,126077,40680,85397,4,12.4,125787,35159,90628,3.5,12.4,290,0,24.8,0,558,561,4569
2001,54,a) 0,2063,2072,12043,6173,2050,197.9,0,0,11740,11740,0,190.2,190.2,0,0,0,0,0,11740,190.2,0,0,,,
2001,54,b) 1,1815,1858,12335,12687,22,1,534,25.3,3337,684,2653,5.4,26.3,4040,2081,1959,16.4,31.8,-703,-5.5,52.6,0,381,381,1576
2001,54,c) 2,1594,1644,12799,13303,69,3.8,390,21.7,2804,1013,1791,7.6,21.1,3811,1556,2255,11.7,28.6,-1007,-7.5,42.2,0,285,285,1143
2001,54,d) 3,1511,1706,13923,14436,96,5.4,255,14.3,2535,758,1777,5.3,17.6,3561,1621,1940,11.2,24.7,-1026,-7.1,35.2,0,186,186,1364
2001,54,e) 4,1375,1385,9473,10105,44,3,233,15.8,1322,165,1157,1.6,13.1,2585,1266,1319,12.5,25.6,-1263,-12.5,26.2,0,166,166,878
2001,54,f) 5,1193,1219,9720,10146,33,2.5,218,16.7,1597,142,1455,1.4,15.7,2449,1350,1099,13.3,24.1,-852,-8.4,31.4,0,152,152,822
2001,54,g) 6 to 10,4871,5099,44135,44878,170,3.2,652,12.3,7549,2001,5548,4.5,16.8,9034,4295,4739,9.6,20.1,-1485,-3.3,33.6,0,434,434,2199
2001,54,h) 11 to 15,3813,4110,52681,53091,103,2.4,410,9.6,6615,1299,5316,2.4,12.5,7435,2553,4882,4.8,14,-820,-1.5,25,0,244,244,1266
2001,54,i) 16 to 20,3273,3751,50276,50905,91,2.4,258,6.7,4858,1127,3731,2.2,9.5,6116,1639,4477,3.2,12,-1258,-2.5,19,0,146,146,582
2001,54,j) 21 to 25,2045,3034,47315,47448,90,2.9,186,6,5459,1258,4201,2.7,11.5,5725,1466,4259,3.1,12.1,-266,-0.6,23,0,102,102,412
2001,54,l) Left Censored,5987,11109,285129,289614,534,4.7,870,7.7,27644,5974,21670,2.1,9.5,36615,12633,23982,4.4,12.6,-8971,-3.1,19,0,243,244,945
2001,55,a) 0,7682,7795,50331,25899,7716,198,0,0,48864,48864,0,188.7,188.7,0,0,0,0,0,48864,188.7,0,0,,,
2001,55,b) 1,6686,6806,49805,49857,103,1.4,1549,20.6,13314,2987,10327,6,26.7,13418,5730,7688,11.5,26.9,-104,-0.2,53.4,0,1066,1068,4135
2001,55,c) 2,5886,6165,57268,58664,205,3.1,1057,16.1,11822,3250,8572,5.5,20.2,14614,5972,8642,10.2,24.9,-2792,-4.7,40.4,0,794,794,4496
2001,55,d) 3,5558,5966,59715,60395,272,4.4,807,13,11899,5319,6580,8.8,19.7,13258,5004,8254,8.3,22,-1359,-2.3,39.4,0,607,607,3807
2001,55,e) 4,4952,5133,41340,42743,139,2.6,702,13,5522,655,4867,1.5,12.9,8327,3611,4716,8.4,19.5,-2805,-6.6,25.8,0,507,507,2613
2001,55,f) 5,4477,4548,41722,42868,101,2.1,592,12.4,5297,557,4740,1.3,12.4,7589,3111,4478,7.3,17.7,-2292,-5.3,24.8,0,424,424,2331
2001,55,g) 6 to 10,17698,18658,183641,190036,453,2.3,1989,10.3,19767,2539,17228,1.3,10.4,32556,12331,20225,6.5,17.1,-12789,-6.7,20.8,0,1354,1354,8419
2001,55,h) 11 to 15,13126,14732,203973,208138,402,2.7,1331,8.8,22368,4770,17598,2.3,10.7,30698,9331,21367,4.5,14.7,-8330,-4,21.4,0,777,777,4691
2001,55,i) 16 to 20,9936,11678,190992,192978,297,2.5,805,6.8,20816,3792,17024,2,10.8,24787,8908,15879,4.6,12.8,-3971,-2,21.6,0,444,445,3056
2001,55,j) 21 to 25,6611,9336,178766,179092,332,3.5,706,7.4,21419,7423,13996,4.1,12,22070,5916,16154,3.3,12.3,-651,-0.3,24,0,296,299,1473
2001,55,l) Left Censored,18991,35716,1324577,1340241,1948,5.4,2259,6.3,119727,32666,87061,2.4,8.9,151054,41229,109825,3.1,11.3,-31327,-2.4,17.8,0,696,701,7153
2001,56,a) 0,1264,1271,6493,3251,1264,198.9,0,0,6484,,,,199.4,0,0,0,0,0,6484,199.4,0,1,,,
2001,56,b) 1,1065,1078,6425,6516,13,1.1,273,22.6,1716,221,1495,3.4,26.3,1898,942,956,14.5,29.1,-182,-2.8,52.6,0,172,172,659
2001,56,c) 2,851,880,6144,6172,36,3.8,184,19.3,1428,378,1050,6.1,23.1,1484,639,845,10.4,24,-56,-0.9,46.2,0,134,134,434
2001,56,d) 3,849,899,6867,7044,53,5.6,149,15.8,1350,376,974,5.3,19.2,1703,723,980,10.3,24.2,-353,-5,38.4,0,96,96,393
2001,56,e) 4,700,713,4784,4848,12,1.6,129,16.8,882,96,786,2,18.2,1009,525,484,10.8,20.8,-127,-2.6,36.4,0,82,82,333
2001,56,f) 5,675,708,4875,5022,14,1.9,99,13.2,709,49,660,1,14.1,1003,366,637,7.3,20,-294,-5.9,28.2,0,58,58,250
2001,56,g) 6 to 10,2364,2420,19274,19935,71,2.8,336,13.2,2549,371,2178,1.9,12.8,3870,1697,2173,8.5,19.4,-1321,-6.6,25.6,0,215,215,1254
2001,56,h) 11 to 15,1449,1581,19937,20302,45,2.8,160,9.8,1860,,,,9.2,2590,880,1710,4.3,12.8,-730,-3.6,18.4,1,112,112,591
2001,56,i) 16 to 20,1379,1590,16913,17040,50,3.1,142,8.7,2092,370,1722,2.2,12.3,2345,549,1796,3.2,13.8,-253,-1.5,24.6,0,80,81,394
2001,56,j) 21 to 25,987,1265,17683,17777,31,2.4,93,7.2,2114,226,1888,1.3,11.9,2302,623,1679,3.5,12.9,-188,-1,23.8,0,59,59,432
2001,56,l) Left Censored,2147,3529,65843,65918,271,7.7,259,7.4,7821,2289,5532,3.5,11.9,7971,2226,5745,3.4,12.1,-150,-0.2,23.8,0,57,57,267
2002,01,a) 0,6342,6422,40462,20231,6422,200,0,0,40462,40462,0,200,200,0,0,0,0,0,40462,200,0,0,,,
2002,01,b) 1,4725,4812,38009,37080,37,0.7,1397,25.4,12430,707,11723,1.9,33.5,10571,6033,4538,16.3,28.5,1859,5,57,0,1054,1054,4559
2002,01,c) 2,4124,4262,35828,36765,215,4.7,931,20.2,7931,1486,6445,4,21.6,9805,4956,4849,13.5,26.7,-1874,-5.1,43.2,0,703,704,3736
2002,01,d) 3,3985,4133,37129,37549,209,4.8,640,14.7,7373,1505,5868,4,19.6,8212,3226,4986,8.6,21.9,-839,-2.3,39.2,0,504,504,2830
2002,01,e) 4,3668,3947,41003,42860,231,5.6,616,14.9,7007,2258,4749,5.3,16.3,10720,3092,7628,7.2,25,-3713,-8.7,32.6,0,470,470,2391
2002,01,f) 5,3362,3457,31779,32998,173,4.8,506,14,5180,1201,3979,3.6,15.7,7617,2589,5028,7.8,23.1,-2437,-7.4,31.4,0,360,360,1698
2002,01,g) 6 to 10,12460,13118,131008,136303,615,4.5,1628,11.9,19333,4138,15195,3,14.2,29922,9814,20108,7.2,22,-10589,-7.8,28.4,0,1118,1118,5735
2002,01,h) 11 to 15,8690,9865,152514,155433,446,4.4,986,9.7,18763,5516,13247,3.5,12.1,24600,7359,17241,4.7,15.8,-5837,-3.7,24.2,0,595,595,3599
2002,01,i) 16 to 20,7344,8847,149307,153350,392,4.4,709,7.9,17161,4233,12928,2.8,11.2,25246,6845,18401,4.5,16.5,-8085,-5.3,22.4,0,352,359,2687
2002,01,j) 21 to 25,5218,7779,141907,149875,446,5.7,641,8.1,16885,4335,12550,2.9,11.3,32821,14923,17898,10,21.9,-15936,-10.6,22.6,0,245,245,1296
2002,01,l) Left Censored,10159,23872,772898,785807,1805,7.5,2319,9.6,103207,39377,63830,5,13.1,129025,40258,88767,5.1,16.4,-25818,-3.3,26.2,0,382,383,5849
2002,02,a) 0,1382,1404,7411,3706,1404,200,0,0,7411,,,,200,0,0,0,0,0,7411,200,0,1,,,
2002,02,b) 1,873,882,4949,5227,4,0.4,313,30.2,1189,,,,22.7,1745,1119,626,21.4,33.4,-556,-10.7,45.4,1,177,177,734
2002,02,c) 2,832,853,5520,5678,53,5.8,173,18.9,1410,283,1127,5,24.8,1726,894,832,15.7,30.4,-316,-5.6,49.6,0,102,102,583
2002,02,d) 3,672,718,6972,6918,64,8.5,130,17.3,1971,1042,929,15.1,28.5,1862,538,1324,7.8,26.9,109,1.6,53.8,0,79,79,379
2002,02,e) 4,707,756,6441,6390,54,6.9,100,12.8,1480,337,1143,5.3,23.2,1377,447,930,7,21.5,103,1.7,43,0,66,66,325
2002,02,f) 5,603,610,4735,4806,41,6.4,103,16.1,903,194,709,4,18.8,1044,369,675,7.7,21.7,-141,-2.9,37.6,0,55,55,198
2002,02,g) 6 to 10,2210,2289,15894,16382,151,6.4,323,13.6,3022,657,2365,4,18.4,3998,1555,2443,9.5,24.4,-976,-6,36.8,0,187,187,1046
2002,02,h) 11 to 15,1593,1702,23756,23666,83,4.7,207,11.7,3253,518,2735,2.2,13.7,3072,1084,1988,4.6,13,181,0.7,26,0,112,112,430
2002,02,i) 16 to 20,1440,1707,18991,19526,91,5.2,168,9.6,3566,905,2661,4.6,18.3,4636,1372,3264,7,23.7,-1070,-5.4,36.6,0,74,76,643
2002,02,j) 21 to 25,1040,1559,30280,29733,101,6.4,117,7.5,5386,1068,4318,3.6,18.1,4291,1094,3197,3.7,14.4,1095,3.7,28.8,0,42,42,411
2002,02,l) Left Censored,1491,3112,89228,90651,190,6,290,9.2,11156,3461,7695,3.8,12.3,14001,3419,10582,3.8,15.4,-2845,-3.1,24.6,0,38,38,228
2002,04,a) 0,9531,9606,63454,31727,9606,200,0,0,63454,63454,0,200,200,0,0,0,0,0,63454,200,0,0,,,
2002,04,b) 1,7098,7260,53727,54983,83,1,2239,26.9,15775,1562,14213,2.8,28.7,18287,9973,8314,18.1,33.3,-2512,-4.6,57.4,0,1549,1553,7645
2002,04,c) 2,5975,6148,64032,65297,294,4.4,1371,20.5,13918,3251,10667,5,21.3,16448,7824,8624,12,25.2,-2530,-3.9,42.6,0,1014,1018,6244
2002,04,d) 3,5481,5678,68539,71914,311,5.2,1011,16.8,11275,2548,8727,3.5,15.7,18024,6546,11478,9.1,25.1,-6749,-9.4,31.4,0,760,760,5237
2002,04,e) 4,4795,5144,58642,60371,325,6.1,755,14.1,10258,2597,7661,4.3,17,13716,4768,8948,7.9,22.7,-3458,-5.7,34,0,527,527,3821
2002,04,f) 5,4114,4320,47790,49627,221,4.8,717,15.7,7495,1441,6054,2.9,15.1,11169,4588,6581,9.2,22.5,-3674,-7.4,30.2,0,501,501,3175
2002,04,g) 6 to 10,14709,15582,188505,199371,734,4.5,2139,13.1,28842,6144,22698,3.1,14.5,50573,19577,30996,9.8,25.4,-21731,-10.9,29,0,1369,1369,10971
2002,04,h) 11 to 15,9490,10880,186534,187148,569,5.1,1206,10.8,30195,10220,19975,5.5,16.1,31422,10562,20860,5.6,16.8,-1227,-0.7,32.2,0,669,669,4059
2002,04,i) 16 to 20,7287,9494,179699,190029,551,5.7,1012,10.4,27674,9455,18219,5,14.6,48333,10422,37911,5.5,25.4,-20659,-10.8,29.2,0,440,450,4181
2002,04,j) 21 to 25,5034,7388,192206,192517,491,6.5,868,11.5,33109,9123,23986,4.7,17.2,33731,14166,19565,7.4,17.5,-622,-0.3,34.4,0,253,254,2592
2002,04,l) Left Censored,7349,21869,816335,824590,2243,10.2,2345,10.7,139467,50044,89423,6.1,16.9,155978,49301,106677,6,18.9,-16511,-2,33.8,0,251,254,2010
2002,05,a) 0,4394,4429,26846,13423,4429,200,0,0,26846,26846,0,200,200,0,0,0,0,0,26846,200,0,0,,,
2002,05,b) 1,3188,3254,20484,21867,27,0.7,978,26.2,4689,262,4427,1.2,21.4,7455,4098,3357,18.7,34.1,-2766,-12.7,42.8,0,740,740,3244
2002,05,c) 2,2760,2834,20151,21581,156,5.1,614,20,4245,1068,3177,4.9,19.7,7104,2968,4136,13.8,32.9,-2859,-13.2,39.4,0,471,471,2608
2002,05,d) 3,2564,2673,18722,19506,179,6.4,460,16.3,3826,1166,2660,6,19.6,5394,2177,3217,11.2,27.7,-1568,-8.1,39.2,0,335,335,1737
2002,05,e) 4,2265,2522,21640,22233,154,5.9,366,13.9,3732,810,2922,3.6,16.8,4917,1503,3414,6.8,22.1,-1185,-5.3,33.6,0,271,271,1253
2002,05,f) 5,2015,2057,17576,18291,126,5.8,321,14.9,2832,916,1916,5,15.5,4262,1699,2563,9.3,23.3,-1430,-7.8,31,0,215,215,1360
2002,05,g) 6 to 10,8115,8539,81077,84314,435,4.9,1056,11.9,12846,3724,9122,4.4,15.2,19319,6590,12729,7.8,22.9,-6473,-7.7,30.4,0,707,709,4289
2002,05,h) 11 to 15,5299,5994,80816,80185,305,5,585,9.5,15824,2847,12977,3.6,19.7,14562,4788,9774,6,18.2,1262,1.5,36.4,0,350,350,1932
2002,05,i) 16 to 20,4568,5278,81647,79169,245,4.6,419,7.8,16938,3443,13495,4.3,21.4,11981,3027,8954,3.8,15.1,4957,6.3,30.2,0,209,209,1147
2002,05,j) 21 to 25,3614,4834,90813,97415,220,4.5,428,8.7,11263,2862,8401,2.9,11.6,24467,15426,9041,15.8,25.1,-13204,-13.5,23.2,0,177,178,1070
2002,05,l) Left Censored,6703,14431,513485,519713,1067,7.4,1212,8.4,56800,23435,33365,4.5,10.9,69255,20177,49078,3.9,13.3,-12455,-2.4,21.8,0,228,229,1389
2002,06,a) 0,63678,64582,437896,219771,64581,200,0,0,436250,436250,0,198.5,198.5,0,0,0,0,0,436250,198.5,0,0,,,
2002,06,b) 1,47259,48190,367045,380077,414,0.7,15204,27.4,97462,8243,89219,2.2,25.6,123526,68053,55473,17.9,32.5,-26064,-6.9,51.2,0,10679,10684,51992
2002,06,c) 2,40174,41337,386303,414126,2159,4.8,9223,20.6,80457,16547,63910,4,19.4,136103,67429,68674,16.3,32.9,-55646,-13.5,38.8,0,6719,6746,55042
2002,06,d) 3,34983,36588,361310,384706,2111,5.4,6552,16.9,70188,18214,51974,4.7,18.2,116980,49644,67336,12.9,30.4,-46792,-12.2,36.4,0,4782,4782,39011
2002,06,e) 4,31358,34153,397157,409565,2137,6,5257,14.7,84809,21352,63457,5.2,20.7,109624,40765,68859,10,26.8,-24815,-6.1,41.4,0,3829,3832,31029
2002,06,f) 5,26852,27669,311143,327970,1359,4.7,4353,14.9,50768,10758,40010,3.3,15.5,84422,32626,51796,9.9,25.7,-33654,-10.2,31,0,3001,3008,22017
2002,06,g) 6 to 10,97095,102415,1261687,1336362,5355,5,13657,12.8,198860,50634,148226,3.8,14.9,348209,122748,225461,9.2,26.1,-149349,-11.2,29.8,0,8808,8816,76474
2002,06,h) 11 to 15,76299,85960,1297013,1333051,4723,5.3,9396,10.6,207282,44702,162580,3.4,15.5,279357,98075,181282,7.4,21,-72075,-5.5,31,0,5216,5222,41943
2002,06,i) 16 to 20,56711,69045,1202491,1248051,3450,4.9,7083,10,169552,49350,120202,4,13.6,260671,91885,168786,7.4,20.9,-91119,-7.3,27.2,0,3188,3240,36893
2002,06,j) 21 to 25,43846,61131,1319829,1345720,3235,5.2,6111,9.8,179262,59605,119657,4.4,13.3,231044,75350,155694,5.6,17.2,-51782,-3.9,26.6,0,2282,2310,20086
2002,06,l) Left Censored,58689,146169,5342652,5418679,12041,8.2,14424,9.8,800724,300096,500628,5.5,14.8,952778,304225,648553,5.6,17.6,-152054,-2.8,29.6,0,2506,2522,27440
2002,08,a) 0,11545,11655,62255,31128,11655,200,0,0,62255,62255,0,200,200,0,0,0,0,0,62255,200,0,0,,,
2002,08,b) 1,8696,8818,59854,59850,61,0.6,2908,28.4,19078,1370,17708,2.3,31.9,19070,10192,8878,17,31.9,8,0,63.8,0,1977,1977,7742
2002,08,c) 2,7459,7626,59264,63573,369,4.4,1747,21,11293,1993,9300,3.1,17.8,19911,8421,11490,13.2,31.3,-8618,-13.5,35.6,0,1216,1218,6534
2002,08,d) 3,6485,6705,53386,55668,378,5.3,1273,17.8,10411,3216,7195,5.8,18.7,14975,6075,8900,10.9,26.9,-4564,-8.2,37.4,0,884,884,4649
2002,08,e) 4,5952,6260,54559,55617,384,5.8,1046,15.9,11291,3866,7425,7,20.3,13406,4828,8578,8.7,24.1,-2115,-3.8,40.6,0,704,704,3476
2002,08,f) 5,5058,5182,47019,50030,244,4.4,907,16.5,7526,1892,5634,3.8,15,13548,5969,7579,11.9,27.1,-6022,-12.1,30,0,579,580,4101
2002,08,g) 6 to 10,18701,19612,199254,207623,935,4.6,2627,12.8,31919,7918,24001,3.8,15.4,48656,18428,30228,8.9,23.4,-16737,-8,30.8,0,1504,1508,10006
2002,08,h) 11 to 15,11436,12910,190308,193881,617,4.7,1310,9.9,27336,6310,21026,3.3,14.1,34481,11389,23092,5.9,17.8,-7145,-3.7,28.2,0,662,662,4491
2002,08,i) 16 to 20,8437,10313,192146,199400,519,4.9,1192,11.2,26362,7479,18883,3.8,13.2,40869,11729,29140,5.9,20.5,-14507,-7.3,26.4,0,419,421,3087
2002,08,j) 21 to 25,6387,8929,174762,182394,493,5.4,861,9.4,21525,7240,14285,4,11.8,36788,12164,24624,6.7,20.2,-15263,-8.4,23.6,0,288,290,2268
2002,08,l) Left Censored,9711,23521,779249,813034,2112,8.9,2417,10.2,111732,42781,68951,5.3,13.7,179301,70933,108368,8.7,22.1,-67569,-8.4,27.4,0,343,346,4959
2002,09,a) 0,5281,5326,36348,18174,5326,200,0,0,36348,36348,0,200,200,0,0,0,0,0,36348,200,0,0,,,
2002,09,b) 1,4025,4069,26610,27291,23,0.5,1048,22.9,6635,229,6406,0.8,24.3,7997,3757,4240,13.8,29.3,-1362,-5,48.6,0,714,714,2730
2002,09,c) 2,3669,3768,30349,31409,180,4.5,712,17.6,6476,1876,4600,6,20.6,8596,3362,5234,10.7,27.4,-2120,-6.8,41.2,0,487,487,2615
2002,09,d) 3,3245,3341,33301,33696,162,4.6,513,14.6,6640,1446,5194,4.3,19.7,7429,2518,4911,7.5,22,-789,-2.3,39.4,0,353,353,1971
2002,09,e) 4,3218,3441,33782,33526,165,4.6,453,12.6,6548,1490,5058,4.4,19.5,6036,1815,4221,5.4,18,512,1.5,36,0,297,297,1407
2002,09,f) 5,2716,2761,23019,24678,87,3,374,12.9,3329,368,2961,1.5,13.5,6646,2676,3970,10.8,26.9,-3317,-13.4,27,0,228,228,1403
2002,09,g) 6 to 10,11013,11298,125292,129548,378,3.2,1333,11.3,15864,2385,13479,1.8,12.2,24376,9519,14857,7.3,18.8,-8512,-6.6,24.4,0,844,844,6416
2002,09,h) 11 to 15,9428,10126,128145,129589,383,3.7,998,9.6,19364,4122,15242,3.2,14.9,22252,7872,14380,6.1,17.2,-2888,-2.3,29.8,0,541,542,3423
2002,09,i) 16 to 20,7405,8404,112242,113993,328,3.8,721,8.4,14135,2858,11277,2.5,12.4,17637,5211,12426,4.6,15.5,-3502,-3.1,24.8,0,340,341,2242
2002,09,j) 21 to 25,5408,6991,125137,127056,274,3.8,627,8.7,17510,5859,11651,4.6,13.8,21347,7267,14080,5.7,16.8,-3837,-3,27.6,0,244,245,1384
2002,09,l) Left Censored,12853,23028,882180,885195,1546,6.6,2189,9.4,118001,42547,75454,4.8,13.3,124030,35393,88637,4,14,-6029,-0.7,26.6,0,496,496,3728
2002,10,a) 0,1600,1631,9694,4847,1631,200,0,0,9694,9694,0,200,200,0,0,0,0,0,9694,200,0,0,,,
2002,10,b) 1,1316,1324,6989,7342,9,0.6,326,22,1476,59,1417,0.8,20.1,2182,1072,1110,14.6,29.7,-706,-9.6,40.2,0,225,227,774
2002,10,c) 2,1199,1208,7377,7924,54,4.2,238,18.3,1209,231,978,2.9,15.3,2302,1035,1267,13.1,29.1,-1093,-13.8,30.6,0,181,181,854
2002,10,d) 3,1006,1022,7968,8161,46,4.2,174,16,1322,400,922,4.9,16.2,1707,686,1021,8.4,20.9,-385,-4.7,32.4,0,124,124,478
2002,10,e) 4,928,979,7910,7901,69,6.8,145,14.3,1378,364,1014,4.6,17.4,1359,496,863,6.3,17.2,19,0.2,34.4,0,107,107,386
2002,10,f) 5,733,756,6533,6665,32,4,110,13.8,912,136,776,2,13.7,1175,341,834,5.1,17.6,-263,-3.9,27.4,0,76,76,207
2002,10,g) 6 to 10,2867,2999,32511,32955,169,5.5,355,11.5,5092,1743,3349,5.3,15.5,5979,2372,3607,7.2,18.1,-887,-2.6,31,0,222,222,788
2002,10,h) 11 to 15,2052,2184,25392,25558,112,5,211,9.4,3554,885,2669,3.5,13.9,3885,1722,2163,6.7,15.2,-331,-1.3,27.8,0,114,115,633
2002,10,i) 16 to 20,1489,1738,25631,25835,82,4.6,161,9.1,3932,1555,2377,6,15.2,4340,1818,2522,7,16.8,-408,-1.6,30.4,0,79,79,1257
2002,10,j) 21 to 25,1152,1544,47186,45348,94,6,116,7.5,13736,5738,7998,12.7,30.3,10060,1647,8413,3.6,22.2,3676,8.1,44.4,0,44,44,361
2002,10,l) Left Censored,3175,6195,208661,210989,604,9.8,601,9.7,27123,11359,15764,5.4,12.9,31778,10405,21373,4.9,15.1,-4655,-2.2,25.8,0,62,65,404
2002,11,a) 0,1150,1154,9652,4826,1154,200,0,0,9652,9652,0,200,200,0,0,0,0,0,9652,200,0,0,,,
2002,11,b) 1,855,860,8069,8247,10,1,200,20.9,2014,173,1841,2.1,24.4,2369,905,1464,11,28.7,-355,-4.3,48.8,0,143,143,683
2002,11,c) 2,739,753,7690,8260,34,4.2,133,16.6,1527,196,1331,2.4,18.5,2667,1250,1417,15.1,32.3,-1140,-13.8,37,0,103,103,1036
2002,11,d) 3,703,717,8550,8413,50,6.8,89,12.1,2084,654,1430,7.8,24.8,1810,664,1146,7.9,21.5,274,3.3,43,0,60,60,397
2002,11,e) 4,678,724,8313,8253,49,6.7,68,9.3,1574,618,956,7.5,19.1,1453,345,1108,4.2,17.6,121,1.5,35.2,0,46,46,230
2002,11,f) 5,599,614,5894,6303,23,3.6,82,12.7,719,194,525,3.1,11.4,1537,637,900,10.1,24.4,-818,-13,22.8,0,58,58,408
2002,11,g) 6 to 10,2295,2384,35206,36387,100,4,290,11.7,4840,1022,3818,2.8,13.3,7202,2402,4800,6.6,19.8,-2362,-6.5,26.6,0,177,177,848
2002,11,h) 11 to 15,1809,1998,33675,34663,108,5.3,199,9.7,6433,1082,5351,3.1,18.6,8408,4598,3810,13.3,24.3,-1975,-5.7,37.2,0,86,86,2657
2002,11,i) 16 to 20,1600,1833,29715,29824,116,6.2,190,10.2,4136,1783,2353,6,13.9,4353,1515,2838,5.1,14.6,-217,-0.7,27.8,0,67,68,357
2002,11,j) 21 to 25,1334,1692,52204,52719,115,6.7,160,9.3,6529,1170,5359,2.2,12.4,7558,1620,5938,3.1,14.3,-1029,-1.9,24.8,0,44,46,214
2002,11,l) Left Censored,3390,5800,228631,229849,536,9.2,614,10.5,32443,14527,17916,6.3,14.1,34878,9143,25735,4,15.2,-2435,-1.1,28.2,0,81,81,1143
2002,12,a) 0,39436,39756,214197,107099,39756,200,0,0,214197,214197,0,200,200,0,0,0,0,0,214197,200,0,0,,,
2002,12,b) 1,27215,27590,188747,191858,147,0.5,9680,29.9,60637,2979,57658,1.6,31.6,66858,41708,25150,21.7,34.8,-6221,-3.2,63.2,0,6665,6671,29582
2002,12,c) 2,22514,23076,168009,175865,1138,4.5,5360,21.3,39631,7702,31929,4.4,22.5,55343,27225,28118,15.5,31.5,-15712,-9,45,0,3853,3854,20373
2002,12,d) 3,20150,21087,188809,193518,1163,5.2,4000,17.8,43292,9130,34162,4.7,22.4,52710,25847,26863,13.4,27.2,-9418,-4.8,44.8,0,2832,2843,19439
2002,12,e) 4,17799,19032,196028,197522,1202,6,3054,15.3,38797,13440,25357,6.8,19.6,41784,18590,23194,9.4,21.2,-2987,-1.6,39.2,0,2178,2178,14303
2002,12,f) 5,15222,15560,140316,146603,756,4.6,2552,15.5,28813,5937,22876,4,19.7,41388,22737,18651,15.5,28.2,-12575,-8.5,39.4,0,1708,1713,18470
2002,12,g) 6 to 10,58136,61048,675870,714918,2959,4.6,8187,12.9,125962,33423,92539,4.7,17.6,204058,105354,98704,14.7,28.5,-78096,-10.9,35.2,0,5140,5143,42998
2002,12,h) 11 to 15,39312,43976,675759,692590,2018,4.4,4810,10.6,95124,20582,74542,3,13.7,128786,50953,77833,7.4,18.6,-33662,-4.9,27.4,0,2680,2683,19495
2002,12,i) 16 to 20,26331,31651,582252,605564,1495,4.6,3243,10,83417,22250,61167,3.7,13.8,130041,70036,60005,11.6,21.5,-46624,-7.7,27.6,0,1483,1497,10493
2002,12,j) 21 to 25,17492,25129,480605,488492,1486,5.8,2459,9.6,78368,30651,47717,6.3,16,94142,38234,55908,7.8,19.3,-15774,-3.3,32,0,844,853,6227
2002,12,l) Left Censored,24822,75954,2761718,2790419,6398,8.3,8171,10.6,417373,147056,270317,5.3,15,474776,174581,300195,6.3,17,-57403,-2,30,0,1050,1059,10319
2002,13,a) 0,16053,16234,107676,57057,16233,200,0,0,101239,101239,0,177.4,177.4,0,0,0,0,0,101239,177.4,0,0,,,
2002,13,b) 1,11524,11765,82432,85324,117,0.9,3728,27.5,22061,2362,19699,2.8,25.9,27845,16388,11457,19.2,32.6,-5784,-6.7,51.8,0,2610,2611,12778
2002,13,c) 2,10176,10366,88781,93642,494,4.4,2357,20.9,17357,3201,14156,3.4,18.5,27078,12836,14242,13.7,28.9,-9721,-10.4,37,0,1680,1684,10333
2002,13,d) 3,9109,9476,87968,97428,598,6,1676,16.7,15980,5027,10953,5.2,16.4,34899,19689,15210,20.2,35.8,-18919,-19.4,32.8,0,1194,1194,15801
2002,13,e) 4,8226,8754,84869,88053,534,5.8,1406,15.3,15756,5316,10440,6,17.9,22124,8702,13422,9.9,25.1,-6368,-7.2,35.8,0,982,982,6618
2002,13,f) 5,6958,7172,71990,74141,345,4.6,1094,14.5,13165,3936,9229,5.3,17.8,17466,6073,11393,8.2,23.6,-4301,-5.8,35.6,0,705,706,4237
2002,13,g) 6 to 10,25293,26814,313199,321412,1252,4.5,3588,12.8,55877,13618,42259,4.2,17.4,72304,28555,43749,8.9,22.5,-16427,-5.1,34.8,0,2123,2135,16761
2002,13,h) 11 to 15,16043,18623,295121,301263,993,5.2,1940,10.2,42675,12273,30402,4.1,14.2,54959,19751,35208,6.6,18.2,-12284,-4,28.4,0,1033,1034,8599
2002,13,i) 16 to 20,12657,15208,265581,271208,771,5,1476,9.5,38038,13644,24394,5,14,49291,15236,34055,5.6,18.2,-11253,-4.2,28,0,688,690,4833
2002,13,j) 21 to 25,8650,12752,281481,288895,813,6.3,1220,9.4,38863,12948,25915,4.5,13.5,53691,18261,35430,6.3,18.6,-14828,-5.1,27,0,379,379,3978
2002,13,l) Left Censored,15928,43714,1686049,1714990,3652,8.3,4592,10.4,232680,93456,139224,5.4,13.6,290562,98379,192183,5.7,16.9,-57882,-3.3,27.2,0,558,562,6706
2002,15,a) 0,1980,2008,12796,6398,2008,200,0,0,12796,12796,0,200,200,0,0,0,0,0,12796,200,0,0,,,
2002,15,b) 1,1436,1457,10863,15158,5,0.3,409,24.7,2321,73,2248,0.5,15.3,10910,1697,9213,11.2,72,-8589,-56.7,30.6,0,296,296,1254
2002,15,c) 2,1278,1320,10483,10963,49,3.5,245,17.3,1882,288,1594,2.6,17.2,2842,984,1858,9,25.9,-960,-8.7,34.4,0,187,187,808
2002,15,d) 3,1044,1080,9872,10125,63,5.6,162,14.3,1845,446,1399,4.4,18.2,2350,643,1707,6.4,23.2,-505,-5,36.4,0,120,120,532
2002,15,e) 4,1021,1102,10655,10975,85,7.5,149,13.1,2271,1146,1125,10.4,20.7,2911,1317,1594,12,26.5,-640,-5.8,41.4,0,101,101,1077
2002,15,f) 5,871,881,8308,8519,37,4,125,13.5,1271,201,1070,2.4,14.9,1692,686,1006,8.1,19.9,-421,-5,29.8,0,85,85,521
2002,15,g) 6 to 10,3538,3703,45286,46801,153,4,412,10.8,5325,722,4603,1.5,11.4,8355,2811,5544,6,17.9,-3030,-6.5,22.8,0,266,266,1474
2002,15,h) 11 to 15,2878,3260,42145,42512,163,4.9,323,9.7,5829,1301,4528,3.1,13.7,6563,2419,4144,5.7,15.4,-734,-1.7,27.4,0,156,157,769
2002,15,i) 16 to 20,2291,2716,36212,36950,101,3.6,251,9,4063,1104,2959,3,11,5538,1846,3692,5,15,-1475,-4,22,0,114,116,603
2002,15,j) 21 to 25,2087,2926,45170,46403,131,4.4,230,7.7,5954,1942,4012,4.2,12.8,8419,2204,6215,4.7,18.1,-2465,-5.3,25.6,0,72,73,720
2002,15,l) Left Censored,3624,7135,207902,210232,434,6,637,8.8,23639,7437,16202,3.5,11.2,28298,8640,19658,4.1,13.5,-4659,-2.3,22.4,0,114,114,1063
2002,16,a) 0,2993,3027,19585,9793,3027,200,0,0,19585,19585,0,200,200,0,0,0,0,0,19585,200,0,0,,,
2002,16,b) 1,2253,2288,14265,14785,17,0.6,741,28,3593,258,3335,1.7,24.3,4632,2774,1858,18.8,31.3,-1039,-7,48.6,0,458,458,2034
2002,16,c) 2,2009,2074,18037,18945,128,5.8,398,18,4065,846,3219,4.5,21.5,5880,3488,2392,18.4,31,-1815,-9.5,43,0,280,280,2800
2002,16,d) 3,1775,1819,13169,13361,114,6,284,14.9,2876,931,1945,7,21.5,3259,1202,2057,9,24.4,-383,-2.9,43,0,185,185,909
2002,16,e) 4,1570,1692,14984,15335,122,6.9,259,14.7,2544,674,1870,4.4,16.6,3245,1043,2202,6.8,21.2,-701,-4.6,33.2,0,171,174,846
2002,16,f) 5,1462,1501,11416,12007,87,5.6,208,13.3,1561,322,1239,2.7,13,2743,854,1889,7.1,22.8,-1182,-9.8,26,0,118,118,507
2002,16,g) 6 to 10,5141,5294,46610,48539,303,5.5,681,12.4,6103,1500,4603,3.1,12.6,9961,3429,6532,7.1,20.5,-3858,-7.9,25.2,0,385,386,2102
2002,16,h) 11 to 15,3045,3375,39320,40310,179,5.2,366,10.6,5237,1653,3584,4.1,13,7217,1982,5235,4.9,17.9,-1980,-4.9,26,0,174,174,949
2002,16,i) 16 to 20,2274,2753,36603,37489,180,6.4,273,9.8,5282,1927,3355,5.1,14.1,7054,1943,5111,5.2,18.8,-1772,-4.7,28.2,0,117,120,736
2002,16,j) 21 to 25,1865,2429,52835,54792,135,5.4,262,10.5,6830,1790,5040,3.3,12.5,10743,4359,6384,8,19.6,-3913,-7.1,25,0,94,106,998
2002,16,l) Left Censored,3319,6860,186516,192674,496,7.2,616,8.9,25654,8387,17267,4.4,13.3,37969,11130,26839,5.8,19.7,-12315,-6.4,26.6,0,111,111,4652
2002,17,a) 0,18465,18651,129202,64601,18651,200,0,0,129202,129202,0,200,200,0,0,0,0,0,129202,200,0,0,,,
2002,17,b) 1,14079,14311,100382,103594,159,1,4025,24.8,25630,1978,23652,1.9,24.7,32054,17305,14749,16.7,30.9,-6424,-6.2,49.4,0,2672,2673,12748
2002,17,c) 2,12819,13146,112372,114069,553,3.9,2630,18.5,28063,4719,23344,4.1,24.6,31457,14700,16757,12.9,27.6,-3394,-3,49.2,0,1788,1790,11824
2002,17,d) 3,11634,12109,118339,123604,574,4.5,2089,16.2,22988,4367,18621,3.5,18.6,33518,13136,20382,10.6,27.1,-10530,-8.5,37.2,0,1429,1438,10579
2002,17,e) 4,11024,11738,116958,118653,586,4.8,1628,13.3,23504,5570,17934,4.7,19.8,26894,8705,18189,7.3,22.7,-3390,-2.9,39.6,0,1057,1057,5927
2002,17,f) 5,9842,10368,99412,101670,396,3.6,1474,13.5,18841,3596,15245,3.5,18.5,23356,7942,15414,7.8,23,-4515,-4.5,37,0,932,933,4753
2002,17,g) 6 to 10,38623,40157,426398,440709,1496,3.6,4808,11.5,65153,10374,54779,2.4,14.8,93774,31734,62040,7.2,21.3,-28621,-6.5,29.6,0,2869,2879,19208
2002,17,h) 11 to 15,28249,31458,470884,498526,1252,3.9,3135,9.7,56467,15258,41209,3.1,11.3,111751,54179,57572,10.9,22.4,-55284,-11.1,22.6,0,1695,1698,11590
2002,17,i) 16 to 20,22190,25980,456501,467626,1081,4.1,2355,8.8,57262,18346,38916,3.9,12.2,79512,23456,56056,5,17,-22250,-4.8,24.4,0,1110,1113,8249
2002,17,j) 21 to 25,16744,22456,458045,468170,1012,4.4,2103,9.1,56606,16662,39944,3.6,12.1,76855,24093,52762,5.1,16.4,-20249,-4.3,24.2,0,774,783,5797
2002,17,l) Left Censored,35469,72748,2700980,2777811,5417,7.3,7559,10.2,324502,123104,201398,4.4,11.7,478165,144840,333325,5.2,17.2,-153663,-5.5,23.4,0,1328,1361,16557
2002,18,a) 0,8928,9017,66931,33466,9017,200,0,0,66931,66931,0,200,200,0,0,0,0,0,66931,200,0,0,,,
2002,18,b) 1,6441,6629,46687,48023,76,1,1921,25.4,11575,766,10809,1.6,24.1,14246,7943,6303,16.5,29.7,-2671,-5.6,48.2,0,1365,1370,6082
2002,18,c) 2,5816,5985,49818,52047,269,4.2,1157,18,9053,1861,7192,3.6,17.4,13511,6032,7479,11.6,26,-4458,-8.6,34.8,0,813,813,4670
2002,18,d) 3,5267,5473,50269,51365,242,4.2,950,16.3,9974,2631,7343,5.1,19.4,12166,5274,6892,10.3,23.7,-2192,-4.3,38.8,0,665,665,3982
2002,18,e) 4,5057,5592,62448,63373,344,5.9,742,12.8,11781,4243,7538,6.7,18.6,13630,4034,9596,6.4,21.5,-1849,-2.9,37.2,0,513,513,3169
2002,18,f) 5,4463,4652,39716,41662,204,4.2,706,14.4,6382,1678,4704,4,15.3,10273,4671,5602,11.2,24.7,-3891,-9.4,30.6,0,488,488,3050
2002,18,g) 6 to 10,17868,18888,197770,205805,746,3.8,2194,11.2,25355,5251,20104,2.6,12.3,41425,15140,26285,7.4,20.1,-16070,-7.8,24.6,0,1351,1353,8866
2002,18,h) 11 to 15,13030,14869,218564,222001,649,4.3,1416,9.3,30930,7619,23311,3.4,13.9,37803,12881,24922,5.8,17,-6873,-3.1,27.8,0,731,733,5317
2002,18,i) 16 to 20,10671,12844,200738,207203,525,4,1117,8.5,23234,6330,16904,3.1,11.2,36165,12078,24087,5.8,17.5,-12931,-6.3,22.4,0,507,512,4105
2002,18,j) 21 to 25,7810,10773,217464,222896,635,5.8,869,8,25426,8732,16694,3.9,11.4,36289,10643,25646,4.8,16.3,-10863,-4.9,22.8,0,329,329,2296
2002,18,l) Left Censored,17323,38141,1364076,1398397,2585,6.7,3560,9.2,157866,55625,102241,4,11.3,226508,63777,162731,4.6,16.2,-68642,-4.9,22.6,0,587,602,6425
2002,19,a) 0,4374,4467,28923,14462,4467,200,0,0,28923,28923,0,200,200,0,0,0,0,0,28923,200,0,0,,,
2002,19,b) 1,3190,3235,21562,22272,22,0.6,876,23.9,5181,540,4641,2.4,23.3,6600,3467,3133,15.6,29.6,-1419,-6.3,46.6,0,592,594,2636
2002,19,c) 2,3053,3125,24693,25461,141,4.2,547,16.4,4858,1556,3302,6.1,19.1,6394,3158,3236,12.4,25.1,-1536,-6,38.2,0,376,376,2006
2002,19,d) 3,2719,2888,24082,24661,158,5.2,423,14,4162,1477,2685,6,16.9,5319,2124,3195,8.6,21.6,-1157,-4.7,33.8,0,290,290,1566
2002,19,e) 4,2537,2696,20877,21571,168,6,386,13.8,3619,1355,2264,6.3,16.8,5007,1685,3322,7.8,23.2,-1388,-6.4,33.6,0,279,279,1434
2002,19,f) 5,2331,2431,22220,22959,83,3.3,305,12,3117,528,2589,2.3,13.6,4595,1660,2935,7.2,20,-1478,-6.4,27.2,0,201,201,1141
2002,19,g) 6 to 10,9452,9850,86896,88930,410,4,1095,10.7,14151,4725,9426,5.3,15.9,18218,6604,11614,7.4,20.5,-4067,-4.6,31.8,0,648,648,4659
2002,19,h) 11 to 15,6817,7459,101809,104685,276,3.6,740,9.6,11920,3211,8709,3.1,11.4,17671,6264,11407,6,16.9,-5751,-5.5,22.8,0,404,404,2777
2002,19,i) 16 to 20,5889,7208,110942,111393,302,4.1,607,8.2,14082,3202,10880,2.9,12.6,14983,4523,10460,4.1,13.5,-901,-0.9,25.2,0,255,256,1416
2002,19,j) 21 to 25,5175,7384,112502,113787,295,3.9,635,8.4,13136,3495,9641,3.1,11.5,15706,4979,10727,4.4,13.8,-2570,-2.3,23,0,243,245,1466
2002,19,l) Left Censored,11670,21845,675058,685718,1197,5.4,1743,7.9,68016,23972,44044,3.5,9.9,89335,27078,62257,3.9,13,-21319,-3.1,19.8,0,383,389,2650
2002,20,a) 0,4690,4745,31150,15575,4745,200,0,0,31150,31150,0,200,200,0,0,0,0,0,31150,200,0,0,,,
2002,20,b) 1,3513,3580,25898,26290,32,0.8,1072,26.1,6299,428,5871,1.6,24,7083,3828,3255,14.6,26.9,-784,-2.9,48,0,771,771,3048
2002,20,c) 2,3145,3201,25967,26413,177,5.1,654,19,6144,2226,3918,8.4,23.3,7035,3161,3874,12,26.6,-891,-3.3,46.6,0,481,481,2805
2002,20,d) 3,2783,2917,22259,23169,159,5.2,495,16,4561,1144,3417,4.9,19.7,6381,2718,3663,11.7,27.5,-1820,-7.8,39.4,0,357,357,1929
2002,20,e) 4,2702,2943,27186,28468,178,5.8,425,13.9,4897,1108,3789,3.9,17.2,7461,3156,4305,11.1,26.2,-2564,-9,34.4,0,302,302,2775
2002,20,f) 5,2343,2437,23427,23583,139,5.5,345,13.6,4388,614,3774,2.6,18.6,4700,1899,2801,8.1,19.9,-312,-1.3,37.2,0,232,232,1469
2002,20,g) 6 to 10,8876,9289,85554,88381,397,4.1,1184,12.2,13564,3669,9895,4.2,15.3,19217,7721,11496,8.7,21.7,-5653,-6.4,30.6,0,771,774,4235
2002,20,h) 11 to 15,6232,6904,91460,92488,306,4.3,641,9.1,11616,3355,8261,3.6,12.6,13672,4349,9323,4.7,14.8,-2056,-2.2,25.2,0,364,364,2307
2002,20,i) 16 to 20,5528,6408,84066,85179,274,4.2,573,8.7,11522,3307,8215,3.9,13.5,13748,4396,9352,5.2,16.1,-2226,-2.6,27,0,256,259,1727
2002,20,j) 21 to 25,4380,6107,98982,100820,321,5.1,603,9.7,13664,4278,9386,4.2,13.6,17340,6594,10746,6.5,17.2,-3676,-3.6,27.2,0,190,191,1269
2002,20,l) Left Censored,9464,18607,579917,588560,1224,6.5,1680,8.9,71687,25696,45991,4.4,12.2,88973,24562,64411,4.2,15.1,-17286,-2.9,24.4,0,280,280,1431
2002,21,a) 0,5448,5507,39789,19895,5507,200,0,0,39789,39789,0,200,200,0,0,0,0,0,39789,200,0,0,,,
2002,21,b) 1,4219,4264,31292,31893,23,0.5,1200,24.7,8472,315,8157,1,26.6,9673,5120,4553,16.1,30.3,-1201,-3.7,53.2,0,921,925,3921
2002,21,c) 2,3774,3883,31251,32491,155,3.7,741,17.7,6031,1268,4763,3.9,18.6,8510,3667,4843,11.3,26.2,-2479,-7.6,37.2,0,565,565,3080
2002,21,d) 3,3503,3692,35819,36422,185,4.8,577,14.8,6677,2083,4594,5.7,18.3,7882,3351,4531,9.2,21.6,-1205,-3.3,36.6,0,429,429,2779
2002,21,e) 4,3271,3538,32091,32902,209,5.7,506,13.7,6785,2754,4031,8.4,20.6,8406,3071,5335,9.3,25.5,-1621,-4.9,41.2,0,378,378,2422
2002,21,f) 5,2813,2971,26444,27132,119,3.8,419,13.4,4564,1099,3465,4.1,16.8,5939,2297,3642,8.5,21.9,-1375,-5.1,33.6,0,277,277,1672
2002,21,g) 6 to 10,11159,11842,121799,126537,595,4.9,1408,11.5,17101,4406,12695,3.5,13.5,26577,9725,16852,7.7,21,-9476,-7.5,27,0,880,884,5558
2002,21,h) 11 to 15,8161,9203,130490,135057,407,4.3,789,8.4,17093,4013,13080,3,12.7,26226,6057,20169,4.5,19.4,-9133,-6.7,25.4,0,468,468,2990
2002,21,i) 16 to 20,6769,7950,125141,127347,364,4.5,612,7.6,16690,4928,11762,3.9,13.1,21101,6937,14164,5.4,16.6,-4411,-3.5,26.2,0,299,299,1783
2002,21,j) 21 to 25,4680,6677,133771,136388,487,7.3,546,8.1,16435,5896,10539,4.3,12.1,21668,5877,15791,4.3,15.9,-5233,-3.8,24.2,0,214,218,1336
2002,21,l) Left Censored,10321,22578,760553,774452,1355,5.9,1980,8.6,83606,24596,59010,3.2,10.8,111403,29473,81930,3.8,14.4,-27797,-3.6,21.6,0,374,378,2811
2002,22,a) 0,6426,6495,47098,23549,6495,200,0,0,47098,47098,0,200,200,0,0,0,0,0,47098,200,0,0,,,
2002,22,b) 1,4816,4912,40962,41556,29,0.5,1340,24.1,11119,846,10273,2,26.8,12307,6497,5810,15.6,29.6,-1188,-2.8,53.6,0,971,971,5238
2002,22,c) 2,4203,4337,51961,53802,208,4.5,852,18.3,10433,3033,7400,5.6,19.4,14115,5095,9020,9.5,26.2,-3682,-6.8,38.8,0,654,656,4105
2002,22,d) 3,3748,3897,34610,35586,226,5.5,612,15,6961,2161,4800,6.1,19.6,8913,3432,5481,9.6,25,-1952,-5.4,39.2,0,442,442,2488
2002,22,e) 4,3727,4049,43216,44053,225,5.4,529,12.6,8014,1634,6380,3.7,18.2,9687,3355,6332,7.6,22,-1673,-3.8,36.4,0,390,390,2483
2002,22,f) 5,3273,3336,35286,36681,145,4.1,473,13.5,6768,1748,5020,4.8,18.5,9557,3474,6083,9.5,26.1,-2789,-7.6,37,0,353,355,2314
2002,22,g) 6 to 10,12680,13226,150798,152989,574,4.2,1454,10.6,22851,3658,19193,2.4,14.9,27233,10303,16930,6.7,17.8,-4382,-2.9,29.8,0,975,976,5690
2002,22,h) 11 to 15,8365,9489,152207,154423,400,4.1,900,9.2,22477,4452,18025,2.9,14.6,26908,8174,18734,5.3,17.4,-4431,-2.8,29.2,0,522,524,4622
2002,22,i) 16 to 20,8094,9463,128600,131049,433,4.5,786,8.2,18263,4728,13535,3.6,13.9,23161,7384,15777,5.6,17.7,-4898,-3.8,27.8,0,381,381,3348
2002,22,j) 21 to 25,6309,8553,145776,152446,394,4.5,687,7.9,19348,5108,14240,3.4,12.7,32687,14833,17854,9.7,21.4,-13339,-8.7,25.4,0,233,236,5190
2002,22,l) Left Censored,11243,24515,732541,741923,1592,6.4,2198,8.9,90506,32910,57596,4.4,12.2,109271,32927,76344,4.4,14.7,-18765,-2.5,24.4,0,402,402,3779
2002,23,a) 0,2625,2641,14611,7306,2641,200,0,0,14611,14611,0,200,200,0,0,0,0,0,14611,200,0,0,,,
2002,23,b) 1,2029,2055,11525,11991,14,0.6,569,24.4,2676,306,2370,2.6,22.3,3608,2024,1584,16.9,30.1,-932,-7.8,44.6,0,372,372,1684
2002,23,c) 2,1764,1816,12479,13880,98,5,405,20.6,1899,345,1554,2.5,13.7,4700,2504,2196,18,33.9,-2801,-20.2,27.4,0,261,261,1625
2002,23,d) 3,1673,1709,11681,12137,83,4.6,297,16.4,1871,424,1447,3.5,15.4,2783,1218,1565,10,22.9,-912,-7.5,30.8,0,198,198,967
2002,23,e) 4,1577,1757,13700,13787,81,4.4,237,12.9,2468,544,1924,3.9,17.9,2642,769,1873,5.6,19.2,-174,-1.3,35.8,0,151,151,491
2002,23,f) 5,1325,1349,8225,8706,52,3.7,200,14.1,1099,197,902,2.3,12.6,2060,809,1251,9.3,23.7,-961,-11.1,25.2,0,131,131,586
2002,23,g) 6 to 10,4929,5095,41594,43224,196,3.7,601,11.3,5661,1312,4349,3,13.1,8920,3445,5475,8,20.6,-3259,-7.5,26.2,0,359,359,1790
2002,23,h) 11 to 15,3875,4160,44129,45250,185,4.3,442,10.3,5828,1781,4047,3.9,12.9,8069,3278,4791,7.2,17.8,-2241,-4.9,25.8,0,235,235,1941
2002,23,i) 16 to 20,2904,3430,45472,46550,125,3.5,321,9.1,5681,1014,4667,2.2,12.2,7836,2796,5040,6,16.8,-2155,-4.6,24.4,0,149,150,816
2002,23,j) 21 to 25,2080,2997,52392,53587,147,4.8,282,9.2,6764,1965,4799,3.7,12.6,9153,2748,6405,5.1,17.1,-2389,-4.5,25.2,0,74,74,798
2002,23,l) Left Censored,4116,7620,224686,229557,450,5.9,580,7.5,22455,7661,14794,3.3,9.8,32197,9178,23019,4,14,-9742,-4.2,19.6,0,119,119,1744
2002,24,a) 0,9003,9080,59825,29913,9080,200,0,0,59825,59825,0,200,200,0,0,0,0,0,59825,200,0,0,,,
2002,24,b) 1,6584,6672,46080,47623,59,0.8,1851,24.5,12067,1039,11028,2.2,25.3,15152,7101,8051,14.9,31.8,-3085,-6.5,50.6,0,1234,1235,5426
2002,24,c) 2,5690,5843,45067,46276,308,4.9,1073,17.2,9527,2253,7274,4.9,20.6,11945,5661,6284,12.2,25.8,-2418,-5.2,41.2,0,747,747,4517
2002,24,d) 3,5277,5511,54630,55361,281,4.8,864,14.9,11533,3209,8324,5.8,20.8,12994,5439,7555,9.8,23.5,-1461,-2.7,41.6,0,580,583,3910
2002,24,e) 4,4917,5291,51298,51407,302,5.5,658,12,10748,3263,7485,6.3,20.9,10965,4317,6648,8.4,21.3,-217,-0.4,41.8,0,453,453,3488
2002,24,f) 5,4360,4468,44048,45178,203,4.3,630,13.5,7412,1506,5906,3.3,16.4,9671,3306,6365,7.3,21.4,-2259,-5,32.8,0,435,435,2532
2002,24,g) 6 to 10,16403,17172,183265,189233,728,4.1,1974,11.1,26876,4549,22327,2.4,14.2,38811,16290,22521,8.6,20.5,-11935,-6.3,28.4,0,1198,1200,10273
2002,24,h) 11 to 15,12662,13903,206685,212717,598,4.2,1360,9.5,29438,7613,21825,3.6,13.8,41502,14609,26893,6.9,19.5,-12064,-5.7,27.6,0,715,715,7942
2002,24,i) 16 to 20,9232,10855,160966,164715,439,3.9,1006,9,23049,5697,17352,3.5,14,30546,11214,19332,6.8,18.5,-7497,-4.5,28,0,422,423,3666
2002,24,j) 21 to 25,6240,8618,178337,180251,423,4.8,749,8.5,23486,6906,16580,3.8,13,27313,9720,17593,5.4,15.2,-3827,-2.2,26,0,293,294,2216
2002,24,l) Left Censored,12943,28567,1022706,1035260,2227,7.7,2808,9.7,130889,49970,80919,4.8,12.6,155997,49761,106236,4.8,15.1,-25108,-2.5,25.2,0,366,371,4791
2002,25,a) 0,10754,10839,68764,34382,10839,200,0,0,68764,68764,0,200,200,0,0,0,0,0,68764,200,0,0,,,
2002,25,b) 1,8578,8694,61348,63466,64,0.7,2034,21,14014,1202,12812,1.9,22.1,18249,8449,9800,13.3,28.8,-4235,-6.7,44.2,0,1407,1407,6456
2002,25,c) 2,7649,7863,57038,62176,374,4.4,1510,17.9,11607,2334,9273,3.8,18.7,21882,9020,12862,14.5,35.2,-10275,-16.5,37.4,0,1027,1027,6521
2002,25,d) 3,7513,7771,62492,66416,373,4.6,1084,13.3,10837,2878,7959,4.3,16.3,18684,8134,10550,12.2,28.1,-7847,-11.8,32.6,0,736,736,5929
2002,25,e) 4,6183,6544,65222,68865,352,5.1,938,13.7,11984,4862,7122,7.1,17.4,19269,5542,13727,8,28,-7285,-10.6,34.8,0,648,648,4359
2002,25,f) 5,5473,5550,52005,56239,227,3.9,872,14.8,7737,1880,5857,3.3,13.8,16204,7336,8868,13,28.8,-8467,-15,27.6,0,543,543,5401
2002,25,g) 6 to 10,20759,21471,229619,239283,764,3.4,2507,11.2,33776,9253,24523,3.9,14.1,53104,21641,31463,9,22.2,-19328,-8.1,28.2,0,1469,1469,10325
2002,25,h) 11 to 15,16265,17995,268260,278790,706,3.8,1634,8.9,36472,9846,26626,3.5,13.1,57531,18465,39066,6.6,20.6,-21059,-7.5,26.2,0,844,844,7766
2002,25,i) 16 to 20,12884,15306,280111,287308,688,4.4,1374,8.8,37520,9419,28101,3.3,13.1,51913,18423,33490,6.4,18.1,-14393,-5,26.2,0,631,636,5152
2002,25,j) 21 to 25,9187,12393,289432,295851,579,4.6,1134,8.9,35276,10226,25050,3.5,11.9,48113,17092,31021,5.8,16.3,-12837,-4.4,23.8,0,397,398,2660
2002,25,l) Left Censored,21689,41229,1558406,1581761,2841,6.8,3356,8.1,209647,73139,136508,4.6,13.3,256356,76207,180149,4.8,16.2,-46709,-2.9,26.6,0,791,793,9640
2002,26,a) 0,14591,14751,115078,57539,14751,200,0,0,115078,115078,0,200,200,0,0,0,0,0,115078,200,0,0,,,
2002,26,b) 1,10596,10739,94367,95483,88,0.7,3272,26.5,22723,1406,21317,1.5,23.8,24955,13660,11295,14.3,26.1,-2232,-2.3,47.6,0,2206,2208,10581
2002,26,c) 2,9535,9772,84818,89926,450,4.2,2088,19.7,16071,3601,12470,4,17.9,26287,10745,15542,11.9,29.2,-10216,-11.3,35.8,0,1398,1398,8591
2002,26,d) 3,8766,9103,88176,91596,457,4.7,1713,17.6,19246,2952,16294,3.2,21,26085,12831,13254,14,28.5,-6839,-7.5,42,0,1092,1102,8815
2002,26,e) 4,8320,8970,87829,90564,455,4.8,1356,14.4,16387,5000,11387,5.5,18.1,21857,7622,14235,8.4,24.1,-5470,-6,36.2,0,857,857,4773
2002,26,f) 5,7614,8057,78643,81294,380,4.5,1299,15.3,14942,3481,11461,4.3,18.4,20244,10549,9695,13,24.9,-5302,-6.5,36.8,0,788,788,7814
2002,26,g) 6 to 10,29458,30682,309014,322832,1280,4,4024,12.6,43381,9548,33833,3,13.4,71017,25972,45045,8,22,-27636,-8.6,26.8,0,2401,2401,14301
2002,26,h) 11 to 15,21846,24590,329259,336978,1028,4.1,2594,10.2,43073,11265,31808,3.3,12.8,58510,19732,38778,5.9,17.4,-15437,-4.6,25.6,0,1339,1344,8951
2002,26,i) 16 to 20,16690,20078,325541,333605,883,4.3,1953,9.5,45570,18944,26626,5.7,13.7,61698,19432,42266,5.8,18.5,-16128,-4.8,27.4,0,720,722,5141
2002,26,j) 21 to 25,12470,16680,291146,303379,826,4.8,1725,10.1,39066,11549,27517,3.8,12.9,63531,25674,37857,8.5,20.9,-24465,-8,25.8,0,564,568,8240
2002,26,l) Left Censored,25298,54920,2064375,2113758,3777,6.8,5383,9.7,253172,88101,165071,4.2,12,351937,112195,239742,5.3,16.6,-98765,-4.6,24,0,949,965,9159
2002,27,a) 0,9131,9229,59432,29716,9229,200,0,0,59432,59432,0,200,200,0,0,0,0,0,59432,200,0,0,,,
2002,27,b) 1,6867,6970,47647,48761,53,0.7,1987,25,12513,1373,11140,2.8,25.7,14740,7559,7181,15.5,30.2,-2227,-4.5,51.4,0,1271,1275,5923
2002,27,c) 2,6075,6207,48847,50348,243,3.6,1262,18.8,9911,1814,8097,3.6,19.7,12913,6005,6908,11.9,25.6,-3002,-5.9,39.4,0,807,809,4382
2002,27,d) 3,5515,5798,54900,56679,301,4.9,1007,16.4,8532,1889,6643,3.3,15.1,12089,4738,7351,8.4,21.3,-3557,-6.2,30.2,0,626,627,3621
2002,27,e) 4,5220,5771,56199,56808,358,6,815,13.6,10725,4342,6383,7.6,18.9,11942,3634,8308,6.4,21,-1217,-2.1,37.8,0,492,492,2698
2002,27,f) 5,4709,4868,42389,43914,185,3.6,707,13.8,6491,971,5520,2.2,14.8,9540,3452,6088,7.9,21.7,-3049,-6.9,29.6,0,439,440,2510
2002,27,g) 6 to 10,17901,18741,192216,196479,758,3.9,2248,11.5,30311,5934,24377,3,15.4,38836,14485,24351,7.4,19.8,-8525,-4.4,30.8,0,1265,1266,8592
2002,27,h) 11 to 15,12359,13885,189117,195063,579,4.1,1342,9.4,23169,5669,17500,2.9,11.9,35060,12489,22571,6.4,18,-11891,-6.1,23.8,0,704,705,6522
2002,27,i) 16 to 20,9409,11499,208329,213394,469,4,1090,9.2,27804,8835,18969,4.1,13,37933,10706,27227,5,17.8,-10129,-4.8,26,0,427,428,3025
2002,27,j) 21 to 25,7367,10093,216425,221468,410,4,960,9.3,26283,7271,19012,3.3,11.9,36369,10727,25642,4.8,16.4,-10086,-4.5,23.8,0,327,327,2710
2002,27,l) Left Censored,15355,31160,1244730,1263564,2003,6.4,2584,8.2,151175,45845,105330,3.6,12,188843,60876,127967,4.8,14.9,-37668,-2.9,24,0,471,472,5265
2002,28,a) 0,3948,3977,28102,14051,3977,200,0,0,28102,28102,0,200,200,0,0,0,0,0,28102,200,0,0,,,
2002,28,b) 1,2841,2890,21764,22702,35,1,925,27.7,5042,574,4468,2.5,22.2,6918,4111,2807,18.1,30.5,-1876,-8.3,44.4,0,704,705,3350
2002,28,c) 2,2425,2525,19115,20542,131,4.8,579,21.1,4233,1296,2937,6.3,20.6,7087,3988,3099,19.4,34.5,-2854,-13.9,41.2,0,427,427,3041
2002,28,d) 3,2348,2453,21380,21971,151,5.8,429,16.6,4139,1119,3020,5.1,18.8,5320,1619,3701,7.4,24.2,-1181,-5.4,37.6,0,316,320,1247
2002,28,e) 4,2174,2371,20232,21159,133,5.4,318,12.9,3718,680,3038,3.2,17.6,5571,1993,3578,9.4,26.3,-1853,-8.7,35.2,0,242,242,1428
2002,28,f) 5,1840,1898,15929,16539,88,4.4,296,14.8,2629,417,2212,2.5,15.9,3849,1487,2362,9,23.3,-1220,-7.4,31.8,0,220,220,1145
2002,28,g) 6 to 10,7327,7732,81536,83469,392,4.9,960,12,12737,2482,10255,3,15.3,16602,6714,9888,8,19.9,-3865,-4.6,30.6,0,627,628,3749
2002,28,h) 11 to 15,4853,5420,78699,80398,268,4.8,536,9.7,9782,2823,6959,3.5,12.2,13180,3823,9357,4.8,16.4,-3398,-4.2,24.4,0,338,338,2256
2002,28,i) 16 to 20,4390,5066,62441,64950,251,4.9,451,8.7,7920,2138,5782,3.3,12.2,12938,3843,9095,5.9,19.9,-5018,-7.7,24.4,0,223,223,995
2002,28,j) 21 to 25,3425,4585,93419,95109,278,6,337,7.3,12168,3875,8293,4.1,12.8,15547,5871,9676,6.2,16.3,-3379,-3.5,25.6,0,146,146,1369
2002,28,l) Left Censored,6874,15035,456823,465848,952,6.3,1334,8.8,51273,18240,33033,3.9,11,69322,22961,46361,4.9,14.9,-18049,-3.9,22,0,229,229,1764
2002,29,a) 0,10213,10289,66587,34441,10288,200,0,0,64292,64292,0,186.7,186.7,0,0,0,0,0,64292,186.7,0,0,,,
2002,29,b) 1,6834,6973,46032,48291,76,1,2017,25.4,12276,1678,10598,3.5,25.4,16793,8860,7933,18.3,34.8,-4517,-9.4,50.8,0,1435,1435,6970
2002,29,c) 2,6413,6592,51003,53886,337,4.8,1275,18.1,10435,2529,7906,4.7,19.4,16200,7918,8282,14.7,30.1,-5765,-10.7,38.8,0,928,928,6131
2002,29,d) 3,5621,5862,50679,53023,296,4.7,1040,16.7,9298,1930,7368,3.6,17.5,13986,6850,7136,12.9,26.4,-4688,-8.9,35,0,755,755,5508
2002,29,e) 4,5132,5549,55305,56144,286,4.9,870,14.9,11528,3236,8292,5.8,20.5,13206,4993,8213,8.9,23.5,-1678,-3,41,0,642,642,3912
2002,29,f) 5,4568,4707,40039,42729,205,4.1,734,14.8,6379,1169,5210,2.7,14.9,11758,5332,6426,12.5,27.5,-5379,-12.6,29.8,0,528,528,4177
2002,29,g) 6 to 10,17928,18793,188864,197764,814,4.2,2425,12.4,27094,5506,21588,2.8,13.7,44893,17909,26984,9.1,22.7,-17799,-9,27.4,0,1505,1508,9006
2002,29,h) 11 to 15,12786,14404,192015,198706,626,4.2,1514,10.2,24921,6499,18422,3.3,12.5,38302,14417,23885,7.3,19.3,-13381,-6.8,25,0,878,878,6931
2002,29,i) 16 to 20,10650,12659,216737,218536,587,4.5,1116,8.6,28868,6387,22481,2.9,13.2,32466,9667,22799,4.4,14.9,-3598,-1.7,26.4,0,546,549,3634
2002,29,j) 21 to 25,7690,10956,223072,222810,655,5.9,958,8.6,31809,12157,19652,5.5,14.3,31284,9874,21410,4.4,14,525,0.3,28,0,385,387,2919
2002,29,l) Left Censored,16371,34791,1213369,1234695,2406,6.8,3196,9.1,149941,51603,98338,4.2,12.1,192593,53172,139421,4.3,15.6,-42652,-3.5,24.2,0,572,573,4087
2002,30,a) 0,2380,2399,11396,5698,2399,200,0,0,11396,11396,0,200,200,0,0,0,0,0,11396,200,0,0,,,
2002,30,b) 1,1811,1824,9368,9620,9,0.4,523,25.1,2297,178,2119,1.9,23.9,2800,1544,1256,16,29.1,-503,-5.2,47.8,0,344,344,1103
2002,30,c) 2,1592,1630,9485,10011,79,4.5,317,18.1,1882,325,1557,3.2,18.8,2934,1050,1884,10.5,29.3,-1052,-10.5,37.6,0,211,211,774
2002,30,d) 3,1403,1445,9526,9662,66,4.3,226,14.8,1570,236,1334,2.4,16.2,1842,754,1088,7.8,19.1,-272,-2.9,32.4,0,139,139,508
2002,30,e) 4,1398,1493,11787,12613,84,5.4,228,14.6,1794,460,1334,3.6,14.2,3446,918,2528,7.3,27.3,-1652,-13.1,28.4,0,138,138,613
2002,30,f) 5,1183,1200,8074,8286,44,3.5,163,12.9,1220,203,1017,2.4,14.7,1643,585,1058,7.1,19.8,-423,-5.1,29.4,0,108,108,463
2002,30,g) 6 to 10,4408,4509,34057,35019,210,4.5,577,12.3,5189,1288,3901,3.7,14.8,7112,2576,4536,7.4,20.3,-1923,-5.5,29.6,0,334,334,1593
2002,30,h) 11 to 15,2724,2938,28603,28525,141,4.7,302,10,5058,764,4294,2.7,17.7,4901,1671,3230,5.9,17.2,157,0.5,34.4,0,160,160,925
2002,30,i) 16 to 20,2208,2560,30179,30128,125,4.8,267,10.1,4367,736,3631,2.4,14.5,4264,1260,3004,4.2,14.2,103,0.3,28.4,0,113,113,551
2002,30,j) 21 to 25,1897,2509,32933,33761,124,4.9,201,7.9,3983,1242,2741,3.7,11.8,5639,1282,4357,3.8,16.7,-1656,-4.9,23.6,0,80,80,374
2002,30,l) Left Censored,3023,5577,114165,115772,307,5.4,464,8.2,12477,3701,8776,3.2,10.8,15691,4717,10974,4.1,13.6,-3214,-2.8,21.6,0,128,129,884
2002,31,a) 0,2967,3021,16978,8489,3021,200,0,0,16978,16978,0,200,200,0,0,0,0,0,16978,200,0,0,,,
2002,31,b) 1,2369,2404,16418,16597,11,0.4,551,20.6,4141,188,3953,1.1,25,4499,2225,2274,13.4,27.1,-358,-2.1,50,0,375,375,1599
2002,31,c) 2,2050,2104,14624,14572,109,4.8,398,17.7,3310,1279,2031,8.8,22.7,3205,1372,1833,9.4,22,105,0.7,44,0,268,268,1066
2002,31,d) 3,1799,1877,22464,22700,101,5.1,323,16.2,2983,660,2323,2.9,13.1,3455,1316,2139,5.8,15.2,-472,-2.1,26.2,0,219,219,942
2002,31,e) 4,1744,1912,22931,22942,102,5.1,264,13.2,3500,724,2776,3.2,15.3,3522,1689,1833,7.4,15.4,-22,-0.1,30.6,0,188,188,1125
2002,31,f) 5,1585,1651,12361,12590,68,4,196,11.4,1840,476,1364,3.8,14.6,2298,749,1549,5.9,18.3,-458,-3.7,29.2,0,133,133,498
2002,31,g) 6 to 10,5917,6133,52514,54767,263,4.1,702,11.1,6668,1256,5412,2.3,12.2,11173,4662,6511,8.5,20.4,-4505,-8.2,24.4,0,430,430,3086
2002,31,h) 11 to 15,4344,4869,69511,69941,214,4.3,436,8.8,10346,4640,5706,6.6,14.8,11205,3278,7927,4.7,16,-859,-1.2,29.6,0,234,236,1411
2002,31,i) 16 to 20,3810,4445,65457,65824,156,3.4,363,8,7080,1109,5971,1.7,10.8,7814,2263,5551,3.4,11.9,-734,-1.1,21.6,0,174,174,855
2002,31,j) 21 to 25,3110,4179,75116,74241,190,4.5,333,7.8,11535,2812,8723,3.8,15.5,9784,2713,7071,3.7,13.2,1751,2.3,26.4,0,136,138,643
2002,31,l) Left Censored,6890,12470,378374,382428,716,5.7,993,7.9,42979,11418,31561,3,11.2,51087,14095,36992,3.7,13.4,-8108,-2.2,22.4,0,215,215,1375
2002,32,a) 0,4940,4971,37446,18723,4971,200,0,0,37446,37446,0,200,200,0,0,0,0,0,37446,200,0,0,,,
2002,32,b) 1,3420,3468,30603,29604,32,0.8,1187,29.3,11009,463,10546,1.6,37.2,9010,5362,3648,18.1,30.4,1999,6.8,60.8,0,869,869,4341
2002,32,c) 2,2828,2877,30551,31734,135,4.3,726,22.9,7847,1065,6782,3.4,24.7,10212,4354,5858,13.7,32.2,-2365,-7.5,49.4,0,539,539,3488
2002,32,d) 3,2485,2607,30640,32514,159,5.7,539,19.3,6156,1695,4461,5.2,18.9,9903,3548,6355,10.9,30.5,-3747,-11.6,37.8,0,399,399,2898
2002,32,e) 4,2212,2375,31738,34676,162,6.5,386,15.5,4219,1329,2890,3.8,12.2,10094,2304,7790,6.6,29.1,-5875,-16.9,24.4,0,264,264,1807
2002,32,f) 5,1791,1840,23922,24726,85,4.4,306,15.7,3809,551,3258,2.2,15.4,5417,2114,3303,8.5,21.9,-1608,-6.5,30.8,0,225,225,1638
2002,32,g) 6 to 10,5633,5972,108429,110417,304,4.9,842,13.5,16178,3722,12456,3.4,14.7,20154,6589,13565,6,18.3,-3976,-3.6,29.4,0,542,542,3850
2002,32,h) 11 to 15,3588,4192,69561,70747,244,5.7,476,11,11587,3957,7630,5.6,16.4,13959,6187,7772,8.7,19.7,-2372,-3.3,32.8,0,248,250,2337
2002,32,i) 16 to 20,2442,3206,69328,70230,219,6.7,388,11.8,11315,2989,8326,4.3,16.1,13118,2971,10147,4.2,18.7,-1803,-2.6,32.2,0,138,138,626
2002,32,j) 21 to 25,2080,3078,102148,104573,189,6,302,9.6,14651,6718,7933,6.4,14,19501,3584,15917,3.4,18.6,-4850,-4.6,28,0,93,93,759
2002,32,l) Left Censored,3482,8749,396434,399147,992,11.4,850,9.8,53409,19974,33435,5,13.4,58835,17270,41565,4.3,14.7,-5426,-1.3,26.8,0,106,106,2630
2002,33,a) 0,2354,2361,12651,6326,2361,200,0,0,12651,12651,0,200,200,0,0,0,0,0,12651,200,0,0,,,
2002,33,b) 1,1846,1890,13248,13443,19,0.9,525,24.5,3666,413,3253,3.1,27.3,4056,1710,2346,12.7,30.2,-390,-2.9,54.6,0,359,359,1349
2002,33,c) 2,1677,1706,11373,11686,81,4.4,313,17.2,2083,310,1773,2.7,17.8,2709,1275,1434,10.9,23.2,-626,-5.4,35.6,0,225,225,1055
2002,33,d) 3,1476,1515,13747,13680,79,4.9,263,16.4,2893,545,2348,4,21.1,2758,970,1788,7.1,20.2,135,0.9,40.4,0,190,190,775
2002,33,e) 4,1494,1584,13747,13928,88,5.4,207,12.6,2409,788,1621,5.7,17.3,2770,994,1776,7.1,19.9,-361,-2.6,34.6,0,147,147,838
2002,33,f) 5,1330,1343,10146,10947,44,3.1,213,14.9,1430,82,1348,0.7,13.1,3031,1639,1392,15,27.7,-1601,-14.6,26.2,0,147,148,1259
2002,33,g) 6 to 10,5031,5149,48653,50842,172,3.2,594,11.1,6479,961,5518,1.9,12.7,10857,3994,6863,7.9,21.4,-4378,-8.7,25.4,0,374,374,2231
2002,33,h) 11 to 15,3840,4100,49436,51222,130,3.1,438,10.3,6685,2168,4517,4.2,13.1,10256,3914,6342,7.6,20,-3571,-6.9,26.2,0,259,259,2129
2002,33,i) 16 to 20,2962,3380,50713,52397,143,4.1,323,9.3,7069,2233,4836,4.3,13.5,10436,3346,7090,6.4,19.9,-3367,-6.4,27,0,155,155,831
2002,33,j) 21 to 25,1882,2528,47983,49395,114,4.4,239,9.2,6085,1864,4221,3.8,12.3,8908,3506,5402,7.1,18,-2823,-5.7,24.6,0,86,86,784
2002,33,l) Left Censored,4117,7907,265833,270728,559,7.1,602,7.6,27303,8627,18676,3.2,10.1,37093,11414,25679,4.2,13.7,-9790,-3.6,20.2,0,104,104,494
2002,34,a) 0,16254,16332,93575,46788,16332,200,0,0,93575,93575,0,200,200,0,0,0,0,0,93575,200,0,0,,,
2002,34,b) 1,12458,12619,97479,100785,96,0.7,3521,24.6,23146,2105,21041,2.1,23,29758,13471,16287,13.4,29.5,-6612,-6.5,46,0,2353,2354,10096
2002,34,c) 2,10883,11002,85667,86821,549,4.6,2227,18.8,18500,2997,15503,3.5,21.3,20807,10412,10395,12,24,-2307,-2.7,42.6,0,1529,1530,8440
2002,34,d) 3,10163,10429,87381,91761,499,4.5,1721,15.6,16359,3816,12543,4.2,17.8,25118,10099,15019,11,27.4,-8759,-9.6,35.6,0,1204,1207,7995
2002,34,e) 4,9638,10106,96370,97262,507,4.8,1529,14.4,18942,3834,15108,3.9,19.5,20726,7110,13616,7.3,21.3,-1784,-1.8,39,0,1028,1028,5308
2002,34,f) 5,8519,8728,78159,79933,381,4.1,1302,14.2,15007,3406,11601,4.3,18.8,18554,8287,10267,10.4,23.2,-3547,-4.4,37.6,0,849,849,6100
2002,34,g) 6 to 10,30090,31018,321727,327404,1266,3.9,3814,11.8,53390,8963,44427,2.7,16.3,64745,23682,41063,7.2,19.8,-11355,-3.5,32.6,0,2424,2426,14480
2002,34,h) 11 to 15,22348,23833,292181,298618,937,3.8,2545,10.3,41185,7937,33248,2.7,13.8,54059,20316,33743,6.8,18.1,-12874,-4.3,27.6,0,1454,1456,9991
2002,34,i) 16 to 20,16808,19161,307496,310313,837,4.3,1775,9,42566,14739,27827,4.7,13.7,48199,15048,33151,4.8,15.5,-5633,-1.8,27.4,0,861,861,5249
2002,34,j) 21 to 25,12421,15074,317064,318502,629,4.1,1359,8.8,42887,9439,33448,3,13.5,45763,13037,32726,4.1,14.4,-2876,-0.9,27,0,601,607,3645
2002,34,l) Left Censored,25602,49292,1798203,1821510,3401,6.8,4326,8.7,248278,82883,165395,4.6,13.6,294892,93574,201318,5.1,16.2,-46614,-2.6,27.2,0,1090,1096,10678
2002,35,a) 0,2982,2998,19759,9880,2998,200,0,0,19759,19759,0,200,200,0,0,0,0,0,19759,200,0,0,,,
2002,35,b) 1,2259,2352,17604,17938,42,1.6,726,26.9,4923,591,4332,3.3,27.4,5590,2986,2604,16.6,31.2,-667,-3.8,54.8,0,507,507,2397
2002,35,c) 2,1912,1953,15720,15589,108,5.1,423,20,4826,2186,2640,14,31,4563,2319,2244,14.9,29.3,263,1.7,58.6,0,301,302,2001
2002,35,d) 3,1682,1705,12635,13121,108,6,319,17.6,2505,518,1987,3.9,19.1,3477,2032,1445,15.5,26.5,-972,-7.4,38.2,0,222,222,1715
2002,35,e) 4,1603,1714,17390,17345,121,6.8,242,13.6,2921,675,2246,3.9,16.8,2830,1030,1800,5.9,16.3,91,0.5,32.6,0,169,169,840
2002,35,f) 5,1475,1501,13260,13462,92,5.8,267,16.8,2592,633,1959,4.7,19.3,2996,1255,1741,9.3,22.3,-404,-3,38.6,0,164,164,823
2002,35,g) 6 to 10,5538,5807,56069,57005,314,5.2,728,12.1,9218,1712,7506,3,16.2,11089,3990,7099,7,19.5,-1871,-3.3,32.4,0,466,466,2746
2002,35,h) 11 to 15,3799,4260,62436,64395,226,5.2,408,9.4,7492,2367,5125,3.7,11.6,11409,3964,7445,6.2,17.7,-3917,-6.1,23.2,0,229,229,1740
2002,35,i) 16 to 20,3168,3817,53043,53250,224,5.8,368,9.5,8374,2795,5579,5.2,15.7,8788,2381,6407,4.5,16.5,-414,-0.8,31.4,0,155,155,954
2002,35,j) 21 to 25,2572,3592,57046,57208,184,4.9,449,12.1,9326,2050,7276,3.6,16.3,9649,3720,5929,6.5,16.9,-323,-0.6,32.6,0,105,105,567
2002,35,l) Left Censored,4077,8654,225205,227974,616,7,833,9.5,31264,11479,19785,5,13.7,36801,11671,25130,5.1,16.1,-5537,-2.4,27.4,0,121,121,1050
2002,36,a) 0,35998,36267,211113,106079,36266,200,0,0,210068,210068,0,198,198,0,0,0,0,0,210068,198,0,0,,,
2002,36,b) 1,27645,27854,176051,183695,142,0.4,7723,24.4,42741,2651,40090,1.4,23.3,58029,30331,27698,16.5,31.6,-15288,-8.3,46.6,0,5348,5348,24071
2002,36,c) 2,23670,23971,182692,189091,1016,3.9,5171,19.9,43531,6443,37088,3.4,23,56328,27825,28503,14.7,29.8,-12797,-6.8,46,0,3831,3832,23595
2002,36,d) 3,21026,21565,184306,189191,1007,4.4,3647,15.9,36054,5868,30186,3.1,19.1,45824,19475,26349,10.3,24.2,-9770,-5.1,38.2,0,2660,2661,16484
2002,36,e) 4,19797,21013,184321,189303,1049,4.8,3135,14.2,35553,8117,27436,4.3,18.8,45517,18465,27052,9.8,24,-9964,-5.2,37.6,0,2213,2213,14778
2002,36,f) 5,17500,17837,157645,161293,670,3.6,2571,13.7,28534,2949,25585,1.8,17.7,35830,14448,21382,9,22.2,-7296,-4.5,35.4,0,1805,1807,11033
2002,36,g) 6 to 10,61381,63218,632813,651138,2304,3.5,7800,11.8,99537,19482,80055,3,15.3,136187,54679,81508,8.4,20.9,-36650,-5.6,30.6,0,5090,5097,32010
2002,36,h) 11 to 15,47003,50074,650982,666166,1690,3.3,4963,9.6,84038,17946,66092,2.7,12.6,114406,37084,77322,5.6,17.2,-30368,-4.6,25.2,0,2798,2802,16439
2002,36,i) 16 to 20,35832,40142,549934,560718,1417,3.4,3372,8.2,68399,17139,51260,3.1,12.2,89967,25769,64198,4.6,16,-21568,-3.8,24.4,0,1721,1724,10998
2002,36,j) 21 to 25,24579,31935,636106,645768,1226,3.8,2694,8.2,76634,18254,58380,2.8,11.9,95958,26234,69724,4.1,14.9,-19324,-3,23.8,0,1224,1227,8405
2002,36,l) Left Censored,55325,103577,3703410,3764670,7096,6.7,10463,9.9,511498,200710,310788,5.3,13.6,634018,241639,392379,6.4,16.8,-122520,-3.2,27.2,0,2338,2348,25835
2002,37,a) 0,13888,14061,88983,44492,14061,200,0,0,88983,88983,0,200,200,0,0,0,0,0,88983,200,0,0,,,
2002,37,b) 1,11006,11160,77668,80255,67,0.5,3330,26,19594,1136,18458,1.4,24.4,24768,14129,10639,17.6,30.9,-5174,-6.5,48.8,0,2339,2340,11117
2002,37,c) 2,9460,9799,77192,80877,460,4.4,1994,18.9,15977,4371,11606,5.4,19.8,23346,10515,12831,13,28.9,-7369,-9.1,39.6,0,1420,1420,7962
2002,37,d) 3,8774,9166,82030,84902,481,4.9,1618,16.6,15103,3697,11406,4.4,17.8,20846,8534,12312,10.1,24.6,-5743,-6.8,35.6,0,1150,1150,6433
2002,37,e) 4,7883,8580,86476,89033,483,5.4,1315,14.6,15126,4274,10852,4.8,17,20240,7416,12824,8.3,22.7,-5114,-5.7,34,0,916,916,5698
2002,37,f) 5,7141,7395,70034,70901,389,5,1079,13.9,13010,2892,10118,4.1,18.3,14744,5629,9115,7.9,20.8,-1734,-2.5,36.6,0,749,752,4118
2002,37,g) 6 to 10,24548,26107,281361,292483,1107,4.1,3182,11.7,41353,10258,31095,3.5,14.1,63596,21006,42590,7.2,21.7,-22243,-7.6,28.2,0,2000,2002,11428
2002,37,h) 11 to 15,17504,19715,288035,297876,879,4.3,1997,9.9,33023,8241,24782,2.8,11.1,52705,16783,35922,5.6,17.7,-19682,-6.6,22.2,0,1106,1110,7815
2002,37,i) 16 to 20,15101,18001,259801,269734,795,4.3,1619,8.8,34531,12140,22391,4.5,12.8,54396,15625,38771,5.8,20.2,-19865,-7.4,25.6,0,680,688,4197
2002,37,j) 21 to 25,9616,13660,282013,289597,724,5.2,1241,8.9,36185,13160,23025,4.5,12.5,51353,13900,37453,4.8,17.7,-15168,-5.2,25,0,399,401,2619
2002,37,l) Left Censored,18991,47246,1741428,1779461,3293,6.9,4188,8.8,204130,74319,129811,4.2,11.5,280195,88172,192023,5,15.7,-76065,-4.2,23,0,683,698,6420
2002,38,a) 0,1036,1061,6092,3046,1061,200,0,0,6092,6092,0,200,200,0,0,0,0,0,6092,200,0,0,,,
2002,38,b) 1,829,838,5551,6227,8,0.9,192,20.6,1120,188,932,3,18,2471,684,1787,11,39.7,-1351,-21.7,36,0,132,132,489
2002,38,c) 2,743,756,5373,6028,34,4.2,132,16.4,1065,249,816,4.1,17.7,2374,1479,895,24.5,39.4,-1309,-21.7,35.4,0,87,87,1377
2002,38,d) 3,621,648,5134,5358,27,4,91,13.4,863,348,515,6.5,16.1,1310,356,954,6.6,24.4,-447,-8.3,32.2,0,66,66,239
2002,38,e) 4,649,701,6348,6569,30,4.1,90,12.3,989,298,691,4.5,15.1,1431,388,1043,5.9,21.8,-442,-6.7,30.2,0,60,60,319
2002,38,f) 5,601,623,4685,5005,24,3.6,107,16.1,650,144,506,2.9,13,1290,538,752,10.7,25.8,-640,-12.8,26,0,70,70,314
2002,38,g) 6 to 10,2413,2480,21324,21506,90,3.5,295,11.4,3172,726,2446,3.4,14.7,3535,1111,2424,5.2,16.4,-363,-1.7,29.4,0,180,180,816
2002,38,h) 11 to 15,1863,1998,20490,20847,97,4.7,195,9.5,2468,532,1936,2.6,11.8,3182,1069,2113,5.1,15.3,-714,-3.5,23.6,0,109,109,512
2002,38,i) 16 to 20,1667,1943,20300,19835,79,4,151,7.6,3533,1833,1700,9.2,17.8,2603,833,1770,4.2,13.1,930,4.7,26.2,0,66,66,327
2002,38,j) 21 to 25,1434,1789,24951,25691,59,3.2,153,8.3,2481,427,2054,1.7,9.7,3960,1112,2848,4.3,15.4,-1479,-5.7,19.4,0,70,70,447
2002,38,l) Left Censored,3121,5318,132195,133507,286,5.4,340,6.4,15245,6920,8325,5.2,11.4,17869,6066,11803,4.5,13.4,-2624,-2,22.8,0,85,85,1014
2002,39,a) 0,14824,15065,114806,57403,15065,200,0,0,114806,114806,0,200,200,0,0,0,0,0,114806,200,0,0,,,
2002,39,b) 1,11219,11392,84850,87939,85,0.7,3072,23.8,21120,1224,19896,1.4,24,27297,14574,12723,16.6,31,-6177,-7,48,0,2128,2128,11686
2002,39,c) 2,9922,10200,90862,94070,449,4.1,2023,18.4,19645,4202,15443,4.5,20.9,26060,12745,13315,13.5,27.7,-6415,-6.8,41.8,0,1399,1399,10338
2002,39,d) 3,9277,9731,95224,98352,447,4.4,1528,14.9,18746,3357,15389,3.4,19.1,25001,10345,14656,10.5,25.4,-6255,-6.3,38.2,0,1067,1069,8855
2002,39,e) 4,8881,9807,93825,96941,544,5.3,1344,13.2,16695,5519,11176,5.7,17.2,22927,7740,15187,8,23.7,-6232,-6.5,34.4,0,958,958,6289
2002,39,f) 5,8069,8503,79935,82679,345,3.9,1200,13.4,12794,2069,10725,2.5,15.5,18281,7159,11122,8.7,22.1,-5487,-6.6,31,0,765,765,4854
2002,39,g) 6 to 10,31898,33840,364254,381039,1367,3.9,4058,11.5,53456,13065,40391,3.4,14,87025,30220,56805,7.9,22.8,-33569,-8.8,28,0,2467,2467,16324
2002,39,h) 11 to 15,24155,27589,384679,397994,1081,3.8,2722,9.6,47083,12795,34288,3.2,11.8,73712,23849,49863,6,18.5,-26629,-6.7,23.6,0,1445,1447,11243
2002,39,i) 16 to 20,18979,22978,380672,389899,843,3.6,2131,9,48232,11709,36523,3,12.4,66686,19643,47043,5,17.1,-18454,-4.7,24.8,0,901,905,6328
2002,39,j) 21 to 25,15251,21068,411474,418403,1009,4.7,1943,9,54242,17533,36709,4.2,13,68099,23633,44466,5.6,16.3,-13857,-3.3,26,0,668,682,5110
2002,39,l) Left Censored,34216,74616,2653500,2716414,4518,6,6647,8.8,321063,103088,217975,3.8,11.8,446890,121595,325295,4.5,16.5,-125827,-4.7,23.6,0,1269,1276,12807
2002,40,a) 0,5944,6017,39288,19644,6017,200,0,0,39288,39288,0,200,200,0,0,0,0,0,39288,200,0,0,,,
2002,40,b) 1,4300,4369,29096,31223,33,0.7,1327,26.5,7148,515,6633,1.6,22.9,11401,6951,4450,22.3,36.5,-4253,-13.6,45.8,0,943,943,5434
2002,40,c) 2,3740,3861,30303,32030,212,5.1,820,19.7,6011,1551,4460,4.8,18.8,9465,4698,4767,14.7,29.6,-3454,-10.8,37.6,0,613,613,3821
2002,40,d) 3,3451,3576,33725,32853,209,5.6,578,15.4,9167,1573,7594,4.8,27.9,7423,3264,4159,9.9,22.6,1744,5.3,45.2,0,442,442,1828
2002,40,e) 4,3188,3479,33005,34512,208,5.8,475,13.1,5948,1353,4595,3.9,17.2,8962,3380,5582,9.8,26,-3014,-8.8,34.4,0,323,323,2641
2002,40,f) 5,2876,3079,28610,29716,191,6,443,13.8,5407,1324,4083,4.5,18.2,7618,3313,4305,11.1,25.6,-2211,-7.4,36.4,0,298,298,2093
2002,40,g) 6 to 10,10487,10977,99493,102983,528,4.6,1293,11.4,16957,4404,12553,4.3,16.5,23936,10929,13007,10.6,23.2,-6979,-6.7,33,0,814,814,5857
2002,40,h) 11 to 15,7140,7878,113281,115305,356,4.4,770,9.5,15748,4586,11162,4,13.7,19795,6957,12838,6,17.2,-4047,-3.5,27.4,0,448,449,3212
2002,40,i) 16 to 20,6992,8047,113600,116842,363,4.4,739,9,16693,5792,10901,5,14.3,23177,7710,15467,6.6,19.8,-6484,-5.5,28.6,0,343,349,2989
2002,40,j) 21 to 25,5131,6891,125987,127676,349,5,613,8.7,17295,5181,12114,4.1,13.5,20673,6342,14331,5,16.2,-3378,-2.7,27,0,218,220,1512
2002,40,l) Left Censored,8764,18870,542713,549280,1123,5.9,1722,9,69690,20512,49178,3.7,12.7,82823,26293,56530,4.8,15.1,-13133,-2.4,25.4,0,306,314,3515
2002,41,a) 0,7146,7235,37817,18909,7235,200,0,0,37817,37817,0,200,200,0,0,0,0,0,37817,200,0,0,,,
2002,41,b) 1,5513,5588,32971,33993,54,0.8,1628,25.5,8050,593,7457,1.7,23.7,10094,5812,4282,17.1,29.7,-2044,-6,47.4,0,1108,1108,4347
2002,41,c) 2,4801,4889,32160,33117,230,4.4,932,17.8,6759,1646,5113,5,20.4,8673,3994,4679,12.1,26.2,-1914,-5.8,40.8,0,658,658,3376
2002,41,d) 3,4300,4436,30742,31833,220,4.6,821,17.3,5838,1510,4328,4.7,18.3,8019,3664,4355,11.5,25.2,-2181,-6.9,36.6,0,550,557,2852
2002,41,e) 4,4010,4284,34313,34272,233,5.2,647,14.4,7796,1942,5854,5.7,22.7,7714,3143,4571,9.2,22.5,82,0.2,45,0,447,447,2285
2002,41,f) 5,3522,3626,28644,29902,154,4,536,14,4055,543,3512,1.8,13.6,6570,2090,4480,7,22,-2515,-8.4,27.2,0,338,338,1477
2002,41,g) 6 to 10,13723,14367,139911,144385,644,4.3,1903,12.7,20854,3231,17623,2.2,14.4,29802,12027,17775,8.3,20.6,-8948,-6.2,28.8,0,1179,1179,7650
2002,41,h) 11 to 15,9055,10021,120641,123079,473,4.6,1146,11.1,18016,3998,14018,3.2,14.6,22891,7671,15220,6.2,18.6,-4875,-4,29.2,0,611,611,3153
2002,41,i) 16 to 20,6698,8170,128151,132440,370,4.4,775,9.3,16653,5648,11005,4.3,12.6,25230,7584,17646,5.7,19.1,-8577,-6.5,25.2,0,301,308,1935
2002,41,j) 21 to 25,5597,7367,131306,134408,365,4.8,696,9.2,15534,4194,11340,3.1,11.6,21738,5942,15796,4.4,16.2,-6204,-4.6,23.2,0,270,270,1692
2002,41,l) Left Censored,8940,19496,603266,613454,1479,7.5,1750,8.9,79780,34532,45248,5.6,13,100156,29247,70909,4.8,16.3,-20376,-3.3,26,0,334,335,4067
2002,42,a) 0,16746,16940,120609,60305,16940,200,0,0,120609,120609,0,200,200,0,0,0,0,0,120609,200,0,0,,,
2002,42,b) 1,13061,13226,121254,111451,105,0.7,3211,21.7,46042,3242,42800,2.9,41.3,26436,12590,13846,11.3,23.7,19606,17.6,47.4,0,2160,2160,9822
2002,42,c) 2,11708,11949,103339,106869,472,3.7,2163,16.9,21678,4466,17212,4.2,20.3,28737,9933,18804,9.3,26.9,-7059,-6.6,40.6,0,1517,1528,7836
2002,42,d) 3,10574,11003,100450,102430,496,4.3,1716,14.8,20569,7390,13179,7.2,20.1,24528,9551,14977,9.3,23.9,-3959,-3.8,40.2,0,1191,1199,7566
2002,42,e) 4,10183,11354,112218,115902,565,4.8,1365,11.6,19974,6114,13860,5.3,17.2,27342,8391,18951,7.2,23.6,-7368,-6.4,34.4,0,933,933,6042
2002,42,f) 5,9023,9414,83603,87270,336,3.4,1276,12.9,12596,2323,10273,2.7,14.4,19929,8301,11628,9.5,22.8,-7333,-8.4,28.8,0,855,856,5829
2002,42,g) 6 to 10,34126,35722,363579,373392,1286,3.5,3913,10.6,52093,9334,42759,2.5,14,71718,27582,44136,7.4,19.2,-19625,-5.2,28,0,2424,2424,16327
2002,42,h) 11 to 15,29230,32012,406826,407256,1162,3.5,2966,9,64491,23351,41140,5.7,15.8,65351,23934,41417,5.9,16,-860,-0.2,31.6,0,1594,1600,10433
2002,42,i) 16 to 20,22905,27171,451475,460527,1119,4,2400,8.6,55800,15941,39859,3.5,12.1,73903,27432,46471,6,16,-18103,-3.9,24.2,0,1064,1071,8179
2002,42,j) 21 to 25,16520,21943,420037,423597,1059,4.7,2026,9,56746,19144,37602,4.5,13.4,63865,23153,40712,5.5,15.1,-7119,-1.7,26.8,0,758,760,5065
2002,42,l) Left Censored,37396,78649,2777191,2818162,4878,6.1,6969,8.7,349651,124179,225472,4.4,12.4,431594,168433,263161,6,15.3,-81943,-2.9,24.8,0,1425,1435,22714
2002,44,a) 0,1834,1842,9215,4608,1842,200,0,0,9215,9215,0,200,200,0,0,0,0,0,9215,200,0,0,,,
2002,44,b) 1,1372,1381,8351,8481,4,0.3,347,22.4,2300,51,2249,0.6,27.1,2559,1387,1172,16.4,30.2,-259,-3.1,54.2,0,216,216,916
2002,44,c) 2,1175,1193,11937,12198,47,3.6,244,18.9,1728,344,1384,2.8,14.2,2250,895,1355,7.3,18.4,-522,-4.2,28.4,0,159,159,701
2002,44,d) 3,1084,1104,8105,8245,48,4.1,206,17.4,1499,271,1228,3.3,18.2,1779,698,1081,8.5,21.6,-280,-3.4,36.4,0,136,136,541
2002,44,e) 4,1109,1205,9328,9403,76,6.1,158,12.7,1670,549,1121,5.8,17.8,1819,613,1206,6.5,19.3,-149,-1.5,35.6,0,113,113,484
2002,44,f) 5,937,957,9013,9387,32,3.2,141,13.9,1180,108,1072,1.2,12.6,1928,766,1162,8.2,20.5,-748,-7.9,25.2,0,94,94,568
2002,44,g) 6 to 10,3596,3654,31902,33061,107,2.8,448,11.7,3872,327,3545,1,11.7,6190,1973,4217,6,18.7,-2318,-7,23.4,0,280,280,1290
2002,44,h) 11 to 15,2937,3134,40700,41121,112,3.5,288,8.9,4980,857,4123,2.1,12.1,5821,1298,4523,3.2,14.2,-841,-2.1,24.2,0,155,155,756
2002,44,i) 16 to 20,2223,2479,34674,34875,98,3.9,211,8.3,4894,1431,3463,4.1,14,5296,1777,3519,5.1,15.2,-402,-1.2,28,0,88,88,351
2002,44,j) 21 to 25,1673,1973,34126,34360,76,3.8,163,8.1,5015,2059,2956,6,14.6,5483,1776,3707,5.2,16,-468,-1.4,29.2,0,68,68,390
2002,44,l) Left Censored,4215,6443,216602,215852,378,5.8,556,8.5,28296,11737,16559,5.4,13.1,26796,7997,18799,3.7,12.4,1500,0.7,24.8,0,156,156,1188
2002,45,a) 0,6954,7022,46398,23199,7022,200,0,0,46398,46398,0,200,200,0,0,0,0,0,46398,200,0,0,,,
2002,45,b) 1,5183,5280,43897,47050,49,0.8,1590,26.3,10875,587,10288,1.2,23.1,17180,7227,9953,15.4,36.5,-6305,-13.4,46.2,0,1115,1115,5632
2002,45,c) 2,4562,4710,39125,40207,218,4.3,975,19.2,9377,1948,7429,4.8,23.3,11540,5143,6397,12.8,28.7,-2163,-5.4,46.6,0,730,730,3951
2002,45,d) 3,4160,4338,42195,44843,261,5.7,775,16.9,6900,1965,4935,4.4,15.4,12196,3417,8779,7.6,27.2,-5296,-11.8,30.8,0,583,583,2733
2002,45,e) 4,3795,4070,39705,41604,230,5.4,621,14.6,6532,2180,4352,5.2,15.7,10329,3599,6730,8.7,24.8,-3797,-9.1,31.4,0,444,444,2847
2002,45,f) 5,3243,3312,34903,36136,140,4,495,14.2,4943,831,4112,2.3,13.7,7408,2466,4942,6.8,20.5,-2465,-6.8,27.4,0,335,335,1780
2002,45,g) 6 to 10,11762,12358,139638,145451,531,4.1,1674,12.9,22420,6044,16376,4.2,15.4,34048,13221,20827,9.1,23.4,-11628,-8,30.8,0,1079,1085,8727
2002,45,h) 11 to 15,8418,9790,137222,139980,420,4.2,909,9.1,18867,3304,15563,2.4,13.5,24383,6761,17622,4.8,17.4,-5516,-3.9,27,0,504,504,2976
2002,45,i) 16 to 20,6977,8436,114271,117514,408,4.7,774,9,14772,5042,9730,4.3,12.6,21258,6698,14560,5.7,18.1,-6486,-5.5,25.2,0,346,346,1759
2002,45,j) 21 to 25,4618,6698,116482,119084,379,5.6,579,8.5,17318,7944,9374,6.7,14.5,22522,6019,16503,5.1,18.9,-5204,-4.4,29,0,232,233,2039
2002,45,l) Left Censored,9369,22094,778174,798683,1411,6.3,1848,8.3,83912,25417,58495,3.2,10.5,124930,35885,89045,4.5,15.6,-41018,-5.1,21,0,305,309,2708
2002,46,a) 0,1665,1677,8528,4264,1677,200,0,0,8528,8528,0,200,200,0,0,0,0,0,8528,200,0,0,,,
2002,46,b) 1,1195,1229,7576,7844,14,1,300,21.9,1727,253,1474,3.2,22,2263,1089,1174,13.9,28.9,-536,-6.9,44,0,191,191,805
2002,46,c) 2,1039,1064,7530,7831,38,3.3,179,15.8,1302,168,1134,2.1,16.6,1904,792,1112,10.1,24.3,-602,-7.7,33.2,0,133,133,687
2002,46,d) 3,936,960,7158,7198,50,4.9,177,17.3,1512,652,860,9.1,21,1592,674,918,9.4,22.1,-80,-1.1,42,0,119,119,520
2002,46,e) 4,912,964,7209,7235,63,6.4,107,10.9,1499,539,960,7.4,20.7,1550,449,1101,6.2,21.4,-51,-0.7,41.4,0,72,72,356
2002,46,f) 5,802,829,6224,6915,44,5.1,104,12.1,943,165,778,2.4,13.6,2325,1584,741,22.9,33.6,-1382,-20,27.2,0,67,67,1160
2002,46,g) 6 to 10,3098,3201,25656,26429,155,4.7,365,11,3617,880,2737,3.3,13.7,5163,1849,3314,7,19.5,-1546,-5.8,27.4,0,244,244,1246
2002,46,h) 11 to 15,2136,2302,28093,28813,110,4.7,232,9.8,2980,779,2201,2.7,10.3,4420,1678,2742,5.8,15.3,-1440,-5,20.6,0,126,126,794
2002,46,i) 16 to 20,1756,2065,27714,33028,87,4.1,169,8,5325,806,4519,2.4,16.1,15953,8907,7046,27,48.3,-10628,-32.2,32.2,0,85,85,465
2002,46,j) 21 to 25,1415,1751,24820,24860,91,5.1,157,8.8,3862,885,2977,3.6,15.5,3942,1471,2471,5.9,15.9,-80,-0.4,31,0,70,70,519
2002,46,l) Left Censored,3222,5585,151715,152971,318,5.7,390,6.9,18022,4934,13088,3.2,11.8,20533,4824,15709,3.2,13.4,-2511,-1.6,23.6,0,116,116,669
2002,47,a) 0,8198,8301,62058,31029,8301,200,0,0,62058,62058,0,200,200,0,0,0,0,0,62058,200,0,0,,,
2002,47,b) 1,5917,6011,47023,49254,51,0.7,2029,29,11873,1026,10847,2.1,24.1,16334,8930,7404,18.1,33.2,-4461,-9.1,48.2,0,1518,1523,7197
2002,47,c) 2,5081,5239,45936,48656,275,4.8,1201,21.1,10169,2295,7874,4.7,20.9,15608,7224,8384,14.8,32.1,-5439,-11.2,41.8,0,884,886,5645
2002,47,d) 3,4741,5093,48174,50580,308,5.7,996,18.3,9471,2271,7200,4.5,18.7,14283,5970,8313,11.8,28.2,-4812,-9.5,37.4,0,752,753,4084
2002,47,e) 4,4572,5085,52514,53882,295,5.5,775,14.6,10801,2860,7941,5.3,20,13537,5239,8298,9.7,25.1,-2736,-5.1,40,0,577,577,3796
2002,47,f) 5,3951,4149,41954,43758,200,4.6,655,15,7651,1606,6045,3.7,17.5,11259,4308,6951,9.8,25.7,-3608,-8.2,35,0,433,435,3082
2002,47,g) 6 to 10,15607,16631,177471,183826,761,4.4,2161,12.5,27325,5571,21754,3,14.9,40034,15015,25019,8.2,21.8,-12709,-6.9,29.8,0,1426,1426,8103
2002,47,h) 11 to 15,11279,13082,203337,210034,567,4.2,1299,9.7,25983,6519,19464,3.1,12.4,39378,13733,25645,6.5,18.7,-13395,-6.3,24.8,0,758,760,6928
2002,47,i) 16 to 20,9798,11598,183965,187250,520,4.4,1070,9,23797,8402,15395,4.5,12.7,30369,9757,20612,5.2,16.2,-6572,-3.5,25.4,0,496,498,3069
2002,47,j) 21 to 25,6807,10505,222015,237023,526,4.9,1010,9.4,27159,6758,20401,2.9,11.5,57174,22679,34495,9.6,24.1,-30015,-12.6,23,0,328,330,2781
2002,47,l) Left Censored,13516,32409,1199474,1221912,2259,6.9,3103,9.5,147344,48535,98809,4,12.1,192220,58247,133973,4.8,15.7,-44876,-3.6,24.2,0,501,510,5743
2002,48,a) 0,35062,35670,298419,149210,35670,200,0,0,298419,298419,0,200,200,0,0,0,0,0,298419,200,0,0,,,
2002,48,b) 1,25738,26288,219797,229300,253,0.8,8228,27.2,57467,4047,53420,1.8,25.1,76472,41795,34677,18.2,33.4,-19005,-8.3,50.2,0,6123,6127,33108
2002,48,c) 2,22019,22785,205857,214007,1126,4.6,4686,19.1,46929,9688,37241,4.5,21.9,63229,30282,32947,14.2,29.5,-16300,-7.6,43.8,0,3515,3524,24736
2002,48,d) 3,19491,20416,216957,224595,1133,5.2,3592,16.6,42416,10132,32284,4.5,18.9,57692,22681,35011,10.1,25.7,-15276,-6.8,37.8,0,2621,2625,17948
2002,48,e) 4,17839,19607,229777,233201,1237,6.1,2903,14.2,47351,14227,33124,6.1,20.3,54198,19270,34928,8.3,23.2,-6847,-2.9,40.6,0,2107,2107,13862
2002,48,f) 5,15855,16571,186647,196712,764,4.4,2502,14.3,35585,8293,27292,4.2,18.1,55715,20532,35183,10.4,28.3,-20130,-10.2,36.2,0,1740,1744,12694
2002,48,g) 6 to 10,59483,64032,765929,794626,3164,4.8,8099,12.2,123642,31757,91885,4,15.6,181037,72269,108768,9.1,22.8,-57395,-7.2,31.2,0,5220,5232,35368
2002,48,h) 11 to 15,39255,45898,740796,763574,2360,5,4754,10.1,108107,24909,83198,3.3,14.2,153664,54690,98974,7.2,20.1,-45557,-5.9,28.4,0,2596,2609,22134
2002,48,i) 16 to 20,33055,40611,663269,677140,1949,4.7,3846,9.3,101531,33398,68133,4.9,15,129272,46913,82359,6.9,19.1,-27741,-4.1,30,0,1705,1718,14095
2002,48,j) 21 to 25,23988,34616,648352,668148,2037,5.8,3417,9.7,98217,32482,65735,4.9,14.7,137809,50453,87356,7.6,20.6,-39592,-5.9,29.4,0,1203,1221,8418
2002,48,l) Left Censored,34404,104013,3774937,3834597,8687,8.3,10932,10.4,535592,203192,332400,5.3,14,654913,208936,445977,5.4,17.1,-119321,-3.1,28,0,1375,1398,12038
2002,49,a) 0,5500,5556,34689,17345,5556,200,0,0,34689,34689,0,200,200,0,0,0,0,0,34689,200,0,0,,,
2002,49,b) 1,3728,3793,26544,27852,29,0.7,1287,29.1,7419,392,7027,1.4,26.6,10035,6018,4017,21.6,36,-2616,-9.4,53.2,0,844,845,4312
2002,49,c) 2,3066,3108,23793,25103,161,4.8,693,20.5,5547,1017,4530,4.1,22.1,8167,3967,4200,15.8,32.5,-2620,-10.4,44.2,0,469,470,3054
2002,49,d) 3,2702,2765,29043,29493,165,5.6,548,18.5,6647,747,5900,2.5,22.5,7546,3254,4292,11,25.6,-899,-3.1,45,0,356,356,2457
2002,49,e) 4,2357,2508,23087,24396,175,6.6,425,16.1,4686,1836,2850,7.5,19.2,7303,3097,4206,12.7,29.9,-2617,-10.7,38.4,0,281,281,2136
2002,49,f) 5,2101,2166,21185,22265,104,4.5,361,15.7,3514,542,2972,2.4,15.8,5673,1941,3732,8.7,25.5,-2159,-9.7,31.6,0,228,228,1179
2002,49,g) 6 to 10,7121,7497,94482,98132,372,4.7,1049,13.4,14097,4316,9781,4.4,14.4,21397,7744,13653,7.9,21.8,-7300,-7.4,28.8,0,590,590,4590
2002,49,h) 11 to 15,4064,4598,91524,90022,234,4.9,494,10.4,20485,3004,17481,3.3,22.8,17480,8143,9337,9,19.4,3005,3.4,38.8,0,246,246,4774
2002,49,i) 16 to 20,2880,3511,62239,64722,183,5.1,357,9.9,8570,2901,5669,4.5,13.2,13536,5019,8517,7.8,20.9,-4966,-7.7,26.4,0,136,137,1132
2002,49,j) 21 to 25,2557,3448,70393,72197,214,6.1,349,9.9,10522,3332,7190,4.6,14.6,14130,4708,9422,6.5,19.6,-3608,-5,29.2,0,110,110,844
2002,49,l) Left Censored,4487,10742,429415,436896,884,8.2,1017,9.4,51267,20469,30798,4.7,11.7,66229,16871,49358,3.9,15.2,-14962,-3.5,23.4,0,152,155,1702
2002,50,a) 0,1244,1250,7768,3884,1250,200,0,0,7768,7768,0,200,200,0,0,0,0,0,7768,200,0,0,,,
2002,50,b) 1,984,993,5810,5721,8,0.7,220,20,1397,206,1191,3.6,24.4,1219,630,589,11,21.3,178,3.1,42.6,0,148,148,461
2002,50,c) 2,925,954,7018,7048,29,2.8,182,17.7,2213,148,2065,2.1,31.4,2272,1331,941,18.9,32.2,-59,-0.8,62.8,0,115,115,914
2002,50,d) 3,838,852,5655,5593,39,4.4,124,13.9,1238,130,1108,2.3,22.1,1113,445,668,8,19.9,125,2.2,39.8,0,80,80,268
2002,50,e) 4,839,908,6797,6892,58,6.2,121,12.9,1223,463,760,6.7,17.7,1413,519,894,7.5,20.5,-190,-2.8,35.4,0,72,72,378
2002,50,f) 5,734,742,4168,4389,21,2.7,112,14.2,579,60,519,1.4,13.2,1021,373,648,8.5,23.3,-442,-10.1,26.4,0,71,71,267
2002,50,g) 6 to 10,2882,2975,23524,24336,88,2.8,355,11.4,3037,377,2660,1.5,12.5,4660,1672,2988,6.9,19.1,-1623,-6.6,25,0,226,226,1191
2002,50,h) 11 to 15,2453,2562,22745,23259,83,3.1,244,9.2,2644,397,2247,1.7,11.4,3671,1204,2467,5.2,15.8,-1027,-4.4,22.8,0,129,129,760
2002,50,i) 16 to 20,1886,2146,31733,32176,70,3.2,196,8.9,3360,536,2824,1.7,10.4,4246,1235,3011,3.8,13.2,-886,-2.8,20.8,0,82,82,540
2002,50,j) 21 to 25,1244,1537,23698,24622,50,3.2,133,8.4,2194,399,1795,1.6,8.9,4042,1498,2544,6.1,16.4,-1848,-7.5,17.8,0,53,53,280
2002,50,l) Left Censored,2511,4111,120068,121371,266,6.4,390,9.3,14185,5555,8630,4.6,11.7,16791,5744,11047,4.7,13.8,-2606,-2.1,23.4,0,76,77,891
2002,51,a) 0,12081,12197,77445,38723,12197,200,0,0,77445,77445,0,200,200,0,0,0,0,0,77445,200,0,0,,,
2002,51,b) 1,8893,9078,63233,64947,94,0.9,2761,26.5,17944,1757,16187,2.7,27.6,21371,11931,9440,18.4,32.9,-3427,-5.3,55.2,0,1930,1931,8543
2002,51,c) 2,7913,8090,60303,63496,390,4.5,1567,18.1,13209,2423,10786,3.8,20.8,19595,8912,10683,14,30.9,-6386,-10.1,41.6,0,1107,1108,7036
2002,51,d) 3,6986,7276,61218,63360,408,5.3,1179,15.4,13142,3803,9339,6,20.7,17426,7563,9863,11.9,27.5,-4284,-6.8,41.4,0,834,838,6135
2002,51,e) 4,6733,7292,70968,71370,378,5,956,12.6,14379,3931,10448,5.5,20.1,15183,5121,10062,7.2,21.3,-804,-1.2,40.2,0,655,655,3737
2002,51,f) 5,5878,6062,54122,56533,280,4.4,806,12.7,9467,2234,7233,4,16.7,14289,4870,9419,8.6,25.3,-4822,-8.6,33.4,0,534,534,3090
2002,51,g) 6 to 10,22374,23561,266094,273456,1044,4.3,2692,11,42769,9064,33705,3.3,15.6,57493,23506,33987,8.6,21,-14724,-5.4,31.2,0,1717,1718,12954
2002,51,h) 11 to 15,16277,18275,272923,278445,804,4.3,1594,8.5,37212,10669,26543,3.8,13.4,48256,17226,31030,6.2,17.3,-11044,-3.9,26.8,0,876,876,7535
2002,51,i) 16 to 20,12791,15541,259821,262895,745,4.7,1243,7.9,35986,11282,24704,4.3,13.7,42134,13578,28556,5.2,16,-6148,-2.3,27.4,0,496,497,3420
2002,51,j) 21 to 25,8442,11975,240756,246056,729,6,1102,9.1,33295,11395,21900,4.6,13.5,43894,18473,25421,7.5,17.8,-10599,-4.3,27,0,342,347,2961
2002,51,l) Left Censored,16455,41803,1466283,1482296,3266,7.8,3916,9.3,198042,72891,125151,4.9,13.4,230067,74429,155638,5,15.5,-32025,-2.1,26.8,0,522,528,5158
2002,53,a) 0,12243,12382,62345,31173,12382,200,0,0,62345,62345,0,200,200,0,0,0,0,0,62345,200,0,0,,,
2002,53,b) 1,9031,9145,55621,59162,60,0.6,3044,28.6,13227,947,12280,1.6,22.4,20308,11200,9108,18.9,34.3,-7081,-11.9,44.8,0,2092,2092,8728
2002,53,c) 2,7904,8080,53595,58800,433,4.9,1872,21.3,10255,2184,8071,3.7,17.4,20664,10916,9748,18.6,35.1,-10409,-17.7,34.8,0,1310,1311,9253
2002,53,d) 3,7219,7525,63113,67113,479,6,1431,17.9,11767,3716,8051,5.5,17.5,19767,7079,12688,10.5,29.5,-8000,-12,35,0,1007,1007,5707
2002,53,e) 4,6596,7126,63319,66247,450,6,1204,16,12960,3340,9620,5,19.6,18815,6125,12690,9.2,28.4,-5855,-8.8,39.2,0,805,815,4904
2002,53,f) 5,5858,6027,49327,52742,327,5.2,946,14.9,7713,1642,6071,3.1,14.6,14542,5946,8596,11.3,27.6,-6829,-13,29.2,0,598,598,3517
2002,53,g) 6 to 10,21755,22693,204484,215828,1228,5.2,3189,13.5,29595,8086,21509,3.7,13.7,52283,19102,33181,8.9,24.2,-22688,-10.5,27.4,0,1947,1948,11756
2002,53,h) 11 to 15,14609,16183,207584,214427,831,5,1901,11.4,27572,7998,19574,3.7,12.9,41257,13629,27628,6.4,19.2,-13685,-6.3,25.8,0,992,993,6463
2002,53,i) 16 to 20,10937,13255,216289,220839,621,4.6,1399,10.3,27927,7148,20779,3.2,12.6,37026,11037,25989,5,16.8,-9099,-4.2,25.2,0,620,624,4156
2002,53,j) 21 to 25,8307,11363,205263,211457,631,5.4,1146,9.9,25657,7898,17759,3.7,12.1,38045,11917,26128,5.6,18,-12388,-5.9,24.2,0,428,429,2727
2002,53,l) Left Censored,13263,30484,999480,1010929,2247,7.3,2808,9.1,151430,75791,75639,7.5,15,174327,42868,131459,4.2,17.2,-22897,-2.2,30,0,446,450,4563
2002,54,a) 0,2230,2273,13629,6815,2273,200,0,0,13629,13629,0,200,200,0,0,0,0,0,13629,200,0,0,,,
2002,54,b) 1,1631,1646,11335,11650,13,0.7,468,25,3042,135,2907,1.2,26.1,3671,2192,1479,18.8,31.5,-629,-5.4,52.2,0,341,341,1852
2002,54,c) 2,1564,1608,11662,11768,83,4.8,327,18.9,2828,477,2351,4.1,24,3039,1532,1507,13,25.8,-211,-1.8,48,0,229,229,1130
2002,54,d) 3,1381,1427,11505,11842,84,5.5,266,17.5,2465,778,1687,6.6,20.8,3139,942,2197,8,26.5,-674,-5.7,41.6,0,187,187,688
2002,54,e) 4,1333,1574,13309,13519,95,5.8,223,13.6,2717,918,1799,6.8,20.1,3137,948,2189,7,23.2,-420,-3.1,40.2,0,166,166,783
2002,54,f) 5,1243,1251,8743,8860,66,5,199,15.1,1568,220,1348,2.5,17.7,1802,831,971,9.4,20.3,-234,-2.6,35.4,0,133,133,552
2002,54,g) 6 to 10,4808,4994,44022,44836,257,5,638,12.3,7468,1620,5848,3.6,16.7,9096,2912,6184,6.5,20.3,-1628,-3.6,33.4,0,410,410,1927
2002,54,h) 11 to 15,3708,3993,49846,50445,163,4,418,10.1,7210,1921,5289,3.8,14.3,8408,3256,5152,6.5,16.7,-1198,-2.4,28.6,0,244,244,1965
2002,54,i) 16 to 20,3334,3868,50539,52225,146,3.7,308,7.8,7046,1197,5849,2.3,13.5,10418,6210,4208,11.9,19.9,-3372,-6.4,27,0,160,163,780
2002,54,j) 21 to 25,2428,3467,53774,54248,164,4.6,307,8.7,7180,1506,5674,2.8,13.2,8128,2433,5695,4.5,15,-948,-1.8,26.4,0,107,107,648
2002,54,l) Left Censored,5637,10771,287789,286726,627,5.7,904,8.3,36887,9271,27616,3.2,12.9,34762,9580,25182,3.3,12.1,2125,0.8,24.2,0,214,216,1421
2002,55,a) 0,8301,8419,54999,27500,8419,200,0,0,54999,54999,0,200,200,0,0,0,0,0,54999,200,0,0,,,
2002,55,b) 1,6207,6363,53440,53364,58,0.8,1579,22.2,13805,878,12927,1.6,25.9,13653,7198,6455,13.5,25.6,152,0.3,51.2,0,1088,1088,5599
2002,55,c) 2,5752,5913,45929,47248,248,3.9,1131,17.8,9215,1830,7385,3.9,19.5,11853,5800,6053,12.3,25.1,-2638,-5.6,39,0,759,759,4408
2002,55,d) 3,5191,5505,51338,53049,243,4.2,834,14.4,8534,2142,6392,4,16.1,11956,4850,7106,9.1,22.5,-3422,-6.4,32.2,0,560,560,3094
2002,55,e) 4,4969,5387,52796,53839,259,4.6,707,12.6,9343,2558,6785,4.8,17.4,11429,4134,7295,7.7,21.2,-2086,-3.8,34.8,0,476,476,3254
2002,55,f) 5,4485,4658,37655,39155,158,3.2,596,12.2,5331,753,4578,1.9,13.6,8331,3337,4994,8.5,21.3,-3000,-7.7,27.2,0,395,395,2448
2002,55,g) 6 to 10,17706,18418,178270,182553,717,3.8,2091,10.9,24957,5644,19313,3.1,13.7,33522,12261,21261,6.7,18.4,-8565,-4.7,27.4,0,1262,1262,7069
2002,55,h) 11 to 15,13135,14716,188931,192951,605,4,1434,9.5,23986,6929,17057,3.6,12.4,32025,11168,20857,5.8,16.6,-8039,-4.2,24.8,0,764,765,6246
2002,55,i) 16 to 20,10039,11844,192957,196245,469,3.9,1029,8.5,24606,7955,16651,4.1,12.5,31181,8521,22660,4.3,15.9,-6575,-3.4,25,0,492,496,3489
2002,55,j) 21 to 25,7870,10882,209056,213637,472,4.2,931,8.4,24666,6555,18111,3.1,11.5,33828,9550,24278,4.5,15.8,-9162,-4.3,23,0,359,361,2236
2002,55,l) Left Censored,17852,34652,1289610,1309264,1975,5.6,2861,8.2,136045,41567,94478,3.2,10.4,175352,47223,128129,3.6,13.4,-39307,-3,20.8,0,647,659,6649
2002,56,a) 0,1529,1535,7468,3734,1535,200,0,0,7468,,,,200,0,0,0,0,0,7468,200,0,1,,,
2002,56,b) 1,1034,1045,5710,6137,5,0.4,302,25.3,1276,,,,20.8,2130,1372,758,22.4,34.7,-854,-13.9,41.6,1,192,192,908
2002,56,c) 2,938,954,5656,6083,49,4.8,185,18.1,1038,181,857,3,17.1,1892,876,1016,14.4,31.1,-854,-14,34.2,0,125,125,679
2002,56,d) 3,768,790,5084,5231,38,4.5,130,15.6,975,117,858,2.2,18.6,1268,522,746,10,24.2,-293,-5.6,37.2,0,88,88,392
2002,56,e) 4,778,840,6934,6812,55,6.4,103,11.9,1357,434,923,6.4,19.9,1113,377,736,5.5,16.3,244,3.6,32.6,0,66,66,283
2002,56,f) 5,644,655,4307,4496,32,4.7,86,12.6,649,150,499,3.3,14.4,1027,454,573,10.1,22.8,-378,-8.4,28.8,0,57,57,190
2002,56,g) 6 to 10,2438,2510,19638,20278,128,4.9,350,13.4,3115,633,2482,3.1,15.4,4394,1798,2596,8.9,21.7,-1279,-6.3,30.8,0,221,221,1196
2002,56,h) 11 to 15,1503,1637,21522,21574,81,4.8,157,9.4,3302,1184,2118,5.5,15.3,3406,946,2460,4.4,15.8,-104,-0.5,30.6,0,89,89,595
2002,56,i) 16 to 20,1322,1508,15456,15956,54,3.5,131,8.5,1799,323,1476,2,11.3,2798,609,2189,3.8,17.5,-999,-6.2,22.6,0,64,64,279
2002,56,j) 21 to 25,1208,1520,19194,19436,82,5.3,137,8.9,2681,950,1731,4.9,13.8,3165,809,2356,4.2,16.3,-484,-2.5,27.6,0,57,58,329
2002,56,l) Left Censored,1932,3317,65248,65991,188,5.6,262,7.8,9848,2235,7613,3.4,14.9,11334,5414,5920,8.2,17.2,-1486,-2.3,29.8,0,55,55,334
2003,01,a) 0,6421,6456,42715,21358,6456,200,0,0,42715,42715,0,200,200,0,0,0,0,0,42715,200,0,0,,,
2003,01,b) 1,4707,4792,36871,38242,20,0.4,1511,27,9765,119,9646,0.3,25.5,12506,7721,4785,20.2,32.7,-2741,-7.2,51,0,1253,1253,6448
2003,01,c) 2,4037,4136,35205,36475,190,4.3,801,17.9,8032,1091,6941,3,22,10571,4837,5734,13.3,29,-2539,-7,44,0,660,660,4259
2003,01,d) 3,3640,3785,35441,35359,179,4.5,586,14.6,7263,1041,6222,2.9,20.5,7099,3121,3978,8.8,20.1,164,0.4,40.2,0,461,461,2524
2003,01,e) 4,3573,3750,36525,36822,151,3.8,496,12.6,6211,758,5453,2.1,16.9,6804,2203,4601,6,18.5,-593,-1.6,33.8,0,405,405,1883
2003,01,f) 5,3355,3673,39429,40145,150,3.9,412,10.8,6348,759,5589,1.9,15.8,7780,2713,5067,6.8,19.4,-1432,-3.6,31.6,0,344,344,2353
2003,01,g) 6 to 10,12798,13368,134234,134029,551,4,1389,10,24501,6104,18397,4.6,18.3,24090,8963,15127,6.7,18,411,0.3,36,0,1088,1088,6582
2003,01,h) 11 to 15,8522,9557,136166,136381,363,3.7,752,7.7,20645,3136,17509,2.3,15.1,21075,5148,15927,3.8,15.5,-430,-0.4,30.2,0,560,560,3156
2003,01,i) 16 to 20,7566,9085,168341,168315,259,2.8,521,5.6,19130,3691,15439,2.2,11.4,19077,5609,13468,3.3,11.3,53,0.1,22.6,0,370,370,2956
2003,01,j) 21 to 25,4847,6449,122304,121212,198,3,335,5.1,16512,4961,11551,4.1,13.6,14328,3000,11328,2.5,11.8,2184,1.8,23.6,0,219,221,1437
2003,01,k) 26+,1158,2341,43796,43173,109,4.7,87,3.7,5720,1115,4605,2.6,13.2,4473,735,3738,1.7,10.4,1247,2.8,20.8,0,47,47,166
2003,01,l) Left Censored,9765,23632,757083,757488,1391,5.9,998,4.3,83492,24926,58566,3.3,11,84302,18693,65609,2.5,11.1,-810,-0.1,22,0,351,351,2314
2003,02,a) 0,1251,1264,7772,3886,1264,200,0,0,7772,7772,0,200,200,0,0,0,0,0,7772,200,0,0,,,
2003,02,b) 1,1013,1042,6591,6939,10,0.8,330,27,1908,43,1865,0.6,27.5,2603,1695,908,24.4,37.5,-695,-10,55,0,211,211,1378
2003,02,c) 2,765,779,4755,4823,60,7.3,143,17.3,1041,200,841,4.1,21.6,1177,478,699,9.9,24.4,-136,-2.8,43.2,0,97,97,306
2003,02,d) 3,745,769,5436,5458,59,7.3,128,15.8,1074,190,884,3.5,19.7,1117,562,555,10.3,20.5,-43,-0.8,39.4,0,91,91,417
2003,02,e) 4,624,682,6036,6414,66,9.5,83,11.9,1008,294,714,4.6,15.7,1763,412,1351,6.4,27.5,-755,-11.8,31.4,0,59,59,305
2003,02,f) 5,650,700,6606,6508,41,5.6,86,11.8,1167,166,1001,2.6,17.9,970,285,685,4.4,14.9,197,3,29.8,0,53,53,175
2003,02,g) 6 to 10,2308,2363,18641,18214,150,6.1,282,11.5,3995,832,3163,4.6,21.9,3141,1238,1903,6.8,17.2,854,4.7,34.4,0,195,195,971
2003,02,h) 11 to 15,1521,1618,16710,16897,74,4.5,139,8.4,2158,351,1807,2.1,12.8,2531,718,1813,4.2,15,-373,-2.2,25.6,0,69,69,391
2003,02,i) 16 to 20,1459,1726,24851,24142,78,4.5,98,5.6,3602,487,3115,2,14.9,2184,397,1787,1.6,9,1418,5.9,18,0,56,56,290
2003,02,j) 21 to 25,998,1297,23625,23100,49,3.8,51,3.9,4547,593,3954,2.6,19.7,3497,1328,2169,5.7,15.1,1050,4.6,30.2,0,30,30,455
2003,02,k) 26+,222,476,10162,9951,29,6.1,22,4.7,1788,364,1424,3.7,18,1366,321,1045,3.2,13.7,422,4.3,27.4,0,6,6,19
2003,02,l) Left Censored,1468,3117,88058,88706,210,6.8,147,4.8,10950,3865,7085,4.4,12.3,12245,2086,10159,2.4,13.8,-1295,-1.5,24.6,0,26,26,118
2003,04,a) 0,9741,9806,66864,33432,9806,200,0,0,66864,66864,0,200,200,0,0,0,0,0,66864,200,0,0,,,
2003,04,b) 1,7187,7281,61091,62072,29,0.3,2136,25.3,17132,258,16874,0.4,27.6,19093,11885,7208,19.1,30.8,-1961,-3.2,55.2,0,1704,1704,10046
2003,04,c) 2,6081,6289,52810,52906,335,5,1169,17.3,12431,2285,10146,4.3,23.5,12623,7028,5595,13.3,23.9,-192,-0.4,47,0,947,947,5938
2003,04,d) 3,5249,5446,69712,65925,299,5.2,902,15.6,17174,1765,15409,2.7,26.1,9599,4815,4784,7.3,14.6,7575,11.5,29.2,0,720,720,4047
2003,04,e) 4,4863,5065,70723,69183,246,4.6,750,14,16320,1792,14528,2.6,23.6,13240,6894,6346,10,19.1,3080,4.5,38.2,0,576,576,5925
2003,04,f) 5,4330,4722,58154,58014,241,4.9,569,11.5,10798,2054,8744,3.5,18.6,10517,4124,6393,7.1,18.1,281,0.5,36.2,0,456,456,3416
2003,04,g) 6 to 10,15309,16143,199951,200740,748,4.5,1716,10.3,33796,7904,25892,3.9,16.8,35373,11662,23711,5.8,17.6,-1577,-0.8,33.6,0,1282,1282,9187
2003,04,h) 11 to 15,9264,11017,172010,172069,500,4.4,934,8.3,25941,7515,18426,4.4,15.1,26058,9407,16651,5.5,15.1,-117,0,30.2,0,685,688,6311
2003,04,i) 16 to 20,7398,9557,199281,199182,423,4.3,764,7.8,29746,5960,23786,3,14.9,29547,10989,18558,5.5,14.8,199,0.1,29.6,0,423,429,4832
2003,04,j) 21 to 25,4966,6549,136752,134628,299,4.5,419,6.3,20870,5440,15430,4,15.5,16621,4220,12401,3.1,12.3,4249,3.2,24.6,0,258,258,1946
2003,04,k) 26+,954,2183,80954,82020,139,6.4,118,5.4,13869,2404,11465,2.9,16.9,16001,1653,14348,2,19.5,-2132,-2.6,33.8,0,41,43,340
2003,04,l) Left Censored,7080,21321,793740,795189,1887,9,1329,6.3,119169,43000,76169,5.4,15,122068,29721,92347,3.7,15.4,-2899,-0.4,30,0,215,223,4283
2003,05,a) 0,4362,4374,23886,11943,4374,200,0,0,23886,23886,0,200,200,0,0,0,0,0,23886,200,0,0,,,
2003,05,b) 1,3310,3354,24790,25652,20,0.5,999,25.7,6096,188,5908,0.7,23.8,7819,4976,2843,19.4,30.5,-1723,-6.7,47.6,0,811,811,4126
2003,05,c) 2,2751,2833,18963,19557,131,4.3,488,16.1,3482,486,2996,2.5,17.8,4669,2178,2491,11.1,23.9,-1187,-6.1,35.6,0,404,404,1578
2003,05,d) 3,2443,2525,19921,19967,115,4.3,381,14.2,3805,519,3286,2.6,19.1,3896,1643,2253,8.2,19.5,-91,-0.4,38.2,0,312,312,1440
2003,05,e) 4,2324,2442,18689,18663,121,4.7,319,12.5,3795,530,3265,2.8,20.3,3742,1746,1996,9.4,20.1,53,0.2,40.2,0,256,256,1370
2003,05,f) 5,2081,2354,21780,21820,106,4.3,258,10.6,3707,501,3206,2.3,17,3787,1197,2590,5.5,17.4,-80,-0.4,34,0,194,194,910
2003,05,g) 6 to 10,8173,8484,80150,80879,355,4,849,9.7,12683,2178,10505,2.7,15.7,14140,4594,9546,5.7,17.5,-1457,-1.8,31.4,0,669,669,3487
2003,05,h) 11 to 15,5331,5853,74759,75246,224,3.7,456,7.6,9451,1558,7893,2.1,12.6,10425,3118,7307,4.1,13.9,-974,-1.3,25.2,0,350,350,2163
2003,05,i) 16 to 20,4674,5533,94356,91824,223,4,341,6.1,14475,2415,12060,2.6,15.8,9410,2422,6988,2.6,10.2,5065,5.6,20.4,0,259,259,1954
2003,05,j) 21 to 25,3337,4130,66552,67230,134,3.2,281,6.7,7521,1010,6511,1.5,11.2,8876,1986,6890,3,13.2,-1355,-2,22.4,0,194,194,1106
2003,05,k) 26+,747,1310,34550,34687,47,3.6,52,4,2980,539,2441,1.6,8.6,3253,664,2589,1.9,9.4,-273,-0.8,17.2,0,28,29,161
2003,05,l) Left Censored,6525,14553,503070,503043,958,6.7,539,3.8,48775,14044,34731,2.8,9.7,48721,9487,39234,1.9,9.7,54,0,19.4,0,197,202,1638
2003,06,a) 0,64795,65190,422877,211439,65190,200,0,0,422877,422877,0,200,200,0,0,0,0,0,422877,200,0,0,,,
2003,06,b) 1,48504,49511,406510,419682,196,0.3,13751,24.1,102998,1983,101015,0.5,24.5,129342,72826,56516,17.4,30.8,-26344,-6.3,49,0,10716,10734,61795
2003,06,c) 2,40499,41632,357552,358988,2337,5.2,7910,17.6,85305,14215,71090,4,23.8,88176,41609,46567,11.6,24.6,-2871,-0.8,47.6,0,6232,6232,33634
2003,06,d) 3,35108,36290,346452,364779,1823,4.7,6179,15.9,70663,10817,59846,3,19.4,107316,43433,63883,11.9,29.4,-36653,-10,38.8,0,4902,4902,37136
2003,06,e) 4,31225,32856,341480,348263,1664,4.8,4801,13.8,64601,10589,54012,3,18.5,78166,34376,43790,9.9,22.4,-13565,-3.9,37,0,3729,3750,27006
2003,06,f) 5,28289,31300,360791,374180,1601,4.9,3969,12.1,62047,11333,50714,3,16.6,88825,29010,59815,7.8,23.7,-26778,-7.1,33.2,0,3046,3047,22231
2003,06,g) 6 to 10,98957,103384,1298120,1315122,4787,4.4,12049,11.2,223200,43636,179564,3.3,17,257204,89286,167918,6.8,19.6,-34004,-2.6,34,0,9172,9174,70607
2003,06,h) 11 to 15,72773,81623,1149713,1154521,3752,4.5,7388,8.8,182558,28323,154235,2.5,15.8,192174,62986,129188,5.5,16.6,-9616,-0.8,31.6,0,5143,5148,43184
2003,06,i) 16 to 20,58245,70536,1285110,1285361,3078,4.3,5097,7.1,175768,45289,130479,3.5,13.7,176269,51414,124855,4,13.7,-501,0,27.4,0,3426,3453,29433
2003,06,j) 21 to 25,42721,54247,1093603,1092688,2115,3.8,3633,6.6,143388,31132,112256,2.8,13.1,141557,36759,104798,3.4,13,1831,0.1,26,0,2309,2326,19384
2003,06,k) 26+,8015,16419,447024,446574,861,5.2,946,5.7,63904,12281,51623,2.8,14.3,63003,16962,46041,3.8,14.1,901,0.2,28.2,0,365,377,3286
2003,06,l) Left Censored,55720,143287,5317107,5291543,9653,6.7,9004,6.3,709359,236001,473358,4.5,13.4,658230,163769,494461,3.1,12.4,51129,1,24.8,0,2470,3062,27983
2003,08,a) 0,11590,11662,68108,34054,11662,200,0,0,68108,68108,0,200,200,0,0,0,0,0,68108,200,0,0,,,
2003,08,b) 1,8626,8744,54987,58338,31,0.3,2727,26.7,12738,252,12486,0.4,21.8,19439,12458,6981,21.4,33.3,-6701,-11.5,43.6,0,2011,2011,10630
2003,08,c) 2,7452,7602,54219,56734,418,5.1,1472,17.9,9493,1648,7845,2.9,16.7,14523,6713,7810,11.8,25.6,-5030,-8.9,33.4,0,1168,1168,5734
2003,08,d) 3,6517,6690,53419,55857,345,4.8,1158,16.2,8614,1064,7550,1.9,15.4,13490,6165,7325,11,24.2,-4876,-8.8,30.8,0,867,867,5091
2003,08,e) 4,5775,5997,49077,50797,296,4.7,886,14,8050,1176,6874,2.3,15.8,11490,5410,6080,10.7,22.6,-3440,-6.8,31.6,0,652,652,4499
2003,08,f) 5,5423,5763,53401,53808,314,5.2,740,12.3,9002,2145,6857,4,16.7,9816,3549,6267,6.6,18.2,-814,-1.5,33.4,0,512,513,3022
2003,08,g) 6 to 10,19233,20007,191230,200088,925,4.4,2262,10.9,25892,4655,21237,2.3,12.9,43608,16918,26690,8.5,21.8,-17716,-8.9,25.8,0,1594,1594,13152
2003,08,h) 11 to 15,11480,12704,171361,172790,512,3.9,1133,8.7,24638,4687,19951,2.7,14.3,27495,8570,18925,5,15.9,-2857,-1.6,28.6,0,728,729,5166
2003,08,i) 16 to 20,8536,10448,196100,199436,476,4.5,800,7.5,30344,9138,21206,4.6,15.2,37015,9931,27084,5,18.6,-6671,-3.4,30.4,0,443,444,3569
2003,08,j) 21 to 25,6219,7986,146225,148504,322,4,525,6.5,18512,5975,12537,4,12.5,23070,4455,18615,3,15.5,-4558,-3,25,0,317,320,2291
2003,08,k) 26+,1173,2359,59495,58288,178,7.6,140,6,11579,3424,8155,5.9,19.9,9164,1719,7445,2.9,15.7,2415,4.2,31.4,0,36,39,237
2003,08,l) Left Censored,9278,23191,754465,760782,1758,7.6,1436,6.2,90753,30010,60743,3.9,11.9,103388,33500,69888,4.4,13.6,-12635,-1.7,23.8,0,302,305,3844
2003,09,a) 0,4851,4866,27146,13573,4866,200,0,0,27146,27146,0,200,200,0,0,0,0,0,27146,200,0,0,,,
2003,09,b) 1,4100,4163,32471,33276,24,0.5,1073,22.6,7799,524,7275,1.6,23.4,9408,5710,3698,17.2,28.3,-1609,-4.9,46.8,0,801,801,4998
2003,09,c) 2,3466,3517,27090,27040,143,3.8,621,16.4,5901,797,5104,2.9,21.8,5800,2892,2908,10.7,21.4,101,0.4,42.8,0,488,488,2288
2003,09,d) 3,3269,3384,30440,31277,154,4.3,511,14.3,4775,739,4036,2.4,15.3,6448,2843,3605,9.1,20.6,-1673,-5.3,30.6,0,377,377,2372
2003,09,e) 4,2942,3042,33658,33403,128,4,386,12.1,5873,1080,4793,3.2,17.6,5363,2230,3133,6.7,16.1,510,1.5,32.2,0,301,301,1388
2003,09,f) 5,2958,3200,33660,33571,128,3.9,343,10.3,5807,808,4999,2.4,17.3,5628,1727,3901,5.1,16.8,179,0.5,33.6,0,259,259,1305
2003,09,g) 6 to 10,10995,11226,117116,115914,408,3.5,1159,10,19889,2487,17402,2.1,17.2,17484,5958,11526,5.1,15.1,2405,2.1,30.2,0,838,841,4544
2003,09,h) 11 to 15,8883,9420,125897,125767,311,3.2,720,7.5,16511,1614,14897,1.3,13.1,16251,4122,12129,3.3,12.9,260,0.2,25.8,0,483,483,2826
2003,09,i) 16 to 20,7721,8704,123999,123489,241,2.7,567,6.4,15467,1790,13677,1.4,12.5,14447,3687,10760,3,11.7,1020,0.8,23.4,0,369,372,1984
2003,09,j) 21 to 25,5181,6211,97072,96940,201,3.2,451,7.1,11425,2917,8508,3,11.8,11161,3131,8030,3.2,11.5,264,0.3,23,0,216,216,1188
2003,09,k) 26+,1107,1765,40900,41278,81,4.6,104,5.8,4704,652,4052,1.6,11.4,5460,916,4544,2.2,13.2,-756,-1.8,22.8,0,52,52,258
2003,09,l) Left Censored,12309,22523,856412,864624,1102,4.9,1266,5.6,87178,21144,66034,2.4,10.1,103601,32476,71125,3.8,12,-16423,-1.9,20.2,0,427,427,4550
2003,10,a) 0,1687,1689,9234,4617,1689,200,0,0,9234,9234,0,200,200,0,0,0,0,0,9234,200,0,0,,,
2003,10,b) 1,1245,1270,8523,8712,3,0.2,334,23,2625,9,2616,0.1,30.1,3002,2041,961,23.4,34.5,-377,-4.4,60.2,0,250,250,1800
2003,10,c) 2,1147,1154,6796,6868,50,4,202,16.3,1396,176,1220,2.6,20.3,1539,680,859,9.9,22.4,-143,-2.1,40.6,0,164,164,603
2003,10,d) 3,1074,1090,7701,7523,60,5.2,166,14.4,1898,863,1035,11.5,25.2,1541,686,855,9.1,20.5,357,4.7,41,0,136,136,626
2003,10,e) 4,890,913,7049,7492,43,4.4,134,13.9,1130,287,843,3.8,15.1,2015,1050,965,14,26.9,-885,-11.8,30.2,0,102,102,710
2003,10,f) 5,834,884,7795,7805,43,4.6,121,13.1,1176,141,1035,1.8,15.1,1195,525,670,6.7,15.3,-19,-0.2,30.2,0,89,89,389
2003,10,g) 6 to 10,2941,3062,33163,33247,122,3.9,304,9.6,4570,869,3701,2.6,13.7,4738,1591,3147,4.8,14.3,-168,-0.6,27.4,0,249,249,1229
2003,10,h) 11 to 15,1989,2122,23531,24094,75,3.4,173,7.9,2811,543,2268,2.3,11.7,3936,1447,2489,6,16.3,-1125,-4.6,23.4,0,128,128,709
2003,10,i) 16 to 20,1550,1798,23886,24250,70,3.8,99,5.4,2318,321,1997,1.3,9.6,3046,524,2522,2.2,12.6,-728,-3,19.2,0,65,65,359
2003,10,j) 21 to 25,1052,1240,24745,25335,29,2.3,69,5.5,2481,419,2062,1.7,9.8,3660,948,2712,3.7,14.4,-1179,-4.6,19.6,0,36,36,172
2003,10,k) 26+,285,494,24310,25826,20,4,36,7.1,1911,411,1500,1.6,7.4,4942,674,4268,2.6,19.1,-3031,-11.7,14.8,0,7,9,35
2003,10,l) Left Censored,3075,6156,203553,205776,416,6.8,325,5.3,20145,6196,13949,3,9.8,24591,7796,16795,3.8,12,-4446,-2.2,19.6,0,64,64,1011
2003,11,a) 0,887,895,6386,3193,895,200,0,0,6386,6386,0,200,200,0,0,0,0,0,6386,200,0,0,,,
2003,11,b) 1,921,932,9710,9626,11,1.1,208,19.9,2126,208,1918,2.2,22.1,1958,1047,911,10.9,20.3,168,1.8,40.6,0,166,166,882
2003,11,c) 2,764,777,8163,7992,42,5.1,113,13.8,1489,131,1358,1.6,18.6,1146,462,684,5.8,14.3,343,4.3,28.6,0,85,85,360
2003,11,d) 3,677,691,7033,7369,24,3.3,80,11.1,1225,114,1111,1.5,16.6,1896,1065,831,14.5,25.7,-671,-9.1,33.2,0,67,67,1031
2003,11,e) 4,641,657,8622,8575,24,3.5,79,11.5,1435,204,1231,2.4,16.7,1340,363,977,4.2,15.6,95,1.1,31.2,0,67,67,297
2003,11,f) 5,641,706,9143,8709,48,6.7,58,8.1,2255,1004,1251,11.5,25.9,1387,356,1031,4.1,15.9,868,10,31.8,0,43,43,291
2003,11,g) 6 to 10,2316,2390,30436,29899,99,4,212,8.6,5247,908,4339,3,17.5,4173,1041,3132,3.5,14,1074,3.5,28,0,160,160,823
2003,11,h) 11 to 15,1790,1953,37298,37889,63,3.1,152,7.6,3834,553,3281,1.5,10.1,5015,1331,3684,3.5,13.2,-1181,-3.1,20.2,0,99,99,686
2003,11,i) 16 to 20,1568,1773,28343,28973,71,3.9,119,6.6,3059,629,2430,2.2,10.6,4318,1538,2780,5.3,14.9,-1259,-4.3,21.2,0,74,74,979
2003,11,j) 21 to 25,1245,1454,28687,28868,59,4,88,6,2790,660,2130,2.3,9.7,3152,999,2153,3.5,10.9,-362,-1.2,19.4,0,51,51,722
2003,11,k) 26+,309,531,24042,25846,31,5.9,19,3.6,1971,645,1326,2.5,7.6,5579,280,5299,1.1,21.6,-3608,-14,15.2,0,6,6,56
2003,11,l) Left Censored,3299,5681,229375,226569,366,6.4,365,6.4,27567,7875,19692,3.5,12.2,21954,4745,17209,2.1,9.7,5613,2.5,19.4,0,75,75,345
2003,12,a) 0,42495,42647,251162,125581,42647,200,0,0,251162,251162,0,200,200,0,0,0,0,0,251162,200,0,0,,,
2003,12,b) 1,29183,29569,201934,206019,99,0.3,9382,27.1,60869,6853,54016,3.3,29.5,69039,45072,23967,21.9,33.5,-8170,-4,59,0,7448,7448,38701
2003,12,c) 2,23205,23602,173419,179751,1301,5.1,4702,18.4,45102,6347,38755,3.5,25.1,57766,38589,19177,21.5,32.1,-12664,-7,50.2,0,3716,3717,34940
2003,12,d) 3,19724,20332,175803,167477,1115,5.1,3465,16,54537,7021,47516,4.2,32.6,37884,19450,18434,11.6,22.6,16653,10,45.2,0,2735,2735,15749
2003,12,e) 4,18004,18944,168353,179038,1031,5.2,2833,14.2,40052,6184,33868,3.5,22.4,61421,40080,21341,22.4,34.3,-21369,-11.9,44.8,0,2152,2163,34311
2003,12,f) 5,16010,17279,189352,192574,878,4.8,2333,12.9,38871,6286,32585,3.3,20.2,45317,11304,34013,5.9,23.5,-6446,-3.3,40.4,0,1763,1763,8648
2003,12,g) 6 to 10,58664,61112,691899,688505,2997,4.7,7099,11.2,160648,28646,132002,4.2,23.3,153860,51810,102050,7.5,22.3,6788,1,44.6,0,5351,5359,37005
2003,12,h) 11 to 15,39476,43903,606628,605381,1947,4.3,3920,8.7,109856,21695,88161,3.6,18.1,107362,30302,77060,5,17.7,2494,0.4,35.4,0,2706,2713,16857
2003,12,i) 16 to 20,27367,32756,677381,675979,1387,4.2,2387,7.2,95178,34228,60950,5.1,14.1,92373,28070,64303,4.2,13.7,2805,0.4,27.4,0,1580,1585,15619
2003,12,j) 21 to 25,17376,21970,415085,408395,907,4.1,1475,6.6,66968,24819,42149,6.1,16.4,53587,14274,39313,3.5,13.1,13381,3.3,26.2,0,960,966,7181
2003,12,k) 26+,3210,7057,159066,159397,451,6.4,495,7,25197,6456,18741,4.1,15.8,25859,6691,19168,4.2,16.2,-662,-0.4,31.6,0,177,194,1507
2003,12,l) Left Censored,23637,74860,2684464,2691345,5646,7.6,4523,6.1,338739,125559,213180,4.7,12.6,352503,115367,237136,4.3,13.1,-13764,-0.5,25.2,0,1004,1021,9360
2003,13,a) 0,16072,16135,102071,51036,16135,200,0,0,102071,102071,0,200,200,0,0,0,0,0,102071,200,0,0,,,
2003,13,b) 1,11938,12149,93645,99774,60,0.4,3765,26.5,22564,1113,21451,1.1,22.6,34822,21178,13644,21.2,34.9,-12258,-12.3,45.2,0,2907,2911,18512
2003,13,c) 2,9881,10127,80610,81537,474,4.3,1925,17.6,18281,1802,16479,2.2,22.4,20135,11429,8706,14,24.7,-1854,-2.3,44.8,0,1533,1533,9639
2003,13,d) 3,8933,9324,78446,83230,627,6.4,1499,15.2,16242,3459,12783,4.2,19.5,25809,8013,17796,9.6,31,-9567,-11.5,39,0,1160,1160,6766
2003,13,e) 4,8135,8522,84533,86522,431,4.8,1283,14.2,14619,2533,12086,2.9,16.9,18597,6268,12329,7.2,21.5,-3978,-4.6,33.8,0,967,967,4913
2003,13,f) 5,7550,8138,87636,86933,426,5,973,11.5,15746,3427,12319,3.9,18.1,14339,5452,8887,6.3,16.5,1407,1.6,33,0,739,739,4049
2003,13,g) 6 to 10,26314,27519,318224,321392,1308,4.6,2914,10.2,54109,11189,42920,3.5,16.8,60444,21328,39116,6.6,18.8,-6335,-2,33.6,0,2188,2190,15115
2003,13,h) 11 to 15,16077,18394,268809,267978,792,4.2,1431,7.6,40972,7707,33265,2.9,15.3,39310,12093,27217,4.5,14.7,1662,0.6,29.4,0,950,951,6640
2003,13,i) 16 to 20,13003,15575,282179,282282,628,4,1081,6.8,36753,7988,28765,2.8,13,36959,9390,27569,3.3,13.1,-206,-0.1,26,0,666,667,5770
2003,13,j) 21 to 25,8272,11051,231155,229859,420,3.8,622,5.6,28084,7891,20193,3.4,12.2,25491,6079,19412,2.6,11.1,2593,1.1,22.2,0,384,387,2515
2003,13,k) 26+,1817,3774,98455,98462,264,7,205,5.5,13418,3371,10047,3.4,13.6,13431,3438,9993,3.5,13.6,-13,0,27.2,0,63,66,378
2003,13,l) Left Censored,15264,42909,1625031,1639424,3148,7.4,2429,5.7,182979,63280,119699,3.9,11.2,211765,49032,162733,3,12.9,-28786,-1.7,22.4,0,550,551,4338
2003,15,a) 0,1943,2029,14168,7084,2029,200,0,0,14168,14168,0,200,200,0,0,0,0,0,14168,200,0,0,,,
2003,15,b) 1,1551,1587,12357,12538,8,0.4,397,22.1,3263,76,3187,0.6,26,3624,2399,1225,19.1,28.9,-361,-2.9,52,0,329,329,2268
2003,15,c) 2,1249,1272,10477,10617,52,3.8,207,15.2,2258,226,2032,2.1,21.3,2537,1621,916,15.3,23.9,-279,-2.6,42.6,0,166,166,1368
2003,15,d) 3,1148,1197,10440,10408,49,3.9,152,12.1,2285,222,2063,2.1,22,2220,1245,975,12,21.3,65,0.7,42.6,0,124,124,1173
2003,15,e) 4,972,1009,10567,10158,46,4.4,105,10.1,2441,903,1538,8.9,24,1622,806,816,7.9,16,819,8,32,0,80,80,668
2003,15,f) 5,951,1038,10309,10518,53,4.9,109,10.2,1464,244,1220,2.3,13.9,1881,931,950,8.9,17.9,-417,-4,27.8,0,89,89,895
2003,15,g) 6 to 10,3549,3653,45853,45328,151,4,353,9.4,6542,736,5806,1.6,14.4,5492,2735,2757,6,12.1,1050,2.3,24.2,0,273,273,1884
2003,15,h) 11 to 15,2853,3217,38200,37770,144,4.4,199,6.1,5076,710,4366,1.9,13.4,4215,1316,2899,3.5,11.2,861,2.2,22.4,0,130,130,808
2003,15,i) 16 to 20,2290,2698,44171,43461,82,3,158,5.8,5829,1103,4726,2.5,13.4,4409,1493,2916,3.4,10.1,1420,3.3,20.2,0,98,98,718
2003,15,j) 21 to 25,2033,2530,39939,39402,92,3.6,128,5,4885,1086,3799,2.8,12.4,3810,819,2991,2.1,9.7,1075,2.7,19.4,0,73,73,429
2003,15,k) 26+,415,790,11361,11402,19,2.4,31,3.9,1212,64,1148,0.6,10.6,1293,271,1022,2.4,11.3,-81,-0.7,21.2,0,10,10,31
2003,15,l) Left Censored,3527,7037,210532,208589,331,4.7,308,4.4,21968,4452,17516,2.1,10.5,18082,4452,13630,2.1,8.7,3886,1.8,17.4,0,98,98,553
2003,16,a) 0,3178,3207,16121,8061,3207,200,0,0,16121,16121,0,200,200,0,0,0,0,0,16121,200,0,0,,,
2003,16,b) 1,2286,2326,19063,19254,10,0.4,644,24,4172,400,3772,2.1,21.7,4554,2983,1571,15.5,23.7,-382,-2,43.4,0,488,488,2404
2003,16,c) 2,1980,2027,14782,14350,137,6.4,355,16.5,3724,706,3018,4.9,26,2860,1374,1486,9.6,19.9,864,6.1,39.8,0,274,274,1130
2003,16,d) 3,1787,1845,16683,17325,89,4.5,292,14.9,2344,294,2050,1.7,13.5,3628,1362,2266,7.9,20.9,-1284,-7.4,27,0,208,219,1022
2003,16,e) 4,1639,1686,12483,12806,82,4.7,193,11,2146,277,1869,2.2,16.8,2792,852,1940,6.7,21.8,-646,-5,33.6,0,140,140,611
2003,16,f) 5,1461,1593,16402,15633,92,5.6,174,10.6,4064,472,3592,3,26,2525,855,1670,5.5,16.2,1539,9.8,32.4,0,127,127,738
2003,16,g) 6 to 10,5403,5570,47943,49117,327,5.7,622,10.8,7363,1551,5812,3.2,15,9711,2887,6824,5.9,19.8,-2348,-4.8,30,0,448,448,2219
2003,16,h) 11 to 15,3173,3428,37780,37946,185,5.3,291,8.3,4903,900,4003,2.4,12.9,5235,1524,3711,4,13.8,-332,-0.9,25.8,0,190,190,1004
2003,16,i) 16 to 20,2317,2759,39500,38761,139,5,207,7.4,6346,1301,5045,3.4,16.4,4867,1364,3503,3.5,12.6,1479,3.8,25.2,0,136,136,865
2003,16,j) 21 to 25,1745,2197,42110,42713,79,3.6,122,5.5,4294,1231,3063,2.9,10.1,5500,980,4520,2.3,12.9,-1206,-2.8,20.2,0,69,69,535
2003,16,k) 26+,372,643,14380,14871,38,5.9,37,5.7,1367,495,872,3.3,9.2,2348,666,1682,4.5,15.8,-981,-6.6,18.4,0,15,15,61
2003,16,l) Left Censored,3206,6778,187792,185859,420,6.2,336,5,22324,4943,17381,2.7,12,18457,4783,13674,2.6,9.9,3867,2.1,19.8,0,103,103,1026
2003,17,a) 0,18844,19018,120650,60325,19018,200,0,0,120650,120650,0,200,200,0,0,0,0,0,120650,200,0,0,,,
2003,17,b) 1,14350,14571,117418,122154,51,0.3,3796,22.9,28595,396,28199,0.3,23.4,38066,22608,15458,18.5,31.2,-9471,-7.8,46.8,0,2784,2784,18749
2003,17,c) 2,12246,12550,97354,98904,641,4.8,2179,16.2,19909,2927,16982,3,20.1,23009,11334,11675,11.5,23.3,-3100,-3.2,40.2,0,1638,1638,8768
2003,17,d) 3,11405,11748,107510,109215,509,4.1,1740,14,19343,1903,17440,1.7,17.7,22752,9618,13134,8.8,20.8,-3409,-3.1,35.4,0,1308,1308,7496
2003,17,e) 4,10480,10993,123884,121394,447,3.9,1426,12.4,25185,2448,22737,2,20.7,20205,7630,12575,6.3,16.6,4980,4.1,33.2,0,1054,1054,5867
2003,17,f) 5,10116,10885,114238,115308,480,4.2,1218,10.8,20008,3262,16746,2.8,17.4,22148,7238,14910,6.3,19.2,-2140,-1.8,34.8,0,892,892,5850
2003,17,g) 6 to 10,39005,40532,425869,432020,1553,3.7,4109,9.8,67915,11214,56701,2.6,15.7,80216,29655,50561,6.9,18.6,-12301,-2.9,31.4,0,2962,2962,20656
2003,17,h) 11 to 15,27769,30387,424384,424577,1065,3.4,2400,7.7,64984,9175,55809,2.2,15.3,65369,23060,42309,5.4,15.4,-385,-0.1,30.6,0,1599,1600,16846
2003,17,i) 16 to 20,22441,26320,488865,487664,813,3,1710,6.4,58031,7997,50034,1.6,11.9,55628,12432,43196,2.5,11.4,2403,0.5,22.8,0,1098,1176,7320
2003,17,j) 21 to 25,16049,19351,377816,378833,595,3,1192,6.1,44728,9654,35074,2.5,11.8,46761,9852,36909,2.6,12.3,-2033,-0.5,23.6,0,758,760,5492
2003,17,k) 26+,3506,6627,158514,161059,305,4.6,334,5,17322,4954,12368,3.1,10.8,22411,3870,18541,2.4,13.9,-5089,-3.1,21.6,0,122,122,708
2003,17,l) Left Censored,33953,71763,2635974,2648176,4392,6.1,3927,5.5,278233,86522,191711,3.3,10.5,302637,80538,222099,3,11.4,-24404,-0.9,21,0,1293,1308,12788
2003,18,a) 0,8456,8531,57122,28561,8531,200,0,0,57122,57122,0,200,200,0,0,0,0,0,57122,200,0,0,,,
2003,18,b) 1,6824,6916,55415,58854,20,0.3,1947,24.5,12675,166,12509,0.3,21.5,19553,12414,7139,21.1,33.2,-6878,-11.7,43,0,1536,1536,10875
2003,18,c) 2,5586,5834,46459,46243,293,4.7,975,15.7,10418,1766,8652,3.8,22.5,9986,4506,5480,9.7,21.6,432,0.9,43.2,0,758,758,3683
2003,18,d) 3,5175,5355,48474,48366,226,4,792,14,9480,1100,8380,2.3,19.6,9263,3767,5496,7.8,19.2,217,0.4,38.4,0,576,576,2964
2003,18,e) 4,4745,4988,51723,50880,226,4.3,648,12.4,10929,1263,9666,2.5,21.5,9243,3845,5398,7.6,18.2,1686,3.3,36.4,0,513,513,3410
2003,18,f) 5,4631,5216,60009,60498,233,4.3,561,10.4,11728,2728,9000,4.5,19.4,12705,5512,7193,9.1,21,-977,-1.6,38.8,0,431,431,4807
2003,18,g) 6 to 10,17929,18742,199318,198160,746,3.8,1855,9.6,32378,6084,26294,3.1,16.3,30061,10696,19365,5.4,15.2,2317,1.1,30.4,0,1377,1377,7716
2003,18,h) 11 to 15,12874,14444,201895,203747,492,3.3,1164,7.8,28247,5297,22950,2.6,13.9,31951,11239,20712,5.5,15.7,-3704,-1.8,27.8,0,805,806,4790
2003,18,i) 16 to 20,10932,13206,215995,216747,448,3.3,816,6.1,28186,4713,23473,2.2,13,29690,7501,22189,3.5,13.7,-1504,-0.7,26,0,477,536,4203
2003,18,j) 21 to 25,7271,8855,161509,158465,258,2.9,449,5,22832,3671,19161,2.3,14.4,16744,4031,12713,2.5,10.6,6088,3.8,21.2,0,299,299,2615
2003,18,k) 26+,1692,3404,87329,86906,115,3.4,150,4.4,9644,1769,7875,2,11.1,8797,1545,7252,1.8,10.1,847,1,20.2,0,64,72,405
2003,18,l) Left Censored,16686,37712,1351752,1349822,1911,5.1,1588,4.2,145679,41260,104419,3.1,10.8,141820,35340,106480,2.6,10.5,3859,0.3,21,0,536,539,5926
2003,19,a) 0,4348,4405,26927,13464,4405,200,0,0,26927,26927,0,200,200,0,0,0,0,0,26927,200,0,0,,,
2003,19,b) 1,3367,3457,24028,26305,10,0.3,930,23.5,4642,35,4607,0.1,17.6,9196,6473,2723,24.6,35,-4554,-17.4,35.2,0,689,689,5444
2003,19,c) 2,2798,2858,19715,20558,132,4.3,472,15.5,3148,373,2775,1.8,15.3,4834,2498,2336,12.2,23.5,-1686,-8.2,30.6,0,360,360,2133
2003,19,d) 3,2723,2800,24514,24572,134,4.5,427,14.4,4395,488,3907,2,17.9,4511,2182,2329,8.9,18.4,-116,-0.5,35.8,0,324,324,1793
2003,19,e) 4,2441,2618,22837,23349,107,3.9,340,12.4,3012,459,2553,2,12.9,4036,1560,2476,6.7,17.3,-1024,-4.4,25.8,0,243,243,1157
2003,19,f) 5,2338,2507,21214,20981,115,4.4,275,10.6,3790,754,3036,3.6,18.1,3324,1205,2119,5.7,15.8,466,2.3,31.6,0,206,206,932
2003,19,g) 6 to 10,9542,9892,85925,87517,370,3.6,929,9.1,11637,2039,9598,2.3,13.3,14821,5180,9641,5.9,16.9,-3184,-3.6,26.6,0,677,677,3919
2003,19,h) 11 to 15,6706,7296,85620,86585,276,3.7,613,8.2,12396,2025,10371,2.3,14.3,14325,5384,8941,6.2,16.5,-1929,-2.2,28.6,0,432,432,2935
2003,19,i) 16 to 20,5918,7212,122569,124321,213,2.9,365,5,10826,1626,9200,1.3,8.7,14330,2984,11346,2.4,11.5,-3504,-2.8,17.4,0,228,229,1469
2003,19,j) 21 to 25,4718,6073,84003,85054,192,3.1,304,5,9026,2242,6784,2.6,10.6,11128,2132,8996,2.5,13.1,-2102,-2.5,21.2,0,198,198,1585
2003,19,k) 26+,1138,2203,38329,38759,98,4.4,107,4.8,3435,669,2766,1.7,8.9,4295,1367,2928,3.5,11.1,-860,-2.2,17.8,0,41,41,267
2003,19,l) Left Censored,11279,21345,671485,669371,1033,4.8,1068,5,65564,19571,45993,2.9,9.8,61335,10264,51071,1.5,9.2,4229,0.6,18.4,0,353,354,2829
2003,20,a) 0,4616,4634,27934,13967,4634,200,0,0,27934,27934,0,200,200,0,0,0,0,0,27934,200,0,0,,,
2003,20,b) 1,3553,3616,27849,29324,8,0.2,1043,24.9,5845,115,5730,0.4,19.9,8794,5294,3500,18.1,30,-2949,-10.1,39.8,0,818,818,4235
2003,20,c) 2,3016,3070,23137,24193,123,3.7,567,17.1,4065,454,3611,1.9,16.8,6176,3044,3132,12.6,25.5,-2111,-8.7,33.6,0,439,439,2493
2003,20,d) 3,2766,2822,25373,25608,117,3.9,450,15,4469,682,3787,2.7,17.5,4939,2189,2750,8.5,19.3,-470,-1.8,35,0,362,362,1667
2003,20,e) 4,2529,2667,22025,22156,126,4.5,343,12.3,3893,776,3117,3.5,17.6,4154,1468,2686,6.6,18.7,-261,-1.1,35.2,0,252,252,1116
2003,20,f) 5,2487,2739,25917,26578,116,4.1,290,10.2,3737,649,3088,2.4,14.1,5059,1991,3068,7.5,19,-1322,-4.9,28.2,0,220,220,1034
2003,20,g) 6 to 10,9017,9422,90910,91246,407,4.2,932,9.6,15061,4958,10103,5.4,16.5,15732,4831,10901,5.3,17.2,-671,-0.7,33,0,709,710,3852
2003,20,h) 11 to 15,6211,6912,86280,86579,245,3.5,561,7.9,11791,2140,9651,2.5,13.6,12388,4933,7455,5.7,14.3,-597,-0.7,27.2,0,401,401,3257
2003,20,i) 16 to 20,5407,6287,87706,88159,239,3.7,419,6.6,10525,2490,8035,2.8,11.9,11430,2925,8505,3.3,13,-905,-1.1,23.8,0,276,276,1719
2003,20,j) 21 to 25,4158,5012,73894,72896,188,3.7,271,5.3,10630,3585,7045,4.9,14.6,8634,1960,6674,2.7,11.8,1996,2.8,23.6,0,180,181,1050
2003,20,k) 26+,935,1906,34726,34803,89,4.6,105,5.5,3735,714,3021,2.1,10.7,3889,1418,2471,4.1,11.2,-154,-0.5,21.4,0,38,47,219
2003,20,l) Left Censored,9101,18295,577826,575696,949,5.2,871,4.8,63862,23620,40242,4.1,11.1,59601,14984,44617,2.6,10.4,4261,0.7,20.8,0,320,320,2841
2003,21,a) 0,5299,5329,34292,17146,5329,200,0,0,34292,34292,0,200,200,0,0,0,0,0,34292,200,0,0,,,
2003,21,b) 1,4187,4253,33939,36177,22,0.5,1173,24,8163,269,7894,0.7,22.6,12638,7823,4815,21.6,34.9,-4475,-12.3,45.2,0,939,939,5646
2003,21,c) 2,3659,3730,28654,29849,168,4.2,638,16,6048,722,5326,2.4,20.3,8438,3685,4753,12.3,28.3,-2390,-8,40.6,0,542,542,3397
2003,21,d) 3,3286,3403,28975,30022,118,3.2,544,15,5197,522,4675,1.7,17.3,7291,3815,3476,12.7,24.3,-2094,-7,34.6,0,445,445,3428
2003,21,e) 4,3164,3387,35703,35841,128,3.6,408,11.5,5810,821,4989,2.3,16.2,6086,2142,3944,6,17,-276,-0.8,32.4,0,326,326,1548
2003,21,f) 5,2969,3264,30197,31223,134,3.9,391,11.5,5001,927,4074,3,16,7052,2480,4572,7.9,22.6,-2051,-6.6,32,0,294,294,1799
2003,21,g) 6 to 10,11159,11758,122929,123632,450,3.7,1188,9.8,19901,3142,16759,2.5,16.1,21307,7131,14176,5.8,17.2,-1406,-1.1,32.2,0,896,898,5777
2003,21,h) 11 to 15,8071,9016,117755,118728,285,3.1,704,7.6,17817,4227,13590,3.6,15,19762,5435,14327,4.6,16.6,-1945,-1.6,30,0,469,501,2993
2003,21,i) 16 to 20,6920,8140,131088,131590,262,3.2,480,5.8,15187,1934,13253,1.5,11.5,16190,4427,11763,3.4,12.3,-1003,-0.8,23,0,335,337,2560
2003,21,j) 21 to 25,4362,5434,100899,101228,142,2.6,325,5.9,11142,1827,9315,1.8,11,11800,3508,8292,3.5,11.7,-658,-0.7,22,0,216,216,1521
2003,21,k) 26+,1035,2177,52645,52698,89,4.1,94,4.3,6191,917,5274,1.7,11.7,6296,1115,5181,2.1,11.9,-105,-0.2,23.4,0,32,32,114
2003,21,l) Left Censored,9940,22437,758677,756337,1257,5.6,938,4.2,77143,25323,51820,3.3,10.2,72463,15267,57196,2,9.6,4680,0.6,19.2,0,326,328,2809
2003,22,a) 0,6308,6350,44744,22372,6350,200,0,0,44744,44744,0,200,200,0,0,0,0,0,44744,200,0,0,,,
2003,22,b) 1,4889,4970,45552,46231,18,0.3,1418,24.7,11820,183,11637,0.4,25.6,13178,8357,4821,18.1,28.5,-1358,-2.9,51.2,0,1162,1162,7529
2003,22,c) 2,4197,4297,45218,42918,184,4,720,15.7,12767,853,11914,2,29.7,8167,3403,4764,7.9,19,4600,10.7,38,0,595,595,2974
2003,22,d) 3,3719,3857,46415,46537,147,3.6,558,13.6,8102,1447,6655,3.1,17.4,8346,2812,5534,6,17.9,-244,-0.5,34.8,0,463,463,2472
2003,22,e) 4,3408,3559,34269,34257,167,4.5,460,12.4,6345,1149,5196,3.4,18.5,6321,2755,3566,8,18.5,24,0,37,0,354,354,2024
2003,22,f) 5,3402,3743,40012,41319,153,3.9,404,10.4,6790,1077,5713,2.6,16.4,9404,3738,5666,9,22.8,-2614,-6.4,32.8,0,319,319,3036
2003,22,g) 6 to 10,12920,13333,156511,158339,522,3.8,1246,9.1,25966,3582,22384,2.3,16.4,29621,12411,17210,7.8,18.7,-3655,-2.3,32.8,0,964,966,10303
2003,22,h) 11 to 15,8555,9667,131728,132454,356,3.6,688,7,19742,2144,17598,1.6,14.9,21193,5083,16110,3.8,16,-1451,-1.1,29.8,0,487,488,2712
2003,22,i) 16 to 20,7772,9199,143916,142942,290,3.1,526,5.6,18043,2262,15781,1.6,12.6,16095,3505,12590,2.5,11.3,1948,1.3,22.6,0,378,379,2425
2003,22,j) 21 to 25,6287,7826,137476,134628,226,2.8,415,5.2,19976,3581,16395,2.7,14.8,14280,2479,11801,1.8,10.6,5696,4.2,21.2,0,277,278,1340
2003,22,k) 26+,1180,2208,42893,42531,97,4.4,78,3.5,5654,893,4761,2.1,13.3,4929,864,4065,2,11.6,725,1.7,23.2,0,42,43,231
2003,22,l) Left Censored,10842,23853,719215,719803,1333,5.6,1039,4.4,75261,23396,51865,3.3,10.5,76436,17012,59424,2.4,10.6,-1175,-0.1,21,0,358,359,2951
2003,23,a) 0,2488,2504,13984,6992,2504,200,0,0,13984,,,,200,0,0,0,0,0,13984,200,0,1,,,
2003,23,b) 1,2006,2026,12328,13408,4,0.2,574,24.6,2631,,,,19.6,4791,3036,1755,22.6,35.7,-2160,-16.1,39.2,1,411,411,2527
2003,23,c) 2,1812,1842,11225,11326,88,4.5,265,13.6,2014,242,1772,2.1,17.8,2216,974,1242,8.6,19.6,-202,-1.8,35.6,0,191,191,707
2003,23,d) 3,1588,1649,12344,12172,84,4.9,226,13.1,2303,675,1628,5.5,18.9,1959,982,977,8.1,16.1,344,2.8,32.2,0,170,171,884
2003,23,e) 4,1543,1581,10862,11205,72,4.4,183,11.1,1557,370,1187,3.3,13.9,2243,785,1458,7,20,-686,-6.1,27.8,0,137,137,620
2003,23,f) 5,1432,1622,13785,13745,66,3.9,190,11.2,1867,233,1634,1.7,13.6,1787,728,1059,5.3,13,80,0.6,26,0,135,135,607
2003,23,g) 6 to 10,5160,5282,41826,42116,214,3.9,490,9,6193,1104,5089,2.6,14.7,6773,2520,4253,6,16.1,-580,-1.4,29.4,0,348,348,2018
2003,23,h) 11 to 15,3715,3985,36792,37034,149,3.7,277,6.8,4419,615,3804,1.7,11.9,4902,1154,3748,3.1,13.2,-483,-1.3,23.8,0,185,185,759
2003,23,i) 16 to 20,3074,3590,46925,47412,149,4.1,230,6.3,4391,648,3743,1.4,9.3,5365,1301,4064,2.7,11.3,-974,-2,18.6,0,154,154,975
2003,23,j) 21 to 25,1964,2465,40327,40996,98,3.9,137,5.5,3686,852,2834,2.1,9,5024,1372,3652,3.3,12.3,-1338,-3.3,18,0,69,69,751
2003,23,k) 26+,441,990,20218,20410,61,6.2,33,3.4,1968,342,1626,1.7,9.6,2352,388,1964,1.9,11.5,-384,-1.9,19.2,0,13,15,198
2003,23,l) Left Censored,3989,7483,221144,221958,351,4.7,363,4.8,23084,6312,16772,2.8,10.4,24711,7068,17643,3.2,11.1,-1627,-0.7,20.8,0,114,114,826
2003,24,a) 0,8726,8769,57381,28691,8769,200,0,0,57381,57381,0,200,200,0,0,0,0,0,57381,200,0,0,,,
2003,24,b) 1,6961,7043,56541,58183,14,0.2,1870,23.2,12575,83,12492,0.1,21.6,15859,9634,6225,16.6,27.3,-3284,-5.7,43.2,0,1408,1408,7944
2003,24,c) 2,5788,5878,44476,44988,268,4.3,954,15.2,9998,1281,8717,2.8,22.2,11021,5222,5799,11.6,24.5,-1023,-2.3,44.4,0,726,726,4352
2003,24,d) 3,5171,5364,45108,44966,256,4.6,690,12.3,8582,1623,6959,3.6,19.1,8298,3703,4595,8.2,18.5,284,0.6,37,0,514,514,2861
2003,24,e) 4,4801,5054,52021,53092,272,5.2,654,12.4,9221,2128,7093,4,17.4,11362,3574,7788,6.7,21.4,-2141,-4,34.8,0,492,492,3003
2003,24,f) 5,4526,4909,48842,48953,215,4.2,498,9.8,8978,2797,6181,5.7,18.3,9199,3222,5977,6.6,18.8,-221,-0.5,36.6,0,353,353,2161
2003,24,g) 6 to 10,16921,17459,188300,189673,711,3.9,1702,9.4,27917,3949,23968,2.1,14.7,30662,9614,21048,5.1,16.2,-2745,-1.5,29.4,0,1235,1235,7630
2003,24,h) 11 to 15,12342,13709,192136,192285,593,4.2,1036,7.4,29390,6722,22668,3.5,15.3,29687,8356,21331,4.3,15.4,-297,-0.1,30.6,0,665,666,4580
2003,24,i) 16 to 20,9666,11167,180156,179710,395,3.5,700,6.2,22918,3788,19130,2.1,12.8,22026,6534,15492,3.6,12.3,892,0.5,24.6,0,462,462,3652
2003,24,j) 21 to 25,6000,7412,141003,137650,256,3.4,391,5.2,21695,4203,17492,3.1,15.8,14988,3499,11489,2.5,10.9,6707,4.9,21.8,0,232,232,1529
2003,24,k) 26+,1336,2570,67219,67267,110,4.3,130,5,7173,1720,5453,2.6,10.7,7268,1712,5556,2.5,10.8,-95,-0.1,21.4,0,39,39,378
2003,24,l) Left Censored,12516,28336,1004290,1004973,1718,6.1,1365,4.8,111678,31740,79938,3.2,11.1,113044,24277,88767,2.4,11.2,-1366,-0.1,22.2,0,373,373,3261
2003,25,a) 0,11816,11876,62263,31132,11876,200,0,0,62263,62263,0,200,200,0,0,0,0,0,62263,200,0,0,,,
2003,25,b) 1,8416,8509,66026,67954,23,0.2,2147,22.2,15117,609,14508,0.9,22.2,18972,10988,7984,16.2,27.9,-3855,-5.7,44.4,0,1600,1600,9213
2003,25,c) 2,7381,7522,58877,59962,292,3.6,1282,15.9,10592,1172,9420,2,17.7,12762,6128,6634,10.2,21.3,-2170,-3.6,35.4,0,1017,1017,5296
2003,25,d) 3,6721,6953,54298,55634,304,4.1,1053,14.3,9267,1542,7725,2.8,16.7,11939,5030,6909,9,21.5,-2672,-4.8,33.4,0,805,805,4256
2003,25,e) 4,6757,7013,59688,60486,285,3.9,947,12.8,10518,2434,8084,4,17.4,12113,5230,6883,8.6,20,-1595,-2.6,34.8,0,706,706,4115
2003,25,f) 5,5644,6062,62950,63774,280,4.4,695,11,10915,1953,8962,3.1,17.1,12562,5053,7509,7.9,19.7,-1647,-2.6,34.2,0,524,524,4199
2003,25,g) 6 to 10,21428,21954,225623,230663,828,3.6,2150,9.5,32439,4467,27972,1.9,14.1,42519,13861,28658,6,18.4,-10080,-4.3,28.2,0,1597,1597,11488
2003,25,h) 11 to 15,15187,16713,233551,238029,587,3.4,1251,7.3,28049,4848,23201,2,11.8,37005,12327,24678,5.2,15.5,-8956,-3.7,23.6,0,814,814,7492
2003,25,i) 16 to 20,13705,16086,270281,272984,595,3.6,980,6,34073,7954,26119,2.9,12.5,39479,10447,29032,3.8,14.5,-5406,-2,25,0,612,625,4636
2003,25,j) 21 to 25,8897,10914,242734,242378,329,3,571,5.2,25891,5718,20173,2.4,10.7,25179,6305,18874,2.6,10.4,712,0.3,20.8,0,362,363,2614
2003,25,k) 26+,1901,3527,115097,114836,164,4.6,182,5.1,14350,4251,10099,3.7,12.5,13828,1678,12150,1.5,12,522,0.5,24,0,65,65,487
2003,25,l) Left Censored,20811,40284,1512491,1521585,2213,5.5,2493,6.2,169995,45849,124146,3,11.2,188183,58899,129284,3.9,12.4,-18188,-1.2,22.4,0,717,720,6449
2003,26,a) 0,13859,13969,102874,51437,13969,200,0,0,102874,102874,0,200,200,0,0,0,0,0,102874,200,0,0,,,
2003,26,b) 1,11078,11259,103307,106875,41,0.3,3251,25,24941,458,24483,0.4,23.3,32077,18277,13800,17.1,30,-7136,-6.7,46.6,0,2472,2472,15694
2003,26,c) 2,9138,9381,79332,86376,522,5.2,1726,17.2,16494,1791,14703,2.1,19.1,30581,16202,14379,18.8,35.4,-14087,-16.3,38.2,0,1322,1323,14753
2003,26,d) 3,8435,8701,78051,80889,420,4.6,1383,15,14026,1955,12071,2.4,17.3,19702,9312,10390,11.5,24.4,-5676,-7.1,34.6,0,1038,1038,8072
2003,26,e) 4,7854,8298,81461,84557,441,5.1,1135,13,14782,3398,11384,4,17.5,20974,8289,12685,9.8,24.8,-6192,-7.3,35,0,849,849,5883
2003,26,f) 5,7523,8221,86453,86847,393,4.6,1040,12.1,16638,2809,13829,3.2,19.2,17426,7943,9483,9.1,20.1,-788,-0.9,38.4,0,770,770,6494
2003,26,g) 6 to 10,29918,31063,315765,319915,1270,3.9,3322,10.3,51800,7926,43874,2.5,16.2,60099,23342,36757,7.3,18.8,-8299,-2.6,32.4,0,2363,2363,18999
2003,26,h) 11 to 15,21031,23472,308011,307542,855,3.6,1909,7.9,47902,8489,39413,2.8,15.6,46966,14383,32583,4.7,15.3,936,0.3,30.6,0,1259,1259,9022
2003,26,i) 16 to 20,17426,20627,332415,334999,651,3.1,1444,6.9,40084,8658,31426,2.6,12,45251,13137,32114,3.9,13.5,-5167,-1.5,24,0,817,925,6845
2003,26,j) 21 to 25,11913,14640,248471,251503,432,2.9,837,5.6,30099,6350,23749,2.5,12,36162,9493,26669,3.8,14.4,-6063,-2.4,24,0,501,501,4330
2003,26,k) 26+,2504,4505,93918,96933,225,5,243,5.4,13052,2569,10483,2.7,13.5,19082,3081,16001,3.2,19.7,-6030,-6.2,27,0,95,95,680
2003,26,l) Left Censored,24261,53942,2015094,2023526,2890,5.4,2761,5.1,222861,72883,149978,3.6,11,239725,44985,194740,2.2,11.8,-16864,-0.8,22,0,825,835,8514
2003,27,a) 0,9280,9311,56601,28301,9311,200,0,0,56601,56601,0,200,200,0,0,0,0,0,56601,200,0,0,,,
2003,27,b) 1,7101,7226,60400,62227,36,0.4,1864,22.6,12981,637,12344,1,20.9,16634,10384,6250,16.7,26.7,-3653,-5.8,41.8,0,1240,1240,8704
2003,27,c) 2,6050,6161,48581,47513,285,4.3,965,14.7,10826,2744,8082,5.8,22.8,8689,3734,4955,7.9,18.3,2137,4.5,36.6,0,694,694,2950
2003,27,d) 3,5478,5624,48536,48990,287,4.9,775,13.1,8932,1454,7478,3,18.2,9839,3513,6326,7.2,20.1,-907,-1.9,36.4,0,549,549,2891
2003,27,e) 4,5018,5327,54157,54133,272,4.9,668,12,8302,1494,6808,2.8,15.3,8254,3045,5209,5.6,15.2,48,0.1,30.4,0,462,462,2404
2003,27,f) 5,4839,5440,55292,55173,292,5.2,551,9.8,8835,1853,6982,3.4,16,8596,2889,5707,5.2,15.6,239,0.4,31.2,0,392,392,2336
2003,27,g) 6 to 10,18299,19084,196575,197271,801,4.1,1882,9.5,31057,5076,25981,2.6,15.7,32449,11954,20495,6.1,16.4,-1392,-0.7,31.4,0,1341,1341,9636
2003,27,h) 11 to 15,12404,13646,173608,175041,440,3.1,1033,7.4,22379,2938,19441,1.7,12.8,25244,7800,17444,4.5,14.4,-2865,-1.6,25.6,0,701,701,5014
2003,27,i) 16 to 20,9657,11783,218314,217720,418,3.5,755,6.3,29984,6755,23229,3.1,13.8,28795,9147,19648,4.2,13.2,1189,0.6,26.4,0,469,470,3868
2003,27,j) 21 to 25,6765,8572,165969,168873,363,4.2,459,5.3,18607,5939,12668,3.5,11,24415,4482,19933,2.7,14.5,-5808,-3.5,22,0,291,292,2406
2003,27,k) 26+,1620,2945,75651,75158,124,4.2,131,4.4,9008,1617,7391,2.2,12,8022,1141,6881,1.5,10.7,986,1.3,21.4,0,56,56,279
2003,27,l) Left Censored,14774,30792,1222028,1225346,1749,5.7,1612,5.2,143067,50141,92926,4.1,11.7,149702,38506,111196,3.1,12.2,-6635,-0.5,23.4,0,461,462,6686
2003,28,a) 0,3978,4009,24768,12384,4009,200,0,0,24768,24768,0,200,200,0,0,0,0,0,24768,200,0,0,,,
2003,28,b) 1,2925,2962,24751,26314,11,0.3,953,27.4,6235,128,6107,0.5,23.7,9361,6043,3318,23,35.6,-3126,-11.9,47.4,0,795,795,4947
2003,28,c) 2,2458,2510,20864,21161,117,4.3,455,16.9,4317,542,3775,2.6,20.4,4911,2308,2603,10.9,23.2,-594,-2.8,40.8,0,373,373,2017
2003,28,d) 3,2169,2266,17996,18290,108,4.5,333,13.9,3661,548,3113,3,20,4248,2238,2010,12.2,23.2,-587,-3.2,40,0,268,268,1787
2003,28,e) 4,2126,2233,19262,20969,105,4.5,299,12.8,2959,578,2381,2.8,14.1,6372,2822,3550,13.5,30.4,-3413,-16.3,28.2,0,243,243,2450
2003,28,f) 5,1977,2198,19603,19943,95,4.2,242,10.6,3265,656,2609,3.3,16.4,3944,1388,2556,7,19.8,-679,-3.4,32.8,0,189,189,1023
2003,28,g) 6 to 10,7446,7768,82161,83613,349,4.3,837,10.4,13299,2172,11127,2.6,15.9,16202,5383,10819,6.4,19.4,-2903,-3.5,31.8,0,667,667,4319
2003,28,h) 11 to 15,4739,5259,67719,66485,200,3.7,448,8.3,12531,5955,6576,9,18.8,10062,3089,6973,4.6,15.1,2469,3.7,30.2,0,338,338,2612
2003,28,i) 16 to 20,4448,5165,76259,75560,181,3.5,301,5.7,9270,1559,7711,2.1,12.3,7872,2286,5586,3,10.4,1398,1.9,20.8,0,208,211,1685
2003,28,j) 21 to 25,3174,3961,68403,68772,118,2.9,227,5.6,8559,1535,7024,2.2,12.4,9297,1901,7396,2.8,13.5,-738,-1.1,24.8,0,158,158,1096
2003,28,k) 26+,743,1218,35877,35390,54,4.4,52,4.3,4179,879,3300,2.5,11.8,3205,339,2866,1,9.1,974,2.7,18.2,0,33,33,171
2003,28,l) Left Censored,6574,14848,446432,446315,866,5.9,648,4.4,46804,11975,34829,2.7,10.5,46570,8223,38347,1.8,10.4,234,0.1,20.8,0,258,258,1613
2003,29,a) 0,10580,10632,59834,29917,10632,200,0,0,59834,59834,0,200,200,0,0,0,0,0,59834,200,0,0,,,
2003,29,b) 1,7655,7749,61796,64117,29,0.3,2376,26.3,14181,766,13415,1.2,22.1,18823,10715,8108,16.7,29.4,-4642,-7.3,44.2,0,1935,1937,8412
2003,29,c) 2,5839,5999,45283,45205,294,4.5,1149,17.7,10523,1223,9300,2.7,23.3,10366,4883,5483,10.8,22.9,157,0.4,45.8,0,911,911,4072
2003,29,d) 3,5657,5858,48705,49603,260,4.2,914,14.7,9045,1238,7807,2.5,18.2,10841,5142,5699,10.4,21.9,-1796,-3.7,36.4,0,722,722,4471
2003,29,e) 4,5025,5268,50049,50134,213,3.8,727,13.1,9806,989,8817,2,19.6,9975,3809,6166,7.6,19.9,-169,-0.3,39.2,0,574,574,3142
2003,29,f) 5,4654,5107,56947,56013,223,4.2,604,11.4,11112,1497,9615,2.7,19.8,9243,3468,5775,6.2,16.5,1869,3.3,33,0,482,482,3091
2003,29,g) 6 to 10,18122,18882,190545,191800,813,4.2,2037,10.4,30586,4796,25790,2.5,15.9,33096,11316,21780,5.9,17.3,-2510,-1.4,31.8,0,1547,1547,9175
2003,29,h) 11 to 15,12556,13920,177055,176697,571,4,1075,7.6,28325,6092,22233,3.4,16,27608,8045,19563,4.6,15.6,717,0.4,31.2,0,737,737,4732
2003,29,i) 16 to 20,10984,13016,231092,230037,461,3.5,837,6.3,25895,3325,22570,1.4,11.3,23784,6990,16794,3,10.3,2111,1,20.6,0,529,529,3727
2003,29,j) 21 to 25,7245,9096,162333,163299,293,3.2,481,5.2,18900,4661,14239,2.9,11.6,20831,5610,15221,3.4,12.8,-1931,-1.2,23.2,0,316,316,2175
2003,29,k) 26+,1607,3290,81618,82153,136,4.1,163,4.9,8629,1829,6800,2.2,10.5,9698,2423,7275,2.9,11.8,-1069,-1.3,21,0,67,70,461
2003,29,l) Left Censored,15672,34327,1211859,1207560,1929,5.6,1719,5,127524,29587,97937,2.5,10.6,118927,28298,90629,2.3,9.8,8597,0.8,19.6,0,566,569,6418
2003,30,a) 0,2367,2375,10727,5364,2375,200,0,0,10727,10727,0,200,200,0,0,0,0,0,10727,200,0,0,,,
2003,30,b) 1,1846,1873,10818,11039,9,0.4,483,22.6,2340,53,2287,0.5,21.2,2782,1601,1181,14.5,25.2,-442,-4,42.4,0,342,342,1306
2003,30,c) 2,1585,1601,8912,9047,83,4.9,277,16.2,1698,276,1422,3.1,18.8,1967,956,1011,10.6,21.7,-269,-2.9,37.6,0,194,194,757
2003,30,d) 3,1455,1494,10274,9855,86,5.5,199,12.7,2471,931,1540,9.4,25.1,1633,700,933,7.1,16.6,838,8.5,33.2,0,144,144,556
2003,30,e) 4,1321,1366,9562,9494,77,5.5,137,9.8,1662,224,1438,2.4,17.5,1526,608,918,6.4,16.1,136,1.4,32.2,0,106,106,499
2003,30,f) 5,1297,1398,11802,11783,78,5.4,159,11,1651,368,1283,3.1,14,1613,529,1084,4.5,13.7,38,0.3,27.4,0,109,109,425
2003,30,g) 6 to 10,4629,4738,34827,35342,224,4.6,414,8.5,5257,843,4414,2.4,14.9,6287,2465,3822,7,17.8,-1030,-2.9,29.8,0,284,284,2023
2003,30,h) 11 to 15,2787,2965,26228,27118,126,4.2,230,7.6,3364,747,2617,2.8,12.4,5143,1136,4007,4.2,19,-1779,-6.6,24.8,0,156,156,666
2003,30,i) 16 to 20,2267,2590,31564,31635,107,4.1,188,7.1,3873,854,3019,2.7,12.2,4015,967,3048,3.1,12.7,-142,-0.5,24.4,0,126,126,554
2003,30,j) 21 to 25,1756,2222,27673,27900,78,3.5,143,6.3,2988,620,2368,2.2,10.7,3442,853,2589,3.1,12.3,-454,-1.6,21.4,0,85,86,438
2003,30,k) 26+,375,602,9479,9255,21,3.4,35,5.7,1433,198,1235,2.1,15.5,984,221,763,2.4,10.6,449,4.9,21.2,0,19,19,81
2003,30,l) Left Censored,2928,5466,113365,113361,295,5.4,293,5.4,12058,3992,8066,3.5,10.6,12050,2899,9151,2.6,10.6,8,0,21.2,0,95,95,449
2003,31,a) 0,2847,2857,16231,8116,2857,200,0,0,16231,16231,0,200,200,0,0,0,0,0,16231,200,0,0,,,
2003,31,b) 1,2346,2410,16248,16559,19,0.7,578,21.3,4245,115,4130,0.7,25.6,4867,2765,2102,16.7,29.4,-622,-3.8,51.2,0,436,436,2373
2003,31,c) 2,2073,2114,15741,15998,93,4.1,339,15,2894,347,2547,2.2,18.1,3407,1493,1914,9.3,21.3,-513,-3.2,36.2,0,264,264,1241
2003,31,d) 3,1869,1923,15098,14861,82,4.1,246,12.2,2919,263,2656,1.8,19.6,2445,982,1463,6.6,16.5,474,3.1,33,0,180,180,718
2003,31,e) 4,1670,1752,21850,22056,88,4.9,194,10.7,2354,497,1857,2.3,10.7,2765,741,2024,3.4,12.5,-411,-1.8,21.4,0,139,139,549
2003,31,f) 5,1615,1789,21452,22021,76,4.1,179,9.7,3907,1210,2697,5.5,17.7,5045,895,4150,4.1,22.9,-1138,-5.2,35.4,0,142,142,771
2003,31,g) 6 to 10,6095,6341,54276,55259,231,3.5,566,8.7,7468,1166,6302,2.1,13.5,9434,2872,6562,5.2,17.1,-1966,-3.6,27,0,418,418,2047
2003,31,h) 11 to 15,4360,4829,59297,59887,191,3.9,353,7.2,7060,2300,4760,3.8,11.8,8239,2072,6167,3.5,13.8,-1179,-2,23.6,0,234,234,1306
2003,31,i) 16 to 20,3792,4376,73409,71649,134,3,247,5.6,11059,1200,9859,1.7,15.4,7539,2754,4785,3.8,10.5,3520,4.9,21,0,157,157,978
2003,31,j) 21 to 25,2876,3504,57575,57787,106,3,213,6,7761,3219,4542,5.6,13.4,8185,1513,6672,2.6,14.2,-424,-0.8,26.8,0,141,141,786
2003,31,k) 26+,669,1230,24837,24966,48,3.9,54,4.4,2773,906,1867,3.6,11.1,3030,1003,2027,4,12.1,-257,-1,22.2,0,31,32,569
2003,31,l) Left Censored,6666,12327,382865,377524,656,5.3,569,4.6,48436,10977,37459,2.9,12.8,37754,8719,29035,2.3,10,10682,2.8,20,0,209,209,1410
2003,32,a) 0,5288,5349,38780,19390,5349,200,0,0,38780,38780,0,200,200,0,0,0,0,0,38780,200,0,0,,,
2003,32,b) 1,3649,3684,37212,37024,16,0.4,1203,27.8,10186,133,10053,0.4,27.5,9809,5743,4066,15.5,26.5,377,1,53,0,990,990,4546
2003,32,c) 2,2854,2916,30454,30529,158,5,614,19.3,7212,705,6507,2.3,23.6,7362,3260,4102,10.7,24.1,-150,-0.5,47.2,0,504,504,2822
2003,32,d) 3,2475,2525,30603,29173,127,4.7,427,15.9,7951,965,6986,3.3,27.3,5091,2272,2819,7.8,17.5,2860,9.8,35,0,347,347,1766
2003,32,e) 4,2230,2351,28598,29199,128,5.2,337,13.7,5118,536,4582,1.8,17.5,6320,2614,3706,9,21.6,-1202,-4.1,35,0,269,269,2263
2003,32,f) 5,1979,2164,31800,31635,110,4.9,279,12.3,5546,843,4703,2.7,17.5,5215,2325,2890,7.3,16.5,331,1,33,0,225,225,1572
2003,32,g) 6 to 10,6069,6422,117003,118752,342,5.1,762,11.4,18612,3851,14761,3.2,15.7,22109,4869,17240,4.1,18.6,-3497,-2.9,31.4,0,597,597,3924
2003,32,h) 11 to 15,3542,4083,68240,67500,194,4.7,327,7.9,10533,2376,8157,3.5,15.6,9052,2639,6413,3.9,13.4,1481,2.2,26.8,0,225,225,1549
2003,32,i) 16 to 20,2551,3406,68835,67588,228,6.7,222,6.5,10752,2950,7802,4.4,15.9,8257,1956,6301,2.9,12.2,2495,3.7,24.4,0,127,127,1005
2003,32,j) 21 to 25,1959,2516,65147,63685,123,4.8,150,5.9,8546,2029,6517,3.2,13.4,5621,1488,4133,2.3,8.8,2925,4.6,17.6,0,99,100,852
2003,32,k) 26+,417,971,55424,56500,50,5.2,39,4,5268,714,4554,1.3,9.3,7420,326,7094,0.6,13.1,-2152,-3.8,18.6,0,9,13,63
2003,32,l) Left Censored,3366,8711,391585,392467,802,9.3,590,6.9,45089,16582,28507,4.2,11.5,46852,14303,32549,3.6,11.9,-1763,-0.4,23,0,86,88,2754
2003,33,a) 0,2408,2429,12288,6144,2429,200,0,0,12288,,,,200,0,0,0,0,0,12288,200,0,1,,,
2003,33,b) 1,1828,1836,11862,12204,2,0.1,499,23.8,2607,,,,21.4,3290,2110,1180,17.3,27,-683,-5.6,42.8,1,372,372,1782
2003,33,c) 2,1584,1629,11887,12316,73,4.2,308,17.5,2279,318,1961,2.6,18.5,3136,1782,1354,14.5,25.5,-857,-7,37,0,242,242,1478
2003,33,d) 3,1464,1502,10995,11160,64,4,247,15.4,1899,458,1441,4.1,17,2228,1071,1157,9.6,20,-329,-3,34,0,196,196,899
2003,33,e) 4,1327,1366,13203,13442,58,4,185,12.8,1945,259,1686,1.9,14.5,2423,811,1612,6,18,-478,-3.5,29,0,132,132,511
2003,33,f) 5,1362,1463,13475,13453,66,4.3,163,10.7,2061,536,1525,4,15.3,2016,659,1357,4.9,15,45,0.3,30,0,122,122,471
2003,33,g) 6 to 10,5208,5300,47472,47821,205,3.7,516,9.4,7222,1504,5718,3.1,15.1,7919,3250,4669,6.8,16.6,-697,-1.5,30.2,0,379,379,2751
2003,33,h) 11 to 15,3560,3799,46562,46347,122,3.1,316,8.1,6448,1313,5135,2.8,13.9,6018,1791,4227,3.9,13,430,0.9,26,0,222,222,1206
2003,33,i) 16 to 20,3224,3638,57625,57396,140,3.8,276,7.4,7309,2023,5286,3.5,12.7,6850,2434,4416,4.2,11.9,459,0.8,23.8,0,194,194,917
2003,33,j) 21 to 25,1731,2051,32273,32239,91,4.4,132,6.4,3955,1681,2274,5.2,12.3,3886,1061,2825,3.3,12.1,69,0.2,24.2,0,86,87,481
2003,33,k) 26+,418,842,20547,20840,46,5.5,46,5.5,1841,454,1387,2.2,8.8,2427,500,1927,2.4,11.6,-586,-2.8,17.6,0,19,19,52
2003,33,l) Left Censored,3964,7749,253176,256420,386,5,394,5.1,26077,8395,17682,3.3,10.2,32564,7384,25180,2.9,12.7,-6487,-2.5,20.4,0,115,115,1342
2003,34,a) 0,16273,16337,90437,45219,16337,200,0,0,90437,90437,0,200,200,0,0,0,0,0,90437,200,0,0,,,
2003,34,b) 1,12351,12444,92792,92642,28,0.2,3559,24.7,25757,1381,24376,1.5,27.8,25457,15230,10227,16.4,27.5,300,0.3,55,0,2693,2693,12330
2003,34,c) 2,10763,10929,94270,94613,487,4.1,1971,16.8,18451,2402,16049,2.5,19.5,19137,7240,11897,7.7,20.2,-686,-0.7,39,0,1512,1512,5769
2003,34,d) 3,9589,9705,77671,81576,411,4,1571,15.2,14148,1884,12264,2.3,17.3,21957,12561,9396,15.4,26.9,-7809,-9.6,34.6,0,1197,1197,9349
2003,34,e) 4,9112,9395,82804,84048,427,4.3,1315,13.3,14202,1749,12453,2.1,16.9,16690,7359,9331,8.8,19.9,-2488,-3,33.8,0,1010,1010,5701
2003,34,f) 5,8810,9302,94002,94842,427,4.4,1099,11.3,20279,7374,12905,7.8,21.4,21958,12079,9879,12.7,23.2,-1679,-1.8,42.8,0,830,830,11014
2003,34,g) 6 to 10,31296,32157,334097,338879,1242,3.7,3472,10.4,53299,8403,44896,2.5,15.7,62863,21088,41775,6.2,18.6,-9564,-2.9,31.4,0,2577,2577,16260
2003,34,h) 11 to 15,21283,22677,263798,267581,797,3.4,1965,8.4,36468,6042,30426,2.3,13.6,44034,15391,28643,5.8,16.5,-7566,-2.9,27.2,0,1406,1407,11056
2003,34,i) 16 to 20,17471,19724,318445,319959,624,3.1,1347,6.7,37543,7932,29611,2.5,11.7,40571,11402,29169,3.6,12.7,-3028,-1,23.4,0,914,921,6895
2003,34,j) 21 to 25,11765,13539,245274,248991,384,2.8,924,6.7,27080,6468,20612,2.6,10.9,34514,6932,27582,2.8,13.9,-7434,-3,21.8,0,600,602,3247
2003,34,k) 26+,2576,3949,118901,120770,198,5,229,5.8,12201,2579,9622,2.1,10.1,15938,3459,12479,2.9,13.2,-3737,-3.1,20.2,0,114,114,1011
2003,34,l) Left Censored,24410,48177,1744647,1752020,3276,6.8,3554,7.3,228175,72030,156145,4.1,13,242922,63893,179029,3.6,13.9,-14747,-0.9,26,0,1034,1038,9122
2003,35,a) 0,2855,2866,18211,9106,2866,200,0,0,18211,,,,200,0,0,0,0,0,18211,200,0,1,,,
2003,35,b) 1,2258,2278,21557,21442,7,0.3,662,25.1,4954,,,,23.1,4724,2754,1970,12.8,22,230,1.1,44,1,516,516,2290
2003,35,c) 2,1969,2072,17101,17564,116,5.3,352,15.9,3930,516,3414,2.9,22.4,4855,2971,1884,16.9,27.6,-925,-5.2,44.8,0,264,264,2671
2003,35,d) 3,1686,1733,15273,15545,85,4.6,273,14.8,2840,309,2531,2,18.3,3384,1389,1995,8.9,21.8,-544,-3.5,36.6,0,222,222,1150
2003,35,e) 4,1526,1553,12332,12393,100,6.2,220,13.5,2146,455,1691,3.7,17.3,2267,1056,1211,8.5,18.3,-121,-1,34.6,0,180,180,916
2003,35,f) 5,1489,1606,17031,17162,82,5,160,9.7,2243,343,1900,2,13.1,2505,765,1740,4.5,14.6,-262,-1.5,26.2,0,113,113,573
2003,35,g) 6 to 10,5754,5990,58707,58419,294,4.8,587,9.5,10113,1812,8301,3.1,17.3,9536,3298,6238,5.6,16.3,577,1,32.6,0,437,438,2560
2003,35,h) 11 to 15,3793,4262,50909,50676,195,4.5,346,7.9,6986,882,6104,1.7,13.8,6519,2115,4404,4.2,12.9,467,0.9,25.8,0,217,217,1044
2003,35,i) 16 to 20,3222,3867,69265,68723,199,5.1,250,6.4,8994,1496,7498,2.2,13.1,7910,2553,5357,3.7,11.5,1084,1.6,23,0,156,156,1229
2003,35,j) 21 to 25,2372,2946,41972,41793,115,3.8,184,6.2,5386,1257,4129,3,12.9,5027,1474,3553,3.5,12,359,0.9,24,0,123,127,666
2003,35,k) 26+,524,1066,25432,24157,46,4.3,75,6.9,4697,2417,2280,10,19.4,2146,840,1306,3.5,8.9,2551,10.5,17.8,0,24,25,88
2003,35,l) Left Censored,3948,8485,221520,220255,557,6.6,469,5.6,29046,10481,18565,4.8,13.2,26515,7749,18766,3.5,12,2531,1.2,24,0,97,97,729
2003,36,a) 0,36773,36919,196205,98103,36919,200,0,0,196205,196205,0,200,200,0,0,0,0,0,196205,200,0,0,,,
2003,36,b) 1,27716,28007,194873,201316,60,0.2,7632,23.8,45993,570,45423,0.3,22.8,58878,36171,22707,18,29.2,-12885,-6.4,45.6,0,5827,5830,30886
2003,36,c) 2,23714,23941,178137,176326,1076,4.2,4581,17.7,44401,4977,39424,2.8,25.2,40778,20988,19790,11.9,23.1,3623,2.1,46.2,0,3697,3697,17536
2003,36,d) 3,20813,21172,165496,174199,918,4.1,3483,15.4,30588,3702,26886,2.1,17.6,47993,17619,30374,10.1,27.6,-17405,-10,35.2,0,2741,2741,14731
2003,36,e) 4,18797,19356,175405,179376,803,3.9,2816,13.8,28600,2922,25678,1.6,15.9,36541,14713,21828,8.2,20.4,-7941,-4.5,31.8,0,2177,2177,12596
2003,36,f) 5,18039,19317,173719,178155,831,4.1,2320,11.5,29885,5170,24715,2.9,16.8,38756,12548,26208,7,21.8,-8871,-5,33.6,0,1786,1786,10723
2003,36,g) 6 to 10,63924,65598,643823,660562,2445,3.6,6985,10.3,100164,17977,82187,2.7,15.2,133642,42870,90772,6.5,20.2,-33478,-5,30.4,0,5271,5271,32635
2003,36,h) 11 to 15,45256,47835,548009,546442,1631,3.3,3773,7.7,79216,13253,65963,2.4,14.5,76081,23964,52117,4.4,13.9,3135,0.6,27.8,0,2656,2658,17059
2003,36,i) 16 to 20,37269,41583,652442,648465,1306,3.1,2695,6.4,79914,16778,63136,2.6,12.3,71960,20622,51338,3.2,11.1,7954,1.2,22.2,0,1862,1867,14168
2003,36,j) 21 to 25,23930,28490,521355,519582,814,2.8,1687,5.8,62783,12698,50085,2.4,12.1,59237,13394,45843,2.6,11.4,3546,0.7,22.8,0,1165,1176,8518
2003,36,k) 26+,4940,8803,222317,221978,483,5.5,432,4.9,29621,7112,22509,3.2,13.3,28942,5015,23927,2.3,13,679,0.3,26,0,199,206,1421
2003,36,l) Left Censored,52960,101081,3685491,3676382,5585,5.5,6433,6.3,424667,111721,312946,3,11.6,406450,106112,300338,2.9,11.1,18217,0.5,22.2,0,2164,2173,20275
2003,37,a) 0,13872,13936,85754,42877,13936,200,0,0,85754,85754,0,200,200,0,0,0,0,0,85754,200,0,0,,,
2003,37,b) 1,10427,10641,79431,82967,68,0.6,3173,25.7,21479,599,20880,0.7,25.9,28550,18503,10047,22.3,34.4,-7071,-8.5,51.8,0,2517,2524,16354
2003,37,c) 2,9526,9765,77402,77142,543,5.2,1719,16.4,16713,2573,14140,3.3,21.7,16193,8136,8057,10.5,21,520,0.7,42,0,1343,1343,6537
2003,37,d) 3,8401,8741,74359,75305,408,4.4,1303,14.1,13990,1714,12276,2.3,18.6,15881,7243,8638,9.6,21.1,-1891,-2.5,37.2,0,1029,1029,6135
2003,37,e) 4,7854,8282,81659,81398,393,4.5,1121,12.9,16939,2316,14623,2.8,20.8,16417,6220,10197,7.6,20.2,522,0.6,40.4,0,859,859,5200
2003,37,f) 5,7196,7934,93244,90143,379,4.6,898,10.9,22121,11795,10326,13.1,24.5,15919,6838,9081,7.6,17.7,6202,6.8,35.4,0,701,701,3796
2003,37,g) 6 to 10,25643,26944,268141,280313,1162,4.2,2893,10.3,42699,8122,34577,2.9,15.2,67042,18704,48338,6.7,23.9,-24343,-8.7,30.4,0,2135,2135,14441
2003,37,h) 11 to 15,17093,19096,262206,262871,702,3.6,1433,7.3,38480,6441,32039,2.5,14.6,39809,11493,28316,4.4,15.1,-1329,-0.5,29.2,0,1042,1047,6582
2003,37,i) 16 to 20,15701,18778,293368,293300,750,4,1058,5.6,36789,10150,26639,3.5,12.5,36653,7625,29028,2.6,12.5,136,0,25,0,672,682,3853
2003,37,j) 21 to 25,9156,11931,230789,228080,437,3.6,646,5.4,28784,6049,22735,2.7,12.6,23365,4966,18399,2.2,10.2,5419,2.4,20.4,0,408,408,2282
2003,37,k) 26+,1975,3987,96375,95903,213,5.4,161,4.1,9870,2072,7798,2.2,10.3,8925,1659,7266,1.7,9.3,945,1,18.6,0,77,77,528
2003,37,l) Left Censored,18293,46495,1691903,1702104,3007,6.5,2411,5.2,198406,73715,124691,4.3,11.7,218807,60453,158354,3.6,12.9,-20401,-1.2,23.4,0,602,602,5380
2003,38,a) 0,1013,1019,5296,2648,1019,200,0,0,5296,,,,200,0,0,0,0,0,5296,200,0,1,,,
2003,38,b) 1,837,860,5510,5796,3,0.3,198,20.6,1166,,,,20.1,1738,966,772,16.7,30,-572,-9.9,40.2,1,123,123,634
2003,38,c) 2,704,720,5545,5558,23,3,126,16.2,1131,67,1064,1.2,20.3,1157,673,484,12.1,20.8,-26,-0.5,40.6,0,100,100,626
2003,38,d) 3,667,681,5229,5277,26,3.6,88,12.3,920,45,875,0.9,17.4,1016,372,644,7,19.3,-96,-1.9,34.8,0,68,68,337
2003,38,e) 4,572,598,4622,4865,22,3.5,60,9.6,494,51,443,1,10.2,979,530,449,10.9,20.1,-485,-9.9,20.4,0,42,42,466
2003,38,f) 5,598,651,6393,6403,23,3.4,65,9.6,929,82,847,1.3,14.5,949,339,610,5.3,14.8,-20,-0.3,29,0,43,43,190
2003,38,g) 6 to 10,2437,2481,21787,21854,94,3.7,220,8.6,3162,480,2682,2.2,14.5,3295,1261,2034,5.8,15.1,-133,-0.6,29,0,151,151,896
2003,38,h) 11 to 15,1827,1977,19383,19279,76,3.8,146,7.2,2701,584,2117,3,14,2493,589,1904,3.1,12.9,208,1.1,25.8,0,92,92,352
2003,38,i) 16 to 20,1696,1946,20600,20959,62,3.1,102,5.2,2261,370,1891,1.8,10.8,2978,1195,1783,5.7,14.2,-717,-3.4,21.6,0,73,73,610
2003,38,j) 21 to 25,1350,1578,21148,20736,46,2.9,87,5.4,3032,1190,1842,5.7,14.6,2207,489,1718,2.4,10.6,825,4,21.2,0,62,62,366
2003,38,k) 26+,295,459,8770,8574,16,3.4,30,6.4,1330,225,1105,2.6,15.5,937,475,462,5.5,10.9,393,4.6,21.8,0,13,13,65
2003,38,l) Left Censored,3021,5231,133959,132251,196,3.7,189,3.6,13010,2805,10205,2.1,9.8,9593,1657,7936,1.3,7.3,3417,2.5,14.6,0,76,76,337
2003,39,a) 0,14183,14266,103193,51597,14266,200,0,0,103193,103193,0,200,200,0,0,0,0,0,103193,200,0,0,,,
2003,39,b) 1,11418,11715,107742,110441,69,0.5,3141,23.4,27678,3002,24676,2.7,25.1,33076,21879,11197,19.8,29.9,-5398,-4.8,50.2,0,2425,2427,19248
2003,39,c) 2,9671,9939,79194,81382,515,4.8,1798,16.9,16186,2375,13811,2.9,19.9,20561,10439,10122,12.8,25.3,-4375,-5.4,39.8,0,1416,1416,8846
2003,39,d) 3,8859,9161,87932,89710,426,4.4,1349,13.9,17230,2400,14830,2.7,19.2,20785,9359,11426,10.4,23.2,-3555,-4,38.4,0,1049,1049,8148
2003,39,e) 4,8439,8980,99868,99353,387,4.1,1100,11.7,17916,2205,15711,2.2,18,16886,7153,9733,7.2,17,1030,1,34,0,810,810,4896
2003,39,f) 5,8047,9038,91608,92554,385,4.1,1047,11.1,14203,2296,11907,2.5,15.3,16094,6126,9968,6.6,17.4,-1891,-2.1,30.6,0,779,781,4649
2003,39,g) 6 to 10,32275,34085,360181,367439,1261,3.6,3318,9.4,54844,9315,45529,2.5,14.9,69359,23331,46028,6.3,18.9,-14515,-4,29.8,0,2452,2455,15946
2003,39,h) 11 to 15,23284,26144,362501,360713,868,3.2,2022,7.5,54117,8044,46073,2.2,15,50540,13960,36580,3.9,14,3577,1,28,0,1338,1338,8164
2003,39,i) 16 to 20,19730,23732,389496,389643,840,3.5,1404,5.8,44483,9473,35010,2.4,11.4,44777,11106,33671,2.9,11.5,-294,-0.1,22.8,0,913,946,6869
2003,39,j) 21 to 25,14194,17877,317401,317902,535,2.9,1082,6,38001,9379,28622,3,12,39003,9637,29366,3,12.3,-1002,-0.3,24,0,662,673,5807
2003,39,k) 26+,3152,6223,158879,159639,230,3.7,306,4.9,19879,4544,15335,2.8,12.5,21399,4253,17146,2.7,13.4,-1520,-0.9,25,0,103,108,769
2003,39,l) Left Censored,32871,73240,2594815,2603260,3959,5.4,3527,4.8,278893,76470,202423,2.9,10.7,295783,61658,234125,2.4,11.4,-16890,-0.7,21.4,0,1162,1175,9890
2003,40,a) 0,5671,5690,30127,15064,5690,200,0,0,30127,30127,0,200,200,0,0,0,0,0,30127,200,0,0,,,
2003,40,b) 1,4405,4495,33318,35898,26,0.5,1409,26.8,8519,467,8052,1.3,23.7,13679,8875,4804,24.7,38.1,-5160,-14.4,47.4,0,1163,1165,7648
2003,40,c) 2,3659,3731,26443,27563,179,4.4,728,18,5468,1075,4393,3.9,19.8,7708,3826,3882,13.9,28,-2240,-8.2,39.6,0,608,608,3374
2003,40,d) 3,3302,3439,30034,29913,152,4.2,511,14,6189,1247,4942,4.2,20.7,5946,2577,3369,8.6,19.9,243,0.8,39.8,0,405,405,2219
2003,40,e) 4,3092,3217,32328,33134,127,3.7,423,12.5,6291,499,5792,1.5,19,7903,2860,5043,8.6,23.9,-1612,-4.9,38,0,343,343,1836
2003,40,f) 5,2941,3251,29143,30160,156,4.6,352,10.5,4835,686,4149,2.3,16,6869,1612,5257,5.3,22.8,-2034,-6.8,32,0,277,277,1328
2003,40,g) 6 to 10,10739,11330,105217,106744,514,4.4,1146,9.8,17152,2880,14272,2.7,16.1,20207,6714,13493,6.3,18.9,-3055,-2.8,32.2,0,894,894,5522
2003,40,h) 11 to 15,7310,7949,100737,100594,301,3.7,613,7.5,15581,3044,12537,3,15.5,15295,4500,10795,4.5,15.2,286,0.3,30.4,0,464,464,2670
2003,40,i) 16 to 20,6620,7628,108806,110193,285,3.7,444,5.7,11327,1960,9367,1.8,10.3,14101,3626,10475,3.3,12.8,-2774,-2.5,20.6,0,318,318,1778
2003,40,j) 21 to 25,5161,6279,108729,110437,194,3,334,5.2,11410,2383,9027,2.2,10.3,14826,3640,11186,3.3,13.4,-3416,-3.1,20.6,0,245,246,1596
2003,40,k) 26+,946,1817,38107,38933,73,4,85,4.7,4093,755,3338,1.9,10.5,5744,1010,4734,2.6,14.8,-1651,-4.3,21,0,41,41,208
2003,40,l) Left Censored,8444,18665,529306,533561,966,5.2,823,4.4,58273,16296,41977,3.1,10.9,66785,13529,53256,2.5,12.5,-8512,-1.6,21.8,0,277,278,2300
2003,41,a) 0,7303,7376,34425,17213,7376,200,0,0,34425,34425,0,200,200,0,0,0,0,0,34425,200,0,0,,,
2003,41,b) 1,5513,5614,34251,35904,22,0.3,1475,22.9,7834,126,7708,0.4,21.8,11140,6615,4525,18.4,31,-3306,-9.2,43.6,0,1128,1130,5268
2003,41,c) 2,4833,4936,31669,32152,282,5.4,825,15.7,6485,968,5517,3,20.2,7450,3585,3865,11.2,23.2,-965,-3,40.4,0,651,651,2977
2003,41,d) 3,4241,4346,31323,31642,225,4.9,669,14.5,6542,915,5627,2.9,20.7,7179,3451,3728,10.9,22.7,-637,-2,41.4,0,526,526,3027
2003,41,e) 4,3919,4053,29701,30034,225,5.3,534,12.6,5332,1015,4317,3.4,17.8,5997,2588,3409,8.6,20,-665,-2.2,35.6,0,396,396,2048
2003,41,f) 5,3700,3995,34015,34072,222,5.4,452,10.9,5839,1096,4743,3.2,17.1,5952,2302,3650,6.8,17.5,-113,-0.4,34.2,0,324,324,1686
2003,41,g) 6 to 10,13993,14534,140583,142522,697,4.6,1571,10.4,20292,3310,16982,2.3,14.2,24170,8178,15992,5.7,17,-3878,-2.8,28.4,0,1175,1175,6230
2003,41,h) 11 to 15,9049,9942,116415,116176,469,4.6,772,7.6,18121,2888,15233,2.5,15.6,17642,4844,12798,4.2,15.2,479,0.4,30.4,0,523,523,3580
2003,41,i) 16 to 20,6885,8389,130432,130442,318,3.7,569,6.7,17639,2988,14651,2.3,13.5,17658,5875,11783,4.5,13.5,-19,0,27,0,372,372,3352
2003,41,j) 21 to 25,5317,6467,100733,101088,191,2.9,351,5.3,11234,1978,9256,2,11.1,11944,2514,9430,2.5,11.8,-710,-0.7,22.2,0,237,237,1773
2003,41,k) 26+,1093,2020,51341,51823,87,4.3,80,4,5653,912,4741,1.8,10.9,6617,1470,5147,2.8,12.8,-964,-1.9,21.8,0,31,31,117
2003,41,l) Left Censored,8566,19048,597138,595639,1117,5.9,1084,5.7,72486,16458,56028,2.8,12.2,69488,20223,49265,3.4,11.7,2998,0.5,23.4,0,292,295,2556
2003,42,a) 0,16148,16241,106475,53238,16241,200,0,0,106475,106475,0,200,200,0,0,0,0,0,106475,200,0,0,,,
2003,42,b) 1,13141,13367,117925,119283,47,0.3,3319,21.9,30585,405,30180,0.3,25.6,33300,20533,12767,17.2,27.9,-2715,-2.3,51.2,0,2498,2502,17514
2003,42,c) 2,11459,11633,115513,117457,485,3.9,1879,15.1,19022,2384,16638,2,16.2,22910,11968,10942,10.2,19.5,-3888,-3.3,32.4,0,1461,1461,10232
2003,42,d) 3,10471,10736,102947,103403,424,3.7,1501,13.2,17827,2440,15387,2.4,17.2,18738,8650,10088,8.4,18.1,-911,-0.9,34.4,0,1149,1149,6663
2003,42,e) 4,9667,10119,104967,102090,437,4.1,1184,11.2,22924,2605,20319,2.6,22.5,17170,5868,11302,5.7,16.8,5754,5.7,33.6,0,877,884,4689
2003,42,f) 5,9284,10522,110566,111148,425,3.9,1106,10.1,17428,3646,13782,3.3,15.7,18591,5709,12882,5.1,16.7,-1163,-1,31.4,0,823,823,4634
2003,42,g) 6 to 10,34814,36287,371194,375418,1301,3.5,3419,9.1,53480,10469,43011,2.8,14.2,61928,19962,41966,5.3,16.5,-8448,-2.3,28.4,0,2528,2529,14979
2003,42,h) 11 to 15,27764,30179,361905,367787,1011,3.3,2277,7.4,49528,8944,40584,2.4,13.5,61291,16038,45253,4.4,16.7,-11763,-3.2,27,0,1605,1607,10426
2003,42,i) 16 to 20,23965,28179,455635,457449,981,3.4,1768,6.2,47135,11497,35638,2.5,10.3,50762,14148,36614,3.1,11.1,-3627,-0.8,20.6,0,1159,1181,8136
2003,42,j) 21 to 25,15611,18938,334863,335018,590,3.1,1099,5.7,38059,9086,28973,2.7,11.4,38369,9017,29352,2.7,11.5,-310,-0.1,22.8,0,746,750,5390
2003,42,k) 26+,3483,6541,172543,168440,309,4.7,283,4.3,29207,5302,23905,3.1,17.3,21000,4277,16723,2.5,12.5,8207,4.8,25,0,109,111,1009
2003,42,l) Left Censored,35919,77378,2701934,2715625,4107,5.3,3818,4.9,309633,91091,218542,3.4,11.4,337016,73558,263458,2.7,12.4,-27383,-1,22.8,0,1289,1311,11942
2003,44,a) 0,1867,1873,11635,5818,1873,200,0,0,11635,11635,0,200,200,0,0,0,0,0,11635,200,0,0,,,
2003,44,b) 1,1413,1421,9050,9101,4,0.2,392,24,2412,26,2386,0.3,26.5,2513,1653,860,18.2,27.6,-101,-1.1,53,0,271,271,1298
2003,44,c) 2,1203,1214,8245,8260,56,4.3,202,15.6,1586,215,1371,2.6,19.2,1616,746,870,9,19.6,-30,-0.4,38.4,0,141,141,494
2003,44,d) 3,1053,1075,7857,9853,48,4.2,158,13.9,1235,116,1119,1.2,12.5,5227,535,4692,5.4,53,-3992,-40.5,25,0,116,116,455
2003,44,e) 4,1008,1030,7804,7885,59,5.5,118,11.1,1333,231,1102,2.9,16.9,1495,433,1062,5.5,19,-162,-2.1,33.8,0,83,83,362
2003,44,f) 5,1011,1112,8880,9092,45,3.9,128,11.1,1187,141,1046,1.6,13.1,1611,663,948,7.3,17.7,-424,-4.6,26.2,0,98,98,579
2003,44,g) 6 to 10,3668,3712,34230,34104,155,4,380,9.9,5786,1421,4365,4.2,17,5534,1866,3668,5.5,16.2,252,0.8,32.4,0,260,261,1470
2003,44,h) 11 to 15,2801,2930,37350,37438,84,2.8,230,7.6,4763,657,4106,1.8,12.7,4938,1549,3389,4.1,13.2,-175,-0.5,25.4,0,134,134,1047
2003,44,i) 16 to 20,2409,2681,37434,37519,100,3.7,174,6.4,4762,870,3892,2.3,12.7,4931,1652,3279,4.4,13.1,-169,-0.4,25.4,0,100,107,812
2003,44,j) 21 to 25,1514,1719,28414,28229,57,3.3,96,5.5,3843,1065,2778,3.8,13.6,3473,882,2591,3.1,12.3,370,1.3,24.6,0,66,66,550
2003,44,k) 26+,395,544,11768,11759,16,2.9,26,4.7,1248,226,1022,1.9,10.6,1229,115,1114,1,10.5,19,0.1,21,0,15,15,50
2003,44,l) Left Censored,4068,6338,217623,216589,343,5.4,336,5.3,22477,4417,18060,2,10.4,20408,5224,15184,2.4,9.4,2069,1,18.8,0,128,128,1100
2003,45,a) 0,6853,6891,50904,25452,6891,200,0,0,50904,50904,0,200,200,0,0,0,0,0,50904,200,0,0,,,
2003,45,b) 1,5317,5394,40745,43347,20,0.3,1507,24.3,9531,168,9363,0.4,22,14735,8558,6177,19.7,34,-5204,-12,44,0,1220,1220,7217
2003,45,c) 2,4432,4544,40619,41877,245,5,880,18,8191,1079,7112,2.6,19.6,10707,5104,5603,12.2,25.6,-2516,-6,39.2,0,718,718,4359
2003,45,d) 3,4063,4202,39164,38938,207,4.7,625,14.1,7866,1044,6822,2.7,20.2,7413,3522,3891,9,19,453,1.2,38,0,497,497,2894
2003,45,e) 4,3749,3932,40749,41309,182,4.4,516,12.5,7080,1334,5746,3.2,17.1,8200,4258,3942,10.3,19.9,-1120,-2.8,34.2,0,421,421,3891
2003,45,f) 5,3450,3746,38944,39245,162,4.1,444,11.4,6318,1151,5167,2.9,16.1,6919,2709,4210,6.9,17.6,-601,-1.5,32.2,0,354,354,2209
2003,45,g) 6 to 10,12185,12668,147748,147999,563,4.3,1300,9.9,24835,4531,20304,3.1,16.8,25338,8001,17337,5.4,17.1,-503,-0.3,33.6,0,1013,1013,6262
2003,45,h) 11 to 15,8247,9446,123331,122881,383,4,712,7.4,20106,5190,14916,4.2,16.4,19206,5512,13694,4.5,15.6,900,0.8,31.2,0,515,517,3043
2003,45,i) 16 to 20,7266,8888,134887,136530,305,3.4,511,5.7,17365,4413,12952,3.2,12.7,20650,4271,16379,3.1,15.1,-3285,-2.4,25.4,0,360,361,2350
2003,45,j) 21 to 25,4360,5733,100295,100255,196,3.4,291,5,11528,2670,8858,2.7,11.5,11447,3013,8434,3,11.4,81,0.1,22.8,0,197,198,1826
2003,45,k) 26+,969,2010,34143,33671,94,4.7,66,3.3,4429,736,3693,2.2,13.2,3484,520,2964,1.5,10.3,945,2.9,20.6,0,38,38,304
2003,45,l) Left Censored,9058,21741,743953,752014,1317,6.1,1037,4.8,76933,27151,49782,3.6,10.2,93054,23043,70011,3.1,12.4,-16121,-2.2,20.4,0,286,287,1958
2003,46,a) 0,1526,1535,7885,3943,1535,200,0,0,7885,,,,200,0,0,0,0,0,7885,200,0,1,,,
2003,46,b) 1,1294,1307,8013,8220,1,0.1,327,21.9,1853,,,,22.5,2267,1339,928,16.3,27.6,-414,-5.1,45,1,234,234,1082
2003,46,c) 2,1042,1077,7652,7570,42,3.7,169,14.7,1657,158,1499,2.1,21.9,1493,718,775,9.5,19.7,164,2.2,39.4,0,135,135,548
2003,46,d) 3,936,962,7684,7570,40,4,129,12.7,1513,283,1230,3.7,20,1284,459,825,6.1,17,229,3,34,0,94,94,349
2003,46,e) 4,852,877,6851,6994,44,4.8,118,12.9,963,127,836,1.8,13.8,1248,505,743,7.2,17.8,-285,-4,27.6,0,89,89,425
2003,46,f) 5,832,887,7218,7189,39,4.2,110,11.9,1234,129,1105,1.8,17.2,1176,480,696,6.7,16.4,58,0.8,32.8,0,75,75,319
2003,46,g) 6 to 10,3120,3217,26997,27115,105,3.1,321,9.6,3796,471,3325,1.7,14,4032,1533,2499,5.7,14.9,-236,-0.9,28,0,219,219,1076
2003,46,h) 11 to 15,2128,2277,23612,23915,81,3.5,204,8.7,2901,477,2424,2,12.1,3507,1461,2046,6.1,14.7,-606,-2.6,24.2,0,134,134,678
2003,46,i) 16 to 20,1778,2031,24781,27805,67,3.2,122,5.9,3097,620,2477,2.2,11.1,9145,6415,2730,23.1,32.9,-6048,-21.8,22.2,0,59,59,420
2003,46,j) 21 to 25,1330,1556,19995,20159,54,3.4,78,5,2147,381,1766,1.9,10.7,2474,876,1598,4.3,12.3,-327,-1.6,21.4,0,58,58,453
2003,46,k) 26+,293,493,8462,8620,13,2.6,19,3.8,667,88,579,1,7.7,983,63,920,0.7,11.4,-316,-3.7,15.4,0,10,10,23
2003,46,l) Left Censored,3111,5383,145732,146819,234,4.3,303,5.6,13327,3786,9541,2.6,9.1,15500,4170,11330,2.8,10.6,-2173,-1.5,18.2,0,97,97,919
2003,47,a) 0,8242,8288,58741,29371,8288,200,0,0,58741,58741,0,200,200,0,0,0,0,0,58741,200,0,0,,,
2003,47,b) 1,6029,6184,51382,56233,64,0.9,2005,27.7,12372,789,11583,1.4,22,22073,13743,8330,24.4,39.3,-9701,-17.3,44,0,1673,1673,11991
2003,47,c) 2,5074,5191,44448,45496,248,4.4,974,17.4,9536,1322,8214,2.9,21,11632,6264,5368,13.8,25.6,-2096,-4.6,42,0,816,816,5077
2003,47,d) 3,4482,4666,45731,45648,262,5.3,738,14.9,9693,1906,7787,4.2,21.2,9527,4506,5021,9.9,20.9,166,0.3,41.8,0,610,610,3512
2003,47,e) 4,4257,4657,49383,49950,230,4.7,613,12.6,8017,1135,6882,2.3,16.1,9150,3365,5785,6.7,18.3,-1133,-2.2,32.2,0,500,500,2902
2003,47,f) 5,4112,4651,52068,51739,212,4.4,579,11.9,10394,1726,8668,3.3,20.1,9736,3989,5747,7.7,18.8,658,1.3,37.6,0,441,441,3330
2003,47,g) 6 to 10,15733,16647,184026,183262,763,4.4,1774,10.3,32923,5946,26977,3.2,18,31395,11863,19532,6.5,17.1,1528,0.9,34.2,0,1345,1345,8633
2003,47,h) 11 to 15,10964,12496,178546,179973,473,3.7,1018,7.9,24549,5933,18616,3.3,13.6,27402,8403,18999,4.7,15.2,-2853,-1.6,27.2,0,752,752,5059
2003,47,i) 16 to 20,10119,12151,205496,205396,427,3.5,712,5.8,24431,4318,20113,2.1,11.9,24232,4495,19737,2.2,11.8,199,0.1,23.6,0,504,504,2951
2003,47,j) 21 to 25,6254,7938,146987,146801,278,3.5,486,6,18983,5629,13354,3.8,12.9,18611,4166,14445,2.8,12.7,372,0.2,25.4,0,317,320,2418
2003,47,k) 26+,1499,3717,103334,103393,217,5.8,318,8.4,18526,7320,11206,7.1,17.9,18643,5178,13465,5,18,-117,-0.1,35.8,0,52,55,251
2003,47,l) Left Censored,12988,32048,1172126,1173621,2029,6.4,1572,4.9,135393,43025,92368,3.7,11.5,138383,27785,110598,2.4,11.8,-2990,-0.3,23,0,456,462,3483
2003,48,a) 0,35370,35661,255112,127556,35661,200,0,0,255112,255112,0,200,200,0,0,0,0,0,255112,200,0,0,,,
2003,48,b) 1,26253,26940,264846,278508,153,0.5,8045,25.7,62177,2358,59819,0.8,22.3,89501,51896,37605,18.6,32.1,-27324,-9.8,44.6,0,6680,6682,44459
2003,48,c) 2,21907,22543,207782,213575,1052,4.3,4306,17.7,43656,5151,38505,2.4,20.4,55241,27737,27504,13,25.9,-11585,-5.5,40.8,0,3573,3573,22082
2003,48,d) 3,19237,20040,195744,199062,904,4.2,3259,15.3,40198,6218,33980,3.1,20.2,46834,20489,26345,10.3,23.5,-6636,-3.3,40.4,0,2670,2671,16654
2003,48,e) 4,17428,18408,210971,214721,854,4.4,2576,13.3,39844,6986,32858,3.3,18.6,47343,22101,25242,10.3,22,-7499,-3.4,37.2,0,2098,2098,17499
2003,48,f) 5,16102,17964,222401,224515,851,4.5,2213,11.8,41262,7176,34086,3.2,18.4,45489,21294,24195,9.5,20.3,-4227,-1.9,36.8,0,1771,1771,18396
2003,48,g) 6 to 10,60177,64255,776063,787293,2948,4.4,7086,10.6,138131,28661,109470,3.6,17.5,160592,56378,104214,7.2,20.4,-22461,-2.9,35,0,5438,5440,42571
2003,48,h) 11 to 15,39714,45456,691916,696450,1920,4.1,3841,8.2,111983,27570,84413,4,16.1,121050,42980,78070,6.2,17.4,-9067,-1.3,32.2,0,2673,2685,21808
2003,48,i) 16 to 20,32208,40156,712279,713762,1711,4.2,2629,6.5,91063,17247,73816,2.4,12.8,94029,24216,69813,3.4,13.2,-2966,-0.4,25.6,0,1740,1770,13872
2003,48,j) 21 to 25,24131,31478,565080,558271,1221,3.8,1864,5.8,84520,25677,58843,4.6,15.1,70901,20024,50877,3.6,12.7,13619,2.4,25.4,0,1195,1211,9953
2003,48,k) 26+,4278,9514,212680,209406,666,7.1,485,5.1,33444,10219,23225,4.9,16,26895,6660,20235,3.2,12.8,6549,3.2,25.6,0,179,198,2231
2003,48,l) Left Censored,32792,101932,3630113,3660403,7493,7.4,6419,6.3,464019,167289,296730,4.6,12.7,524599,154479,370120,4.2,14.3,-60580,-1.6,25.4,0,1278,1347,14415
2003,49,a) 0,5632,5646,34168,17084,5646,200,0,0,34168,34168,0,200,200,0,0,0,0,0,34168,200,0,0,,,
2003,49,b) 1,3982,4046,29476,31830,19,0.4,1399,29.1,7070,233,6837,0.7,22.2,11777,7658,4119,24.1,37,-4707,-14.8,44.4,0,1060,1061,6493
2003,49,c) 2,3192,3259,24614,25490,197,5.6,674,19.1,5251,793,4458,3.1,20.6,7003,3359,3644,13.2,27.5,-1752,-6.9,41.2,0,507,507,2775
2003,49,d) 3,2702,2744,22986,23284,139,4.8,465,15.9,5197,1457,3740,6.3,22.3,5793,2552,3241,11,24.9,-596,-2.6,44.6,0,352,354,2126
2003,49,e) 4,2401,2470,23839,26382,142,5.4,405,15.5,4967,1393,3574,5.3,18.8,10052,4043,6009,15.3,38.1,-5085,-19.3,37.6,0,291,291,3584
2003,49,f) 5,2136,2293,22570,22746,120,5,309,12.9,3754,530,3224,2.3,16.5,4105,1593,2512,7,18,-351,-1.5,33,0,229,229,1300
2003,49,g) 6 to 10,7561,7857,96010,97626,423,5.2,885,10.9,17376,6141,11235,6.3,17.8,20607,5197,15410,5.3,21.1,-3231,-3.3,35.6,0,644,645,4262
2003,49,h) 11 to 15,4159,4682,83207,85748,205,4.3,422,8.8,11814,3113,8701,3.6,13.8,16896,7567,9329,8.8,19.7,-5082,-5.9,27.6,0,286,286,5539
2003,49,i) 16 to 20,2935,3657,71002,70251,216,5.9,272,7.4,13330,4197,9133,6,19,11827,3965,7862,5.6,16.8,1503,2.2,33.6,0,163,163,1717
2003,49,j) 21 to 25,2379,2923,59268,59164,130,4.4,183,6.2,7652,2191,5461,3.7,12.9,7444,1656,5788,2.8,12.6,208,0.3,25.2,0,115,118,835
2003,49,k) 26+,567,964,19695,19653,43,4.4,69,7.1,2389,628,1761,3.2,12.2,2304,768,1536,3.9,11.7,85,0.5,23.4,0,16,16,144
2003,49,l) Left Censored,4284,10463,417786,419801,811,7.8,785,7.5,48207,16046,32161,3.8,11.5,52237,14243,37994,3.4,12.4,-4030,-0.9,23,0,144,144,2390
2003,50,a) 0,1284,1295,6565,3283,1295,200,0,0,6565,6565,0,200,200,0,0,0,0,0,6565,200,0,0,,,
2003,50,b) 1,971,980,5973,6203,5,0.4,247,22.2,1074,31,1043,0.5,17.3,1533,939,594,15.1,24.7,-459,-7.4,34.6,0,172,172,757
2003,50,c) 2,870,879,5116,5452,37,4,139,14.9,818,130,688,2.4,15,1489,816,673,15,27.3,-671,-12.3,30,0,99,99,717
2003,50,d) 3,816,841,7715,7320,36,4,131,14.6,1789,381,1408,5.2,24.4,999,465,534,6.4,13.6,790,10.8,27.2,0,90,90,311
2003,50,e) 4,777,792,5762,5702,37,4.5,92,11.2,1334,396,938,6.9,23.4,1214,330,884,5.8,21.3,120,2.1,42.6,0,68,68,278
2003,50,f) 5,773,845,6509,6645,39,4.5,93,10.6,825,96,729,1.4,12.4,1097,412,685,6.2,16.5,-272,-4.1,24.8,0,72,72,349
2003,50,g) 6 to 10,2919,3003,22664,23098,105,3.4,303,9.7,2965,313,2652,1.4,12.8,3832,1475,2357,6.4,16.6,-867,-3.8,25.6,0,215,215,1143
2003,50,h) 11 to 15,2339,2443,21175,21543,82,3.3,182,7.3,2590,526,2064,2.4,12,3325,1013,2312,4.7,15.4,-735,-3.4,24,0,119,119,566
2003,50,i) 16 to 20,1968,2206,32747,32365,78,3.5,128,5.7,4216,934,3282,2.9,13,3452,1276,2176,3.9,10.7,764,2.3,21.4,0,85,85,1073
2003,50,j) 21 to 25,1205,1401,17911,18076,34,2.4,65,4.6,1881,297,1584,1.6,10.4,2210,438,1772,2.4,12.2,-329,-1.8,20.8,0,42,42,306
2003,50,k) 26+,273,429,10178,9809,20,4.7,13,3,1316,106,1210,1.1,13.4,577,54,523,0.6,5.9,739,7.5,11.8,0,6,6,14
2003,50,l) Left Censored,2412,4080,114422,117048,235,5.8,185,4.6,10735,2898,7837,2.5,9.2,15987,4522,11465,3.9,13.7,-5252,-4.5,18.4,0,65,66,787
2003,51,a) 0,12092,12142,71169,35585,12142,200,0,0,71169,71169,0,200,200,0,0,0,0,0,71169,200,0,0,,,
2003,51,b) 1,9216,9341,65713,70650,36,0.3,2639,24.5,16527,289,16238,0.4,23.4,26401,14539,11862,20.6,37.4,-9874,-14,46.8,0,2040,2040,12118
2003,51,c) 2,7718,7983,61259,61870,477,5.6,1416,16.6,13824,1865,11959,3,22.3,15046,6765,8281,10.9,24.3,-1222,-2,44.6,0,1112,1112,5732
2003,51,d) 3,7015,7197,56523,57197,340,4.5,1100,14.4,11381,1887,9494,3.3,19.9,12728,5939,6789,10.4,22.3,-1347,-2.4,39.8,0,847,847,4532
2003,51,e) 4,6366,6685,61263,61099,315,4.5,812,11.6,11258,1366,9892,2.2,18.4,10929,4129,6800,6.8,17.9,329,0.5,35.8,0,644,644,3408
2003,51,f) 5,6210,6863,74039,75107,358,5.1,714,10.1,11113,1978,9135,2.6,14.8,13248,5215,8033,6.9,17.6,-2135,-2.8,29.6,0,534,534,4325
2003,51,g) 6 to 10,22933,23902,258568,258890,1007,4.1,2292,9.3,43068,9198,33870,3.6,16.6,43711,15743,27968,6.1,16.9,-643,-0.3,33.2,0,1633,1656,11392
2003,51,h) 11 to 15,16103,17822,257802,257971,641,3.5,1287,7.1,35790,5160,30630,2,13.9,36127,12901,23226,5,14,-337,-0.1,27.8,0,862,864,7523
2003,51,i) 16 to 20,13336,16093,279499,278125,615,3.8,957,5.9,37379,7694,29685,2.8,13.4,34631,9460,25171,3.4,12.5,2748,0.9,25,0,594,596,4210
2003,51,j) 21 to 25,8113,10462,205639,203717,374,3.5,522,4.9,24905,5004,19901,2.5,12.2,21061,4294,16767,2.1,10.3,3844,1.9,20.6,0,328,329,2645
2003,51,k) 26+,1742,3573,77442,79652,222,6.3,159,4.5,10283,2510,7773,3.2,12.9,14703,4343,10360,5.5,18.5,-4420,-5.6,25.8,0,65,65,271
2003,51,l) Left Censored,15848,41533,1433156,1439514,2832,6.9,2142,5.2,158159,54923,103236,3.8,11,170875,40931,129944,2.8,11.9,-12716,-0.9,22,0,495,519,6142
2003,53,a) 0,12406,12431,67201,33601,12431,200,0,0,67201,67201,0,200,200,0,0,0,0,0,67201,200,0,0,,,
2003,53,b) 1,9168,9325,57257,59360,32,0.3,2800,25.8,13965,371,13594,0.6,23.5,18171,11638,6533,19.6,30.6,-4206,-7.1,47,0,2069,2069,9453
2003,53,c) 2,7756,7895,53466,54307,474,5.6,1532,18,11312,1685,9627,3.1,20.8,12993,6254,6739,11.5,23.9,-1681,-3.1,41.6,0,1196,1196,5032
2003,53,d) 3,6986,7190,51654,51975,438,5.7,1183,15.5,10739,2021,8718,3.9,20.7,11381,5282,6099,10.2,21.9,-642,-1.2,41.4,0,901,901,4403
2003,53,e) 4,6554,6857,59859,60478,373,5.2,933,13,10338,1266,9072,2.1,17.1,11576,5073,6503,8.4,19.1,-1238,-2,34.2,0,706,706,4373
2003,53,f) 5,5999,6537,62899,62973,362,5.3,840,12.3,10774,1803,8971,2.9,17.1,10922,4359,6563,6.9,17.3,-148,-0.2,34.2,0,624,624,3597
2003,53,g) 6 to 10,22294,23200,212905,214519,1215,5.1,2555,10.6,34013,5468,28545,2.5,15.9,37241,12394,24847,5.8,17.4,-3228,-1.5,31.8,0,1861,1868,9666
2003,53,h) 11 to 15,14705,16013,185118,185917,753,4.6,1412,8.6,28278,4412,23866,2.4,15.2,29875,11991,17884,6.4,16.1,-1597,-0.9,30.4,0,953,953,5871
2003,53,i) 16 to 20,11207,13601,219143,217482,584,4.2,1011,7.3,29059,5557,23502,2.6,13.4,25737,7545,18192,3.5,11.8,3322,1.6,23.6,0,594,602,3351
2003,53,j) 21 to 25,7899,9756,186662,185508,343,3.5,607,6.1,23436,6583,16853,3.5,12.6,21128,7469,13659,4,11.4,2308,1.2,22.8,0,388,388,2814
2003,53,k) 26+,1653,3199,76389,75658,162,5.1,156,4.9,9579,1993,7586,2.6,12.7,8116,1906,6210,2.5,10.7,1463,2,21.4,0,73,73,481
2003,53,l) Left Censored,12741,29951,966534,974594,1903,6.4,1639,5.5,110260,32827,77433,3.4,11.3,126381,31639,94742,3.2,13,-16121,-1.7,22.6,0,419,421,3589
2003,54,a) 0,2128,2143,13016,6508,2143,200,0,0,13016,,,,200,0,0,0,0,0,13016,200,0,1,,,
2003,54,b) 1,1688,1729,12386,12591,1,0.1,489,24.5,3123,,,,24.8,3533,2003,1530,15.9,28.1,-410,-3.3,49.6,1,377,377,1540
2003,54,c) 2,1416,1432,11082,11179,69,4.5,258,16.8,2235,371,1864,3.3,20,2429,1338,1091,12,21.7,-194,-1.7,40,0,200,200,864
2003,54,d) 3,1386,1438,10951,11218,70,4.6,212,13.9,1827,360,1467,3.2,16.3,2360,791,1569,7.1,21,-533,-4.7,32.6,0,163,163,668
2003,54,e) 4,1252,1307,11338,11435,65,4.8,167,12.2,1877,276,1601,2.4,16.4,2071,735,1336,6.4,18.1,-194,-1.7,32.8,0,124,124,540
2003,54,f) 5,1204,1451,12448,12799,54,3.6,159,10.5,1796,267,1529,2.1,14,2497,1078,1419,8.4,19.5,-701,-5.5,28,0,118,118,910
2003,54,g) 6 to 10,4831,4965,42301,42871,207,4,517,10,6833,868,5965,2,15.9,7972,2277,5695,5.3,18.6,-1139,-2.7,31.8,0,379,379,1778
2003,54,h) 11 to 15,3614,3849,45079,45324,176,4.5,350,8.9,6423,1285,5138,2.8,14.2,6913,2218,4695,4.9,15.3,-490,-1.1,28.4,0,249,250,1397
2003,54,i) 16 to 20,3322,3832,55869,54424,115,3,213,5.5,8468,4603,3865,8.5,15.6,5577,1260,4317,2.3,10.2,2891,5.4,20.4,0,154,155,928
2003,54,j) 21 to 25,2259,2706,37251,38040,63,2.3,163,5.9,3676,597,3079,1.6,9.7,5253,1017,4236,2.7,13.8,-1577,-4.1,19.4,0,115,115,840
2003,54,k) 26+,560,1208,23766,23687,51,4.2,54,4.5,3157,981,2176,4.1,13.3,2999,365,2634,1.5,12.7,158,0.6,25.4,0,16,16,44
2003,54,l) Left Censored,5408,10659,279651,282387,566,5.3,472,4.4,26162,9052,17110,3.2,9.3,31633,6430,25203,2.3,11.2,-5471,-1.9,18.6,0,192,195,2314
2003,55,a) 0,7895,7950,52690,26345,7950,200,0,0,52690,52690,0,200,200,0,0,0,0,0,52690,200,0,0,,,
2003,55,b) 1,6440,6574,49320,51448,26,0.3,1717,22.9,10596,220,10376,0.4,20.6,14852,9475,5377,18.4,28.9,-4256,-8.3,41.2,0,1249,1249,7654
2003,55,c) 2,5467,5681,52574,52563,289,4.8,886,14.7,12718,1106,11612,2.1,24.2,12696,4808,7888,9.1,24.2,22,0,48.4,0,677,677,3723
2003,55,d) 3,5118,5287,45695,45477,228,4.1,773,13.8,8559,974,7585,2.1,18.8,8123,3666,4457,8.1,17.9,436,0.9,35.8,0,580,581,2797
2003,55,e) 4,4684,5031,51966,51599,218,4.1,642,12.2,8708,1741,6967,3.4,16.9,7974,3101,4873,6,15.5,734,1.4,31,0,479,479,2618
2003,55,f) 5,4527,4973,52982,53150,188,3.6,551,10.7,9434,1687,7747,3.2,17.7,9769,2502,7267,4.7,18.4,-335,-0.7,35.4,0,401,401,1934
2003,55,g) 6 to 10,17891,18578,179235,179923,673,3.5,1801,9.4,26192,3526,22666,2,14.6,27567,10233,17334,5.7,15.3,-1375,-0.7,29.2,0,1311,1311,7567
2003,55,h) 11 to 15,12715,13840,162807,164497,435,3.1,1078,7.6,19893,3874,16019,2.4,12.1,23272,8070,15202,4.9,14.1,-3379,-2,24.2,0,703,710,5105
2003,55,i) 16 to 20,10559,12573,205920,208489,365,2.8,791,6.2,20920,3241,17679,1.6,10,26057,6873,19184,3.3,12.5,-5137,-2.5,20,0,533,533,3302
2003,55,j) 21 to 25,7219,8824,157613,159182,258,2.9,549,6.1,16596,3626,12970,2.3,10.4,19734,4533,15201,2.8,12.4,-3138,-2,20.8,0,354,354,2474
2003,55,k) 26+,1676,3391,78831,77458,173,5.1,170,5,10197,2464,7733,3.2,13.2,7451,1268,6183,1.6,9.6,2746,3.6,19.2,0,59,59,354
2003,55,l) Left Censored,17182,34165,1286883,1283371,1647,4.8,1560,4.6,131750,38658,93092,3,10.3,124725,26447,98278,2.1,9.7,7025,0.6,19.4,0,578,595,6814
2003,56,a) 0,1345,1345,5880,2940,1345,200,0,0,5880,5880,0,200,200,0,0,0,0,0,5880,200,0,0,,,
2003,56,b) 1,1159,1167,6838,7112,4,0.3,336,24.9,1537,19,1518,0.3,21.6,2085,1262,823,17.7,29.3,-548,-7.7,43.2,0,250,250,1072
2003,56,c) 2,883,893,5112,5378,41,4.2,177,18.3,924,99,825,1.8,17.2,1455,639,816,11.9,27.1,-531,-9.9,34.4,0,139,139,534
2003,56,d) 3,846,863,5176,5377,46,5.1,125,13.8,842,170,672,3.2,15.7,1243,421,822,7.8,23.1,-401,-7.4,31.4,0,94,94,339
2003,56,e) 4,695,718,4872,4958,32,4.2,96,12.7,805,193,612,3.9,16.2,976,346,630,7,19.7,-171,-3.5,32.4,0,74,74,253
2003,56,f) 5,712,774,6552,6732,36,4.5,87,10.8,796,92,704,1.4,11.8,1155,345,810,5.1,17.2,-359,-5.4,23.6,0,66,66,249
2003,56,g) 6 to 10,2524,2589,20637,20849,129,4.8,258,9.7,3395,580,2815,2.8,16.3,3819,1307,2512,6.3,18.3,-424,-2,32.6,0,170,170,919
2003,56,h) 11 to 15,1547,1662,17751,17972,49,2.9,128,7.5,1959,176,1783,1,10.9,2401,501,1900,2.8,13.4,-442,-2.5,21.8,0,82,82,355
2003,56,i) 16 to 20,1266,1427,16459,16415,56,3.8,110,7.6,2702,391,2311,2.4,16.5,2613,1211,1402,7.4,15.9,89,0.6,31.8,0,67,70,566
2003,56,j) 21 to 25,1162,1348,16568,16602,43,3.1,92,6.7,1804,215,1589,1.3,10.9,1872,330,1542,2,11.3,-68,-0.4,21.8,0,67,69,245
2003,56,k) 26+,231,394,6706,6483,20,5.1,14,3.6,1002,97,905,1.5,15.5,556,65,491,1,8.6,446,6.9,17.2,0,6,6,11
2003,56,l) Left Censored,1883,3283,64592,64429,205,6.3,165,5.1,7707,2240,5467,3.5,12,7380,1991,5389,3.1,11.5,327,0.5,23,0,48,48,520
2004,01,a) 0,6478,6493,40172,20159,6467,199.2,0,0,40026,40026,0,198.6,198.6,0,0,0,0,0,40026,198.6,0,0,,,
2004,01,b) 1,4926,4968,41338,41337,14,0.2,1349,23.6,11364,93,11271,0.2,27.5,11362,7022,4340,17,27.5,2,0,55,0,1140,1140,6349
2004,01,c) 2,4078,4170,37084,37004,148,3.3,737,16.5,8041,701,7340,1.9,21.7,7880,3572,4308,9.7,21.3,161,0.4,42.6,0,612,612,2956
2004,01,d) 3,3561,3713,34892,35174,168,4.3,569,14.5,6801,1418,5383,4,19.3,7365,2863,4502,8.1,20.9,-564,-1.6,38.6,0,470,470,2139
2004,01,e) 4,3319,3485,35202,35434,149,4.1,433,11.9,6321,831,5490,2.3,17.8,6784,2244,4540,6.3,19.1,-463,-1.3,35.6,0,351,351,1872
2004,01,f) 5,3273,3452,35724,35588,117,3.3,372,10.3,6280,565,5715,1.6,17.6,6007,2238,3769,6.3,16.9,273,0.7,33.8,0,289,289,1627
2004,01,g) 6 to 10,13065,13889,149142,149784,485,3.4,1371,9.5,24236,3658,20578,2.4,16.2,25519,9768,15751,6.5,17,-1283,-0.8,32.4,0,1083,1086,6658
2004,01,h) 11 to 15,8533,9469,125238,127156,307,3.2,744,7.7,17797,2011,15786,1.6,14,21632,6879,14753,5.4,17,-3835,-3,28,0,552,552,5414
2004,01,i) 16 to 20,7711,9166,181127,179091,291,3.1,569,6.1,25060,8836,16224,4.9,14,20988,6691,14297,3.7,11.7,4072,2.3,23.4,0,375,385,2734
2004,01,j) 21 to 25,4709,5964,118518,117250,181,3,361,6,15042,2497,12545,2.1,12.8,12506,3921,8585,3.3,10.7,2536,2.1,21.4,0,228,228,1909
2004,01,k) 26+,2024,3808,66388,66682,171,4.5,163,4.3,7144,1979,5165,3,10.7,7731,1486,6245,2.2,11.6,-587,-0.9,21.4,0,97,97,546
2004,01,l) Left Censored,9353,23058,747632,748809,1206,5.2,1524,6.6,85054,21779,63275,2.9,11.4,87407,27898,59509,3.7,11.7,-2353,-0.3,22.8,0,344,346,3188
2004,02,a) 0,1341,1342,5902,2959,1337,199.3,0,0,5886,5886,0,198.9,198.9,0,0,0,0,0,5886,198.9,0,0,,,
2004,02,b) 1,903,918,7363,7330,2,0.2,320,29.4,1801,,,,24.6,1735,1009,726,13.8,23.7,66,0.9,47.4,1,210,210,788
2004,02,c) 2,890,922,6477,6499,67,6.8,165,16.8,1485,,,,22.8,1529,742,787,11.4,23.5,-44,-0.7,45.6,1,120,120,521
2004,02,d) 3,685,698,4781,4758,44,6,122,16.5,1202,124,1078,2.6,25.3,1155,517,638,10.9,24.3,47,1,48.6,0,83,83,361
2004,02,e) 4,689,715,6348,5919,42,5.7,89,12,1692,133,1559,2.2,28.6,834,289,545,4.9,14.1,858,14.5,28.2,0,59,59,209
2004,02,f) 5,564,620,6328,6128,33,5.1,86,13.3,1337,153,1184,2.5,21.8,936,378,558,6.2,15.3,401,6.5,30.6,0,59,59,296
2004,02,g) 6 to 10,2380,2477,20908,21330,130,5.1,298,11.6,3194,454,2740,2.1,15,4037,1444,2593,6.8,18.9,-843,-3.9,30,0,194,194,1114
2004,02,h) 11 to 15,1534,1629,14428,14720,72,4.3,168,10,1974,266,1708,1.8,13.4,2557,884,1673,6,17.4,-583,-4,26.8,0,103,103,618
2004,02,i) 16 to 20,1411,1620,23786,24495,51,3.1,90,5.5,2533,322,2211,1.3,10.3,3950,2012,1938,8.2,16.1,-1417,-5.8,20.6,0,50,50,224
2004,02,j) 21 to 25,1000,1284,21843,22121,44,3.4,64,4.9,2426,279,2147,1.3,11,2981,329,2652,1.5,13.5,-555,-2.5,22,0,37,37,154
2004,02,k) 26+,409,740,14726,14532,34,4.6,27,3.7,1627,339,1288,2.3,11.2,1239,172,1067,1.2,8.5,388,2.7,17,0,15,15,75
2004,02,l) Left Censored,1426,3103,90166,88949,187,6,173,5.6,10635,2737,7898,3.1,12,8201,2280,5921,2.6,9.2,2434,2.8,18.4,0,35,35,652
2004,04,a) 0,10167,10221,63605,31947,10173,199.1,0,0,63316,63316,0,198.2,198.2,0,0,0,0,0,63316,198.2,0,0,,,
2004,04,b) 1,7362,7445,62911,64438,26,0.3,2117,24.5,18125,523,17602,0.8,28.1,21178,12192,8986,18.9,32.9,-3053,-4.8,56.2,0,1701,1701,10524
2004,04,c) 2,6177,6276,61002,61021,243,3.6,1157,17.1,12992,1672,11320,2.7,21.3,13030,6546,6484,10.7,21.4,-38,-0.1,42.6,0,912,912,5427
2004,04,d) 3,5399,5615,51360,51862,218,3.7,852,14.3,8970,1283,7687,2.5,17.3,9974,4166,5808,8,19.2,-1004,-1.9,34.6,0,657,659,3373
2004,04,e) 4,4731,4923,72793,70762,202,3.9,654,12.6,13223,1790,11433,2.5,18.7,9161,3842,5319,5.4,12.9,4062,5.8,25.8,0,494,498,2820
2004,04,f) 5,4381,4608,63837,66692,203,4.2,622,12.9,11011,2187,8824,3.3,16.5,16721,11364,5357,17,25.1,-5710,-8.6,33,0,470,470,10472
2004,04,g) 6 to 10,16027,17102,218061,220851,715,4,1828,10.3,34449,6270,28179,2.8,15.6,40028,15121,24907,6.8,18.1,-5579,-2.5,31.2,0,1347,1352,11653
2004,04,h) 11 to 15,9355,10869,170774,167638,414,3.7,933,8.4,28055,4610,23445,2.7,16.7,21783,8096,13687,4.8,13,6272,3.7,26,0,642,642,4611
2004,04,i) 16 to 20,7460,9500,193716,196658,394,4.1,666,6.9,24098,3496,20602,1.8,12.3,29981,9737,20244,5,15.2,-5883,-2.9,24.6,0,403,407,3082
2004,04,j) 21 to 25,5033,6949,150075,150374,277,3.9,450,6.4,17350,3899,13451,2.6,11.5,17948,5801,12147,3.9,11.9,-598,-0.4,23,0,239,239,1726
2004,04,k) 26+,1660,3215,88107,94530,181,5.7,150,4.7,14538,4643,9895,4.9,15.4,27384,1763,25621,1.9,29,-12846,-13.6,30.8,0,70,70,316
2004,04,l) Left Censored,6814,21202,815192,800519,1779,8.5,1457,6.9,119192,37952,81240,4.7,14.9,89846,25848,63998,3.2,11.2,29346,3.7,22.4,0,192,192,2577
2004,05,a) 0,4448,4466,24585,12311,4452,199.4,0,0,24549,24549,0,199.4,199.4,0,0,0,0,0,24549,199.4,0,0,,,
2004,05,b) 1,3326,3342,22201,22566,8,0.2,946,24.5,6424,,,,28.5,7154,4785,2369,21.2,31.7,-730,-3.2,57,1,790,790,4296
2004,05,c) 2,2824,2876,23365,24030,100,3.2,556,17.8,4455,,,,18.5,5784,2969,2815,12.4,24.1,-1329,-5.6,37,1,465,465,2469
2004,05,d) 3,2421,2518,18695,18847,84,3.1,382,14.3,3285,354,2931,1.9,17.4,3588,1668,1920,8.9,19,-303,-1.6,34.8,0,318,318,1479
2004,05,e) 4,2236,2325,19283,19484,90,3.7,280,11.5,3388,459,2929,2.4,17.4,3789,1558,2231,8,19.4,-401,-2,34.8,0,227,227,1197
2004,05,f) 5,2139,2253,17529,17913,72,3.1,245,10.4,2871,456,2415,2.5,16,3638,1340,2298,7.5,20.3,-767,-4.3,32,0,189,189,1016
2004,05,g) 6 to 10,8229,8847,86882,87480,347,3.8,900,9.8,13115,1844,11271,2.1,15,14311,5188,9123,5.9,16.4,-1196,-1.4,30,0,695,695,4026
2004,05,h) 11 to 15,5485,5954,65139,65241,176,2.9,498,8.1,9056,1506,7550,2.3,13.9,9260,3042,6218,4.7,14.2,-204,-0.3,27.8,0,364,364,1709
2004,05,i) 16 to 20,4626,5524,104527,103938,207,3.7,316,5.7,10958,1964,8994,1.9,10.5,9779,2548,7231,2.5,9.4,1179,1.1,18.8,0,231,231,1577
2004,05,j) 21 to 25,3272,4103,69386,69410,148,3.6,223,5.4,8059,1235,6824,1.8,11.6,8106,2003,6103,2.9,11.7,-47,-0.1,23.2,0,160,160,1293
2004,05,k) 26+,1349,2001,46186,45778,63,3.1,92,4.6,4609,1121,3488,2.4,10.1,3792,858,2934,1.9,8.3,817,1.8,16.6,0,59,59,260
2004,05,l) Left Censored,6262,14169,495534,494836,637,4.5,822,5.8,50838,11392,39446,2.3,10.3,49443,11437,38006,2.3,10,1395,0.3,20,0,234,240,1561
2004,06,a) 0,65111,65337,426911,213845,65057,199.1,0,0,426132,426132,0,199.3,199.3,0,0,0,0,0,426132,199.3,0,0,,,
2004,06,b) 1,49275,49738,398950,407377,103,0.2,14042,24.4,105517,1436,104081,0.4,25.9,122370,69020,53350,16.9,30,-16853,-4.1,51.8,0,11007,11007,58073
2004,06,c) 2,41454,42498,378081,387487,1685,3.7,8086,17.6,75615,8564,67051,2.2,19.5,94427,49805,44622,12.9,24.4,-18812,-4.9,39,0,6382,6382,42543
2004,06,d) 3,35488,36712,332194,342412,1573,4,6089,15.5,60379,7770,52609,2.3,17.6,80814,35308,45506,10.3,23.6,-20435,-6,35.2,0,4664,4667,28701
2004,06,e) 4,31145,32298,322995,332198,1298,3.8,4842,14.1,54811,6997,47814,2.1,16.5,73216,33434,39782,10.1,22,-18405,-5.5,33,0,3687,3687,26828
2004,06,f) 5,27943,29467,318292,326392,1197,3.8,4121,13.2,53125,7314,45811,2.2,16.3,69324,32334,36990,9.9,21.2,-16199,-4.9,32.6,0,3088,3092,25966
2004,06,g) 6 to 10,102223,108844,1391547,1413147,4527,4,12543,11.1,212640,30069,182571,2.1,15,255840,98850,156990,7,18.1,-43200,-3.1,30,0,9488,9495,70787
2004,06,h) 11 to 15,70007,77457,1101232,1109548,2927,3.7,7335,9.2,165036,34762,130274,3.1,14.9,181668,61821,119847,5.6,16.4,-16632,-1.5,29.8,0,5099,5126,38553
2004,06,i) 16 to 20,58872,71345,1315509,1317638,2655,3.6,5524,7.6,169801,42037,127764,3.2,12.9,174060,50487,123573,3.8,13.2,-4259,-0.3,25.8,0,3572,3580,25948
2004,06,j) 21 to 25,41865,53203,1024445,1029694,1879,3.5,3764,6.9,122500,28358,94142,2.8,11.9,132999,40469,92530,3.9,12.9,-10499,-1,23.8,0,2224,2236,19608
2004,06,k) 26+,14581,25462,672592,685922,964,3.7,1421,5.5,79244,21680,57564,3.2,11.6,105903,30718,75185,4.5,15.4,-26659,-3.8,23.2,0,736,747,17109
2004,06,l) Left Censored,53010,139842,5330930,5291567,8785,6.3,9882,7,716702,216995,499707,4.1,13.5,637976,190576,447400,3.6,12.1,78726,1.4,24.2,0,2269,2311,28493
2004,08,a) 0,11670,11716,58979,29563,11661,199.1,0,0,58832,58832,0,199,199,0,0,0,0,0,58832,199,0,0,,,
2004,08,b) 1,8682,8771,60761,63072,26,0.3,2657,26,15754,287,15467,0.5,25,20376,11416,8960,18.1,32.3,-4622,-7.3,50,0,1985,1985,9568
2004,08,c) 2,7350,7481,50671,52653,353,4.4,1525,18.8,9723,1274,8449,2.4,18.5,13686,7659,6027,14.5,26,-3963,-7.5,37,0,1156,1156,6636
2004,08,d) 3,6531,6697,51772,52977,285,4,1126,15.7,9490,1172,8318,2.2,17.9,11900,6392,5508,12.1,22.5,-2410,-4.6,35.8,0,827,834,5203
2004,08,e) 4,5837,6014,53170,53156,294,4.6,876,13.8,9946,1119,8827,2.1,18.7,9917,4206,5711,7.9,18.7,29,0,37.4,0,629,629,3526
2004,08,f) 5,5242,5447,46344,47460,247,4.3,738,12.9,7747,1353,6394,2.9,16.3,9979,4681,5298,9.9,21,-2232,-4.7,32.6,0,538,538,2877
2004,08,g) 6 to 10,19889,20950,211623,212880,905,4.2,2378,10.9,32039,5048,26991,2.4,15.1,34553,12293,22260,5.8,16.2,-2514,-1.1,30.2,0,1678,1678,8613
2004,08,h) 11 to 15,11848,12924,160736,163377,504,3.8,1157,8.7,19837,3560,16277,2.2,12.1,25118,8707,16411,5.3,15.4,-5281,-3.3,24.2,0,741,742,4879
2004,08,i) 16 to 20,8745,10440,174062,178172,419,4,687,6.5,21988,5449,16539,3.1,12.3,30208,9532,20676,5.3,17,-8220,-4.7,24.6,0,417,420,3388
2004,08,j) 21 to 25,6099,8082,162670,164064,345,4.2,501,6.1,19622,6306,13316,3.8,12,22410,5690,16720,3.5,13.7,-2788,-1.7,24,0,257,268,1966
2004,08,k) 26+,2203,3805,87263,88083,157,4.1,192,5,11371,3519,7852,4,12.9,13012,2245,10767,2.5,14.8,-1641,-1.9,25.8,0,70,70,548
2004,08,l) Left Censored,8928,22839,763962,754242,1578,6.9,1583,6.9,102000,44090,57910,5.8,13.5,82561,22097,60464,2.9,10.9,19439,2.6,21.8,0,267,267,3236
2004,09,a) 0,5241,5251,27254,13651,5234,199.4,0,0,27206,27206,0,199.3,199.3,0,0,0,0,0,27206,199.3,0,0,,,
2004,09,b) 1,3827,3852,26839,27132,15,0.3,927,21.3,7050,,,,26,7635,4385,3250,16.2,28.1,-585,-2.1,52,1,704,704,3688
2004,09,c) 2,3592,3665,31059,31608,137,3.5,595,15.2,5347,,,,16.9,6444,2706,3738,8.6,20.4,-1097,-3.5,33.8,1,464,464,2247
2004,09,d) 3,3104,3162,25086,25714,115,3.4,437,13.1,4106,702,3404,2.7,16,5362,2374,2988,9.2,20.9,-1256,-4.9,32,0,353,353,2053
2004,09,e) 4,2959,3076,30009,29907,129,4,413,12.8,4212,525,3687,1.8,14.1,4007,1589,2418,5.3,13.4,205,0.7,26.8,0,308,308,1227
2004,09,f) 5,2701,2798,33661,33226,114,3.9,323,11.1,5078,1085,3993,3.3,15.3,4208,1760,2448,5.3,12.7,870,2.6,25.4,0,239,239,1493
2004,09,g) 6 to 10,11225,11651,112727,117135,380,3.2,1090,9.1,14641,1871,12770,1.6,12.5,23457,10199,13258,8.7,20,-8816,-7.5,25,0,771,771,5174
2004,09,h) 11 to 15,8552,8981,108156,114059,256,2.8,684,7.4,13541,1752,11789,1.5,11.9,25346,15709,9637,13.8,22.2,-11805,-10.3,23.8,0,487,487,14293
2004,09,i) 16 to 20,8023,9025,127368,127790,282,3.1,564,6.1,13431,2655,10776,2.1,10.5,14275,4251,10024,3.3,11.2,-844,-0.7,21,0,356,360,2095
2004,09,j) 21 to 25,5187,6159,98792,98576,215,3.5,332,5.3,9544,1806,7738,1.8,9.7,9111,2112,6999,2.1,9.2,433,0.5,18.4,0,221,228,1267
2004,09,k) 26+,1947,2842,58344,57850,91,3.2,149,5.2,6470,1480,4990,2.6,11.2,5481,1057,4424,1.8,9.5,989,1.7,19,0,96,96,617
2004,09,l) Left Censored,11846,22212,842989,851802,1181,5.3,1278,5.7,80857,23119,57738,2.7,9.5,98484,28062,70422,3.3,11.6,-17627,-2.1,19,0,371,371,2535
2004,10,a) 0,1669,1683,9025,4528,1677,199.3,0,0,8994,8994,0,198.6,198.6,0,0,0,0,0,8994,198.6,0,0,,,
2004,10,b) 1,1352,1354,8726,8960,1,0.1,311,20.5,2223,,,,24.8,2691,1906,785,21.3,30,-468,-5.2,49.6,1,236,236,1713
2004,10,c) 2,1090,1119,7909,8215,41,3.4,193,16.1,1602,,,,19.5,2213,704,1509,8.6,26.9,-611,-7.4,39,1,154,154,607
2004,10,d) 3,1051,1058,6146,6247,29,2.6,119,10.8,990,89,901,1.4,15.8,1191,535,656,8.6,19.1,-201,-3.3,31.6,0,91,91,466
2004,10,e) 4,959,976,7875,7801,39,3.8,145,14.1,1469,185,1284,2.4,18.8,1320,458,862,5.9,16.9,149,1.9,33.8,0,117,117,411
2004,10,f) 5,826,851,7114,7078,38,4.3,106,12,1384,170,1214,2.4,19.6,1312,505,807,7.1,18.5,72,1.1,37,0,85,85,432
2004,10,g) 6 to 10,3060,3226,37671,37845,120,3.6,341,10.2,4224,785,3439,2.1,11.2,4571,1606,2965,4.2,12.1,-347,-0.9,22.4,0,261,261,1360
2004,10,h) 11 to 15,2039,2147,22930,23402,80,3.7,151,6.9,3306,469,2837,2,14.1,4249,1444,2805,6.2,18.2,-943,-4.1,28.2,0,108,108,636
2004,10,i) 16 to 20,1614,1857,25757,25471,76,4,121,6.4,2953,519,2434,2,11.6,2381,734,1647,2.9,9.3,572,2.3,18.6,0,72,77,414
2004,10,j) 21 to 25,1032,1234,25897,25666,46,3.7,70,5.6,2516,538,1978,2.1,9.8,2054,462,1592,1.8,8,462,1.8,16,0,43,45,225
2004,10,k) 26+,470,730,28615,29048,38,5.2,28,3.9,1607,421,1186,1.4,5.5,2472,256,2216,0.9,8.5,-865,-3,11,0,13,13,122
2004,10,l) Left Censored,2960,6135,198356,198843,493,8.1,400,6.6,24951,8258,16693,4.2,12.5,25925,9281,16644,4.7,13,-974,-0.5,25,0,71,71,602
2004,11,a) 0,569,569,5284,2646,563,197.9,0,0,5276,5276,0,199.4,199.4,0,0,0,0,0,5276,199.4,0,0,,,
2004,11,b) 1,725,734,6073,6220,2,0.2,144,17.7,1454,,,,23.4,1748,1070,678,17.2,28.1,-294,-4.7,46.8,1,119,119,984
2004,11,c) 2,795,806,9810,9720,22,2.5,132,15.2,1579,,,,16.2,1399,796,603,8.2,14.4,180,1.8,28.8,1,100,100,720
2004,11,d) 3,692,708,8730,8731,25,3.4,98,13.2,1083,98,985,1.1,12.4,1085,321,764,3.7,12.4,-2,0,24.8,0,74,74,250
2004,11,e) 4,609,624,6773,6817,19,2.9,76,11.6,1019,125,894,1.8,14.9,1106,474,632,7,16.2,-87,-1.3,29.8,0,60,60,299
2004,11,f) 5,585,599,8700,8654,16,2.5,69,11,1142,99,1043,1.1,13.2,1049,437,612,5,12.1,93,1.1,24.2,0,55,57,413
2004,11,g) 6 to 10,2420,2559,34865,34154,79,3,204,7.8,5649,681,4968,2,16.5,4227,1233,2994,3.6,12.4,1422,4.1,24.8,0,158,159,1090
2004,11,h) 11 to 15,1711,1838,34108,34665,75,4,145,7.7,4325,992,3333,2.9,12.5,5438,1442,3996,4.2,15.7,-1113,-3.2,25,0,115,115,930
2004,11,i) 16 to 20,1564,1783,29396,29572,48,2.6,113,6.2,2912,663,2249,2.2,9.8,3264,711,2553,2.4,11,-352,-1.2,19.6,0,64,66,489
2004,11,j) 21 to 25,1223,1420,28814,28977,64,4.4,121,8.3,2878,798,2080,2.8,9.9,3203,1041,2162,3.6,11.1,-325,-1.2,19.8,0,61,61,246
2004,11,k) 26+,528,804,32786,30888,45,5.6,39,4.9,5359,774,4585,2.5,17.3,1562,505,1057,1.6,5.1,3797,12.2,10.2,0,14,14,189
2004,11,l) Left Censored,3222,5666,232372,230319,440,7.8,409,7.2,26081,7637,18444,3.3,11.3,21975,5411,16564,2.3,9.5,4106,1.8,19,0,81,81,609
2004,12,a) 0,49839,50029,249851,125416,49801,199.1,0,0,248870,248870,0,198.4,198.4,0,0,0,0,0,248870,198.4,0,0,,,
2004,12,b) 1,31414,31620,238336,241747,70,0.2,9984,26.9,65171,1223,63948,0.5,27,71992,45889,26103,19,29.8,-6821,-2.8,54,0,7967,7967,39825
2004,12,c) 2,24607,25018,191650,195817,1022,3.7,5269,19.3,49479,4973,44506,2.5,25.3,57812,34257,23555,17.5,29.5,-8333,-4.2,50.6,0,4253,4253,30337
2004,12,d) 3,20370,20799,193786,182648,904,4.1,3480,15.7,57679,4368,53311,2.4,31.6,35403,17715,17688,9.7,19.4,22276,12.2,38.8,0,2707,2709,14557
2004,12,e) 4,17726,18320,174096,173486,802,4.2,2623,13.6,39589,7546,32043,4.3,22.8,38368,19599,18769,11.3,22.1,1221,0.7,44.2,0,1997,1997,12161
2004,12,f) 5,16296,17169,158667,163107,745,4.1,2364,13.1,31726,4232,27494,2.6,19.5,40605,21982,18623,13.5,24.9,-8879,-5.4,39,0,1741,1781,17861
2004,12,g) 6 to 10,59840,63090,728060,739480,2772,4.2,7071,10.8,137224,32837,104387,4.4,18.6,160064,51536,108528,7,21.6,-22840,-3,37.2,0,5265,5270,41176
2004,12,h) 11 to 15,39663,43905,584346,579593,1635,3.6,3837,8.5,92164,18314,73850,3.2,15.9,82659,32430,50229,5.6,14.3,9505,1.6,28.6,0,2756,2778,21045
2004,12,i) 16 to 20,28474,34095,638243,692022,1316,3.8,2559,7.4,82752,18092,64660,2.6,12,190310,92151,98159,13.3,27.5,-107558,-15.5,24,0,1659,1702,10380
2004,12,j) 21 to 25,17520,22301,439602,438741,1018,4.5,1625,7.2,60093,12023,48070,2.7,13.7,58370,14970,43400,3.4,13.3,1723,0.4,26.6,0,1002,1026,6863
2004,12,k) 26+,5829,10598,225272,225019,433,4,607,5.7,30206,9110,21096,4,13.4,29699,6731,22968,3,13.2,507,0.2,26.4,0,307,312,2584
2004,12,l) Left Censored,22569,73659,2660997,2658468,5505,7.5,5511,7.5,359479,109750,249729,4.1,13.5,354421,149180,205241,5.6,13.3,5058,0.2,26.6,0,887,958,9556
2004,13,a) 0,16750,16862,98547,49413,16786,199.1,0,0,98269,98269,0,198.9,198.9,0,0,0,0,0,98269,198.9,0,0,,,
2004,13,b) 1,12152,12247,90165,95324,37,0.3,3592,25.3,24793,918,23875,1,26,35110,20718,14392,21.7,36.8,-10317,-10.8,52,0,2867,2867,17982
2004,13,c) 2,10289,10536,92493,92574,475,4.2,1937,17.1,19304,2193,17111,2.4,20.9,19466,9938,9528,10.7,21,-162,-0.1,41.8,0,1544,1544,8231
2004,13,d) 3,8793,9062,81260,80709,361,3.8,1338,13.9,16387,2219,14168,2.7,20.3,15285,6056,9229,7.5,18.9,1102,1.4,37.8,0,1037,1037,4958
2004,13,e) 4,8111,8510,79969,78830,376,4.2,1112,12.5,15833,2338,13495,3,20.1,13555,5870,7685,7.4,17.2,2278,2.9,34.4,0,856,856,4612
2004,13,f) 5,7390,7783,82689,83078,329,4,982,12.1,14155,2029,12126,2.4,17,14933,6419,8514,7.7,18,-778,-1,34,0,721,726,5298
2004,13,g) 6 to 10,27585,29164,343205,343266,1231,4.1,3029,10,59099,9556,49543,2.8,17.2,59220,21558,37662,6.3,17.3,-121,-0.1,34.4,0,2207,2226,16877
2004,13,h) 11 to 15,16480,18564,267952,266883,659,3.5,1512,7.9,39958,8181,31777,3.1,15,37819,12981,24838,4.9,14.2,2139,0.8,28.4,0,1057,1058,7071
2004,13,i) 16 to 20,13350,16121,299378,304130,568,3.5,998,6.1,37530,10390,27140,3.4,12.3,47034,9515,37519,3.1,15.5,-9504,-3.2,24.6,0,630,636,4406
2004,13,j) 21 to 25,8187,10871,217646,217212,408,3.7,671,6.1,25662,4698,20964,2.2,11.8,24794,6573,18221,3,11.4,868,0.4,22.8,0,380,380,2364
2004,13,k) 26+,3196,5684,151334,147288,257,4.5,268,4.7,23573,6094,17479,4.1,16,15480,4309,11171,2.9,10.5,8093,5.5,21,0,134,136,2308
2004,13,l) Left Censored,14652,42135,1617504,1608958,2746,6.5,2695,6.4,207315,63409,143906,3.9,12.9,190223,57632,132591,3.6,11.8,17092,1.1,23.6,0,488,494,4576
2004,15,a) 0,2008,2026,12037,6029,2015,198.9,0,0,12017,12017,0,199.3,199.3,0,0,0,0,0,12017,199.3,0,0,,,
2004,15,b) 1,1543,1649,12803,13487,25,1.4,362,19.7,2897,,,,21.5,4265,2201,2064,16.3,31.6,-1368,-10.1,43,1,291,291,1826
2004,15,c) 2,1344,1380,11500,11951,41,2.8,228,15.4,2136,,,,17.9,3038,1782,1256,14.9,25.4,-902,-7.5,35.8,1,179,179,1417
2004,15,d) 3,1099,1126,10284,10301,45,3.8,172,14.4,1870,367,1503,3.6,18.2,1904,945,959,9.2,18.5,-34,-0.3,36.4,0,131,131,830
2004,15,e) 4,1012,1068,10285,10347,35,3.1,157,13.9,1662,224,1438,2.2,16.1,1786,755,1031,7.3,17.3,-124,-1.2,32.2,0,124,124,571
2004,15,f) 5,907,942,10204,10361,29,3,88,9,1415,116,1299,1.1,13.7,1728,574,1154,5.5,16.7,-313,-3,27.4,0,62,62,449
2004,15,g) 6 to 10,3686,3869,45663,45729,132,3.3,331,8.3,5046,446,4600,1,11,5178,1599,3579,3.5,11.3,-132,-0.3,22,0,248,248,1263
2004,15,h) 11 to 15,2750,3021,36568,36770,128,4.2,230,7.5,4383,815,3568,2.2,11.9,4787,1347,3440,3.7,13,-404,-1.1,23.8,0,157,157,898
2004,15,i) 16 to 20,2343,2830,46546,46369,90,3.1,137,4.8,4609,1317,3292,2.8,9.9,4254,1353,2901,2.9,9.2,355,0.7,18.4,0,107,107,898
2004,15,j) 21 to 25,1998,2499,42128,42119,73,2.9,145,5.7,3951,429,3522,1,9.4,3933,1333,2600,3.2,9.3,18,0.1,18.6,0,87,87,585
2004,15,k) 26+,750,1160,16130,16142,37,3.2,58,5,1799,560,1239,3.5,11.1,1823,375,1448,2.3,11.3,-24,-0.2,22.2,0,22,22,68
2004,15,l) Left Censored,3434,6999,217946,214818,357,5.1,358,5.1,24379,5476,18903,2.5,11.3,18123,4141,13982,1.9,8.4,6256,2.9,16.8,0,101,101,705
2004,16,a) 0,3397,3407,18014,9026,3391,199.1,0,0,17977,17977,0,199.2,199.2,0,0,0,0,0,17977,199.2,0,0,,,
2004,16,b) 1,2327,2363,15240,15556,8,0.3,766,27.5,3762,,,,24.2,4394,2581,1813,16.6,28.2,-632,-4,48.4,1,554,554,2064
2004,16,c) 2,1999,2040,18926,19048,73,3.3,348,15.9,2711,425,2286,2.2,14.2,2955,1327,1628,7,15.5,-244,-1.3,28.4,0,242,242,1009
2004,16,d) 3,1782,1842,14883,14770,95,4.9,261,13.5,2775,423,2352,2.9,18.8,2549,1131,1418,7.7,17.3,226,1.5,34.6,0,194,194,968
2004,16,e) 4,1610,1671,14606,15650,68,3.9,224,12.7,2377,343,2034,2.2,15.2,4464,1101,3363,7,28.5,-2087,-13.3,30.4,0,172,172,813
2004,16,f) 5,1500,1556,13009,12758,77,4.7,197,12.1,2531,459,2072,3.6,19.8,2028,994,1034,7.8,15.9,503,3.9,31.8,0,151,151,798
2004,16,g) 6 to 10,5701,5976,54390,54320,276,4.5,555,9,7599,1139,6460,2.1,14,7459,2549,4910,4.7,13.7,140,0.3,27.4,0,389,393,1984
2004,16,h) 11 to 15,3314,3540,36168,36203,154,4.2,297,8.2,4799,574,4225,1.6,13.3,4868,1954,2914,5.4,13.4,-69,-0.1,26.6,0,173,177,997
2004,16,i) 16 to 20,2363,2760,48675,44795,100,3.6,182,6.5,14237,,,,31.8,6476,1723,4753,3.8,14.5,7761,17.3,29,1,103,103,659
2004,16,j) 21 to 25,1735,2218,44321,44374,85,3.8,101,4.5,3975,838,3137,1.9,9,4081,1102,2979,2.5,9.2,-106,-0.2,18,0,53,53,325
2004,16,k) 26+,690,1029,21407,20563,46,4.5,52,5,3854,1265,2589,6.2,18.7,2167,449,1718,2.2,10.5,1687,8.2,21,0,25,25,110
2004,16,l) Left Censored,3137,6731,186167,186057,401,6,391,5.8,20876,7667,13209,4.1,11.2,20657,6660,13997,3.6,11.1,219,0.1,22.2,0,80,80,576
2004,17,a) 0,19661,19722,120912,60666,19624,199,0,0,120492,120492,0,198.6,198.6,0,0,0,0,0,120492,198.6,0,0,,,
2004,17,b) 1,14588,14840,115586,117657,66,0.4,3934,23.2,30189,880,29309,0.7,25.7,34330,19634,14696,16.7,29.2,-4141,-3.5,51.4,0,2849,2849,16378
2004,17,c) 2,12438,12678,107823,111872,455,3.3,2214,16.3,18736,1713,17023,1.5,16.7,26833,13354,13479,11.9,24,-8097,-7.3,33.4,0,1673,1673,10750
2004,17,d) 3,11026,11330,92811,94806,465,3.9,1628,13.6,15987,2790,13197,2.9,16.9,19977,9864,10113,10.4,21.1,-3990,-4.2,33.8,0,1176,1176,8668
2004,17,e) 4,10416,10747,102577,104479,434,3.9,1341,11.9,18483,2989,15494,2.9,17.7,22286,7281,15005,7,21.3,-3803,-3.6,35.4,0,980,982,5454
2004,17,f) 5,9608,10130,124781,123906,379,3.6,1170,11.1,19979,1433,18546,1.2,16.1,18229,6634,11595,5.4,14.7,1750,1.4,29.4,0,843,843,4878
2004,17,g) 6 to 10,39468,41314,456915,458699,1521,3.6,4266,10,71556,10065,61491,2.2,15.6,75124,27568,47556,6,16.4,-3568,-0.8,31.2,0,3008,3019,21710
2004,17,h) 11 to 15,27819,30094,392094,397186,980,3.2,2409,7.8,53175,7832,45343,2,13.4,63359,17655,45704,4.4,16,-10184,-2.6,26.8,0,1592,1597,10532
2004,17,i) 16 to 20,22879,26612,483935,486786,824,3,1816,6.7,50057,9024,41033,1.9,10.3,55759,14664,41095,3,11.5,-5702,-1.2,20.6,0,1114,1179,8982
2004,17,j) 21 to 25,15757,19338,401909,405063,571,2.9,1103,5.6,40972,9857,31115,2.4,10.1,47280,10305,36975,2.5,11.7,-6308,-1.6,20.2,0,661,661,4954
2004,17,k) 26+,6150,9961,224597,224179,305,3,473,4.7,23661,4549,19112,2,10.6,22824,5228,17596,2.3,10.2,837,0.4,20.4,0,240,243,1557
2004,17,l) Left Censored,32575,70014,2588014,2595724,3720,5.3,4395,6.2,286532,72599,213933,2.8,11,301952,82950,219002,3.2,11.6,-15420,-0.6,22,0,1190,1197,12702
2004,18,a) 0,8778,8822,56068,28091,8778,199,0,0,55954,55954,0,199.2,199.2,0,0,0,0,0,55954,199.2,0,0,,,
2004,18,b) 1,6430,6531,54812,56544,29,0.4,1870,24.8,13281,678,12603,1.2,23.5,16745,10545,6200,18.6,29.6,-3464,-6.1,47,0,1468,1468,9158
2004,18,c) 2,5922,6018,56216,56148,192,3,1040,16.1,11439,1373,10066,2.4,20.4,11303,5575,5728,9.9,20.1,136,0.3,40.2,0,850,850,4860
2004,18,d) 3,5003,5251,45752,45797,201,3.6,757,13.7,8064,832,7232,1.8,17.6,8154,3691,4463,8.1,17.8,-90,-0.2,35.2,0,587,587,2899
2004,18,e) 4,4714,4901,46428,47382,204,4,632,12.3,7812,1253,6559,2.6,16.5,9719,4117,5602,8.7,20.5,-1907,-4,33,0,489,489,3155
2004,18,f) 5,4372,4607,50013,51037,139,2.9,500,10.4,7666,855,6811,1.7,15,9714,4114,5600,8.1,19,-2048,-4,30,0,361,361,2016
2004,18,g) 6 to 10,18069,19320,214910,217104,690,3.5,1888,9.5,31233,5025,26208,2.3,14.4,35620,15085,20535,6.9,16.4,-4387,-2,28.8,0,1442,1442,10904
2004,18,h) 11 to 15,13011,14445,191471,190154,404,2.7,1077,7.3,27455,3436,24019,1.8,14.4,24820,7750,17070,4.1,13.1,2635,1.3,26.2,0,737,737,5133
2004,18,i) 16 to 20,11010,13407,226295,228628,418,3.1,722,5.3,23010,4648,18362,2,10.1,27676,7475,20201,3.3,12.1,-4666,-2,20.2,0,487,488,4060
2004,18,j) 21 to 25,7297,8863,166062,165636,297,3.3,470,5.2,17423,3008,14415,1.8,10.5,16570,4541,12029,2.7,10,853,0.5,20,0,298,299,2299
2004,18,k) 26+,2902,5081,117312,115223,338,6.7,257,5.1,15998,7750,8248,6.7,13.9,11819,2886,8933,2.5,10.3,4179,3.6,20.6,0,128,130,1212
2004,18,l) Left Censored,16091,37156,1351156,1346317,1744,4.7,1767,4.8,141071,34929,106142,2.6,10.5,131394,32297,99097,2.4,9.8,9677,0.7,19.6,0,457,460,4287
2004,19,a) 0,4390,4407,24498,12296,4376,198.6,0,0,24404,24404,0,198.5,198.5,0,0,0,0,0,24404,198.5,0,0,,,
2004,19,b) 1,3381,3439,24913,25625,7,0.2,884,22.5,5462,56,5406,0.2,21.3,6886,3966,2920,15.5,26.9,-1424,-5.6,42.6,0,676,676,3210
2004,19,c) 2,2923,3015,23194,23601,109,3.4,526,16.3,4319,399,3920,1.7,18.3,5132,2623,2509,11.1,21.7,-813,-3.4,36.6,0,412,412,2239
2004,19,d) 3,2516,2582,18880,19220,102,3.8,344,12.7,2991,299,2692,1.6,15.6,3670,1442,2228,7.5,19.1,-679,-3.5,31.2,0,264,264,1098
2004,19,e) 4,2462,2542,24496,24464,93,3.5,334,12.5,3454,477,2977,1.9,14.1,3389,1427,1962,5.8,13.9,65,0.2,27.8,0,242,242,1203
2004,19,f) 5,2258,2421,22280,22484,92,3.7,274,10.9,3019,249,2770,1.1,13.4,3426,1427,1999,6.3,15.2,-407,-1.8,26.8,0,202,202,993
2004,19,g) 6 to 10,9646,10140,93460,92987,385,3.7,952,9.1,14421,2865,11556,3.1,15.5,13474,4801,8673,5.2,14.5,947,1,29,0,706,708,3494
2004,19,h) 11 to 15,6767,7306,79540,79980,230,3.1,559,7.5,9986,1516,8470,1.9,12.5,10865,3371,7494,4.2,13.6,-879,-1.1,25,0,356,362,2082
2004,19,i) 16 to 20,5925,6999,119902,120668,212,3,463,6.5,9885,1194,8691,1,8.2,11416,3294,8122,2.7,9.5,-1531,-1.3,16.4,0,299,299,1890
2004,19,j) 21 to 25,4465,5821,87083,86688,162,2.7,297,5,9811,1654,8157,1.9,11.3,9020,2589,6431,3,10.4,791,0.9,20.8,0,203,203,923
2004,19,k) 26+,1997,3440,56396,55764,131,3.8,150,4.3,6890,2564,4326,4.6,12.4,5626,1975,3651,3.5,10.1,1264,2.3,20.2,0,77,77,338
2004,19,l) Left Censored,10884,20850,660620,663168,797,3.8,1112,5.3,64223,14170,50053,2.1,9.7,69319,20030,49289,3,10.5,-5096,-0.8,19.4,0,339,340,2979
2004,20,a) 0,4653,4671,26526,13290,4645,198.9,0,0,26473,26473,0,199.2,199.2,0,0,0,0,0,26473,199.2,0,0,,,
2004,20,b) 1,3579,3613,27084,27428,19,0.5,954,23.1,7554,515,7039,1.9,27.5,8242,5402,2840,19.7,30,-688,-2.5,55,0,747,747,4092
2004,20,c) 2,3067,3133,24508,26087,118,3.5,567,16.8,3613,440,3173,1.7,13.8,6770,3720,3050,14.3,26,-3157,-12.2,27.6,0,463,463,2419
2004,20,d) 3,2717,2782,21579,22294,95,3.2,366,12.5,3666,504,3162,2.3,16.4,5096,2729,2367,12.2,22.9,-1430,-6.5,32.8,0,292,292,2533
2004,20,e) 4,2470,2528,23613,23868,84,3.1,354,13.2,3705,489,3216,2,15.5,4214,1930,2284,8.1,17.7,-509,-2.2,31,0,269,269,1437
2004,20,f) 5,2304,2440,20967,21376,111,4.4,313,12.3,3066,709,2357,3.3,14.3,3884,1649,2235,7.7,18.2,-818,-3.9,28.6,0,231,231,1264
2004,20,g) 6 to 10,9342,9940,100352,101227,343,3.3,937,9.1,14977,3827,11150,3.8,14.8,16726,5801,10925,5.7,16.5,-1749,-1.7,29.6,0,716,716,4507
2004,20,h) 11 to 15,6257,6816,82816,83362,245,3.5,566,8.1,10299,2089,8210,2.5,12.4,11390,3119,8271,3.7,13.7,-1091,-1.3,24.8,0,354,355,1705
2004,20,i) 16 to 20,5386,6197,88280,89129,194,3.1,404,6.4,7348,1208,6140,1.4,8.2,9046,2529,6517,2.8,10.1,-1698,-1.9,16.4,0,272,272,1725
2004,20,j) 21 to 25,4070,5006,72550,72628,192,3.8,280,5.5,8861,2537,6324,3.5,12.2,9017,2488,6529,3.4,12.4,-156,-0.2,24.4,0,182,182,1013
2004,20,k) 26+,1653,2901,53121,53030,112,3.9,88,3,5335,2037,3298,3.8,10.1,5152,1008,4144,1.9,9.7,183,0.4,19.4,0,44,44,643
2004,20,l) Left Censored,8820,17863,563399,568583,819,4.6,998,5.6,54250,14400,39850,2.5,9.5,64620,15513,49107,2.7,11.4,-10370,-1.9,19,0,246,247,2099
2004,21,a) 0,5566,5595,39365,19736,5567,199,0,0,39259,39259,0,198.9,198.9,0,0,0,0,0,39259,198.9,0,0,,,
2004,21,b) 1,4074,4114,31914,32946,17,0.4,1144,24.2,8341,96,8245,0.3,25.3,10404,6429,3975,19.5,31.6,-2063,-6.3,50.6,0,938,938,5730
2004,21,c) 2,3581,3648,32219,32801,121,3.1,697,17.7,7029,695,6334,2.1,21.4,8192,4281,3911,13.1,25,-1163,-3.6,42.8,0,568,568,3721
2004,21,d) 3,3251,3336,27146,27819,117,3.3,473,13.4,4501,618,3883,2.2,16.2,5846,2717,3129,9.8,21,-1345,-4.8,32.4,0,389,389,2069
2004,21,e) 4,2970,3103,27597,28117,112,3.4,396,12.2,4248,419,3829,1.5,15.1,5288,2512,2776,8.9,18.8,-1040,-3.7,30.2,0,317,317,2047
2004,21,f) 5,2883,3109,32811,33867,100,3.1,357,11,4391,542,3849,1.6,13,6502,3189,3313,9.4,19.2,-2111,-6.2,26,0,292,292,2909
2004,21,g) 6 to 10,11372,12122,126757,128078,422,3.4,1138,9.1,18819,3249,15570,2.5,14.7,21460,8514,12946,6.6,16.8,-2641,-2.1,29.4,0,890,890,6843
2004,21,h) 11 to 15,8057,8987,112293,113446,253,2.7,682,7.4,14104,2079,12025,1.8,12.4,16409,5579,10830,4.9,14.5,-2305,-2.1,24.8,0,467,468,3048
2004,21,i) 16 to 20,7094,8311,141699,142738,245,2.9,491,5.8,13776,2409,11367,1.7,9.7,15855,3444,12411,2.4,11.1,-2079,-1.4,19.4,0,302,302,1982
2004,21,j) 21 to 25,4347,5356,100040,99897,165,3,330,6.1,10689,1877,8812,1.9,10.7,10403,3081,7322,3.1,10.4,286,0.3,20.8,0,198,198,1126
2004,21,k) 26+,1760,3162,67118,67678,130,4.1,123,3.9,6656,1576,5080,2.3,9.8,7775,2098,5677,3.1,11.5,-1119,-1.7,19.6,0,70,70,661
2004,21,l) Left Censored,9616,22066,748230,742418,1134,5.1,1183,5.4,84817,24200,60617,3.3,11.4,73192,19810,53382,2.7,9.9,11625,1.5,19.8,0,279,284,1950
2004,22,a) 0,6476,6525,45813,22973,6491,199,0,0,45680,45680,0,198.8,198.8,0,0,0,0,0,45680,198.8,0,0,,,
2004,22,b) 1,4884,4940,42381,43180,16,0.3,1307,23.1,11449,125,11324,0.3,26.5,13047,7203,5844,16.7,30.2,-1598,-3.7,53,0,1076,1076,6359
2004,22,c) 2,4255,4353,45581,45305,142,3,729,15.6,9807,823,8984,1.8,21.6,9255,3555,5700,7.8,20.4,552,1.2,40.8,0,592,592,3003
2004,22,d) 3,3737,3844,40052,42383,110,2.7,550,13.5,7414,434,6980,1,17.5,12075,7892,4183,18.6,28.5,-4661,-11,35,0,434,434,7405
2004,22,e) 4,3369,3522,45264,45649,99,2.7,419,11.3,7117,471,6646,1,15.6,7887,3373,4514,7.4,17.3,-770,-1.7,31.2,0,341,341,2650
2004,22,f) 5,3105,3264,33476,33539,115,3.4,374,11,5880,727,5153,2.2,17.5,6005,2042,3963,6.1,17.9,-125,-0.4,35,0,305,305,1789
2004,22,g) 6 to 10,13213,13871,162226,162510,441,3.1,1236,8.6,25106,2604,22502,1.6,15.4,25673,8400,17273,5.2,15.8,-567,-0.4,30.8,0,980,997,6761
2004,22,h) 11 to 15,8825,9838,129922,132294,283,2.8,721,7.1,17045,2552,14493,1.9,12.9,21788,6053,15735,4.6,16.5,-4743,-3.6,25.8,0,527,527,3953
2004,22,i) 16 to 20,7502,8884,145921,145863,262,2.9,535,5.9,16743,2008,14735,1.4,11.5,16627,4260,12367,2.9,11.4,116,0.1,22.8,0,364,364,2125
2004,22,j) 21 to 25,6331,7883,141638,141754,198,2.5,414,5.2,18272,1774,16498,1.3,12.9,18503,4042,14461,2.9,13.1,-231,-0.2,25.8,0,256,256,1856
2004,22,k) 26+,2148,3385,59364,59391,110,3.2,148,4.3,7383,1575,5808,2.7,12.4,7437,1155,6282,1.9,12.5,-54,-0.1,24.8,0,96,96,415
2004,22,l) Left Censored,10436,23339,710582,715778,1173,5,1398,6,70428,16532,53896,2.3,9.8,80819,23439,57380,3.3,11.3,-10391,-1.5,19.6,0,342,342,2227
2004,23,a) 0,2609,2610,11809,5912,2599,199.2,0,0,11795,11795,0,199.5,199.5,0,0,0,0,0,11795,199.5,0,0,,,
2004,23,b) 1,1882,1899,12166,13087,2,0.1,554,25.2,2528,,,,19.3,4370,3037,1333,23.2,33.4,-1842,-14.1,38.6,1,415,415,2685
2004,23,c) 2,1739,1766,11705,11997,72,3.8,309,16.3,1992,,,,16.6,2575,1209,1366,10.1,21.5,-583,-4.9,33.2,1,222,222,907
2004,23,d) 3,1640,1675,10764,10973,71,4,222,12.6,1595,195,1400,1.8,14.5,2012,767,1245,7,18.3,-417,-3.8,29,0,168,168,571
2004,23,e) 4,1442,1506,11758,11978,56,3.5,189,12,1571,253,1318,2.1,13.1,2010,725,1285,6.1,16.8,-439,-3.7,26.2,0,138,138,540
2004,23,f) 5,1392,1423,10232,10473,48,3.2,190,12.7,1507,223,1284,2.1,14.4,1989,927,1062,8.9,19,-482,-4.6,28.8,0,129,129,679
2004,23,g) 6 to 10,5362,5647,46433,46648,200,3.4,566,9.7,6606,1065,5541,2.3,14.2,7035,2592,4443,5.6,15.1,-429,-0.9,28.4,0,399,408,2065
2004,23,h) 11 to 15,3591,3817,37072,37294,123,3.1,288,7.4,4520,1086,3434,2.9,12.1,4964,1706,3258,4.6,13.3,-444,-1.2,24.2,0,194,194,839
2004,23,i) 16 to 20,3260,3762,47647,47838,129,3.4,257,6.7,4514,998,3516,2.1,9.4,4895,1833,3062,3.8,10.2,-381,-0.8,18.8,0,168,168,1163
2004,23,j) 21 to 25,1934,2474,40199,40341,82,3.3,135,5.4,3859,392,3467,1,9.6,4142,1470,2672,3.6,10.3,-283,-0.7,19.2,0,63,69,498
2004,23,k) 26+,791,1397,25489,25674,33,2.4,44,3.1,1770,259,1511,1,6.9,2139,439,1700,1.7,8.3,-369,-1.4,13.8,0,26,26,104
2004,23,l) Left Censored,3885,7410,220363,219906,344,4.6,329,4.4,19219,3313,15906,1.5,8.7,18305,4176,14129,1.9,8.3,914,0.4,16.6,0,102,102,823
2004,24,a) 0,9240,9278,52417,26273,9232,199,0,0,52288,52288,0,199,199,0,0,0,0,0,52288,199,0,0,,,
2004,24,b) 1,6724,6781,50956,53554,22,0.3,1850,23.8,14012,327,13685,0.6,26.2,19208,12713,6495,23.7,35.9,-5196,-9.7,52.4,0,1432,1432,11540
2004,24,c) 2,6128,6224,54941,55395,255,3.8,1010,15.2,11213,1797,9416,3.2,20.2,12120,6811,5309,12.3,21.9,-907,-1.7,40.4,0,780,780,5500
2004,24,d) 3,5244,5356,44649,44488,223,4,713,12.7,8668,1188,7480,2.7,19.5,8345,3958,4387,8.9,18.8,323,0.7,37.6,0,543,543,3254
2004,24,e) 4,4753,4911,45041,44643,173,3.4,554,10.8,8416,800,7616,1.8,18.9,7620,3457,4163,7.7,17.1,796,1.8,34.2,0,418,418,2751
2004,24,f) 5,4435,4687,54337,52885,183,3.8,515,10.6,12111,1184,10927,2.2,22.9,9206,3721,5485,7,17.4,2905,5.5,34.8,0,368,369,2741
2004,24,g) 6 to 10,17503,18341,199890,199140,712,3.8,1685,8.9,30009,4841,25168,2.4,15.1,28508,10044,18464,5,14.3,1501,0.8,28.6,0,1223,1225,7810
2004,24,h) 11 to 15,12260,13451,194867,192078,438,3.2,980,7.1,27684,3707,23977,1.9,14.4,22106,6924,15182,3.6,11.5,5578,2.9,23,0,609,609,4065
2004,24,i) 16 to 20,10064,11683,197434,196186,380,3.2,729,6.1,24319,4932,19387,2.5,12.4,21823,5833,15990,3,11.1,2496,1.3,22.2,0,457,471,3260
2004,24,j) 21 to 25,6113,7588,140304,141974,254,3.3,402,5.2,15975,3062,12913,2.2,11.3,19314,3215,16099,2.3,13.6,-3339,-2.3,22.6,0,229,229,1761
2004,24,k) 26+,2302,3817,92975,91895,132,3.4,178,4.6,10616,2863,7753,3.1,11.6,8456,1746,6710,1.9,9.2,2160,2.4,18.4,0,110,110,937
2004,24,l) Left Censored,12042,27738,1005173,1000289,1565,5.6,1717,6.2,118971,37278,81693,3.7,11.9,109205,33771,75434,3.4,10.9,9766,1,21.8,0,401,401,3792
2004,25,a) 0,10699,10756,60318,30217,10723,199.4,0,0,60203,60203,0,199.2,199.2,0,0,0,0,0,60203,199.2,0,0,,,
2004,25,b) 1,8098,8169,57207,59281,19,0.2,3523,35.2,15729,376,15353,0.6,26.5,19876,10848,9028,18.3,33.5,-4147,-7,53,0,2994,2994,9334
2004,25,c) 2,7120,7236,61511,63668,295,3.7,1495,19,9513,1278,8235,2,14.9,13827,6729,7098,10.6,21.7,-4314,-6.8,29.8,0,1227,1227,5716
2004,25,d) 3,6272,6429,54932,55787,243,3.5,1266,18.2,9122,1344,7778,2.4,16.4,10832,4749,6083,8.5,19.4,-1710,-3,32.8,0,1045,1045,4020
2004,25,e) 4,5856,6058,54306,54269,261,4,1073,16.5,10127,1155,8972,2.1,18.7,10052,4735,5317,8.7,18.5,75,0.2,37,0,862,862,3712
2004,25,f) 5,5666,5918,57425,58263,193,3,1250,19.3,9411,3069,6342,5.3,16.2,11087,5435,5652,9.3,19,-1676,-2.8,32.4,0,1070,1070,4422
2004,25,g) 6 to 10,22051,22889,234535,239324,801,3.4,2158,9.1,29636,4233,25403,1.8,12.4,39213,13053,26160,5.5,16.4,-9577,-4,24.8,0,1598,1598,10285
2004,25,h) 11 to 15,14704,15857,209007,209033,471,2.9,1177,7.2,27977,6020,21957,2.9,13.4,28029,8426,19603,4,13.4,-52,0,26.8,0,831,831,4973
2004,25,i) 16 to 20,14192,16756,287350,289013,584,3.4,1059,6.2,29872,6715,23157,2.3,10.3,33197,10090,23107,3.5,11.5,-3325,-1.2,20.6,0,665,668,4199
2004,25,j) 21 to 25,8957,10945,253970,252778,299,2.7,647,5.8,26469,4247,22222,1.7,10.5,24085,5944,18141,2.4,9.5,2384,1,19,0,366,384,2333
2004,25,k) 26+,3392,5506,149618,150092,169,3.1,232,4.2,13996,3022,10974,2,9.3,14943,3374,11569,2.2,10,-947,-0.7,18.6,0,120,120,954
2004,25,l) Left Censored,20065,39287,1487317,1496199,1857,4.7,2350,5.9,151691,45520,106171,3,10.1,169456,45507,123949,3,11.3,-17765,-1.2,20.2,0,666,670,7030
2004,26,a) 0,14101,14179,115830,58063,14107,199,0,0,115535,115535,0,199,199,0,0,0,0,0,115535,199,0,0,,,
2004,26,b) 1,10657,10798,96937,106625,39,0.3,2940,23.7,24043,658,23385,0.6,22.5,43418,16441,26977,15.4,40.7,-19375,-18.2,45,0,2192,2197,13657
2004,26,c) 2,9555,9750,99006,101134,358,3.4,1744,16.6,17705,2741,14964,2.7,17.5,21960,10854,11106,10.7,21.7,-4255,-4.2,35,0,1329,1329,8920
2004,26,d) 3,8069,8316,69646,74222,314,3.5,1315,14.9,12329,1910,10419,2.6,16.6,21480,12636,8844,17,28.9,-9151,-12.3,33.2,0,980,980,11567
2004,26,e) 4,7562,7819,76874,76678,321,3.9,1121,13.6,14909,2503,12406,3.3,19.4,14517,6528,7989,8.5,18.9,392,0.5,37.8,0,826,826,5290
2004,26,f) 5,7109,7469,77143,79156,305,3.9,962,12.3,12005,1468,10537,1.9,15.2,16031,6547,9484,8.3,20.3,-4026,-5.1,30.4,0,704,704,4959
2004,26,g) 6 to 10,30111,31564,334061,339763,1258,3.8,3416,10.4,47873,6733,41140,2,14.1,59276,21488,37788,6.3,17.4,-11403,-3.3,28.2,0,2433,2435,16021
2004,26,h) 11 to 15,20801,22935,292242,292975,687,2.9,1920,8.1,45958,10515,35443,3.6,15.7,47424,16282,31142,5.6,16.2,-1466,-0.5,31.4,0,1256,1257,7479
2004,26,i) 16 to 20,17679,21157,350598,351547,807,3.8,1331,6.2,41383,10888,30495,3.1,11.8,43282,13832,29450,3.9,12.3,-1899,-0.5,23.6,0,792,802,6724
2004,26,j) 21 to 25,11783,14502,247773,249534,434,2.9,863,5.9,29330,5489,23841,2.2,11.8,32852,10760,22092,4.3,13.2,-3522,-1.4,23.6,0,499,517,3569
2004,26,k) 26+,4513,6905,135360,134929,197,2.8,464,6.6,16371,3471,12900,2.6,12.1,15509,3222,12287,2.4,11.5,862,0.6,23,0,197,206,1101
2004,26,l) Left Censored,23293,52299,1950291,1965352,2449,4.6,3377,6.4,182165,43668,138497,2.2,9.3,212287,57749,154538,2.9,10.8,-30122,-1.5,18.6,0,821,845,9271
2004,27,a) 0,9517,9553,55241,27689,9517,199.2,0,0,55105,55105,0,199,199,0,0,0,0,0,55105,199,0,0,,,
2004,27,b) 1,7125,7178,50057,52746,28,0.3,1960,23.8,12286,542,11744,1,23.3,17664,11796,5868,22.4,33.5,-5378,-10.2,46.6,0,1346,1346,9992
2004,27,c) 2,6217,6343,55731,57891,245,3.6,1046,15.4,8443,813,7630,1.4,14.6,12762,6347,6415,11,22,-4319,-7.4,29.2,0,764,765,5438
2004,27,d) 3,5457,5586,46695,47295,259,4.4,792,13.5,7993,1159,6834,2.5,16.9,9193,4501,4692,9.5,19.4,-1200,-2.5,33.8,0,595,595,3890
2004,27,e) 4,4995,5142,46792,47333,202,3.8,649,12.1,6583,683,5900,1.4,13.9,7664,3069,4595,6.5,16.2,-1081,-2.3,27.8,0,435,436,2312
2004,27,f) 5,4654,4921,54547,54309,225,4.4,587,11.5,8304,801,7503,1.5,15.3,7827,3240,4587,6,14.4,477,0.9,28.8,0,353,355,2119
2004,27,g) 6 to 10,18823,19967,208047,209889,749,3.6,1915,9.3,27100,4210,22890,2,12.9,30783,10899,19884,5.2,14.7,-3683,-1.8,25.8,0,1329,1329,7981
2004,27,h) 11 to 15,12464,13645,170505,172906,492,3.5,1011,7.3,18926,3443,15483,2,10.9,23727,7048,16679,4.1,13.7,-4801,-2.8,21.8,0,685,687,4461
2004,27,i) 16 to 20,9986,11976,213295,214598,392,3.2,654,5.4,22821,5015,17806,2.3,10.6,25426,6132,19294,2.9,11.8,-2605,-1.2,21.2,0,421,422,3262
2004,27,j) 21 to 25,6571,8463,165605,167956,307,3.6,486,5.7,16682,3633,13049,2.2,9.9,21384,6887,14497,4.1,12.7,-4702,-2.8,19.8,0,284,284,2462
2004,27,k) 26+,2796,4526,105871,105943,139,3,263,5.7,11081,2504,8577,2.4,10.5,11224,4061,7163,3.8,10.6,-143,-0.1,21,0,121,128,1382
2004,27,l) Left Censored,14364,30548,1207334,1212918,1598,5.2,1622,5.3,124399,30067,94332,2.5,10.3,135567,40008,95559,3.3,11.2,-11168,-0.9,20.6,0,375,376,4709
2004,28,a) 0,3919,3935,25370,12809,3912,198.8,0,0,25122,25122,0,196.1,196.1,0,0,0,0,0,25122,196.1,0,0,,,
2004,28,b) 1,3004,3040,23849,24085,9,0.3,899,25.5,6880,60,6820,0.2,28.6,7352,4878,2474,20.3,30.5,-472,-1.9,57.2,0,737,737,4351
2004,28,c) 2,2486,2530,23707,24096,88,3.2,488,17.8,4409,607,3802,2.5,18.3,5187,2644,2543,11,21.5,-778,-3.2,36.6,0,414,414,2403
2004,28,d) 3,2215,2273,20605,20718,76,3.2,300,12.5,3662,319,3343,1.5,17.7,3887,1583,2304,7.6,18.8,-225,-1.1,35.4,0,241,241,1228
2004,28,e) 4,1956,2016,16929,17326,83,3.9,272,12.8,2653,389,2264,2.2,15.3,3446,1374,2072,7.9,19.9,-793,-4.6,30.6,0,224,224,1197
2004,28,f) 5,1951,2069,20009,19501,85,4,229,10.7,4232,1344,2888,6.9,21.7,3215,1153,2062,5.9,16.5,1017,5.2,33,0,192,192,1035
2004,28,g) 6 to 10,7570,8069,81563,82172,278,3.3,824,9.9,12146,1533,10613,1.9,14.8,13363,5077,8286,6.2,16.3,-1217,-1.5,29.6,0,670,670,4152
2004,28,h) 11 to 15,4851,5330,68727,67103,183,3.3,434,7.9,12756,5299,7457,7.9,19,9508,3180,6328,4.7,14.2,3248,4.8,28.4,0,325,325,1964
2004,28,i) 16 to 20,4444,5133,78247,79134,167,3.2,283,5.4,8229,1414,6815,1.8,10.4,10003,2118,7885,2.7,12.6,-1774,-2.2,20.8,0,181,185,871
2004,28,j) 21 to 25,3107,3867,67284,67802,155,4,248,6.3,7722,1264,6458,1.9,11.4,8758,3072,5686,4.5,12.9,-1036,-1.5,22.8,0,153,153,840
2004,28,k) 26+,1276,1936,47120,46680,67,3.4,94,4.8,5273,2212,3061,4.7,11.3,4393,847,3546,1.8,9.4,880,1.9,18.8,0,57,57,394
2004,28,l) Left Censored,6336,14682,448460,449201,716,4.9,802,5.4,45885,13201,32684,2.9,10.2,47366,14555,32811,3.2,10.5,-1481,-0.3,20.4,0,191,198,991
2004,29,a) 0,11558,11603,62724,31406,11564,199.3,0,0,62636,62636,0,199.4,199.4,0,0,0,0,0,62636,199.4,0,0,,,
2004,29,b) 1,7853,7922,52971,55889,25,0.3,2529,27.3,13155,308,12847,0.6,23.5,18990,11971,7019,21.4,34,-5835,-10.5,47,0,2062,2062,10289
2004,29,c) 2,6539,6643,59051,60790,225,3.1,1265,17.6,9619,721,8898,1.2,15.8,13096,6410,6686,10.5,21.5,-3477,-5.7,31.6,0,1042,1042,5659
2004,29,d) 3,5157,5316,44576,44606,210,3.7,844,14.9,9308,1108,8200,2.5,20.9,9368,4077,5291,9.1,21,-60,-0.1,41.8,0,661,661,3286
2004,29,e) 4,5116,5327,46510,47385,216,3.9,687,12.3,7263,658,6605,1.4,15.3,9013,3587,5426,7.6,19,-1750,-3.7,30.6,0,539,539,3071
2004,29,f) 5,4621,4872,51198,51007,191,3.8,560,11,8933,1317,7616,2.6,17.5,8551,3208,5343,6.3,16.8,382,0.7,33.6,0,445,445,2640
2004,29,g) 6 to 10,18391,19488,212881,213263,732,3.6,1990,9.9,33703,4422,29281,2.1,15.8,34467,13132,21335,6.2,16.2,-764,-0.4,31.6,0,1524,1524,10182
2004,29,h) 11 to 15,12414,13593,165876,166873,441,3.2,1166,8.3,23568,3273,20295,2,14.1,25561,8294,17267,5,15.3,-1993,-1.2,28.2,0,818,819,4964
2004,29,i) 16 to 20,11066,13123,216299,218276,479,3.6,858,6.4,22992,3694,19298,1.7,10.5,26945,7972,18973,3.7,12.3,-3953,-1.8,21,0,589,590,4435
2004,29,j) 21 to 25,7151,9109,182582,182902,291,3.2,509,5.5,22362,7909,14453,4.3,12.2,23002,9264,13738,5.1,12.6,-640,-0.4,24.4,0,325,325,2799
2004,29,k) 26+,2824,4864,112104,111296,148,3,237,4.8,13375,3333,10042,3,12,11759,3580,8179,3.2,10.6,1616,1.4,21.2,0,123,123,1388
2004,29,l) Left Censored,15046,33562,1186892,1191849,1691,5,2004,5.9,123825,35761,88064,3,10.4,133740,38022,95718,3.2,11.2,-9915,-0.8,20.8,0,513,514,4623
2004,30,a) 0,2723,2732,11098,5571,2727,199.6,0,0,11054,11054,0,198.4,198.4,0,0,0,0,0,11054,198.4,0,0,,,
2004,30,b) 1,1811,1821,9404,9987,2,0.1,501,23.9,2472,,,,24.8,3638,1495,2143,15,36.4,-1166,-11.6,49.6,1,344,344,1173
2004,30,c) 2,1628,1661,10353,10554,72,4.1,265,15,1781,209,1572,2,16.9,2183,1086,1097,10.3,20.7,-402,-3.8,33.8,0,195,195,823
2004,30,d) 3,1420,1437,8678,8748,59,3.9,203,13.4,1509,149,1360,1.7,17.2,1648,796,852,9.1,18.8,-139,-1.6,34.4,0,150,150,621
2004,30,e) 4,1316,1354,10172,10117,56,3.9,178,12.5,1612,137,1475,1.4,15.9,1502,671,831,6.6,14.8,110,1.1,29.6,0,125,125,511
2004,30,f) 5,1203,1250,9168,9258,33,2.5,139,10.6,1247,88,1159,1,13.5,1426,556,870,6,15.4,-179,-1.9,27,0,100,100,390
2004,30,g) 6 to 10,4910,5083,39564,39757,225,4.3,473,9.1,5209,744,4465,1.9,13.1,5594,2043,3551,5.1,14.1,-385,-1,26.2,0,328,328,1408
2004,30,h) 11 to 15,2841,3031,26635,26599,116,3.7,264,8.5,4002,558,3444,2.1,15,3930,1531,2399,5.8,14.8,72,0.2,29.6,0,164,164,859
2004,30,i) 16 to 20,2270,2555,32164,32121,107,4.1,187,7.2,3515,710,2805,2.2,10.9,3428,1265,2163,3.9,10.7,87,0.2,21.4,0,115,115,936
2004,30,j) 21 to 25,1730,2208,28012,28074,70,3.1,140,6.2,2874,261,2613,0.9,10.2,2997,984,2013,3.5,10.7,-123,-0.5,20.4,0,68,68,424
2004,30,k) 26+,669,970,13127,13098,42,4.3,54,5.5,1475,,,,11.3,1416,685,731,5.2,10.8,59,0.5,21.6,1,40,40,253
2004,30,l) Left Censored,2825,5339,114301,113505,274,5.1,335,6.2,12187,2787,9400,2.5,10.7,10595,4134,6461,3.6,9.3,1592,1.4,18.6,0,93,94,823
2004,31,a) 0,2933,2943,16451,8244,2928,199,0,0,16415,16415,0,199.1,199.1,0,0,0,0,0,16415,199.1,0,0,,,
2004,31,b) 1,2242,2260,15065,15414,4,0.2,548,21.4,3676,69,3607,0.4,23.8,4374,2948,1426,19.1,28.4,-698,-4.6,47.6,0,422,422,2675
2004,31,c) 2,2031,2092,15788,15992,62,2.8,357,15.9,2681,196,2485,1.2,16.8,3089,1539,1550,9.6,19.3,-408,-2.5,33.6,0,264,264,1193
2004,31,d) 3,1830,1876,15014,15247,60,3,277,13.9,2352,203,2149,1.3,15.4,2817,1142,1675,7.5,18.5,-465,-3.1,30.8,0,218,218,1003
2004,31,e) 4,1687,1738,13715,14329,63,3.4,238,13,1991,455,1536,3.2,13.9,3218,1429,1789,10,22.5,-1227,-8.6,27.8,0,178,178,1011
2004,31,f) 5,1518,1604,20895,21217,65,3.9,194,11.6,2104,356,1748,1.7,9.9,2748,1057,1691,5,13,-644,-3.1,19.8,0,148,148,688
2004,31,g) 6 to 10,6300,6706,65802,65661,236,3.4,558,8.1,9039,1786,7253,2.7,13.8,8757,2772,5985,4.2,13.3,282,0.5,26.6,0,410,410,2216
2004,31,h) 11 to 15,4356,4767,56499,55991,172,3.5,349,7.2,7470,1872,5598,3.3,13.3,6454,1972,4482,3.5,11.5,1016,1.8,23,0,248,248,1161
2004,31,i) 16 to 20,3794,4364,76927,77223,149,3.4,263,5.9,6915,1748,5167,2.3,9,7506,1802,5704,2.3,9.7,-591,-0.7,18,0,172,172,910
2004,31,j) 21 to 25,2821,3449,50369,50348,109,3.1,177,5.1,5702,1023,4679,2,11.3,5660,1286,4374,2.6,11.2,42,0.1,22.4,0,105,105,581
2004,31,k) 26+,1177,1916,41202,41312,48,2.5,83,4.3,4073,1436,2637,3.5,9.9,4293,912,3381,2.2,10.4,-220,-0.5,19.8,0,44,44,149
2004,31,l) Left Censored,6457,12021,383786,381743,477,3.9,648,5.4,35231,8716,26515,2.3,9.2,31147,6423,24724,1.7,8.2,4084,1,16.4,0,183,204,1077
2004,32,a) 0,5538,5554,37815,18933,5533,199.2,0,0,37764,37764,0,199.5,199.5,0,0,0,0,0,37764,199.5,0,0,,,
2004,32,b) 1,3912,3986,33887,34051,20,0.4,1256,26.9,10417,582,9835,1.7,30.6,10745,6333,4412,18.6,31.6,-328,-1,61.2,0,999,999,5464
2004,32,c) 2,3074,3120,33618,35379,127,3.7,647,19,6130,649,5481,1.8,17.3,9651,5344,4307,15.1,27.3,-3521,-10,34.6,0,526,526,3418
2004,32,d) 3,2520,2587,30550,31178,124,4.5,431,15.7,5537,478,5059,1.5,17.8,6793,2193,4600,7,21.8,-1256,-4,35.6,0,328,328,1775
2004,32,e) 4,2180,2231,28928,29304,99,4.2,369,15.5,5706,880,4826,3,19.5,6458,2879,3579,9.8,22,-752,-2.5,39,0,288,288,2112
2004,32,f) 5,1991,2118,29867,29302,99,4.4,301,13.5,5261,620,4641,2.1,18,4131,1522,2609,5.2,14.1,1130,3.9,28.2,0,236,236,1219
2004,32,g) 6 to 10,6633,7118,124823,124845,329,4.5,789,10.7,17833,2833,15000,2.3,14.3,17877,6103,11774,4.9,14.3,-44,0,28.6,0,619,619,5130
2004,32,h) 11 to 15,3607,4090,72289,71810,194,4.6,336,8,11056,2059,8997,2.9,15.4,10097,3584,6513,5,14.1,959,1.3,28.2,0,242,243,2997
2004,32,i) 16 to 20,2591,3389,71848,70320,159,4.6,248,7.2,10897,1917,8980,2.7,15.5,7840,2545,5295,3.6,11.1,3057,4.4,22.2,0,158,159,1354
2004,32,j) 21 to 25,1922,2620,69524,68748,161,6.2,153,5.8,9210,2488,6722,3.6,13.4,7657,1768,5889,2.6,11.1,1553,2.3,22.2,0,87,87,941
2004,32,k) 26+,767,1380,68964,66916,89,6.4,114,8.2,8468,2580,5888,3.9,12.7,4372,1542,2830,2.3,6.5,4096,6.2,13,0,37,37,615
2004,32,l) Left Censored,3292,8785,412795,404246,820,9.4,646,7.4,62040,17920,44120,4.4,15.3,44941,15315,29626,3.8,11.1,17099,4.2,22.2,0,78,95,1261
2004,33,a) 0,2607,2617,11803,5914,2605,199.1,0,0,11778,11778,0,199.2,199.2,0,0,0,0,0,11778,199.2,0,0,,,
2004,33,b) 1,1844,1867,11276,11672,5,0.2,518,24.1,2919,20,2899,0.2,25,3711,2352,1359,20.2,31.8,-792,-6.8,50,0,377,377,1990
2004,33,c) 2,1606,1615,11535,11687,67,3.9,275,15.9,2141,245,1896,2.1,18.3,2444,1052,1392,9,20.9,-303,-2.6,36.6,0,219,219,792
2004,33,d) 3,1402,1447,11451,11649,52,3.4,220,14.3,1905,142,1763,1.2,16.4,2301,987,1314,8.5,19.8,-396,-3.4,32.8,0,175,175,654
2004,33,e) 4,1325,1362,10697,10759,50,3.5,173,12.1,1625,236,1389,2.2,15.1,1748,719,1029,6.7,16.2,-123,-1.1,30.2,0,137,137,638
2004,33,f) 5,1228,1267,12326,12739,50,3.8,143,10.9,1500,126,1374,1,11.8,2326,828,1498,6.5,18.3,-826,-6.5,23.6,0,110,110,696
2004,33,g) 6 to 10,5346,5527,51629,52185,190,3.3,576,10,6691,825,5866,1.6,12.8,7803,3460,4343,6.6,15,-1112,-2.2,25.6,0,422,422,2516
2004,33,h) 11 to 15,3429,3619,42735,43021,132,3.6,277,7.5,5413,922,4491,2.1,12.6,5984,2641,3343,6.1,13.9,-571,-1.3,25.2,0,203,203,1539
2004,33,i) 16 to 20,3415,3849,61599,61242,121,3.1,234,6,6581,1229,5352,2,10.7,5866,1629,4237,2.7,9.6,715,1.1,19.2,0,156,156,974
2004,33,j) 21 to 25,1773,2086,32914,33089,66,3.1,119,5.6,2592,286,2306,0.9,7.8,2942,897,2045,2.7,8.9,-350,-1.1,15.6,0,67,77,334
2004,33,k) 26+,716,1210,26474,26312,41,3.4,58,4.8,2727,839,1888,3.2,10.4,2403,374,2029,1.4,9.1,324,1.3,18.2,0,28,28,229
2004,33,l) Left Censored,3839,7663,253374,253043,397,5.2,379,4.9,22712,5813,16899,2.3,9,22050,5879,16171,2.3,8.7,662,0.3,17.4,0,109,116,2096
2004,34,a) 0,16908,16939,89844,45013,16869,199.2,0,0,89662,89662,0,199.2,199.2,0,0,0,0,0,89662,199.2,0,0,,,
2004,34,b) 1,12467,12545,88856,88915,22,0.2,3463,24,24530,340,24190,0.4,27.6,24647,13417,11230,15.1,27.7,-117,-0.1,55.2,0,2638,2638,10703
2004,34,c) 2,10675,10771,85544,88789,398,3.4,1942,16.7,17005,1289,15716,1.5,19.2,23494,11959,11535,13.5,26.5,-6489,-7.3,38.4,0,1545,1545,10568
2004,34,d) 3,9689,9859,91352,90018,452,4.4,1429,13.8,17521,1641,15880,1.8,19.5,14853,5775,9078,6.4,16.5,2668,3,33,0,1098,1098,4749
2004,34,e) 4,8625,8747,78362,77843,360,3.9,1248,13.5,14076,1433,12643,1.8,18.1,13038,5868,7170,7.5,16.7,1038,1.4,33.4,0,939,939,4845
2004,34,f) 5,8284,8575,81452,82432,335,3.7,1069,11.9,11732,1600,10132,1.9,14.2,13692,5846,7846,7.1,16.6,-1960,-2.4,28.4,0,837,837,4892
2004,34,g) 6 to 10,32581,33842,361306,363265,1221,3.5,3581,10.2,56562,6509,50053,1.8,15.6,60480,18614,41866,5.1,16.6,-3918,-1,31.2,0,2705,2710,15071
2004,34,h) 11 to 15,20851,21929,255439,258773,713,3.2,1770,7.9,32202,5625,26577,2.2,12.4,38869,11629,27240,4.5,15,-6667,-2.6,24.8,0,1247,1248,8595
2004,34,i) 16 to 20,18024,20370,336086,338746,624,3,1441,6.9,36952,6993,29959,2.1,10.9,42272,13738,28534,4.1,12.5,-5320,-1.6,21.8,0,966,969,6097
2004,34,j) 21 to 25,11856,13758,249536,250415,469,3.4,881,6.3,26916,5724,21192,2.3,10.7,28674,8448,20226,3.4,11.5,-1758,-0.8,21.4,0,598,609,4180
2004,34,k) 26+,4411,6122,160377,159681,210,3.4,360,5.8,16061,4347,11714,2.7,10.1,14668,3582,11086,2.2,9.2,1393,0.9,18.4,0,204,207,1846
2004,34,l) Left Censored,23266,45770,1708811,1707029,2514,5.4,4360,9.3,221668,57794,163874,3.4,13,218105,68357,149748,4,12.8,3563,0.2,25.6,0,1008,1016,11463
2004,35,a) 0,3057,3081,18700,9393,3059,198.6,0,0,18615,18615,0,198.2,198.2,0,0,0,0,0,18615,198.2,0,0,,,
2004,35,b) 1,2163,2181,16879,17288,6,0.2,616,24.4,4334,35,4299,0.2,25.1,5151,3176,1975,18.4,29.8,-817,-4.7,50.2,0,496,496,2920
2004,35,c) 2,1939,1969,19261,19332,88,4.1,369,17.4,3601,339,3262,1.8,18.6,3742,1582,2160,8.2,19.4,-141,-0.8,37.2,0,290,290,1296
2004,35,d) 3,1757,1869,16008,16650,75,3.8,260,13.2,2412,213,2199,1.3,14.5,3695,1559,2136,9.4,22.2,-1283,-7.7,29,0,206,206,1322
2004,35,e) 4,1518,1569,14785,15011,59,3.6,212,12.8,2258,248,2010,1.7,15,2709,1141,1568,7.6,18,-451,-3,30,0,162,162,849
2004,35,f) 5,1380,1410,11479,11751,50,3.4,174,11.8,1756,334,1422,2.8,14.9,2300,840,1460,7.1,19.6,-544,-4.7,29.8,0,124,124,646
2004,35,g) 6 to 10,5909,6233,66348,66433,263,4.1,596,9.3,9952,1712,8240,2.6,15,10121,3312,6809,5,15.2,-169,-0.2,30,0,444,444,2633
2004,35,h) 11 to 15,3903,4314,46533,46849,156,3.5,337,7.6,6459,1259,5200,2.7,13.8,7091,2329,4762,5,15.1,-632,-1.3,27.6,0,215,215,1559
2004,35,i) 16 to 20,3083,3671,65486,66669,118,3.2,253,6.8,5745,685,5060,1,8.6,8111,1850,6261,2.8,12.2,-2366,-3.6,17.2,0,169,169,1083
2004,35,j) 21 to 25,2418,3078,46513,46721,108,3.5,190,6.1,5237,1185,4052,2.5,11.2,5652,1565,4087,3.3,12.1,-415,-0.9,22.4,0,119,119,667
2004,35,k) 26+,908,1573,32334,32385,86,5.5,63,4,4796,1754,3042,5.4,14.8,4897,2316,2581,7.2,15.1,-101,-0.3,29.6,0,33,33,147
2004,35,l) Left Censored,3829,8273,221710,220816,429,5.2,530,6.4,27834,6769,21065,3.1,12.6,26046,9433,16613,4.3,11.8,1788,0.8,23.6,0,94,94,985
2004,36,a) 0,37687,37771,196840,98622,37589,199,0,0,196437,196437,0,199.2,199.2,0,0,0,0,0,196437,199.2,0,0,,,
2004,36,b) 1,28209,28397,181916,189043,60,0.2,7946,24.3,45724,1325,44399,0.7,24.2,59977,35418,24559,18.7,31.7,-14253,-7.5,48.4,0,6096,6096,29747
2004,36,c) 2,23702,23991,194424,194436,891,3.4,4736,18.2,43766,8174,35592,4.2,22.5,43789,23271,20518,12,22.5,-23,0,45,0,3714,3717,19045
2004,36,d) 3,20766,21025,166050,172473,779,3.5,3582,15.9,29357,4340,25017,2.5,17,42202,18355,23847,10.6,24.5,-12845,-7.5,34,0,2798,2798,15494
2004,36,e) 4,18616,19001,153347,159298,720,3.6,2806,14,23510,3424,20086,2.1,14.8,35411,16564,18847,10.4,22.2,-11901,-7.4,29.6,0,2201,2205,13178
2004,36,f) 5,17070,17635,164359,169037,610,3.3,2208,11.9,24103,2516,21587,1.5,14.3,33459,13615,19844,8.1,19.8,-9356,-5.5,28.6,0,1697,1697,11558
2004,36,g) 6 to 10,66376,68966,685135,695340,2266,3.2,7365,10.3,88924,11247,77677,1.6,12.8,109333,42936,66397,6.2,15.7,-20409,-2.9,25.6,0,5570,5573,33237
2004,36,h) 11 to 15,44062,46374,530861,535707,1319,2.8,3745,7.9,62915,7214,55701,1.3,11.7,72607,21754,50853,4.1,13.6,-9692,-1.9,23.4,0,2664,2664,15791
2004,36,i) 16 to 20,38177,42326,675463,670731,1244,2.9,2791,6.5,75901,15522,60379,2.3,11.3,66437,18561,47876,2.8,9.9,9464,1.4,19.8,0,1915,1918,12007
2004,36,j) 21 to 25,24252,28680,527443,532128,769,2.6,1775,6.1,47490,7477,40013,1.4,8.9,56859,14799,42060,2.8,10.7,-9369,-1.8,17.8,0,1169,1192,8497
2004,36,k) 26+,8822,13709,320716,318017,416,3,726,5.2,36511,8116,28395,2.6,11.5,31112,6503,24609,2,9.8,5399,1.7,19.6,0,390,394,2444
2004,36,l) Left Censored,50655,98902,3596425,3615570,6504,6.5,7569,7.6,415368,103273,312095,2.9,11.5,453658,112933,340725,3.1,12.5,-38290,-1,23,0,2098,2120,20219
2004,37,a) 0,14675,14737,89387,44802,14658,198.9,0,0,89171,89171,0,199,199,0,0,0,0,0,89171,199,0,0,,,
2004,37,b) 1,10728,10815,83583,84031,40,0.3,2854,23.1,23498,734,22764,0.9,28,24394,14652,9742,17.4,29,-896,-1,56,0,2263,2263,12713
2004,37,c) 2,9076,9285,75113,76762,356,3.6,1620,16.3,15218,1694,13524,2.2,19.8,18515,8696,9819,11.3,24.1,-3297,-4.3,39.6,0,1274,1274,7558
2004,37,d) 3,8518,8802,77172,76948,358,3.9,1247,13.4,14117,1815,12302,2.4,18.3,13669,6310,7359,8.2,17.8,448,0.5,35.6,0,1019,1019,5332
2004,37,e) 4,7520,7894,73498,73778,285,3.4,1063,12.8,12371,1386,10985,1.9,16.8,12931,4837,8094,6.6,17.5,-560,-0.7,33.6,0,813,813,3950
2004,37,f) 5,7200,7618,79424,79851,299,3.8,888,11.2,12034,1876,10158,2.3,15.1,12887,5265,7622,6.6,16.1,-853,-1,30.2,0,657,663,4046
2004,37,g) 6 to 10,26995,28819,308283,311301,1131,3.8,2827,9.5,47168,6674,40494,2.1,15.2,53203,18137,35066,5.8,17.1,-6035,-1.9,30.4,0,2036,2055,14645
2004,37,h) 11 to 15,16907,18830,240869,241184,644,3.3,1501,7.8,34034,6970,27064,2.9,14.1,34663,11175,23488,4.6,14.4,-629,-0.3,28.2,0,1096,1097,8345
2004,37,i) 16 to 20,15933,19060,314949,316462,615,3.2,1153,6,35932,7170,28762,2.3,11.4,38958,12304,26654,3.9,12.3,-3026,-0.9,22.8,0,763,776,6334
2004,37,j) 21 to 25,9107,11904,224812,226071,418,3.5,658,5.5,23242,4848,18394,2.1,10.3,25759,5554,20205,2.5,11.4,-2517,-1.1,20.6,0,422,422,2852
2004,37,k) 26+,3541,6061,142780,140639,293,4.8,290,4.8,21203,5633,15570,4,15.1,16920,6046,10874,4.3,12,4283,3.1,24,0,155,155,1469
2004,37,l) Left Censored,17565,45480,1630730,1647634,2444,5.4,2669,5.8,170735,41979,128756,2.5,10.4,204544,55529,149015,3.4,12.4,-33809,-2,20.8,0,581,582,5788
2004,38,a) 0,1157,1165,6049,3035,1154,198.1,0,0,6028,6028,0,198.6,198.6,0,0,0,0,0,6028,198.6,0,0,,,
2004,38,b) 1,811,822,5224,5227,7,0.8,184,20,1494,24,1470,0.5,28.6,1499,910,589,17.4,28.7,-5,-0.1,57.2,0,127,127,808
2004,38,c) 2,735,760,5558,5577,26,3.2,119,14.7,1099,64,1035,1.1,19.7,1137,521,616,9.3,20.4,-38,-0.7,39.4,0,97,97,477
2004,38,d) 3,630,645,5400,5387,20,2.9,89,13.1,755,46,709,0.9,14,728,312,416,5.8,13.5,27,0.5,27,0,66,66,247
2004,38,e) 4,627,642,4778,4988,26,3.9,61,9.2,700,82,618,1.6,14,1120,482,638,9.7,22.5,-420,-8.5,28,0,45,45,433
2004,38,f) 5,535,561,4680,4651,15,2.6,50,8.6,598,54,544,1.2,12.9,540,209,331,4.5,11.6,58,1.3,23.2,0,40,40,192
2004,38,g) 6 to 10,2414,2512,22241,22517,93,3.6,233,9,2597,324,2273,1.4,11.5,3148,1153,1995,5.1,14,-551,-2.5,23,0,168,168,950
2004,38,h) 11 to 15,1864,1992,19965,19897,60,2.9,148,7.2,2358,264,2094,1.3,11.9,2222,843,1379,4.2,11.2,136,0.7,22.4,0,113,113,505
2004,38,i) 16 to 20,1674,1889,20745,20631,50,2.6,99,5.2,2183,527,1656,2.6,10.6,1955,563,1392,2.7,9.5,228,1.1,19,0,77,77,478
2004,38,j) 21 to 25,1328,1613,21423,21792,35,2.1,79,4.8,2007,91,1916,0.4,9.2,2744,1339,1405,6.1,12.6,-737,-3.4,18.4,0,54,54,209
2004,38,k) 26+,524,712,10487,11299,18,2.5,37,5.1,1013,224,789,2,9,2637,1458,1179,12.9,23.3,-1624,-14.3,18,0,18,18,164
2004,38,l) Left Censored,2939,5103,135361,134182,158,3.1,216,4.2,12093,2355,9738,1.8,9,9735,3560,6175,2.7,7.3,2358,1.7,14.6,0,67,67,404
2004,39,a) 0,14431,14513,98872,49551,14441,199,0,0,98643,98643,0,199.1,199.1,0,0,0,0,0,98643,199.1,0,0,,,
2004,39,b) 1,10884,11035,91565,96650,50,0.4,3019,23.9,22651,833,21818,0.9,23.4,32820,20056,12764,20.8,34,-10169,-10.6,46.8,0,2359,2359,17483
2004,39,c) 2,9862,10212,100031,103003,389,3.5,1806,16.5,18637,2904,15733,2.8,18.1,24581,11347,13234,11,23.9,-5944,-5.8,36.2,0,1410,1412,9514
2004,39,d) 3,8681,8996,75878,77309,337,3.6,1234,13,13349,1592,11757,2.1,17.3,16211,6973,9238,9,21,-2862,-3.7,34.6,0,971,971,5793
2004,39,e) 4,7998,8338,90481,89099,331,3.8,1104,12.6,17937,2322,15615,2.6,20.1,15172,6147,9025,6.9,17,2765,3.1,34,0,817,817,4793
2004,39,f) 5,7694,8258,96837,98347,309,3.6,963,11.2,12703,1929,10774,2,12.9,15723,6697,9026,6.8,16,-3020,-3.1,25.8,0,727,727,4967
2004,39,g) 6 to 10,32362,34744,369061,373982,1255,3.5,3430,9.5,52818,7927,44891,2.1,14.1,62660,25821,36839,6.9,16.8,-9842,-2.7,28.2,0,2539,2546,21588
2004,39,h) 11 to 15,23091,25676,331323,336342,768,2.9,1999,7.6,41007,6015,34992,1.8,12.2,51044,20696,30348,6.2,15.2,-10037,-3,24.4,0,1378,1378,14873
2004,39,i) 16 to 20,20159,24217,398859,401697,746,3,1461,5.9,39961,6693,33268,1.7,9.9,45636,11592,34044,2.9,11.4,-5675,-1.5,19.8,0,937,942,7468
2004,39,j) 21 to 25,13722,17423,323982,327077,630,3.6,996,5.7,33384,7252,26132,2.2,10.2,39573,10519,29054,3.2,12.1,-6189,-1.9,20.4,0,595,597,4859
2004,39,k) 26+,5662,9358,208800,209233,308,3.3,441,4.7,19805,6188,13617,3,9.5,20671,4813,15858,2.3,9.9,-866,-0.4,19,0,215,239,2103
2004,39,l) Left Censored,31643,72129,2552813,2563877,3678,5.1,3841,5.3,257139,69362,187777,2.7,10,279268,76335,202933,3,10.9,-22129,-0.9,20,0,1058,1069,10701
2004,40,a) 0,5705,5732,32464,16266,5714,199.4,0,0,32397,32397,0,199.2,199.2,0,0,0,0,0,32397,199.2,0,0,,,
2004,40,b) 1,4325,4348,27804,28820,5,0.1,1242,24.7,7509,9,7500,0,26.1,9541,5709,3832,19.8,33.1,-2032,-7,52.2,0,1028,1028,5207
2004,40,c) 2,3789,3875,34164,33805,138,3.3,720,17.2,7925,1136,6789,3.4,23.4,7207,3479,3728,10.3,21.3,718,2.1,42.6,0,575,581,2923
2004,40,d) 3,3260,3385,25286,25813,158,4.4,476,13.4,4875,712,4163,2.8,18.9,5929,2778,3151,10.8,23,-1054,-4.1,37.8,0,399,399,2550
2004,40,e) 4,2958,3075,27312,28536,106,3.3,449,13.8,4426,881,3545,3.1,15.5,6873,3049,3824,10.7,24.1,-2447,-8.6,31,0,331,336,1931
2004,40,f) 5,2833,2949,31769,31736,106,3.4,346,11.2,6810,1757,5053,5.5,21.5,6744,2577,4167,8.1,21.3,66,0.2,42.6,0,264,264,2085
2004,40,g) 6 to 10,11073,11882,114686,114790,515,4.2,1185,9.7,19534,3442,16092,3,17,19742,6783,12959,5.9,17.2,-208,-0.2,34,0,880,880,5426
2004,40,h) 11 to 15,7523,8153,94554,95775,264,3.2,624,7.5,11871,2298,9573,2.4,12.4,14313,4110,10203,4.3,14.9,-2442,-2.5,24.8,0,432,432,2300
2004,40,i) 16 to 20,6380,7334,107103,107221,214,2.9,419,5.6,12287,1833,10454,1.7,11.5,12522,2703,9819,2.5,11.7,-235,-0.2,23,0,288,289,1500
2004,40,j) 21 to 25,5233,6400,110161,109208,197,3,339,5.2,12202,2445,9757,2.2,11.2,10296,2517,7779,2.3,9.4,1906,1.8,18.8,0,212,212,984
2004,40,k) 26+,1764,2879,59022,58097,157,5.5,108,3.8,8769,3774,4995,6.5,15.1,6918,1297,5621,2.2,11.9,1851,3.2,23.8,0,61,61,692
2004,40,l) Left Censored,8150,18316,517569,521459,908,4.9,1014,5.5,54019,14810,39209,2.8,10.4,61799,15082,46717,2.9,11.9,-7780,-1.5,20.8,0,288,310,2094
2004,41,a) 0,7533,7587,40444,20267,7547,198.9,0,0,40355,40355,0,199.1,199.1,0,0,0,0,0,40355,199.1,0,0,,,
2004,41,b) 1,5518,5617,32694,33396,23,0.4,1630,25.1,8933,295,8638,0.9,26.7,10336,5971,4365,17.9,30.9,-1403,-4.2,53.4,0,1241,1241,4876
2004,41,c) 2,4792,4900,33501,33742,191,3.6,854,16.3,6908,1302,5606,3.9,20.5,7389,3730,3659,11.1,21.9,-481,-1.4,41,0,660,660,3122
2004,41,d) 3,4294,4415,30268,30915,187,4,678,14.5,4898,637,4261,2.1,15.8,6191,3210,2981,10.4,20,-1293,-4.2,31.6,0,499,499,2496
2004,41,e) 4,3823,3934,31442,31449,170,4.1,554,13.4,5442,499,4943,1.6,17.3,5456,2273,3183,7.2,17.3,-14,0,34.6,0,431,431,1775
2004,41,f) 5,3643,3782,29113,29211,171,4.4,419,10.7,4562,909,3653,3.1,15.6,4757,2150,2607,7.4,16.3,-195,-0.7,31.2,0,305,305,1624
2004,41,g) 6 to 10,14506,15292,154250,154219,686,4.4,1530,9.7,21429,4003,17426,2.6,13.9,21367,8159,13208,5.3,13.9,62,0,27.8,0,1091,1096,6587
2004,41,h) 11 to 15,9111,9882,106561,108545,348,3.4,903,8.9,14069,1963,12106,1.8,13,18037,8823,9214,8.1,16.6,-3968,-3.6,26,0,600,600,5078
2004,41,i) 16 to 20,6993,8297,127980,128625,287,3.4,620,7.3,13346,2138,11208,1.7,10.4,14635,3671,10964,2.9,11.4,-1289,-1,20.8,0,404,405,2406
2004,41,j) 21 to 25,5158,6497,107219,107705,226,3.4,348,5.3,11080,2246,8834,2.1,10.3,12052,4172,7880,3.9,11.2,-972,-0.9,20.6,0,201,201,1394
2004,41,k) 26+,2008,3176,67217,68511,131,4.1,141,4.4,6267,2163,4104,3.2,9.1,8854,2437,6417,3.6,12.9,-2587,-3.8,18.2,0,78,78,458
2004,41,l) Left Censored,8252,18864,584978,587640,1149,6.1,1082,5.7,60347,16322,44025,2.8,10.3,65671,21146,44525,3.6,11.2,-5324,-0.9,20.6,0,278,282,1786
2004,42,a) 0,16934,17085,106626,53410,17013,199.2,0,0,106432,106432,0,199.3,199.3,0,0,0,0,0,106432,199.3,0,0,,,
2004,42,b) 1,12721,12845,104208,105723,36,0.2,3151,21.7,25203,755,24448,0.7,23.8,28233,17127,11106,16.2,26.7,-3030,-2.9,47.6,0,2431,2431,14870
2004,42,c) 2,11579,11836,119992,118961,438,3.5,1869,14.8,28258,1774,26484,1.5,23.8,26195,10515,15680,8.8,22,2063,1.8,44,0,1457,1457,8627
2004,42,d) 3,10362,10602,87720,100329,422,3.8,1386,12.5,14559,2607,11952,2.6,14.5,39776,30632,9144,30.5,39.6,-25217,-25.1,29,0,1101,1101,29292
2004,42,e) 4,9611,9895,98000,99147,394,3.8,1147,11.1,15536,2633,12903,2.7,15.7,17829,7171,10658,7.2,18,-2293,-2.3,31.4,0,882,882,6034
2004,42,f) 5,8934,9405,94445,94287,326,3.3,970,9.9,14392,2555,11837,2.7,15.3,14076,5911,8165,6.3,14.9,316,0.4,29.8,0,723,723,4381
2004,42,g) 6 to 10,35926,38302,415259,415969,1279,3.2,3496,8.8,59575,8682,50893,2.1,14.3,60994,22871,38123,5.5,14.7,-1419,-0.4,28.6,0,2586,2586,16981
2004,42,h) 11 to 15,26687,28832,353140,354962,831,2.8,2222,7.5,48084,7960,40124,2.2,13.5,51727,17811,33916,5,14.6,-3643,-1.1,27,0,1575,1575,10013
2004,42,i) 16 to 20,24692,28940,458832,462003,852,2.9,1825,6.2,43545,9576,33969,2.1,9.4,49886,15955,33931,3.5,10.8,-6341,-1.4,18.8,0,1192,1196,7669
2004,42,j) 21 to 25,15478,18956,343248,348338,791,4.1,992,5.2,36791,8399,28392,2.4,10.6,46971,17819,29152,5.1,13.5,-10180,-2.9,21.2,0,632,642,4478
2004,42,k) 26+,6132,9983,230744,230421,308,3.1,449,4.5,22383,5009,17374,2.2,9.7,21737,4618,17119,2,9.4,646,0.3,18.8,0,244,244,1926
2004,42,l) Left Censored,34552,75390,2671232,2670706,3375,4.4,4365,5.7,285247,71386,213861,2.7,10.7,284195,82991,201204,3.1,10.6,1052,0.1,21.2,0,1215,1219,10881
2004,44,a) 0,2097,2105,11513,5760,2100,199.5,0,0,11506,11506,0,199.8,199.8,0,0,0,0,0,11506,199.8,0,0,,,
2004,44,b) 1,1464,1472,10729,11111,2,0.1,375,22.4,2356,,,,21.2,3119,2022,1097,18.2,28.1,-763,-6.9,42.4,1,279,279,1780
2004,44,c) 2,1229,1239,8703,8786,61,4.6,232,17.4,1660,232,1428,2.6,18.9,1826,770,1056,8.8,20.8,-166,-1.9,37.8,0,176,176,592
2004,44,d) 3,1103,1119,8172,8153,56,4.8,142,12.2,1411,226,1185,2.8,17.3,1373,483,890,5.9,16.8,38,0.5,33.6,0,105,105,350
2004,44,e) 4,962,992,8158,8068,33,3.2,119,11.5,1342,97,1245,1.2,16.6,1161,483,678,6,14.4,181,2.2,28.8,0,81,81,401
2004,44,f) 5,930,953,7737,7756,34,3.4,100,10.1,1110,70,1040,0.9,14.3,1147,419,728,5.4,14.8,-37,-0.5,28.6,0,66,66,291
2004,44,g) 6 to 10,3800,3938,39081,38425,123,3,332,8.2,5862,586,5276,1.5,15.3,4550,1311,3239,3.4,11.8,1312,3.5,23.6,0,252,252,1110
2004,44,h) 11 to 15,2761,2881,33411,33448,113,3.9,197,6.7,4650,1078,3572,3.2,13.9,4724,1386,3338,4.1,14.1,-74,-0.2,27.8,0,140,140,1195
2004,44,i) 16 to 20,2519,2814,40000,40159,99,3.5,184,6.4,4148,,,,10.3,4465,1582,2883,3.9,11.1,-317,-0.8,20.6,1,123,123,895
2004,44,j) 21 to 25,1491,1688,28109,28195,47,2.7,112,6.5,3222,633,2589,2.2,11.4,3393,1105,2288,3.9,12,-171,-0.6,22.8,0,80,81,875
2004,44,k) 26+,665,868,17219,17288,20,2.3,35,4,1619,240,1379,1.4,9.4,1757,249,1508,1.4,10.2,-138,-0.8,18.8,0,23,23,151
2004,44,l) Left Censored,3936,6239,219602,217973,272,4.3,313,5,23038,4467,18571,2,10.6,19780,5706,14074,2.6,9.1,3258,1.5,18.2,0,125,125,1349
2004,45,a) 0,7022,7063,43042,21588,7039,199.3,0,0,42908,42908,0,198.8,198.8,0,0,0,0,0,42908,198.8,0,0,,,
2004,45,b) 1,5286,5330,45751,47918,18,0.3,1432,23.4,12163,96,12067,0.2,25.4,16496,7024,9472,14.7,34.4,-4333,-9,50.8,0,1134,1134,6196
2004,45,c) 2,4619,4705,36742,38628,176,3.5,814,16.1,7247,911,6336,2.4,18.8,11019,5947,5072,15.4,28.5,-3772,-9.7,37.6,0,668,668,5288
2004,45,d) 3,3915,4059,39401,40166,169,3.9,639,14.8,6262,707,5555,1.8,15.6,7791,3602,4189,9,19.4,-1529,-3.8,31.2,0,515,515,2902
2004,45,e) 4,3690,3837,37007,37518,152,3.8,479,11.9,6418,1676,4742,4.5,17.1,7440,3187,4253,8.5,19.8,-1022,-2.7,34.2,0,401,401,2876
2004,45,f) 5,3412,3595,38995,39852,136,3.6,443,11.8,5786,816,4970,2,14.5,7500,2786,4714,7,18.8,-1714,-4.3,29,0,323,323,2148
2004,45,g) 6 to 10,12810,13531,159201,161788,518,3.7,1364,9.7,22420,3381,19039,2.1,13.9,27593,10289,17304,6.4,17.1,-5173,-3.2,27.8,0,1044,1044,7683
2004,45,h) 11 to 15,8185,9244,116103,116987,321,3.4,681,7.2,17078,4330,12748,3.7,14.6,18846,6863,11983,5.9,16.1,-1768,-1.5,29.2,0,487,488,2758
2004,45,i) 16 to 20,7444,9235,140402,140711,311,3.3,539,5.8,15249,2820,12429,2,10.8,15866,3992,11874,2.8,11.3,-617,-0.5,21.6,0,357,357,1819
2004,45,j) 21 to 25,4287,5445,97749,98338,212,3.9,313,5.7,10558,3356,7202,3.4,10.7,11735,2973,8762,3,11.9,-1177,-1.2,21.4,0,193,193,1236
2004,45,k) 26+,1746,3116,53398,53150,113,3.6,135,4.3,7587,2962,4625,5.6,14.3,7090,2187,4903,4.1,13.3,497,1,26.6,0,75,75,364
2004,45,l) Left Censored,8744,21474,731024,733583,1203,5.6,1182,5.5,75014,21561,53453,2.9,10.2,80133,21117,59016,2.9,10.9,-5119,-0.7,20.4,0,285,285,2639
2004,46,a) 0,1595,1598,7057,3547,1586,198.5,0,0,7020,7020,0,197.9,197.9,0,0,0,0,0,7020,197.9,0,0,,,
2004,46,b) 1,1174,1190,7081,7281,8,0.6,328,24,1746,21,1725,0.3,24,2146,1417,729,19.5,29.5,-400,-5.5,48,0,259,259,1238
2004,46,c) 2,1145,1156,7541,7712,45,3.7,178,14.5,1189,,,,15.4,1531,645,886,8.4,19.9,-342,-4.5,30.8,1,132,132,497
2004,46,d) 3,929,966,6812,7226,30,2.9,141,13.8,1040,153,887,2.1,14.4,1867,1058,809,14.6,25.8,-827,-11.4,28.8,0,118,118,704
2004,46,e) 4,860,883,7521,7602,33,3.6,107,11.6,1004,195,809,2.6,13.2,1165,453,712,6,15.3,-161,-2.1,26.4,0,72,72,320
2004,46,f) 5,791,817,6801,6803,28,3.3,77,9.1,942,78,864,1.1,13.8,946,293,653,4.3,13.9,-4,-0.1,27.6,0,59,59,259
2004,46,g) 6 to 10,3278,3420,30221,30094,129,3.7,281,8,4170,616,3554,2,13.9,3916,1411,2505,4.7,13,254,0.9,26,0,211,211,1060
2004,46,h) 11 to 15,2163,2301,23027,22938,90,3.8,166,7.1,3153,811,2342,3.5,13.7,2975,711,2264,3.1,13,178,0.7,26,0,119,119,579
2004,46,i) 16 to 20,1807,2013,25873,25397,56,2.7,119,5.8,3742,399,3343,1.6,14.7,2789,969,1820,3.8,11,953,3.7,22,0,80,80,842
2004,46,j) 21 to 25,1266,1576,20599,20672,55,3.5,83,5.2,2102,455,1647,2.2,10.2,2247,655,1592,3.2,10.9,-145,-0.7,20.4,0,48,48,245
2004,46,k) 26+,545,775,12366,12349,20,2.6,31,4,1496,,,,12.1,1461,804,657,6.5,11.8,35,0.3,23.6,1,21,21,182
2004,46,l) Left Censored,2997,5238,147480,146113,204,3.9,299,5.7,16913,3799,13114,2.6,11.6,14179,4610,9569,3.2,9.7,2734,1.9,19.4,0,93,93,535
2004,47,a) 0,8606,8657,58303,29209,8623,199.2,0,0,58189,58189,0,199.2,199.2,0,0,0,0,0,58189,199.2,0,0,,,
2004,47,b) 1,6188,6253,52864,55542,24,0.3,1868,25.7,13467,378,13089,0.7,24.2,18823,11509,7314,20.7,33.9,-5356,-9.7,48.4,0,1533,1533,10204
2004,47,c) 2,5171,5336,49870,50506,200,3.5,1005,17.5,10266,1528,8738,3,20.3,11538,6449,5089,12.8,22.8,-1272,-2.5,40.6,0,839,839,5647
2004,47,d) 3,4486,4630,41899,42308,178,3.6,699,14.2,7510,878,6632,2.1,17.8,8328,3316,5012,7.8,19.7,-818,-1.9,35.6,0,588,588,2969
2004,47,e) 4,4042,4211,45302,45506,170,3.8,574,12.9,8141,820,7321,1.8,17.9,8548,4169,4379,9.2,18.8,-407,-0.9,35.8,0,454,454,3304
2004,47,f) 5,3885,4311,50422,50124,194,4.3,497,11.1,10352,1102,9250,2.2,20.7,9756,4099,5657,8.2,19.5,596,1.2,39,0,388,388,2961
2004,47,g) 6 to 10,15971,17180,201451,202163,688,3.9,1742,9.8,31156,5292,25864,2.6,15.4,32580,12586,19994,6.2,16.1,-1424,-0.7,30.8,0,1321,1321,9829
2004,47,h) 11 to 15,10993,12470,172096,171031,393,3.1,968,7.6,25550,4777,20773,2.8,14.9,23420,8018,15402,4.7,13.7,2130,1.2,27.4,0,698,699,4860
2004,47,i) 16 to 20,10295,12241,203009,206260,421,3.4,715,5.8,21248,4576,16672,2.2,10.3,27749,5943,21806,2.9,13.5,-6501,-3.2,20.6,0,478,480,3043
2004,47,j) 21 to 25,6129,7864,150183,149823,266,3.3,420,5.3,15840,3613,12227,2.4,10.6,15120,3320,11800,2.2,10.1,720,0.5,20.2,0,286,286,1951
2004,47,k) 26+,2677,5221,134265,133270,166,3.2,195,3.7,15830,5749,10081,4.3,11.9,13839,2275,11564,1.7,10.4,1991,1.5,20.8,0,87,87,538
2004,47,l) Left Censored,12527,31681,1174089,1167637,1830,5.8,1830,5.8,135070,37161,97909,3.2,11.6,122165,37629,84536,3.2,10.5,12905,1.1,21,0,396,410,4481
2004,48,a) 0,35959,36196,257087,129584,36043,199.2,0,0,255007,255007,0,196.8,196.8,0,0,0,0,0,255007,196.8,0,0,,,
2004,48,b) 1,26495,26845,232250,241687,86,0.3,8136,26,61318,1179,60139,0.5,25.4,80192,47922,32270,19.8,33.2,-18874,-7.8,50.8,0,6677,6682,42132
2004,48,c) 2,22212,22925,243467,253079,808,3.2,4519,18.1,44490,4661,39829,1.8,17.6,63715,33723,29992,13.3,25.2,-19225,-7.6,35.2,0,3778,3780,30184
2004,48,d) 3,19150,19913,197348,202040,801,3.8,3219,15.2,37103,4573,32530,2.3,18.4,46487,22718,23769,11.2,23,-9384,-4.6,36.8,0,2586,2596,19169
2004,48,e) 4,17075,17873,184405,188708,666,3.5,2624,13.9,32659,4398,28261,2.3,17.3,41264,17709,23555,9.4,21.9,-8605,-4.6,34.6,0,2096,2096,13852
2004,48,f) 5,15708,16732,202598,206660,578,3.3,2119,12.1,32801,4440,28361,2.1,15.9,40925,15847,25078,7.7,19.8,-8124,-3.9,31.8,0,1721,1722,12660
2004,48,g) 6 to 10,61336,66545,829584,840994,2604,3.8,6979,10.1,130264,24279,105985,2.9,15.5,153083,56341,96742,6.7,18.2,-22819,-2.7,31,0,5365,5387,42100
2004,48,h) 11 to 15,40303,45457,658610,668930,1660,3.5,3998,8.5,94198,21733,72465,3.2,14.1,114838,36138,78700,5.4,17.2,-20640,-3.1,28.2,0,2739,2739,19464
2004,48,i) 16 to 20,31697,39514,701078,711110,1372,3.4,2607,6.5,88726,18043,70683,2.5,12.5,108790,24935,83855,3.5,15.3,-20064,-2.8,25,0,1734,1759,13476
2004,48,j) 21 to 25,24367,31920,604569,597855,1163,3.6,2072,6.4,94825,33666,61159,5.6,15.9,81399,24830,56569,4.2,13.6,13426,2.3,27.2,0,1242,1243,9063
2004,48,k) 26+,7732,14353,321723,321179,591,4.1,726,5,39491,12713,26778,4,12.3,38402,8037,30365,2.5,12,1089,0.3,24,0,355,376,2378
2004,48,l) Left Censored,31465,101054,3597356,3590125,7434,7.4,6808,6.8,467087,167677,299410,4.7,13,452624,143267,309357,4,12.6,14463,0.4,25.2,0,1178,1179,10913
2004,49,a) 0,5790,5815,32456,16294,5786,199,0,0,32324,32324,0,198.4,198.4,0,0,0,0,0,32324,198.4,0,0,,,
2004,49,b) 1,4185,4206,34774,34053,12,0.2,1307,26.5,12104,149,11955,0.4,35.5,10662,7025,3637,20.6,31.3,1442,4.2,62.6,0,971,971,6041
2004,49,c) 2,3412,3478,28675,28922,175,4.7,689,18.3,6095,621,5474,2.1,21.1,6588,3197,3391,11.1,22.8,-493,-1.7,42.2,0,530,531,2767
2004,49,d) 3,2793,2873,25015,24716,134,4.4,486,15.8,5464,493,4971,2,22.1,4866,2542,2324,10.3,19.7,598,2.4,39.4,0,358,358,2078
2004,49,e) 4,2441,2482,21408,22063,130,5,358,13.7,3651,391,3260,1.8,16.5,4961,2455,2506,11.1,22.5,-1310,-6,33,0,270,270,2061
2004,49,f) 5,2174,2248,21324,22341,111,4.7,306,13,3321,579,2742,2.6,14.9,5354,1767,3587,7.9,24,-2033,-9.1,29.8,0,233,233,1522
2004,49,g) 6 to 10,8048,8435,106703,105891,372,4.3,861,9.9,18433,2463,15970,2.3,17.4,16808,4773,12035,4.5,15.9,1625,1.5,31.8,0,593,593,3362
2004,49,h) 11 to 15,4314,4677,79298,80695,161,3.3,437,9,12439,2462,9977,3.1,15.4,15233,3785,11448,4.7,18.9,-2794,-3.5,30.8,0,260,260,2222
2004,49,i) 16 to 20,2964,3663,82057,78087,131,3.5,267,7.1,17120,1416,15704,1.8,21.9,9179,2699,6480,3.5,11.8,7941,10.1,23.6,0,159,159,1308
2004,49,j) 21 to 25,2284,2972,55997,56463,167,5.6,202,6.7,7080,2146,4934,3.8,12.5,8012,2938,5074,5.2,14.2,-932,-1.7,25,0,117,117,1032
2004,49,k) 26+,964,1472,36393,34553,66,4.5,83,5.6,6575,3064,3511,8.9,19,2894,995,1899,2.9,8.4,3681,10.6,16.8,0,38,38,273
2004,49,l) Left Censored,4135,10368,417372,413007,731,7.1,689,6.7,51101,18069,33032,4.4,12.4,42370,12135,30235,2.9,10.3,8731,2.1,20.6,0,132,132,1021
2004,50,a) 0,1303,1308,6666,3338,1305,199.5,0,0,6656,6656,0,199.4,199.4,0,0,0,0,0,6656,199.4,0,0,,,
2004,50,b) 1,1021,1034,5998,6077,4,0.3,235,20.2,1233,12,1221,0.2,20.3,1391,659,732,10.8,22.9,-158,-2.6,40.6,0,165,165,544
2004,50,c) 2,861,871,5543,5767,43,4.6,146,15.8,720,134,586,2.3,12.5,1167,610,557,10.6,20.2,-447,-7.7,25,0,112,112,541
2004,50,d) 3,783,792,4706,4886,28,3.4,104,12.4,720,62,658,1.3,14.7,1079,418,661,8.6,22.1,-359,-7.4,29.4,0,77,77,350
2004,50,e) 4,772,791,6425,6969,38,4.7,74,9.1,734,116,618,1.7,10.5,1822,308,1514,4.4,26.1,-1088,-15.6,21,0,56,56,267
2004,50,f) 5,718,733,5307,5535,26,3.4,80,10.5,737,142,595,2.6,13.3,1192,604,588,10.9,21.5,-455,-8.2,26.6,0,51,51,438
2004,50,g) 6 to 10,2981,3128,24212,24826,105,3.3,290,9,2490,274,2216,1.1,10,3718,1468,2250,5.9,15,-1228,-5,20,0,225,225,1245
2004,50,h) 11 to 15,2307,2407,20855,21076,76,3.1,167,6.8,2152,237,1915,1.1,10.2,2593,804,1789,3.8,12.3,-441,-2.1,20.4,0,103,103,534
2004,50,i) 16 to 20,2070,2285,32529,32471,74,3.2,132,5.7,2768,305,2463,0.9,8.5,2652,405,2247,1.2,8.2,116,0.3,16.4,0,81,81,293
2004,50,j) 21 to 25,1206,1410,18877,19273,35,2.4,83,5.8,1545,370,1175,1.9,8,2337,1054,1283,5.5,12.1,-792,-4.1,16,0,52,52,579
2004,50,k) 26+,476,675,12955,13145,16,2.4,28,4.1,873,80,793,0.6,6.6,1253,235,1018,1.8,9.5,-380,-2.9,13.2,0,18,18,60
2004,50,l) Left Censored,2348,3994,110413,111398,160,4,187,4.7,7856,1725,6131,1.5,7.1,9825,2056,7769,1.8,8.8,-1969,-1.7,14.2,0,49,49,250
2004,51,a) 0,13423,13454,79031,39583,13391,199.1,0,0,78897,78897,0,199.3,199.3,0,0,0,0,0,78897,199.3,0,0,,,
2004,51,b) 1,9326,9393,67701,69062,24,0.2,2551,23.7,19088,363,18725,0.5,27.6,21809,14362,7447,20.8,31.6,-2721,-4,55.2,0,2026,2026,12232
2004,51,c) 2,8079,8226,63661,63852,325,3.7,1321,15,13662,2023,11639,3.2,21.4,14044,7269,6775,11.4,22,-382,-0.6,42.8,0,1060,1060,6448
2004,51,d) 3,6949,7237,61044,61060,296,3.9,993,13,12950,1298,11652,2.1,21.2,12982,7248,5734,11.9,21.3,-32,-0.1,42.4,0,775,775,6323
2004,51,e) 4,6408,6634,59136,57925,284,4.1,815,11.8,12006,1403,10603,2.4,20.7,9584,4131,5453,7.1,16.5,2422,4.2,33,0,598,600,3287
2004,51,f) 5,5898,6245,63132,62305,210,3.2,639,9.9,10597,1174,9423,1.9,17,8942,3392,5550,5.4,14.4,1655,2.6,28.8,0,476,476,2559
2004,51,g) 6 to 10,23874,25249,290401,287189,984,3.8,2268,8.7,45694,7158,38536,2.5,15.9,39271,13038,26233,4.5,13.7,6423,2.2,27.4,0,1614,1616,10325
2004,51,h) 11 to 15,16099,17592,243010,243524,579,3.2,1231,6.9,32718,6016,26702,2.5,13.4,33746,12144,21602,5,13.9,-1028,-0.5,26.8,0,821,821,4875
2004,51,i) 16 to 20,13879,16744,295772,295889,534,3.1,978,5.8,34623,6322,28301,2.1,11.7,34856,9725,25131,3.3,11.8,-233,-0.1,23.4,0,610,614,4619
2004,51,j) 21 to 25,8198,10595,216327,213830,418,3.9,519,4.9,25128,4784,20344,2.2,11.8,20133,4756,15377,2.2,9.4,4995,2.4,18.8,0,325,325,2722
2004,51,k) 26+,3042,5380,114441,112585,202,3.7,224,4.2,14950,4992,9958,4.4,13.3,11238,1998,9240,1.8,10,3712,3.3,20,0,125,125,921
2004,51,l) Left Censored,15325,41120,1458900,1439851,2510,6.1,2319,5.7,192030,54857,137173,3.8,13.3,153931,36293,117638,2.5,10.7,38099,2.6,21.4,0,476,487,4946
2004,53,a) 0,12831,12871,65335,32769,12789,198.7,0,0,65132,65132,0,198.8,198.8,0,0,0,0,0,65132,198.8,0,0,,,
2004,53,b) 1,9135,9179,60695,63118,24,0.2,2937,27.2,15942,467,15475,0.7,25.3,20788,9896,10892,15.7,32.9,-4846,-7.6,50.6,0,2166,2166,8095
2004,53,c) 2,7990,8159,56735,56741,367,4.2,1434,16.4,12232,1561,10671,2.8,21.6,12244,6399,5845,11.3,21.6,-12,0,43.2,0,1117,1117,5505
2004,53,d) 3,6906,7074,52269,52908,312,4.2,1087,14.5,9448,1368,8080,2.6,17.9,10725,5091,5634,9.6,20.3,-1277,-2.4,35.8,0,857,857,4369
2004,53,e) 4,6333,6547,52866,53022,331,4.8,923,13.4,9533,1277,8256,2.4,18,9845,4433,5412,8.4,18.6,-312,-0.6,36,0,689,689,3428
2004,53,f) 5,5953,6241,58341,58764,253,3.9,786,12,8349,1011,7338,1.7,14.2,9194,3899,5295,6.6,15.6,-845,-1.4,28.4,0,574,574,3266
2004,53,g) 6 to 10,23002,24219,230415,232631,1077,4.3,2537,10.1,35038,6777,28261,2.9,15.1,39469,13764,25705,5.9,17,-4431,-1.9,30.2,0,1825,1825,10731
2004,53,h) 11 to 15,14976,16231,179510,181919,702,4.2,1511,9.1,24031,4080,19951,2.2,13.2,28849,10127,18722,5.6,15.9,-4818,-2.7,26.4,0,998,998,5318
2004,53,i) 16 to 20,11330,13511,216837,217740,489,3.6,912,6.6,22097,4714,17383,2.2,10.1,23902,6027,17875,2.8,11,-1805,-0.9,20.2,0,587,589,4015
2004,53,j) 21 to 25,7773,9902,192312,193280,455,4.6,580,5.8,19886,3879,16007,2,10.3,21822,6033,15789,3.1,11.3,-1936,-1,20.6,0,358,362,2036
2004,53,k) 26+,3041,4947,108834,107087,196,3.9,292,5.8,13108,2995,10113,2.8,12.2,9613,2628,6985,2.5,9,3495,3.2,18,0,137,137,672
2004,53,l) Left Censored,12283,29733,980496,970638,1794,6,1671,5.6,123054,37360,85694,3.8,12.7,103337,24179,79158,2.5,10.6,19717,2.1,21.2,0,392,393,4638
2004,54,a) 0,2325,2344,12472,6255,2334,199.1,0,0,12435,12435,0,198.8,198.8,0,0,0,0,0,12435,198.8,0,0,,,
2004,54,b) 1,1630,1657,13117,13023,12,0.6,457,24.1,3465,92,3373,0.7,26.6,3276,1925,1351,14.8,25.2,189,1.4,50.4,0,361,361,1621
2004,54,c) 2,1464,1499,12071,12201,63,3.9,272,16.9,2351,350,2001,2.9,19.3,2611,1431,1180,11.7,21.4,-260,-2.1,38.6,0,215,215,1268
2004,54,d) 3,1267,1283,11089,10997,50,3.7,184,13.6,2138,259,1879,2.4,19.4,1954,908,1046,8.3,17.8,184,1.6,35.6,0,153,153,826
2004,54,e) 4,1283,1334,11119,11017,55,4,155,11.2,1970,153,1817,1.4,17.9,1766,743,1023,6.7,16,204,1.9,32,0,119,119,564
2004,54,f) 5,1155,1212,11237,11259,53,4.2,141,11.2,1881,337,1544,3,16.7,1925,844,1081,7.5,17.1,-44,-0.4,33.4,0,112,112,585
2004,54,g) 6 to 10,4902,5263,48277,48044,228,4.2,501,9.2,8050,1400,6650,2.9,16.8,7583,2378,5205,4.9,15.8,467,1,31.6,0,381,381,1895
2004,54,h) 11 to 15,3565,3786,39945,40590,120,3.1,318,8.2,4465,453,4012,1.1,11,5755,2150,3605,5.3,14.2,-1290,-3.2,22,0,229,229,1497
2004,54,i) 16 to 20,3321,3800,58642,59323,115,3,231,6,5224,705,4519,1.2,8.8,6586,1472,5114,2.5,11.1,-1362,-2.3,17.6,0,168,168,1029
2004,54,j) 21 to 25,2243,2578,36489,36477,65,2.5,160,6.1,4279,528,3751,1.4,11.7,4255,1400,2855,3.8,11.7,24,0,23.4,0,97,114,766
2004,54,k) 26+,939,1782,31694,31574,82,4.6,76,4.3,3815,1042,2773,3.3,12.1,3575,819,2756,2.6,11.3,240,0.8,22.6,0,41,42,149
2004,54,l) Left Censored,5183,10452,274687,274828,431,4.1,512,4.9,25027,5881,19146,2.1,9.1,25308,5395,19913,2,9.2,-281,-0.1,18.2,0,182,182,1017
2004,55,a) 0,8044,8091,56732,28410,8057,199.2,0,0,56645,56645,0,199.4,199.4,0,0,0,0,0,56645,199.4,0,0,,,
2004,55,b) 1,6120,6186,48128,49980,18,0.3,1629,23,11080,129,10951,0.3,22.2,14783,9795,4988,19.6,29.6,-3703,-7.4,44.4,0,1224,1224,8198
2004,55,c) 2,5702,5840,47783,48315,209,3.4,899,14.5,8834,1394,7440,2.9,18.3,9897,4611,5286,9.5,20.5,-1063,-2.2,36.6,0,686,686,3832
2004,55,d) 3,4931,5158,52287,52437,186,3.4,687,12.7,7353,816,6537,1.6,14,7652,3482,4170,6.6,14.6,-299,-0.6,28,0,532,532,2709
2004,55,e) 4,4734,4907,45051,45227,182,3.6,513,10.1,7041,1067,5974,2.4,15.6,7392,2995,4397,6.6,16.3,-351,-0.7,31.2,0,372,372,1981
2004,55,f) 5,4324,4653,52550,52395,168,3.5,512,10.6,7128,602,6526,1.1,13.6,6818,2571,4247,4.9,13,310,0.6,26,0,373,374,1811
2004,55,g) 6 to 10,18061,19061,195411,196323,625,3.2,1723,8.8,26044,3390,22654,1.7,13.3,27868,8937,18931,4.6,14.2,-1824,-0.9,26.6,0,1236,1245,7174
2004,55,h) 11 to 15,12960,14061,165638,165868,468,3.3,1004,7,20551,3581,16970,2.2,12.4,21010,7138,13872,4.3,12.7,-459,-0.3,24.8,0,700,706,5043
2004,55,i) 16 to 20,10804,12816,207819,207114,354,2.7,748,5.7,24626,4028,20598,1.9,11.9,23216,6795,16421,3.3,11.2,1410,0.7,22.4,0,474,480,3544
2004,55,j) 21 to 25,6999,8505,152076,152174,236,2.7,442,5.1,15479,2436,13043,1.6,10.2,15674,4182,11492,2.7,10.3,-195,-0.1,20.4,0,271,274,2627
2004,55,k) 26+,3015,5176,110570,110227,193,3.7,201,3.9,11182,2558,8624,2.3,10.1,10495,2876,7619,2.6,9.5,687,0.6,19,0,114,119,787
2004,55,l) Left Censored,16628,33722,1292745,1285553,1542,4.6,1561,4.6,132167,35445,96722,2.8,10.3,117783,31147,86636,2.4,9.2,14384,1.1,18.4,0,487,493,4653
2004,56,a) 0,1366,1369,5964,2987,1362,199,0,0,5955,5955,0,199.4,199.4,0,0,0,0,0,5955,199.4,0,0,,,
2004,56,b) 1,1036,1038,6189,5936,4,0.3,275,23.1,1985,32,1953,0.5,33.4,1478,975,503,16.4,24.9,507,8.5,49.8,0,202,202,706
2004,56,c) 2,1011,1020,6835,6766,48,4.4,177,16.2,1499,126,1373,1.9,22.2,1360,666,694,9.8,20.1,139,2.1,40.2,0,127,127,505
2004,56,d) 3,791,801,4911,5009,22,2.6,111,13.1,883,103,780,2.1,17.6,1079,450,629,9,21.5,-196,-3.9,35.2,0,79,79,367
2004,56,e) 4,777,794,5253,5195,30,3.6,94,11.3,939,105,834,2,18.1,823,399,424,7.7,15.8,116,2.3,31.6,0,72,72,330
2004,56,f) 5,620,642,4323,4576,18,2.6,85,12.5,651,91,560,2,14.2,1157,474,683,10.4,25.3,-506,-11.1,28.4,0,61,61,341
2004,56,g) 6 to 10,2679,2789,22931,22891,118,4.1,273,9.5,3621,504,3117,2.2,15.8,3540,1241,2299,5.4,15.5,81,0.3,31,0,195,195,873
2004,56,h) 11 to 15,1582,1682,18449,18627,53,3.1,139,8,2090,209,1881,1.1,11.2,2445,766,1679,4.1,13.1,-355,-1.9,22.4,0,95,95,450
2004,56,i) 16 to 20,1264,1380,16385,16185,38,2.7,83,5.9,1867,214,1653,1.3,11.5,1466,332,1134,2.1,9.1,401,2.4,18.2,0,57,57,238
2004,56,j) 21 to 25,1123,1356,17501,17302,44,3.2,80,5.8,2199,492,1707,2.8,12.7,1801,334,1467,1.9,10.4,398,2.3,20.8,0,54,54,245
2004,56,k) 26+,441,641,10299,10063,30,4.7,24,3.8,1428,343,1085,3.4,14.2,955,144,811,1.4,9.5,473,4.7,19,0,15,15,109
2004,56,l) Left Censored,1832,3249,65468,64845,207,6.4,208,6.4,7528,2181,5347,3.4,11.6,6281,1787,4494,2.8,9.7,1247,1.9,19.4,0,41,41,265
2005,01,a) 0,6645,6724,44131,22186,6683,198.8,0,0,43891,43891,0,197.8,197.8,0,0,0,0,0,43891,197.8,0,0,,,
2005,01,b) 1,4995,5024,39197,39292,20,0.3,1328,23.1,11013,352,10661,0.9,28,11203,6604,4599,16.8,28.5,-190,-0.5,56,0,1119,1119,5835
2005,01,c) 2,4217,4251,37400,39294,125,2.7,804,17.5,7399,646,6753,1.6,18.8,11186,5957,5229,15.2,28.5,-3787,-9.7,37.6,0,687,687,5577
2005,01,d) 3,3630,3732,34750,35523,123,3.1,530,13.4,6625,662,5963,1.9,18.6,8171,3628,4543,10.2,23,-1546,-4.4,37.2,0,448,448,2974
2005,01,e) 4,3178,3353,34793,34795,125,3.5,446,12.6,6989,602,6387,1.7,20.1,6992,2455,4537,7.1,20.1,-3,0,40.2,0,362,367,2184
2005,01,f) 5,3014,3176,33894,34464,107,3.2,386,11.6,5815,801,5014,2.3,16.9,6955,2488,4467,7.2,20.2,-1140,-3.3,33.8,0,320,320,2008
2005,01,g) 6 to 10,13169,14086,153423,155385,514,3.5,1349,9.3,24576,4363,20213,2.8,15.8,28499,9062,19437,5.8,18.3,-3923,-2.5,31.6,0,1044,1044,6798
2005,01,h) 11 to 15,8666,9515,127001,128491,310,3.2,818,8.4,18081,2430,15651,1.9,14.1,21060,6436,14624,5,16.4,-2979,-2.3,28.2,0,621,622,5165
2005,01,i) 16 to 20,6977,8423,160007,161988,278,3.3,494,5.8,18146,3452,14694,2.1,11.2,22107,6508,15599,4,13.6,-3961,-2.4,22.4,0,347,347,2749
2005,01,j) 21 to 25,5525,6712,129978,128935,176,2.6,300,4.4,14171,2370,11801,1.8,11,12085,2789,9296,2.2,9.4,2086,1.6,18.8,0,214,214,1266
2005,01,k) 26+,2835,5049,95770,94991,196,3.9,239,4.7,13129,4306,8823,4.5,13.8,11571,2554,9017,2.7,12.2,1558,1.6,24.4,0,128,138,1254
2005,01,l) Left Censored,9061,23066,769105,756238,1458,6.4,1129,4.9,103741,30596,73145,4,13.7,78007,16137,61870,2.1,10.3,25734,3.4,20.6,0,291,292,1979
2005,02,a) 0,1279,1280,6036,3040,1269,198.3,0,0,5993,,,,197.1,0,0,0,0,0,5993,197.1,0,1,,,
2005,02,b) 1,964,971,5313,5523,6,0.5,333,28.8,1535,,,,27.8,1954,940,1014,17,35.4,-419,-7.6,55.6,1,222,222,706
2005,02,c) 2,782,809,5441,5557,57,6.6,144,16.7,1354,150,1204,2.7,24.4,1585,530,1055,9.5,28.5,-231,-4.1,48.8,0,106,106,383
2005,02,d) 3,808,843,6545,6516,41,4.6,120,13.6,1362,163,1199,2.5,20.9,1304,550,754,8.4,20,58,0.9,40,0,84,84,413
2005,02,e) 4,627,643,5140,4950,41,6.1,91,13.6,1171,155,1016,3.1,23.7,790,365,425,7.4,16,381,7.7,32,0,69,69,261
2005,02,f) 5,639,663,8646,8302,28,4.1,74,10.7,1997,93,1904,1.1,24.1,1308,426,882,5.1,15.8,689,8.3,31.6,0,47,47,272
2005,02,g) 6 to 10,2428,2590,23620,23854,154,5.8,262,9.9,3943,438,3505,1.8,16.5,4411,1170,3241,4.9,18.5,-468,-2,33,0,180,180,884
2005,02,h) 11 to 15,1632,1725,14930,15008,87,5,137,7.8,2331,301,2030,2,15.5,2486,872,1614,5.8,16.6,-155,-1.1,31,0,90,90,594
2005,02,i) 16 to 20,1288,1451,21541,21652,55,3.7,89,6.1,2445,653,1792,3,11.3,2666,419,2247,1.9,12.3,-221,-1,22.6,0,66,66,350
2005,02,j) 21 to 25,1084,1387,24675,24191,33,2.3,73,5.2,3142,485,2657,2,13,2173,318,1855,1.3,9,969,4,18,0,43,43,232
2005,02,k) 26+,552,961,18374,18220,39,4,46,4.8,2028,406,1622,2.2,11.1,1719,290,1429,1.6,9.4,309,1.7,18.8,0,23,23,233
2005,02,l) Left Censored,1388,3113,89489,89293,179,5.8,120,3.9,8829,2268,6561,2.5,9.9,8437,1404,7033,1.6,9.4,392,0.5,18.8,0,24,24,236
2005,04,a) 0,11174,11330,78429,39368,11253,198.6,0,0,78123,78123,0,198.4,198.4,0,0,0,0,0,78123,198.4,0,0,,,
2005,04,b) 1,7854,7941,63885,63015,51,0.6,2056,22.6,18480,888,17592,1.4,29.3,16739,9654,7085,15.3,26.6,1741,2.7,53.2,0,1626,1626,8061
2005,04,c) 2,6328,6440,64941,63607,244,3.5,1169,16.9,17139,1955,15184,3.1,26.9,14471,6792,7679,10.7,22.8,2668,4.1,45.6,0,980,980,6042
2005,04,d) 3,5514,5618,62357,62261,212,3.6,829,13.9,12267,1397,10870,2.2,19.7,12074,5446,6628,8.7,19.4,193,0.3,38.8,0,666,666,4775
2005,04,e) 4,4896,5117,50854,51046,211,3.9,641,11.9,8418,1037,7381,2,16.5,8802,3397,5405,6.7,17.2,-384,-0.7,33,0,498,498,2568
2005,04,f) 5,4309,4504,76576,74717,171,3.6,537,11.4,12174,1078,11096,1.4,16.3,8456,3577,4879,4.8,11.3,3718,5,22.6,0,423,423,2915
2005,04,g) 6 to 10,16589,17840,245865,243828,834,4.5,1823,9.9,42125,5887,36238,2.4,17.3,38050,14786,23264,6.1,15.6,4075,1.7,31.2,0,1396,1396,12055
2005,04,h) 11 to 15,9716,10631,169601,168619,437,4,878,8.1,26910,5923,20987,3.5,16,24945,7679,17266,4.6,14.8,1965,1.2,29.6,0,652,652,6339
2005,04,i) 16 to 20,7299,9770,194268,193343,441,4.5,637,6.4,26531,7118,19413,3.7,13.7,24680,8123,16557,4.2,12.8,1851,0.9,25.6,0,392,395,5371
2005,04,j) 21 to 25,5318,7416,154863,151018,348,4.7,431,5.8,23156,9220,13936,6.1,15.3,15465,4043,11422,2.7,10.2,7691,5.1,20.4,0,247,247,2334
2005,04,k) 26+,2432,4566,131189,127626,314,6.9,255,5.6,25449,12917,12532,10.1,19.9,18323,3852,14471,3,14.4,7126,5.5,28.8,0,112,113,988
2005,04,l) Left Censored,6594,21619,846185,830686,2030,9.6,1199,5.7,132219,49062,83157,5.9,15.9,101220,29231,71989,3.5,12.2,30999,3.7,24.4,0,211,211,2791
2005,05,a) 0,4580,4618,26349,13217,4585,198.6,0,0,26264,,,,198.7,0,0,0,0,0,26264,198.7,0,1,,,
2005,05,b) 1,3334,3359,21370,22852,8,0.2,1025,26.2,5165,,,,22.6,8129,5274,2855,23.1,35.6,-2964,-13,45.2,1,853,853,4759
2005,05,c) 2,2824,2846,20464,21257,96,3.1,562,18.2,3800,270,3530,1.3,17.9,5386,2265,3121,10.7,25.3,-1586,-7.4,35.8,0,470,470,1939
2005,05,d) 3,2475,2540,21851,22510,84,3.1,398,14.7,3624,379,3245,1.7,16.1,4941,1952,2989,8.7,22,-1317,-5.9,32.2,0,333,333,1776
2005,05,e) 4,2161,2250,18000,18125,87,3.7,317,13.4,3589,634,2955,3.5,19.8,3838,1283,2555,7.1,21.2,-249,-1.4,39.6,0,262,262,1054
2005,05,f) 5,2012,2113,18041,18830,69,3.1,265,11.9,2897,613,2284,3.3,15.4,4475,1893,2582,10.1,23.8,-1578,-8.4,30.8,0,211,211,1704
2005,05,g) 6 to 10,8299,9002,85124,87370,317,3.4,879,9.5,12398,2782,9616,3.2,14.2,16890,5965,10925,6.8,19.3,-4492,-5.1,28.4,0,695,695,4861
2005,05,h) 11 to 15,5698,6186,63726,65298,227,3.6,527,8.3,8384,1937,6447,3,12.8,11527,3839,7688,5.9,17.7,-3143,-4.9,25.6,0,421,423,2381
2005,05,i) 16 to 20,4087,4960,98266,98689,130,2.6,302,6,9280,1765,7515,1.8,9.4,10125,3723,6402,3.8,10.3,-845,-0.9,18.8,0,227,229,1834
2005,05,j) 21 to 25,3605,4297,72166,71923,107,2.4,244,5.6,8280,785,7495,1.1,11.5,7794,2129,5665,3,10.8,486,0.7,21.6,0,178,178,1238
2005,05,k) 26+,1921,2880,60700,60361,87,3,120,4.1,6434,1839,4595,3,10.7,5755,1229,4526,2,9.5,679,1.2,19,0,79,79,619
2005,05,l) Left Censored,6068,14306,506628,500907,843,5.9,553,3.9,52189,15099,37090,3,10.4,40748,8199,32549,1.6,8.1,11441,2.3,16.2,0,180,182,2098
2005,06,a) 0,69732,71296,449266,225593,70835,198.7,0,0,447346,447346,0,198.3,198.3,0,0,0,0,0,447346,198.3,0,0,,,
2005,06,b) 1,49985,50394,399280,403328,225,0.4,13684,23.7,108905,2656,106249,0.7,27,117002,65100,51902,16.1,29,-8097,-2,54,0,10860,10860,54213
2005,06,c) 2,42279,42836,370402,375850,1833,4,8214,17.8,87725,8653,79072,2.3,23.3,98620,49527,49093,13.2,26.2,-10895,-2.9,46.6,0,6685,6702,42915
2005,06,d) 3,36736,37787,353626,365037,1566,3.9,5960,14.9,60579,7871,52708,2.2,16.6,83401,38110,45291,10.4,22.8,-22822,-6.2,33.2,0,4790,4800,31924
2005,06,e) 4,31925,33204,309270,317483,1467,4.2,4642,13.3,52703,7872,44831,2.5,16.6,69128,31010,38118,9.8,21.8,-16425,-5.2,33.2,0,3639,3645,25979
2005,06,f) 5,28365,29536,305959,312462,1300,4.2,3798,12.3,48826,6568,42258,2.1,15.6,61832,25121,36711,8,19.8,-13006,-4.2,31.2,0,2965,2965,20349
2005,06,g) 6 to 10,105437,113086,1395103,1419315,4980,4.3,12266,10.5,216454,36126,180328,2.5,15.3,264878,98081,166797,6.9,18.7,-48424,-3.4,30.6,0,9385,9403,78531
2005,06,h) 11 to 15,68415,75159,1069761,1083164,3158,4.1,6792,8.8,150770,33287,117483,3.1,13.9,177575,56834,120741,5.2,16.4,-26805,-2.5,27.8,0,5071,5081,40377
2005,06,i) 16 to 20,57956,69784,1242139,1259296,2925,4.1,5479,7.7,136469,31285,105184,2.5,10.8,170782,55683,115099,4.4,13.6,-34313,-2.8,21.6,0,3690,3706,30120
2005,06,j) 21 to 25,42691,55001,1057440,1069517,1907,3.4,3508,6.3,120831,26673,94158,2.5,11.3,144985,42344,102641,4,13.6,-24154,-2.3,22.6,0,2248,2262,21473
2005,06,k) 26+,21032,34626,872846,877849,1630,4.7,2232,6.4,127449,50340,77109,5.7,14.5,137455,24519,112936,2.8,15.7,-10006,-1.2,29,0,1115,1127,9863
2005,06,l) Left Censored,50721,139233,5352053,5343299,9312,6.7,7924,5.7,622352,196147,426205,3.7,11.6,604843,151075,453768,2.8,11.3,17509,0.3,22.6,0,2242,2287,30944
2005,08,a) 0,12585,12683,66549,33389,12592,198.6,0,0,66321,66321,0,198.6,198.6,0,0,0,0,0,66321,198.6,0,0,,,
2005,08,b) 1,8707,8771,53236,55538,31,0.3,2686,26.2,14531,353,14178,0.6,26.2,19135,12249,6886,22.1,34.5,-4604,-8.3,52.4,0,1994,1994,10349
2005,08,c) 2,7454,7560,50046,54781,342,4.2,1443,17.7,9634,1174,8460,2.1,17.6,19104,12853,6251,23.5,34.9,-9470,-17.3,35.2,0,1150,1150,11403
2005,08,d) 3,6481,6621,47955,49109,298,4.2,1090,15.5,8154,726,7428,1.5,16.6,10461,4415,6046,9,21.3,-2307,-4.7,33.2,0,823,823,3633
2005,08,e) 4,5913,6105,49593,50542,303,4.7,841,13.1,8372,1185,7187,2.3,16.6,10270,4573,5697,9,20.3,-1898,-3.7,33.2,0,627,627,3984
2005,08,f) 5,5335,5491,50327,51262,270,4.7,744,13,7927,1028,6899,2,15.5,9797,4251,5546,8.3,19.1,-1870,-3.6,31,0,527,533,3473
2005,08,g) 6 to 10,20228,21367,205770,211108,947,4.3,2310,10.5,32003,6118,25885,2.9,15.2,42678,16339,26339,7.7,20.2,-10675,-5,30.4,0,1672,1672,13312
2005,08,h) 11 to 15,12523,13468,161875,163503,533,3.9,1181,8.5,21532,5064,16468,3.1,13.2,24788,7616,17172,4.7,15.2,-3256,-2,26.4,0,785,796,4930
2005,08,i) 16 to 20,8506,10093,166938,168235,369,3.6,691,6.7,19084,4418,14666,2.6,11.3,21677,6073,15604,3.6,12.9,-2593,-1.6,22.6,0,418,418,2875
2005,08,j) 21 to 25,6359,8493,160381,161979,386,4.5,475,5.6,18262,4226,14036,2.6,11.3,21457,5005,16452,3.1,13.2,-3195,-1.9,22.6,0,279,280,2218
2005,08,k) 26+,3237,5304,123201,120653,264,5,302,5.7,17712,5185,12527,4.3,14.7,12615,3767,8848,3.1,10.5,5097,4.2,21,0,150,157,888
2005,08,l) Left Censored,8634,22954,780776,772681,1778,7.8,1393,6.1,94290,35737,58553,4.6,12.2,78100,22440,55660,2.9,10.1,16190,2.1,20.2,0,264,271,3620
2005,09,a) 0,5554,5614,36531,18310,5581,198.8,0,0,36443,36443,0,199,199,0,0,0,0,0,36443,199,0,0,,,
2005,09,b) 1,4057,4071,24990,25745,6,0.1,1067,22.9,7155,21,7134,0.1,27.8,8664,4837,3827,18.8,33.7,-1509,-5.9,55.6,0,811,811,4050
2005,09,c) 2,3306,3337,25611,26163,115,3.2,608,16.9,4559,895,3664,3.4,17.4,5663,2464,3199,9.4,21.6,-1104,-4.2,34.8,0,496,496,2111
2005,09,d) 3,3255,3337,28536,29793,123,3.5,446,12.7,3874,532,3342,1.8,13,6387,2219,4168,7.4,21.4,-2513,-8.4,26,0,359,359,1994
2005,09,e) 4,2859,2917,24069,24487,114,3.8,350,11.5,4015,542,3473,2.2,16.4,4851,1807,3044,7.4,19.8,-836,-3.4,32.8,0,284,284,1525
2005,09,f) 5,2723,2844,28817,29367,113,3.8,341,11.5,3844,285,3559,1,13.1,4943,1759,3184,6,16.8,-1099,-3.7,26.2,0,247,247,1218
2005,09,g) 6 to 10,11215,11734,127701,126744,456,3.8,1119,9.3,27765,15442,12323,12.2,21.9,25851,10838,15013,8.6,20.4,1914,1.5,40.8,0,834,834,9650
2005,09,h) 11 to 15,8217,8626,93116,94328,266,3,640,7.2,10620,1745,8875,1.8,11.3,13044,3401,9643,3.6,13.8,-2424,-2.5,22.6,0,455,455,2574
2005,09,i) 16 to 20,7874,8772,132766,133284,265,3,622,6.9,17214,2964,14250,2.2,12.9,18249,6134,12115,4.6,13.7,-1035,-0.8,25.8,0,410,410,4068
2005,09,j) 21 to 25,5503,6606,100561,102132,205,3.1,346,5.2,9385,1465,7920,1.4,9.2,12526,4346,8180,4.3,12.3,-3141,-3.1,18.4,0,230,231,2543
2005,09,k) 26+,2787,3967,79321,79342,157,3.9,215,5.4,9240,3647,5593,4.6,11.6,9282,3463,5819,4.4,11.7,-42,-0.1,23.2,0,109,109,781
2005,09,l) Left Censored,11486,21806,819684,828507,1272,5.8,1350,6.2,78612,31154,47458,3.8,9.5,96258,34620,61638,4.2,11.6,-17646,-2.1,19,0,346,348,4599
2005,10,a) 0,1644,1645,9648,4832,1635,198.8,0,0,9633,,,,199.4,0,0,0,0,0,9633,199.4,0,1,,,
2005,10,b) 1,1301,1313,8513,8400,1,0.1,328,21.9,2178,,,,25.9,1952,986,966,11.7,23.2,226,2.7,46.4,1,254,254,800
2005,10,c) 2,1204,1206,8021,8355,36,2.8,171,13.4,1354,110,1244,1.3,16.2,2021,1053,968,12.6,24.2,-667,-8,32.4,0,139,139,771
2005,10,d) 3,991,1020,7256,7582,32,3,124,11.6,1345,86,1259,1.1,17.7,1997,1378,619,18.2,26.3,-652,-8.6,35.4,0,100,100,1302
2005,10,e) 4,935,941,5915,6010,30,3,138,13.8,865,62,803,1,14.4,1054,515,539,8.6,17.5,-189,-3.1,28.8,0,104,105,436
2005,10,f) 5,868,883,7000,7381,31,3.3,115,12.4,844,61,783,0.8,11.4,1606,1015,591,13.8,21.8,-762,-10.4,22.8,0,82,82,848
2005,10,g) 6 to 10,3134,3309,35432,36585,134,3.9,347,10.1,4844,936,3908,2.6,13.2,7149,2930,4219,8,19.5,-2305,-6.3,26.4,0,271,271,2682
2005,10,h) 11 to 15,2014,2167,22884,23812,91,4.1,163,7.4,3234,949,2285,4,13.6,5089,2499,2590,10.5,21.4,-1855,-7.8,27.2,0,126,126,1859
2005,10,i) 16 to 20,1639,1883,25705,25951,58,3,126,6.6,2818,886,1932,3.4,10.9,3310,624,2686,2.4,12.8,-492,-1.9,21.8,0,84,84,417
2005,10,j) 21 to 25,1087,1301,24978,25411,46,3.5,72,5.5,2057,406,1651,1.6,8.1,2923,810,2113,3.2,11.5,-866,-3.4,16.2,0,42,42,299
2005,10,k) 26+,650,960,33370,33256,44,4.6,57,5.9,2444,481,1963,1.4,7.3,2216,322,1894,1,6.7,228,0.6,13.4,0,27,27,142
2005,10,l) Left Censored,2870,5858,200326,199545,369,6.2,531,8.9,24779,7102,17677,3.6,12.4,23216,9861,13355,4.9,11.6,1563,0.8,23.2,0,48,50,355
2005,11,a) 0,1504,1504,9720,4915,1500,199.5,0,0,9611,9611,0,195.5,195.5,0,0,0,0,0,9611,195.5,0,0,,,
2005,11,b) 1,464,464,5941,5598,8,1.5,102,19.7,1613,21,1592,0.4,28.8,926,427,499,7.6,16.5,687,12.3,33,0,76,76,380
2005,11,c) 2,654,667,5504,5708,21,3,85,12.1,1021,132,889,2.3,17.9,1428,581,847,10.2,25,-407,-7.1,35.8,0,70,70,531
2005,11,d) 3,724,736,9150,8671,29,3.8,102,13.2,2102,264,1838,3,24.2,1144,371,773,4.3,13.2,958,11,26.4,0,79,79,298
2005,11,e) 4,643,662,8730,8730,30,4.4,64,9.4,1327,183,1144,2.1,15.2,1327,698,629,8,15.2,0,0,30.4,0,48,48,674
2005,11,f) 5,568,581,6666,6671,20,3.3,55,9.2,962,119,843,1.8,14.4,972,391,581,5.9,14.6,-10,-0.2,28.8,0,43,43,211
2005,11,g) 6 to 10,2410,2555,38519,38343,90,3.4,225,8.6,5406,605,4801,1.6,14.1,5054,1094,3960,2.9,13.2,352,0.9,26.4,0,161,161,832
2005,11,h) 11 to 15,1707,1819,32788,32673,58,3.1,133,7.2,3561,1013,2548,3.1,10.9,3330,788,2542,2.4,10.2,231,0.7,20.4,0,94,94,492
2005,11,i) 16 to 20,1515,1756,29022,29469,102,5.8,112,6.3,3187,1200,1987,4.1,10.8,4080,780,3300,2.6,13.8,-893,-3,21.6,0,61,61,368
2005,11,j) 21 to 25,1298,1532,28975,28737,78,5.1,78,5.1,3516,1451,2065,5,12.2,3040,571,2469,2,10.6,476,1.6,21.2,0,47,47,250
2005,11,k) 26+,710,990,40177,39353,43,4.2,92,9.1,4316,351,3965,0.9,11,2667,968,1699,2.5,6.8,1649,4.2,13.6,0,23,29,239
2005,11,l) Left Censored,3166,5700,229791,231223,441,7.8,351,6.2,22068,7101,14967,3.1,9.5,24932,5697,19235,2.5,10.8,-2864,-1.3,19,0,63,63,688
2005,12,a) 0,50273,50581,252797,127160,50219,198.6,0,0,251274,251274,0,197.6,197.6,0,0,0,0,0,251274,197.6,0,0,,,
2005,12,b) 1,37567,37811,231066,237375,79,0.2,11065,25.2,62671,914,61757,0.4,26.4,75289,48080,27209,20.3,31.7,-12618,-5.3,52.8,0,8781,8781,41279
2005,12,c) 2,26796,27019,204766,215311,1147,3.9,5417,18.5,44396,4636,39760,2.2,20.6,65485,39778,25707,18.5,30.4,-21089,-9.8,41.2,0,4387,4387,33309
2005,12,d) 3,21716,22180,187034,191737,920,3.9,3568,15.1,35353,4291,31062,2.2,18.4,44758,19229,25529,10,23.3,-9405,-4.9,36.8,0,2850,2850,15498
2005,12,e) 4,18304,18769,193323,192431,857,4.3,2703,13.7,47228,5815,41413,3,24.5,45443,19534,25909,10.2,23.6,1785,0.9,47.2,0,2119,2120,16113
2005,12,f) 5,16101,16739,152008,161650,701,4,2161,12.3,25948,5483,20465,3.4,16.1,45232,17061,28171,10.6,28,-19284,-11.9,32.2,0,1650,1650,14168
2005,12,g) 6 to 10,61295,65032,698699,710081,2802,4.2,6814,10.1,123799,31968,91831,4.5,17.4,146563,50934,95629,7.2,20.6,-22764,-3.2,34.8,0,5086,5138,40885
2005,12,h) 11 to 15,40446,44001,620020,622269,1729,3.8,3710,8.2,103708,28483,75225,4.6,16.7,108206,33492,74714,5.4,17.4,-4498,-0.7,33.4,0,2726,2736,19243
2005,12,i) 16 to 20,28792,34683,616617,623223,1503,4.3,2493,7.1,83812,20604,63208,3.3,13.4,97023,22487,74536,3.6,15.6,-13211,-2.2,26.8,0,1641,1655,12261
2005,12,j) 21 to 25,18819,24063,440604,450922,1033,4.3,1418,5.8,56428,15310,41118,3.4,12.5,77064,39872,37192,8.8,17.1,-20636,-4.6,25,0,950,950,34501
2005,12,k) 26+,8363,14942,345579,338010,738,4.9,742,5,51450,13871,37579,4.1,15.2,36311,7126,29185,2.1,10.7,15139,4.5,21.4,0,420,429,2875
2005,12,l) Left Censored,21639,74497,2774217,2710106,7300,9.9,4999,6.8,422519,182336,240183,6.7,15.6,294298,91674,202624,3.4,10.9,128221,4.7,21.8,0,885,910,15177
2005,13,a) 0,17612,17778,112151,56225,17676,198.9,0,0,111853,111853,0,198.9,198.9,0,0,0,0,0,111853,198.9,0,0,,,
2005,13,b) 1,12768,12935,96454,97037,70,0.5,3639,24.4,28398,955,27443,1,29.3,29564,18953,10611,19.5,30.5,-1166,-1.2,58.6,0,2891,2891,16560
2005,13,c) 2,10438,10561,81083,84586,408,3.6,1953,17.1,17256,2635,14621,3.1,20.4,24261,11337,12924,13.4,28.7,-7005,-8.3,40.8,0,1588,1588,10273
2005,13,d) 3,9135,9385,87495,89814,389,3.9,1469,14.8,13879,2276,11603,2.5,15.5,18517,9072,9445,10.1,20.6,-4638,-5.1,31,0,1164,1164,7756
2005,13,e) 4,7971,8256,82996,81621,357,4.1,1099,12.7,21642,1662,19980,2,26.5,18892,8670,10222,10.6,23.1,2750,3.4,46.2,0,881,882,7894
2005,13,f) 5,7366,7778,75176,76340,281,3.5,954,11.7,13299,1299,12000,1.7,17.4,15627,6244,9383,8.2,20.5,-2328,-3.1,34.8,0,726,726,5553
2005,13,g) 6 to 10,28366,30209,341126,351654,1301,4.2,3058,9.8,50834,9670,41164,2.7,14.5,71890,29027,42863,8.3,20.4,-21056,-5.9,29,0,2313,2313,24500
2005,13,h) 11 to 15,17066,18903,257112,260364,672,3.5,1560,8.1,37664,10577,27087,4.1,14.5,44168,11311,32857,4.3,17,-6504,-2.5,29,0,1108,1108,7686
2005,13,i) 16 to 20,12723,15599,296203,298255,592,3.7,1100,6.9,33823,8856,24967,3,11.3,37926,10327,27599,3.5,12.7,-4103,-1.4,22.6,0,688,693,5200
2005,13,j) 21 to 25,9152,11867,209893,211676,428,3.6,689,5.7,23123,5892,17231,2.8,10.9,26688,5788,20900,2.7,12.6,-3565,-1.7,21.8,0,427,428,3133
2005,13,k) 26+,4508,7727,215561,214053,372,4.8,414,5.3,26167,6825,19342,3.2,12.2,23151,7019,16132,3.3,10.8,3016,1.4,21.6,0,189,190,1504
2005,13,l) Left Censored,14116,42212,1613602,1609394,3257,7.8,2384,5.7,184253,59554,124699,3.7,11.4,175836,45487,130349,2.8,10.9,8417,0.5,21.8,0,471,476,4847
2005,15,a) 0,2030,2038,14537,7295,2018,198,0,0,14484,14484,0,198.5,198.5,0,0,0,0,0,14484,198.5,0,0,,,
2005,15,b) 1,1588,1614,12012,11973,10,0.5,376,20.7,3014,59,2955,0.5,25.2,2936,1690,1246,14.1,24.5,78,0.7,49,0,307,307,1504
2005,15,c) 2,1339,1457,13202,12960,44,2.8,217,14,2652,452,2200,3.5,20.5,2167,1047,1120,8.1,16.7,485,3.8,33.4,0,175,175,890
2005,15,d) 3,1200,1240,11084,11261,51,3.9,176,13.4,1832,383,1449,3.4,16.3,2185,1012,1173,9,19.4,-353,-3.1,32.6,0,145,145,824
2005,15,e) 4,1037,1068,10097,10183,41,3.7,94,8.6,1465,211,1254,2.1,14.4,1637,701,936,6.9,16.1,-172,-1.7,28.8,0,74,74,626
2005,15,f) 5,937,996,10262,10255,39,3.8,104,10.1,1474,228,1246,2.2,14.4,1460,405,1055,3.9,14.2,14,0.2,28.4,0,87,87,356
2005,15,g) 6 to 10,3761,3968,43327,43877,147,3.6,330,8.1,5584,869,4715,2,12.7,6684,1986,4698,4.5,15.2,-1100,-2.5,25.4,0,255,255,1624
2005,15,h) 11 to 15,2691,2971,39723,40600,91,3,218,7.2,4672,421,4251,1,11.5,6425,2394,4031,5.9,15.8,-1753,-4.3,23,0,157,157,2028
2005,15,i) 16 to 20,2401,2819,43199,43810,71,2.5,153,5.3,4142,647,3495,1.5,9.5,5364,1206,4158,2.8,12.2,-1222,-2.7,19,0,94,99,721
2005,15,j) 21 to 25,1927,2436,40074,39181,62,2.5,120,4.9,5880,2099,3781,5.4,15,4093,792,3301,2,10.4,1787,4.6,20.8,0,66,80,403
2005,15,k) 26+,1102,1580,29788,28909,40,2.5,76,4.8,4353,510,3843,1.8,15.1,2594,659,1935,2.3,9,1759,6.1,18,0,31,37,233
2005,15,l) Left Censored,3329,7031,220707,218977,408,5.8,299,4.3,24077,9161,14916,4.2,11,20617,6371,14246,2.9,9.4,3460,1.6,18.8,0,97,97,2655
2005,16,a) 0,3870,3881,18827,9447,3856,198.7,0,0,18760,18760,0,198.6,198.6,0,0,0,0,0,18760,198.6,0,0,,,
2005,16,b) 1,2599,2619,18793,18234,15,0.5,715,23.7,6105,124,5981,0.7,33.5,4986,3083,1903,16.9,27.3,1119,6.2,54.6,0,554,554,2656
2005,16,c) 2,2070,2112,15249,15234,120,5.4,348,15.6,3695,561,3134,3.7,24.3,3665,1902,1763,12.5,24.1,30,0.2,48.2,0,281,281,1710
2005,16,d) 3,1823,1856,19154,18975,88,4.5,254,13.1,3311,788,2523,4.2,17.4,2952,1204,1748,6.3,15.6,359,1.8,31.2,0,181,181,724
2005,16,e) 4,1654,1726,14536,14684,102,5.7,211,11.8,2463,428,2035,2.9,16.8,2758,1007,1751,6.9,18.8,-295,-2,33.6,0,168,168,773
2005,16,f) 5,1499,1560,14946,14722,59,3.7,162,10,2474,159,2315,1.1,16.8,2026,699,1327,4.7,13.8,448,3,27.6,0,120,120,568
2005,16,g) 6 to 10,5972,6285,59626,59350,310,4.8,559,8.7,9884,1959,7925,3.3,16.7,9332,3442,5890,5.8,15.7,552,1,31.4,0,408,410,2804
2005,16,h) 11 to 15,3552,3740,36463,36291,176,4.6,284,7.5,5362,1272,4090,3.5,14.8,5017,1334,3683,3.7,13.8,345,1,27.6,0,191,191,982
2005,16,i) 16 to 20,2302,2728,50891,50185,124,4.5,179,6.5,6406,921,5485,1.8,12.8,4993,2181,2812,4.3,9.9,1413,2.9,19.8,0,133,133,1600
2005,16,j) 21 to 25,1774,2249,35082,34488,70,3.1,107,4.7,4614,398,4216,1.2,13.4,3426,709,2717,2.1,9.9,1188,3.5,19.8,0,66,66,334
2005,16,k) 26+,1029,1472,36624,36747,48,3.2,82,5.5,4008,478,3530,1.3,10.9,4253,707,3546,1.9,11.6,-245,-0.7,21.8,0,41,41,335
2005,16,l) Left Censored,3058,6780,192477,189660,479,7.1,355,5.3,27637,14314,13323,7.5,14.6,22004,9245,12759,4.9,11.6,5633,3,23.2,0,68,68,759
2005,17,a) 0,20452,20631,131727,66572,20511,198.8,0,0,130310,130310,0,195.7,195.7,0,0,0,0,0,130310,195.7,0,0,,,
2005,17,b) 1,15279,15369,109525,114341,48,0.3,3993,22.8,26083,449,25634,0.4,22.8,35714,19518,16196,17.1,31.2,-9631,-8.4,45.6,0,2922,2922,15812
2005,17,c) 2,12658,12993,106466,110752,579,4.2,2316,16.6,20089,2710,17379,2.4,18.1,28660,14882,13778,13.4,25.9,-8571,-7.8,36.2,0,1803,1803,13226
2005,17,d) 3,11141,11402,101049,103640,463,3.8,1680,14,16777,2558,14219,2.5,16.2,21959,9912,12047,9.6,21.2,-5182,-5,32.4,0,1301,1301,8723
2005,17,e) 4,9987,10347,90547,91327,380,3.5,1309,12.1,17093,1627,15466,1.8,18.7,18653,7047,11606,7.7,20.4,-1560,-1.7,37.4,0,1004,1004,6014
2005,17,f) 5,9565,9936,101391,101681,389,3.8,1139,11,15735,1970,13765,1.9,15.5,16314,6106,10208,6,16,-579,-0.5,31,0,827,828,4911
2005,17,g) 6 to 10,39557,41750,478629,487023,1620,3.8,4189,9.7,73013,15059,57954,3.1,15,89800,26336,63464,5.4,18.4,-16787,-3.4,30,0,2968,2968,19797
2005,17,h) 11 to 15,27708,29775,379682,384710,999,3.3,2374,7.8,49848,11359,38489,3,13,59903,15999,43904,4.2,15.6,-10055,-2.6,26,0,1633,1641,10809
2005,17,i) 16 to 20,22209,25782,454422,462423,925,3.5,1765,6.7,48344,12138,36206,2.6,10.5,64345,20592,43753,4.5,13.9,-16001,-3.4,21,0,1123,1124,13682
2005,17,j) 21 to 25,16792,20548,410749,415619,625,3,1218,5.8,36933,7807,29126,1.9,8.9,46672,8766,37906,2.1,11.2,-9739,-2.3,17.8,0,748,748,4980
2005,17,k) 26+,8590,13243,297245,294610,503,3.8,688,5.2,37688,9074,28614,3.1,12.8,32417,6948,25469,2.4,11,5271,1.8,22,0,383,385,3438
2005,17,l) Left Censored,31293,69010,2565248,2573775,4401,6.4,4235,6.1,266916,86867,180049,3.4,10.4,283971,80724,203247,3.1,11,-17055,-0.6,20.8,0,1183,1215,18274
2005,18,a) 0,8733,8822,64097,32132,8760,198.6,0,0,63930,63930,0,199,199,0,0,0,0,0,63930,199,0,0,,,
2005,18,b) 1,6745,6795,49747,52558,18,0.2,1862,23.9,12077,127,11950,0.2,23,17699,9957,7742,18.9,33.7,-5622,-10.7,46,0,1470,1470,8802
2005,18,c) 2,5518,5628,47462,50128,228,3.8,1039,17.1,9813,1324,8489,2.6,19.6,15145,8482,6663,16.9,30.2,-5332,-10.6,39.2,0,831,831,7673
2005,18,d) 3,5220,5322,50478,52678,177,3.1,837,14.8,7662,895,6767,1.7,14.5,12061,5918,6143,11.2,22.9,-4399,-8.4,29,0,675,675,5445
2005,18,e) 4,4504,4784,45132,45145,191,3.8,617,12.3,7916,1113,6803,2.5,17.5,7941,3114,4827,6.9,17.6,-25,-0.1,35,0,496,496,2656
2005,18,f) 5,4244,4440,43130,44723,143,3.1,578,12.4,6783,801,5982,1.8,15.2,9969,4925,5044,11,22.3,-3186,-7.1,30.4,0,446,446,4201
2005,18,g) 6 to 10,17976,19303,221218,220668,691,3.5,1819,9.1,35870,9845,26025,4.5,16.3,34770,11356,23414,5.1,15.8,1100,0.5,31.6,0,1395,1398,9202
2005,18,h) 11 to 15,13035,14249,175463,178976,474,3.2,1200,8.2,22685,4147,18538,2.3,12.7,29711,10627,19084,5.9,16.6,-7026,-3.9,25.4,0,880,880,6159
2005,18,i) 16 to 20,10264,12553,228644,230093,381,3,792,6.2,25138,6271,18867,2.7,10.9,28035,6532,21503,2.8,12.2,-2897,-1.3,21.8,0,510,517,3484
2005,18,j) 21 to 25,8126,10005,179198,178114,285,2.8,496,4.9,19588,3709,15879,2.1,11,17420,3572,13848,2,9.8,2168,1.2,19.6,0,341,345,2482
2005,18,k) 26+,4119,6716,142729,143218,268,4,313,4.6,14827,3609,11218,2.5,10.4,15805,3220,12585,2.2,11,-978,-0.6,20.8,0,163,171,1645
2005,18,l) Left Censored,15586,36815,1354420,1353155,1904,5.2,1765,4.8,129361,40268,89093,3,9.6,126831,27427,99404,2,9.4,2530,0.2,18.8,0,488,502,6320
2005,19,a) 0,4525,4553,27806,13929,4528,198.9,0,0,27754,27754,0,199.3,199.3,0,0,0,0,0,27754,199.3,0,0,,,
2005,19,b) 1,3408,3435,22196,23159,11,0.3,894,22.8,5243,155,5088,0.7,22.6,7168,4283,2885,18.5,31,-1925,-8.4,45.2,0,678,678,3677
2005,19,c) 2,2932,3001,21722,23182,115,3.6,524,16.3,4034,333,3701,1.4,17.4,6953,3881,3072,16.7,30,-2919,-12.6,34.8,0,433,433,3448
2005,19,d) 3,2606,2703,21970,22592,112,3.9,410,14.3,3004,283,2721,1.3,13.3,4247,1829,2418,8.1,18.8,-1243,-5.5,26.6,0,343,343,1677
2005,19,e) 4,2319,2394,18648,18755,95,3.8,287,11.5,2976,522,2454,2.8,15.9,3190,1340,1850,7.1,17,-214,-1.1,31.8,0,227,227,1094
2005,19,f) 5,2271,2353,25367,25241,92,3.8,273,11.2,4032,443,3589,1.8,16,3779,1146,2633,4.5,15,253,1,30,0,201,201,945
2005,19,g) 6 to 10,9528,10131,98595,98895,352,3.4,956,9.1,14269,2079,12190,2.1,14.4,14869,4621,10248,4.7,15,-600,-0.6,28.8,0,703,704,3828
2005,19,h) 11 to 15,6932,7384,77336,77787,249,3.3,534,7.1,9956,1589,8367,2,12.8,10857,2953,7904,3.8,14,-901,-1.2,25.6,0,387,387,2052
2005,19,i) 16 to 20,5331,6314,110136,110396,199,3.1,431,6.7,9355,1377,7978,1.2,8.5,9874,3022,6852,2.7,8.9,-519,-0.4,17,0,284,298,1787
2005,19,j) 21 to 25,4924,6113,84340,85407,140,2.3,302,4.9,7809,1019,6790,1.2,9.1,9943,2760,7183,3.2,11.6,-2134,-2.5,18.2,0,205,205,1773
2005,19,k) 26+,2762,4716,76859,77769,188,4,202,4.3,7722,2241,5481,2.9,9.9,9542,1693,7849,2.2,12.3,-1820,-2.4,19.8,0,117,117,777
2005,19,l) Left Censored,10557,20560,667803,663508,810,3.9,865,4.2,58898,13757,45141,2.1,8.9,50308,11309,38999,1.7,7.6,8590,1.3,15.2,0,317,322,2478
2005,20,a) 0,4761,4784,28637,14367,4749,198.5,0,0,28541,28541,0,198.7,198.7,0,0,0,0,0,28541,198.7,0,0,,,
2005,20,b) 1,3588,3617,26213,26165,18,0.4,982,23.7,7242,356,6886,1.4,27.7,7145,4647,2498,17.8,27.3,97,0.4,54.6,0,798,798,4185
2005,20,c) 2,3056,3097,25553,26194,116,3.5,587,17.5,4535,446,4089,1.7,17.3,5816,3053,2763,11.7,22.2,-1281,-4.9,34.6,0,478,478,2682
2005,20,d) 3,2746,2816,23645,24222,103,3.5,416,14,3696,359,3337,1.5,15.3,4850,2435,2415,10.1,20,-1154,-4.7,30.6,0,331,331,1838
2005,20,e) 4,2450,2513,20265,20890,84,3.2,325,12.3,3040,658,2382,3.1,14.6,4290,1720,2570,8.2,20.5,-1250,-5.9,29.2,0,255,255,1425
2005,20,f) 5,2283,2337,22991,23060,105,4.3,286,11.8,3908,671,3237,2.9,16.9,4045,1482,2563,6.4,17.5,-137,-0.6,33.8,0,225,225,1078
2005,20,g) 6 to 10,9516,10173,107639,108528,372,3.6,932,8.9,14669,2221,12448,2,13.5,16446,5971,10475,5.5,15.2,-1777,-1.7,27,0,707,707,3858
2005,20,h) 11 to 15,6299,6739,78189,79445,220,3.2,518,7.5,10521,2794,7727,3.5,13.2,13032,3156,9876,4,16.4,-2511,-3.2,26.4,0,376,376,2186
2005,20,i) 16 to 20,4994,5871,86342,85706,202,3.4,347,5.8,10138,3986,6152,4.7,11.8,8866,2842,6024,3.3,10.3,1272,1.5,20.6,0,245,252,2134
2005,20,j) 21 to 25,4389,5258,72077,72259,182,3.4,268,5,7402,1610,5792,2.2,10.2,7765,2146,5619,3,10.7,-363,-0.5,20.4,0,187,187,1215
2005,20,k) 26+,2337,3939,72344,71040,212,5.4,184,4.7,9177,1946,7231,2.7,12.9,6569,1579,4990,2.2,9.2,2608,3.7,18.4,0,89,89,964
2005,20,l) Left Censored,8506,17578,550881,555197,747,4.2,802,4.6,53947,15928,38019,2.9,9.7,62579,20043,42536,3.6,11.3,-8632,-1.6,19.4,0,259,263,1366
2005,21,a) 0,5801,5835,40332,20387,5803,198.9,0,0,39890,39890,0,195.7,195.7,0,0,0,0,0,39890,195.7,0,0,,,
2005,21,b) 1,4310,4349,33454,36203,15,0.3,1164,23.4,8730,59,8671,0.2,24.1,14227,6345,7882,17.5,39.3,-5497,-15.2,48.2,0,963,963,5196
2005,21,c) 2,3463,3505,29192,30368,105,2.8,668,17.5,5043,512,4531,1.7,16.6,7395,3469,3926,11.4,24.4,-2352,-7.8,33.2,0,544,544,3060
2005,21,d) 3,3102,3179,30398,30723,99,2.9,528,15.5,6505,630,5875,2.1,21.2,7154,3662,3492,11.9,23.3,-649,-2.1,42.4,0,432,432,3218
2005,21,e) 4,2950,3040,31843,29452,92,2.9,385,12.1,10027,818,9209,2.8,34,5245,2136,3109,7.3,17.8,4782,16.2,35.6,0,320,320,1878
2005,21,f) 5,2743,2870,26903,27069,101,3.4,307,10.3,4416,678,3738,2.5,16.3,4748,1663,3085,6.1,17.5,-332,-1.2,32.6,0,242,247,1260
2005,21,g) 6 to 10,11464,12390,130545,134215,425,3.3,1182,9.2,18031,4174,13857,3.1,13.4,25371,10676,14695,8,18.9,-7340,-5.5,26.8,0,931,931,9219
2005,21,h) 11 to 15,7969,8764,109374,108144,296,3.3,736,8.2,17561,3598,13963,3.3,16.2,15100,4393,10707,4.1,14,2461,2.2,28,0,555,559,3132
2005,21,i) 16 to 20,6543,7840,135648,136318,252,3.2,483,6.1,14793,2993,11800,2.2,10.9,16132,4430,11702,3.2,11.8,-1339,-0.9,21.8,0,344,345,2116
2005,21,j) 21 to 25,5048,6045,104045,104187,177,2.9,320,5.2,10976,2660,8316,2.6,10.5,11260,2212,9048,2.1,10.8,-284,-0.3,21,0,227,227,1365
2005,21,k) 26+,2497,4260,95258,94161,210,4.9,183,4.3,11054,2817,8237,3,11.7,8860,2054,6806,2.2,9.4,2194,2.3,18.8,0,98,98,608
2005,21,l) Left Censored,9265,21811,740435,742781,1100,5,1037,4.8,72214,18051,54163,2.4,9.7,76906,13543,63363,1.8,10.4,-4692,-0.7,19.4,0,320,331,3127
2005,22,a) 0,6342,6400,42720,21416,6366,198.9,0,0,42609,42609,0,199,199,0,0,0,0,0,42609,199,0,0,,,
2005,22,b) 1,4877,4951,40119,42660,28,0.5,1414,24.6,10704,604,10100,1.4,25.1,15786,7781,8005,18.2,37,-5082,-11.9,50.2,0,1153,1153,6639
2005,22,c) 2,4179,4250,37137,39571,141,3.1,784,17.1,6705,545,6160,1.4,16.9,11572,6158,5414,15.6,29.2,-4867,-12.3,33.8,0,657,657,5467
2005,22,d) 3,3795,3896,38679,42084,130,3.2,546,13.2,6650,1207,5443,2.9,15.8,13460,8475,4985,20.1,32,-6810,-16.2,31.6,0,445,445,7654
2005,22,e) 4,3391,3506,35962,37951,129,3.5,429,11.7,5539,875,4664,2.3,14.6,9517,4266,5251,11.2,25.1,-3978,-10.5,29.2,0,358,358,4015
2005,22,f) 5,3090,3236,41695,43047,104,3.1,333,9.9,5660,702,4958,1.6,13.1,8364,4040,4324,9.4,19.4,-2704,-6.3,26.2,0,272,272,3600
2005,22,g) 6 to 10,13002,13692,158865,162579,415,2.9,1329,9.4,22640,3790,18850,2.3,13.9,30068,8723,21345,5.4,18.5,-7428,-4.6,27.8,0,1025,1030,7341
2005,22,h) 11 to 15,9102,9992,130945,133497,298,2.9,784,7.6,16795,2973,13822,2.2,12.6,21899,5379,16520,4,16.4,-5104,-3.8,25.2,0,586,586,3555
2005,22,i) 16 to 20,6747,8175,140507,140970,243,2.9,495,5.9,16158,3669,12489,2.6,11.5,17084,4151,12933,2.9,12.1,-926,-0.6,23,0,329,329,2726
2005,22,j) 21 to 25,6607,8044,134410,134470,229,2.8,438,5.4,16560,3113,13447,2.3,12.3,16680,3318,13362,2.5,12.4,-120,-0.1,24.6,0,305,305,1522
2005,22,k) 26+,3209,4926,91045,91296,154,3.1,272,5.4,11295,2635,8660,2.9,12.4,11796,3078,8718,3.4,12.9,-501,-0.5,24.8,0,170,171,1285
2005,22,l) Left Censored,10002,23051,703483,701555,1244,5.4,1164,5.1,85738,24627,61111,3.5,12.2,81881,26334,55547,3.8,11.7,3857,0.5,23.4,0,361,376,3001
2005,23,a) 0,2720,2726,11659,5842,2714,199.1,0,0,11635,,,,199.2,0,0,0,0,0,11635,199.2,0,1,,,
2005,23,b) 1,2037,2041,11320,11493,4,0.2,518,22.3,2515,,,,21.9,2861,1584,1277,13.8,24.9,-346,-3,43.8,1,363,363,1273
2005,23,c) 2,1599,1621,13523,12824,73,4.1,335,19,4310,250,4060,1.9,33.6,2911,1545,1366,12,22.7,1399,10.9,45.4,0,259,259,1385
2005,23,d) 3,1606,1640,11655,11691,66,3.9,189,11.1,1848,277,1571,2.4,15.8,1920,686,1234,5.9,16.4,-72,-0.6,31.6,0,143,143,598
2005,23,e) 4,1477,1516,10184,10449,57,3.6,211,13.2,1550,179,1371,1.7,14.8,2079,848,1231,8.1,19.9,-529,-5.1,29.6,0,146,146,660
2005,23,f) 5,1325,1382,10864,11313,59,4.1,177,12.2,1165,214,951,1.9,10.3,2063,950,1113,8.4,18.2,-898,-7.9,20.6,0,119,119,591
2005,23,g) 6 to 10,5534,5838,46841,47944,216,3.6,548,9.1,5918,1325,4593,2.8,12.3,8123,2906,5217,6.1,16.9,-2205,-4.6,24.6,0,389,389,1942
2005,23,h) 11 to 15,3471,3710,35834,36143,157,4.2,276,7.3,3751,816,2935,2.3,10.4,4369,1269,3100,3.5,12.1,-618,-1.7,20.8,0,210,210,1083
2005,23,i) 16 to 20,3296,3747,46708,46808,117,3.1,239,6.3,4840,1251,3589,2.7,10.3,5039,1180,3859,2.5,10.8,-199,-0.5,20.6,0,164,164,861
2005,23,j) 21 to 25,2077,2657,42748,42620,71,2.6,117,4.4,4399,856,3543,2,10.3,4142,769,3373,1.8,9.7,257,0.6,19.4,0,68,68,190
2005,23,k) 26+,1134,1812,31722,31960,56,3.1,94,5.1,2683,734,1949,2.3,8.4,3159,853,2306,2.7,9.9,-476,-1.5,16.8,0,52,54,542
2005,23,l) Left Censored,3753,7345,218008,218237,352,4.8,345,4.7,18917,5555,13362,2.5,8.7,19375,3773,15602,1.7,8.9,-458,-0.2,17.4,0,115,115,921
2005,24,a) 0,9646,9709,54893,27560,9632,198.4,0,0,54666,54666,0,198.4,198.4,0,0,0,0,0,54666,198.4,0,0,,,
2005,24,b) 1,7198,7259,51286,51833,32,0.4,1865,22.6,14906,175,14731,0.3,28.8,16000,7700,8300,14.9,30.9,-1094,-2.1,57.6,0,1404,1404,6439
2005,24,c) 2,5921,5986,49918,51545,250,3.9,979,15.3,9448,1097,8351,2.1,18.3,12702,5010,7692,9.7,24.6,-3254,-6.3,36.6,0,781,781,4337
2005,24,d) 3,5549,5654,52551,53417,212,3.6,770,13,8895,1182,7713,2.2,16.7,10626,4345,6281,8.1,19.9,-1731,-3.2,33.4,0,602,602,3744
2005,24,e) 4,4808,4926,42509,43342,191,3.7,583,11.3,7249,1155,6094,2.7,16.7,8915,3145,5770,7.3,20.6,-1666,-3.9,33.4,0,416,420,2094
2005,24,f) 5,4328,4484,42786,43678,138,2.9,529,11.3,6285,908,5377,2.1,14.4,8068,3241,4827,7.4,18.5,-1783,-4.1,28.8,0,392,392,2775
2005,24,g) 6 to 10,17855,18875,202742,209678,718,3.7,1765,9.1,26920,4010,22910,1.9,12.8,40791,17755,23036,8.5,19.5,-13871,-6.7,25.6,0,1270,1278,10768
2005,24,h) 11 to 15,12151,13195,177465,178762,454,3.4,983,7.3,22788,4101,18687,2.3,12.7,25382,6280,19102,3.5,14.2,-2594,-1.5,25.4,0,665,665,4084
2005,24,i) 16 to 20,10155,11796,208788,207929,476,4,744,6.2,26565,5673,20892,2.7,12.8,24846,6710,18136,3.2,11.9,1719,0.9,23.8,0,488,489,4081
2005,24,j) 21 to 25,6534,8168,140825,143301,276,3.3,491,5.9,14823,3380,11443,2.4,10.3,19774,5266,14508,3.7,13.8,-4951,-3.5,20.6,0,302,304,3494
2005,24,k) 26+,3247,5119,124319,124562,197,3.8,287,5.6,13935,4632,9303,3.7,11.2,14421,4251,10170,3.4,11.6,-486,-0.4,22.4,0,138,147,1037
2005,24,l) Left Censored,11533,27323,1001473,1000760,1780,6.5,1675,6.1,105004,35557,69447,3.6,10.5,103579,28480,75099,2.8,10.4,1425,0.1,20.8,0,430,430,4482
2005,25,a) 0,10647,10702,58433,29305,10641,198.9,0,0,58256,58256,0,198.8,198.8,0,0,0,0,0,58256,198.8,0,0,,,
2005,25,b) 1,7951,8018,56601,58033,20,0.2,2533,27,12587,222,12365,0.4,21.7,15450,9537,5913,16.4,26.6,-2863,-4.9,43.4,0,2009,2009,8100
2005,25,c) 2,6766,6850,53096,54813,245,3.3,1502,20,10369,864,9505,1.6,18.9,13803,7486,6317,13.7,25.2,-3434,-6.3,37.8,0,1214,1214,6602
2005,25,d) 3,6297,6421,59345,59649,235,3.4,1003,14.7,9928,1495,8433,2.5,16.6,10536,4296,6240,7.2,17.7,-608,-1.1,33.2,0,804,804,3210
2005,25,e) 4,5700,5860,51860,52932,227,3.7,765,12.5,8276,1111,7165,2.1,15.6,10420,5057,5363,9.6,19.7,-2144,-4.1,31.2,0,595,595,3776
2005,25,f) 5,5323,5530,52508,53810,218,3.8,727,12.6,7827,1387,6440,2.6,14.5,10430,4014,6416,7.5,19.4,-2603,-4.9,29,0,561,571,3390
2005,25,g) 6 to 10,22075,23136,241366,247012,809,3.4,2484,10.3,32867,6176,26691,2.5,13.3,44159,14880,29279,6,17.9,-11292,-4.6,26.6,0,1900,1900,10724
2005,25,h) 11 to 15,14629,15666,202032,202912,474,3,1190,7.4,24624,5104,19520,2.5,12.1,26383,8278,18105,4.1,13,-1759,-0.9,24.2,0,879,879,6289
2005,25,i) 16 to 20,13993,16155,272260,272186,527,3.2,1038,6.3,30131,8062,22069,3,11.1,29983,7969,22014,2.9,11,148,0.1,22,0,695,695,4826
2005,25,j) 21 to 25,9405,11872,264654,266442,334,2.8,670,5.6,25182,5443,19739,2,9.5,28758,9421,19337,3.5,10.8,-3576,-1.3,19,0,426,431,4699
2005,25,k) 26+,4768,7395,187087,186294,342,4.6,378,5.1,20865,9054,11811,4.9,11.2,19279,5038,14241,2.7,10.3,1586,0.9,20.6,0,215,217,1824
2005,25,l) Left Censored,19314,38632,1485484,1482603,2112,5.5,2248,5.8,149594,45465,104129,3.1,10.1,143832,38745,105087,2.6,9.7,5762,0.4,19.4,0,696,701,5764
2005,26,a) 0,14496,14601,109583,55000,14477,198.3,0,0,109166,109166,0,198.5,198.5,0,0,0,0,0,109166,198.5,0,0,,,
2005,26,b) 1,10702,10777,103690,108456,23,0.2,3071,24.6,23825,301,23524,0.3,22,33357,14090,19267,13,30.8,-9532,-8.8,44,0,2309,2309,11820
2005,26,c) 2,9083,9242,86074,90734,351,3.5,1798,17.9,15636,2469,13167,2.7,17.2,24955,11795,13160,13,27.5,-9319,-10.3,34.4,0,1452,1452,10557
2005,26,d) 3,8534,8718,88584,93828,318,3.4,1341,14.5,14093,1528,12565,1.6,15,24581,8546,16035,9.1,26.2,-10488,-11.2,30,0,1043,1043,7391
2005,26,e) 4,7324,7594,62998,66060,366,4.6,1061,13.3,9670,1551,8119,2.3,14.6,15794,6285,9509,9.5,23.9,-6124,-9.3,29.2,0,808,808,5279
2005,26,f) 5,6856,7144,69065,72830,291,3.9,915,12.2,9998,1780,8218,2.4,13.7,17527,6065,11462,8.3,24.1,-7529,-10.4,27.4,0,709,709,5011
2005,26,g) 6 to 10,29787,31415,323049,335935,1197,3.7,3346,10.3,47836,10873,36963,3.2,14.2,73607,28566,45041,8.5,21.9,-25771,-7.7,28.4,0,2388,2392,23239
2005,26,h) 11 to 15,20702,22543,275359,282268,805,3.5,1847,8,36599,9947,26652,3.5,13,50417,11653,38764,4.1,17.9,-13818,-4.9,26,0,1258,1258,8456
2005,26,i) 16 to 20,17043,20291,311318,320743,714,3.5,1371,6.6,30649,7460,23189,2.3,9.6,49499,12593,36906,3.9,15.4,-18850,-5.8,19.2,0,872,878,7445
2005,26,j) 21 to 25,12550,15735,258270,263396,492,3.1,885,5.5,28548,8573,19975,3.3,10.8,38800,10108,28692,3.8,14.7,-10252,-3.9,21.6,0,550,563,5168
2005,26,k) 26+,6529,9517,185744,187916,302,3.1,529,5.5,19320,5842,13478,3.1,10.3,23663,5892,17771,3.1,12.6,-4343,-2.3,20.6,0,259,260,2287
2005,26,l) Left Censored,22421,51303,1870822,1906659,2637,5.1,2845,5.5,163920,44129,119791,2.3,8.6,235594,47852,187742,2.5,12.4,-71674,-3.8,17.2,0,784,829,11811
2005,27,a) 0,9548,9623,58874,29535,9560,198.7,0,0,58678,58678,0,198.7,198.7,0,0,0,0,0,58678,198.7,0,0,,,
2005,27,b) 1,7303,7350,50595,52453,19,0.2,2034,24.1,13191,177,13014,0.3,25.1,16906,10358,6548,19.7,32.2,-3715,-7.1,50.2,0,1429,1429,8658
2005,27,c) 2,6204,6273,46782,48115,276,4.1,1123,16.7,9220,1137,8083,2.4,19.2,11886,6686,5200,13.9,24.7,-2666,-5.5,38.4,0,845,845,5268
2005,27,d) 3,5615,5741,50302,50956,244,4,819,13.6,8072,934,7138,1.8,15.8,9379,4391,4988,8.6,18.4,-1307,-2.6,31.6,0,601,601,3671
2005,27,e) 4,5001,5132,42958,44410,209,3.9,619,11.6,6299,865,5434,1.9,14.2,9202,2972,6230,6.7,20.7,-2903,-6.5,28.4,0,422,422,2416
2005,27,f) 5,4616,4758,45063,45712,200,4,537,10.9,5929,773,5156,1.7,13,7227,2529,4698,5.5,15.8,-1298,-2.8,26,0,386,386,2026
2005,27,g) 6 to 10,18900,20190,212805,215879,758,3.6,1966,9.4,27195,4587,22608,2.1,12.6,33343,11071,22272,5.1,15.4,-6148,-2.8,25.2,0,1376,1376,8800
2005,27,h) 11 to 15,12820,13963,175857,174943,459,3.2,1004,7,24613,4756,19857,2.7,14.1,22784,6724,16060,3.8,13,1829,1.1,26,0,697,697,4693
2005,27,i) 16 to 20,9682,11553,201057,201710,376,3.2,688,5.9,21522,5867,15655,2.9,10.7,22828,5812,17016,2.9,11.3,-1306,-0.6,21.4,0,449,449,3732
2005,27,j) 21 to 25,7071,9140,179061,178960,273,3,438,4.7,17590,3262,14328,1.8,9.8,17388,3881,13507,2.2,9.7,202,0.1,19.4,0,258,258,1673
2005,27,k) 26+,3950,6015,142031,140075,233,3.9,275,4.6,19400,7824,11576,5.6,13.8,15488,2909,12579,2.1,11.1,3912,2.7,22.2,0,146,147,1377
2005,27,l) Left Censored,13922,30239,1221681,1214079,1486,4.9,1452,4.8,129937,40232,89705,3.3,10.7,114732,28055,86677,2.3,9.5,15205,1.2,19,0,400,405,4575
2005,28,a) 0,3908,3943,25495,12789,3922,198.9,0,0,25413,,,,198.7,0,0,0,0,0,25413,198.7,0,1,,,
2005,28,b) 1,2901,2921,21028,22926,8,0.2,907,26.5,5598,,,,24.4,9393,5891,3502,25.7,41,-3795,-16.6,48.8,1,757,757,5354
2005,28,c) 2,2552,2592,21551,22643,96,3.4,515,18.3,3670,429,3241,1.9,16.2,5854,3003,2851,13.3,25.9,-2184,-9.7,32.4,0,432,432,2631
2005,28,d) 3,2184,2229,20754,22003,73,3.1,358,15.1,3289,409,2880,1.9,14.9,5786,2337,3449,10.6,26.3,-2497,-11.4,29.8,0,302,302,1936
2005,28,e) 4,1977,2032,18364,19204,70,3.3,282,13.1,2847,447,2400,2.3,14.8,4527,2168,2359,11.3,23.6,-1680,-8.8,29.6,0,238,238,1911
2005,28,f) 5,1783,1845,15950,16437,59,3.1,223,11.5,2512,664,1848,4,15.3,3485,1205,2280,7.3,21.2,-973,-5.9,30.6,0,170,170,1010
2005,28,g) 6 to 10,7549,8158,81060,83523,310,3.7,833,9.9,11398,2367,9031,2.8,13.6,16323,6169,10154,7.4,19.5,-4925,-5.9,27.2,0,666,667,5264
2005,28,h) 11 to 15,5033,5518,71140,72682,181,3.2,462,8.1,9021,1368,7653,1.9,12.4,12104,3509,8595,4.8,16.7,-3083,-4.3,24.8,0,355,355,2018
2005,28,i) 16 to 20,3806,4412,71314,72205,132,2.9,336,7.4,6576,1149,5427,1.6,9.1,8357,2195,6162,3,11.6,-1781,-2.5,18.2,0,223,233,1251
2005,28,j) 21 to 25,3552,4283,66509,66547,134,3.1,210,4.8,7892,1942,5950,2.9,11.9,7968,1338,6630,2,12,-76,-0.1,23.8,0,136,136,799
2005,28,k) 26+,1815,2672,52763,52938,80,3,125,4.6,6689,2044,4645,3.9,12.6,7039,1433,5606,2.7,13.3,-350,-0.7,25.2,0,79,79,696
2005,28,l) Left Censored,6091,14642,455080,453793,888,6.1,726,5,45935,13729,32206,3,10.1,43360,9168,34192,2,9.6,2575,0.5,19.2,0,210,212,1525
2005,29,a) 0,11752,11837,67986,34138,11777,199,0,0,67696,67696,0,198.3,198.3,0,0,0,0,0,67696,198.3,0,0,,,
2005,29,b) 1,8592,8650,56393,58418,21,0.2,2742,27.1,13821,242,13579,0.4,23.7,17870,11423,6447,19.6,30.6,-4049,-6.9,47.4,0,2283,2283,10312
2005,29,c) 2,6637,6719,46771,48879,263,3.6,1377,18.8,8674,1051,7623,2.2,17.7,12889,5878,7011,12,26.4,-4215,-8.7,35.4,0,1155,1155,5263
2005,29,d) 3,5789,5905,52932,55733,204,3.3,926,14.8,7348,892,6456,1.6,13.2,12950,5148,7802,9.2,23.2,-5602,-10,26.4,0,773,773,4640
2005,29,e) 4,4740,4920,43545,43998,211,4.1,589,11.5,8033,920,7113,2.1,18.3,8938,2749,6189,6.2,20.3,-905,-2,36.6,0,483,483,2432
2005,29,f) 5,4719,4935,45366,46215,199,3.9,557,10.9,7320,1571,5749,3.4,15.8,9017,3537,5480,7.7,19.5,-1697,-3.7,31.6,0,428,428,3150
2005,29,g) 6 to 10,18347,19548,209057,217686,738,3.6,2021,10,29334,4577,24757,2.1,13.5,46591,15496,31095,7.1,21.4,-17257,-7.9,27,0,1555,1556,12647
2005,29,h) 11 to 15,12516,13613,157555,161456,419,3,1082,7.7,19666,3422,16244,2.1,12.2,27468,9384,18084,5.8,17,-7802,-4.8,24.4,0,819,819,7747
2005,29,i) 16 to 20,10480,12629,214642,215727,484,3.8,825,6.4,24873,5711,19162,2.6,11.5,27043,8348,18695,3.9,12.5,-2170,-1,23,0,561,569,6368
2005,29,j) 21 to 25,7777,9738,173573,174458,270,2.7,543,5.5,15646,3551,12095,2,9,17415,3998,13417,2.3,10,-1769,-1,18,0,352,352,2422
2005,29,k) 26+,4034,6675,155015,154685,355,5.3,368,5.5,18919,7396,11523,4.8,12.2,18258,3467,14791,2.2,11.8,661,0.4,23.6,0,183,184,1121
2005,29,l) Left Censored,14507,33280,1180758,1181071,1893,5.7,1625,4.9,110673,37521,73152,3.2,9.4,111299,25857,85442,2.2,9.4,-626,0,18.8,0,473,475,6833
2005,30,a) 0,2812,2815,12321,6183,2797,198.7,0,0,12276,,,,198.5,0,0,0,0,0,12276,198.5,0,1,,,
2005,30,b) 1,2101,2113,10710,10790,4,0.2,549,22.6,2676,,,,24.8,2835,1527,1308,14.2,26.3,-159,-1.5,49.6,1,382,382,1163
2005,30,c) 2,1594,1613,9027,9180,88,5.1,282,16.4,1821,377,1444,4.1,19.8,2127,970,1157,10.6,23.2,-306,-3.4,39.6,0,210,210,761
2005,30,d) 3,1485,1521,10015,10150,61,3.8,188,11.8,1657,201,1456,2,16.3,1926,744,1182,7.3,19,-269,-2.7,32.6,0,152,152,671
2005,30,e) 4,1308,1327,8158,8377,56,4.1,160,11.6,1405,275,1130,3.3,16.8,1843,756,1087,9,22,-438,-5.2,33.6,0,126,126,629
2005,30,f) 5,1241,1279,10275,10163,64,4.9,126,9.6,1581,217,1364,2.1,15.6,1356,528,828,5.2,13.3,225,2.3,26.6,0,95,95,419
2005,30,g) 6 to 10,4969,5169,41583,42540,196,3.7,515,9.6,5470,716,4754,1.7,12.9,7384,2649,4735,6.2,17.4,-1914,-4.5,25.8,0,372,378,1833
2005,30,h) 11 to 15,3029,3162,26701,27146,123,3.8,244,7.6,3219,700,2519,2.6,11.9,4108,1231,2877,4.5,15.1,-889,-3.2,23.8,0,170,170,887
2005,30,i) 16 to 20,2093,2353,28189,28346,91,3.8,185,7.7,4044,1764,2280,6.2,14.3,4357,928,3429,3.3,15.4,-313,-1.1,28.6,0,129,129,681
2005,30,j) 21 to 25,1768,2125,28967,28931,59,2.7,109,5.1,2549,366,2183,1.3,8.8,2476,492,1984,1.7,8.6,73,0.2,17.2,0,75,75,320
2005,30,k) 26+,1018,1578,20739,20539,69,4.4,83,5.2,2228,608,1620,3,10.8,1828,467,1361,2.3,8.9,400,1.9,17.8,0,32,32,94
2005,30,l) Left Censored,2757,5321,114742,113995,234,4.4,216,4.1,9901,2240,7661,2,8.7,8406,1288,7118,1.1,7.4,1495,1.3,14.8,0,74,74,252
2005,31,a) 0,3033,3051,17791,8918,3031,198.7,0,0,17747,17747,0,199,199,0,0,0,0,0,17747,199,0,0,,,
2005,31,b) 1,2307,2326,15288,15850,11,0.4,552,21,3339,73,3266,0.5,21.1,4463,2773,1690,17.5,28.2,-1124,-7.1,42.2,0,425,425,2283
2005,31,c) 2,1964,1988,13134,14216,72,3.4,335,15.8,2108,244,1864,1.7,14.8,4272,2663,1609,18.7,30.1,-2164,-15.3,29.6,0,283,283,2485
2005,31,d) 3,1817,1885,15015,15298,83,4.2,279,14,2523,390,2133,2.5,16.5,3088,1225,1863,8,20.2,-565,-3.7,33,0,207,207,1018
2005,31,e) 4,1667,1714,14458,14658,52,2.9,203,11.3,2212,248,1964,1.7,15.1,2611,1118,1493,7.6,17.8,-399,-2.7,30.2,0,163,163,1015
2005,31,f) 5,1561,1610,13627,13622,61,3.7,174,10.4,1917,225,1692,1.7,14.1,1906,540,1366,4,14,11,0.1,28,0,139,139,460
2005,31,g) 6 to 10,6325,6783,74965,75293,214,3.1,607,8.7,9086,881,8205,1.2,12.1,9742,3056,6686,4.1,12.9,-656,-0.8,24.2,0,447,447,2468
2005,31,h) 11 to 15,4397,4743,46882,47818,153,3.2,317,6.6,5498,1377,4121,2.9,11.5,7370,2388,4982,5,15.4,-1872,-3.9,23,0,234,234,1586
2005,31,i) 16 to 20,3531,4110,87965,85964,101,2.4,255,6.1,13241,1934,11307,2.2,15.4,9238,1614,7624,1.9,10.7,4003,4.7,21.4,0,180,190,990
2005,31,j) 21 to 25,3049,3665,50234,51036,88,2.4,177,4.8,4805,1266,3539,2.5,9.4,6408,1463,4945,2.9,12.6,-1603,-3.2,18.8,0,123,123,953
2005,31,k) 26+,1629,2518,49572,50094,95,3.7,132,5.2,5152,1074,4078,2.1,10.3,6195,1414,4781,2.8,12.4,-1043,-2.1,20.6,0,74,74,431
2005,31,l) Left Censored,6273,11907,373383,376613,543,4.6,520,4.4,38879,9980,28899,2.6,10.3,45340,7000,38340,1.9,12,-6461,-1.7,20.6,0,163,163,1408
2005,32,a) 0,5963,6042,49519,24798,6005,198.8,0,0,49443,49443,0,199.4,199.4,0,0,0,0,0,49443,199.4,0,0,,,
2005,32,b) 1,4138,4161,42148,40389,16,0.3,1300,26.8,14953,106,14847,0.3,37,11435,7315,4120,18.1,28.3,3518,8.7,56.6,0,1044,1044,5879
2005,32,c) 2,3330,3417,36108,34982,172,4.6,710,19.2,9241,1321,7920,3.8,26.4,6989,3225,3764,9.2,20,2252,6.4,40,0,565,565,2619
2005,32,d) 3,2676,2718,35061,34441,107,3.7,478,16.4,6993,485,6508,1.4,20.3,5753,2968,2785,8.6,16.7,1240,3.6,33.4,0,380,380,2418
2005,32,e) 4,2222,2292,32171,31221,106,4.3,379,15.5,7158,602,6556,1.9,22.9,5258,2607,2651,8.4,16.8,1900,6.1,33.6,0,311,311,2302
2005,32,f) 5,1964,2010,27386,28356,96,4.5,307,14.5,5867,1631,4236,5.8,20.7,7806,4855,2951,17.1,27.5,-1939,-6.8,41.4,0,238,238,4089
2005,32,g) 6 to 10,7110,7690,125851,126404,367,4.6,835,10.5,21127,2566,18561,2,16.7,22233,10173,12060,8,17.6,-1106,-0.9,33.4,0,647,648,8922
2005,32,h) 11 to 15,3649,3989,78806,77674,185,4.5,375,9.2,12097,2078,10019,2.7,15.6,9833,3843,5990,4.9,12.7,2264,2.9,25.4,0,277,277,2458
2005,32,i) 16 to 20,2627,3454,74217,73865,149,4.2,254,7.2,9565,1687,7878,2.3,12.9,8860,2268,6592,3.1,12,705,0.9,24,0,176,176,1338
2005,32,j) 21 to 25,1910,2719,75327,74929,188,6.9,182,6.7,11787,3932,7855,5.2,15.7,10990,4775,6215,6.4,14.7,797,1,29.4,0,108,108,800
2005,32,k) 26+,1131,1955,59307,57731,131,6.8,89,4.6,7800,2384,5416,4.1,13.5,4647,738,3909,1.3,8,3153,5.5,16,0,38,38,188
2005,32,l) Left Censored,3224,8950,439770,438131,800,9.1,477,5.4,52316,15336,36980,3.5,11.9,49038,19162,29876,4.4,11.2,3278,0.7,22.4,0,81,82,4336
2005,33,a) 0,2639,2661,14819,7423,2646,198.9,0,0,14792,,,,199.3,0,0,0,0,0,14792,199.3,0,1,,,
2005,33,b) 1,1988,2000,11212,11435,4,0.2,566,24.5,2752,,,,24.1,3198,1854,1344,16.2,28,-446,-3.9,48.2,1,438,438,1539
2005,33,c) 2,1598,1630,10620,10860,69,3.9,306,17.5,1962,295,1667,2.7,18.1,2442,1119,1323,10.3,22.5,-480,-4.4,36.2,0,253,253,1008
2005,33,d) 3,1419,1431,10823,11080,49,3.2,226,14.8,1942,310,1632,2.8,17.5,2455,1245,1210,11.2,22.2,-513,-4.7,35,0,186,186,1015
2005,33,e) 4,1264,1312,10677,11108,62,4.5,189,13.7,1636,374,1262,3.4,14.7,2497,1049,1448,9.4,22.5,-861,-7.8,29.4,0,146,146,700
2005,33,f) 5,1235,1273,10384,10466,51,3.9,125,9.5,1446,132,1314,1.3,13.8,1610,405,1205,3.9,15.4,-164,-1.6,27.6,0,96,96,352
2005,33,g) 6 to 10,5290,5510,52461,53258,223,3.9,546,9.6,6928,1616,5312,3,13,8522,3731,4791,7,16,-1594,-3,26,0,422,422,3110
2005,33,h) 11 to 15,3516,3671,40861,41224,116,3.1,227,6.1,4716,967,3749,2.3,11.4,5442,1420,4022,3.4,13.2,-726,-1.8,22.8,0,170,170,1059
2005,33,i) 16 to 20,3330,3745,59228,59092,118,3.1,233,6.1,6882,1602,5280,2.7,11.6,6609,1759,4850,3,11.2,273,0.4,22.4,0,174,174,996
2005,33,j) 21 to 25,1920,2322,39478,39643,60,2.5,141,6,3551,339,3212,0.9,9,3880,1152,2728,2.9,9.8,-329,-0.8,18,0,104,104,945
2005,33,k) 26+,1031,1586,33664,33295,65,4.1,73,4.6,3444,1059,2385,3.2,10.3,2705,534,2171,1.6,8.1,739,2.2,16.2,0,35,35,139
2005,33,l) Left Censored,3726,7628,254413,253016,476,6.3,413,5.4,23804,8839,14965,3.5,9.4,21009,5760,15249,2.3,8.3,2795,1.1,16.6,0,116,117,2214
2005,34,a) 0,17810,17900,95530,48059,17766,198.5,0,0,94942,94942,0,197.6,197.6,0,0,0,0,0,94942,197.6,0,0,,,
2005,34,b) 1,12917,12972,82189,85131,33,0.2,3626,24.3,22461,455,22006,0.5,26.4,28344,18115,10229,21.3,33.3,-5883,-6.9,52.8,0,2850,2850,15586
2005,34,c) 2,10738,10827,81031,83190,425,3.6,2037,17.4,14690,1431,13259,1.7,17.7,19008,10348,8660,12.4,22.8,-4318,-5.1,35.4,0,1620,1620,9098
2005,34,d) 3,9387,9493,82111,83564,351,3.5,1582,15.6,14184,1977,12207,2.4,17,17089,8912,8177,10.7,20.5,-2905,-3.5,34,0,1244,1244,7486
2005,34,e) 4,8763,8948,77018,79238,354,3.8,1223,13,11115,1440,9675,1.8,14,15554,5866,9688,7.4,19.6,-4439,-5.6,28,0,944,944,4975
2005,34,f) 5,7869,8002,73346,75561,331,4,1030,12.3,9712,1308,8404,1.7,12.9,14141,6629,7512,8.8,18.7,-4429,-5.8,25.8,0,795,795,5810
2005,34,g) 6 to 10,33270,34703,360448,371476,1301,3.6,3617,10.1,45172,6989,38183,1.9,12.2,67228,25517,41711,6.9,18.1,-22056,-5.9,24.4,0,2777,2777,19754
2005,34,h) 11 to 15,20630,21580,250248,253302,682,3.1,1754,7.9,33116,5415,27701,2.1,13.1,39223,10811,28412,4.3,15.5,-6107,-2.4,26.2,0,1277,1277,7786
2005,34,i) 16 to 20,17867,19927,300471,301830,587,2.9,1487,7.3,32661,4226,28435,1.4,10.8,35379,10027,25352,3.3,11.7,-2718,-0.9,21.6,0,1001,1001,5962
2005,34,j) 21 to 25,12263,14363,267246,271661,437,3,898,6.1,23863,3443,20420,1.3,8.8,32692,6528,26164,2.4,12,-8829,-3.2,17.6,0,619,625,3974
2005,34,k) 26+,6274,8665,203404,203481,355,4.1,509,5.8,24829,7132,17697,3.5,12.2,24983,9110,15873,4.5,12.3,-154,-0.1,24.4,0,295,296,3445
2005,34,l) Left Censored,22303,44858,1679071,1697009,2982,6.6,3258,7.2,188573,68267,120306,4,11.1,224448,69763,154685,4.1,13.2,-35875,-2.1,22.2,0,934,939,11578
2005,35,a) 0,3135,3156,17937,9004,3140,199,0,0,17867,17867,0,198.4,198.4,0,0,0,0,0,17867,198.4,0,0,,,
2005,35,b) 1,2319,2367,17956,17896,31,1.1,668,24.5,5519,659,4860,3.7,30.8,5398,3541,1857,19.8,30.2,121,0.6,60.4,0,532,532,3202
2005,35,c) 2,1875,1900,13939,14577,78,3.8,344,16.9,3007,272,2735,1.9,20.6,4282,2241,2041,15.4,29.4,-1275,-8.8,41.2,0,276,283,2050
2005,35,d) 3,1729,1762,17274,18194,63,3.4,258,13.8,2443,281,2162,1.5,13.4,4283,1623,2660,8.9,23.5,-1840,-10.1,26.8,0,217,217,1479
2005,35,e) 4,1597,1711,15814,15809,63,3.5,199,11.1,2514,281,2233,1.8,15.9,2503,967,1536,6.1,15.8,11,0.1,31.6,0,150,150,744
2005,35,f) 5,1418,1473,14415,14583,60,3.9,149,9.8,2346,326,2020,2.2,16.1,2682,810,1872,5.6,18.4,-336,-2.3,32.2,0,112,112,666
2005,35,g) 6 to 10,5855,6163,64537,65797,287,4.5,638,10,9371,1928,7443,2.9,14.2,11891,3422,8469,5.2,18.1,-2520,-3.9,28.4,0,477,477,2572
2005,35,h) 11 to 15,4010,4389,48880,49113,156,3.5,346,7.7,7243,1599,5644,3.3,14.7,7709,1728,5981,3.5,15.7,-466,-1,29.4,0,235,235,1264
2005,35,i) 16 to 20,2925,3507,65405,63256,116,3.2,236,6.6,10765,1509,9256,2.4,17,6467,1517,4950,2.4,10.2,4298,6.8,20.4,0,147,149,736
2005,35,j) 21 to 25,2557,3274,47410,47890,98,3,155,4.7,4671,684,3987,1.4,9.8,5631,880,4751,1.8,11.8,-960,-2,19.6,0,110,111,654
2005,35,k) 26+,1312,2122,41036,41190,108,5.1,106,5,4942,1019,3923,2.5,12,5250,1147,4103,2.8,12.7,-308,-0.7,24,0,48,48,297
2005,35,l) Left Censored,3706,8232,225667,224158,472,5.8,393,4.8,28158,8721,19437,3.9,12.6,25140,6239,18901,2.8,11.2,3018,1.4,22.4,0,92,92,1581
2005,36,a) 0,38663,38863,216233,108340,38655,198.9,0,0,215787,215787,0,199.2,199.2,0,0,0,0,0,215787,199.2,0,0,,,
2005,36,b) 1,29110,29237,177544,184399,54,0.2,7959,23.8,42357,565,41792,0.3,23,56066,32628,23438,17.7,30.4,-13709,-7.4,46,0,6184,6184,26449
2005,36,c) 2,24365,24565,161607,168410,932,3.5,4570,17.3,28500,3354,25146,2,16.9,42106,21253,20853,12.6,25,-13606,-8.1,33.8,0,3720,3720,18135
2005,36,d) 3,21048,21354,170938,179068,854,3.8,3383,14.9,25420,3046,22374,1.7,14.2,41679,19477,22202,10.9,23.3,-16259,-9.1,28.4,0,2709,2709,13415
2005,36,e) 4,18699,18985,151061,156338,774,3.9,2710,13.5,22490,3511,18979,2.2,14.4,33044,14751,18293,9.4,21.1,-10554,-6.7,28.8,0,2141,2142,12997
2005,36,f) 5,16857,17254,147201,150856,605,3.3,2256,12.4,21608,2529,19079,1.7,14.3,28917,12611,16306,8.4,19.2,-7309,-4.9,28.6,0,1752,1753,10297
2005,36,g) 6 to 10,67420,70428,699877,715234,2357,3.2,7613,10.4,91435,14083,77352,2,12.8,122149,48574,73575,6.8,17.1,-30714,-4.3,25.6,0,5860,5860,40652
2005,36,h) 11 to 15,43281,45421,519037,526825,1399,3,3600,7.7,61662,9538,52124,1.8,11.7,77237,24544,52693,4.7,14.7,-15575,-3,23.4,0,2706,2708,18884
2005,36,i) 16 to 20,37928,41738,639937,651155,1248,2.9,2825,6.6,59030,12749,46281,2,9.1,81466,22513,58953,3.5,12.5,-22436,-3.4,18.2,0,1972,1983,15039
2005,36,j) 21 to 25,25768,30458,536579,539005,795,2.6,1742,5.6,54940,10730,44210,2,10.2,59792,15194,44598,2.8,11.1,-4852,-0.9,20.4,0,1231,1247,11668
2005,36,k) 26+,12510,18422,417551,418720,668,3.6,996,5.4,44850,11079,33771,2.6,10.7,47188,9934,37254,2.4,11.3,-2338,-0.6,21.4,0,612,617,4185
2005,36,l) Left Censored,48514,94906,3565504,3577477,4985,5.2,7862,8.2,394383,135155,259228,3.8,11,418328,118621,299707,3.3,11.7,-23945,-0.7,22,0,2065,2069,25855
2005,37,a) 0,15858,15976,97000,48610,15888,198.9,0,0,96781,96781,0,199.1,199.1,0,0,0,0,0,96781,199.1,0,0,,,
2005,37,b) 1,11352,11444,83776,85469,47,0.4,2987,22.8,23874,1167,22707,1.4,27.9,27259,14015,13244,16.4,31.9,-3385,-4,55.8,0,2367,2367,12313
2005,37,c) 2,9312,9420,78431,80143,342,3.4,1635,16.2,16457,1869,14588,2.3,20.5,19880,10499,9381,13.1,24.8,-3423,-4.3,41,0,1344,1344,9262
2005,37,d) 3,8070,8317,71578,73701,344,3.9,1245,14.1,13197,1649,11548,2.2,17.9,17443,7373,10070,10,23.7,-4246,-5.8,35.8,0,1015,1015,6706
2005,37,e) 4,7688,7979,72300,74541,281,3.4,1081,12.9,11284,1084,10200,1.5,15.1,15765,5211,10554,7,21.1,-4481,-6,30.2,0,880,880,4457
2005,37,f) 5,6941,7307,69719,71408,289,3.8,823,10.8,10973,1693,9280,2.4,15.4,14350,4777,9573,6.7,20.1,-3377,-4.7,30.8,0,626,626,3780
2005,37,g) 6 to 10,28037,30168,327274,330322,1256,4,2926,9.4,52447,8748,43699,2.6,15.9,58542,19614,38928,5.9,17.7,-6095,-1.8,31.8,0,2259,2269,16679
2005,37,h) 11 to 15,16910,18512,231299,233780,677,3.6,1522,8,32969,6546,26423,2.8,14.1,37930,11282,26648,4.8,16.2,-4961,-2.1,28.2,0,1087,1087,7782
2005,37,i) 16 to 20,14327,17228,305394,306364,557,3.2,1097,6.3,34944,5480,29464,1.8,11.4,36884,9389,27495,3.1,12,-1940,-0.6,22.8,0,730,741,4988
2005,37,j) 21 to 25,10924,13823,222746,224025,442,3.2,772,5.5,25430,5112,20318,2.3,11.4,27987,7752,20235,3.5,12.5,-2557,-1.1,22.8,0,466,481,2613
2005,37,k) 26+,5102,8703,205401,202333,382,4.4,386,4.4,25922,6920,19002,3.4,12.8,19786,4512,15274,2.2,9.8,6136,3,19.6,0,231,231,2346
2005,37,l) Left Censored,16921,45116,1636004,1628846,2776,6.2,2368,5.3,189888,74710,115178,4.6,11.7,175571,41097,134474,2.5,10.8,14317,0.9,21.6,0,601,604,6379
2005,38,a) 0,1192,1199,7030,3529,1192,198.8,0,0,7002,,,,198.4,0,0,0,0,0,7002,198.4,0,1,,,
2005,38,b) 1,900,910,6154,6063,3,0.3,235,22.6,1447,,,,23.9,1264,647,617,10.7,20.8,183,3.1,41.6,1,143,143,478
2005,38,c) 2,701,715,4704,4946,34,4.4,135,17.6,857,80,777,1.6,17.3,1341,501,840,10.1,27.1,-484,-9.8,34.6,0,108,108,440
2005,38,d) 3,684,711,5097,5329,29,3.9,77,10.5,672,80,592,1.5,12.6,1136,322,814,6,21.3,-464,-8.7,25.2,0,62,62,297
2005,38,e) 4,587,600,4972,5191,24,3.9,62,10,520,52,468,1,10,958,238,720,4.6,18.5,-438,-8.5,20,0,46,46,206
2005,38,f) 5,582,597,4800,4785,21,3.4,63,10.2,736,58,678,1.2,15.4,706,213,493,4.5,14.8,30,0.6,29.6,0,54,54,183
2005,38,g) 6 to 10,2363,2489,23607,23158,86,3.4,224,8.8,3861,745,3116,3.2,16.7,2962,1031,1931,4.5,12.8,899,3.9,25.6,0,165,165,874
2005,38,h) 11 to 15,1905,1995,20644,20577,70,3.4,142,7,2571,268,2303,1.3,12.5,2436,696,1740,3.4,11.8,135,0.7,23.6,0,110,110,589
2005,38,i) 16 to 20,1536,1733,19181,19278,50,2.8,93,5.3,1987,419,1568,2.2,10.3,2181,593,1588,3.1,11.3,-194,-1,20.6,0,60,60,247
2005,38,j) 21 to 25,1411,1692,22249,22005,44,2.6,97,5.6,2678,242,2436,1.1,12.2,2189,411,1778,1.9,9.9,489,2.3,19.8,0,58,58,276
2005,38,k) 26+,752,1043,17585,16313,65,6.3,53,5.1,3741,2187,1554,13.4,22.9,1197,180,1017,1.1,7.3,2544,15.6,14.6,0,24,24,71
2005,38,l) Left Censored,2849,5052,133370,134057,202,4,212,4.2,11009,2627,8382,2,8.2,12383,5360,7023,4,9.2,-1374,-1,16.4,0,83,83,795
2005,39,a) 0,14651,14818,114115,57215,14725,198.7,0,0,113800,113800,0,198.9,198.9,0,0,0,0,0,113800,198.9,0,0,,,
2005,39,b) 1,11055,11166,92080,94608,34,0.3,3076,24,22445,340,22105,0.4,23.7,27501,15787,11714,16.7,29.1,-5056,-5.4,47.4,0,2410,2410,13326
2005,39,c) 2,9329,9503,81973,86380,363,3.5,1826,17.8,16026,3003,13023,3.5,18.6,24839,14490,10349,16.8,28.8,-8813,-10.2,37.2,0,1489,1489,12842
2005,39,d) 3,8801,9184,91488,94636,353,3.6,1325,13.7,14161,1493,12668,1.6,15,20456,8545,11911,9,21.6,-6295,-6.6,30,0,1052,1052,7677
2005,39,e) 4,7799,8119,72259,74369,272,3.2,1083,12.7,11073,1374,9699,1.8,14.9,15293,6085,9208,8.2,20.6,-4220,-5.7,29.8,0,854,854,4979
2005,39,f) 5,7260,7599,81418,83220,283,3.6,944,11.9,12368,2440,9928,2.9,14.9,15971,6538,9433,7.9,19.2,-3603,-4.3,29.8,0,712,713,5601
2005,39,g) 6 to 10,31962,34595,379144,389217,1247,3.5,3434,9.6,49805,8138,41667,2.1,12.8,69950,25246,44704,6.5,18,-20145,-5.2,25.6,0,2561,2561,19091
2005,39,h) 11 to 15,23135,25535,323789,325407,839,3.2,1837,7,43708,8114,35594,2.5,13.4,46944,12173,34771,3.7,14.4,-3236,-1,26.8,0,1334,1335,9498
2005,39,i) 16 to 20,19343,23374,401419,407386,767,3.2,1519,6.4,40973,10193,30780,2.5,10.1,52906,13870,39036,3.4,13,-11933,-2.9,20.2,0,956,976,8067
2005,39,j) 21 to 25,14544,18472,310377,312795,529,2.8,925,4.9,32849,9100,23749,2.9,10.5,37685,10380,27305,3.3,12,-4836,-1.5,21,0,626,626,8237
2005,39,k) 26+,8088,12814,290424,286944,524,4.1,618,4.8,35581,11494,24087,4,12.4,28621,6795,21826,2.4,10,6960,2.4,20,0,323,333,2378
2005,39,l) Left Censored,30422,70822,2506443,2514785,3582,5,3818,5.4,272800,78539,194261,3.1,10.8,289484,73311,216173,2.9,11.5,-16684,-0.7,21.6,0,1140,1141,16456
2005,40,a) 0,6120,6196,37920,19055,6155,198.7,0,0,37731,37731,0,198,198,0,0,0,0,0,37731,198,0,0,,,
2005,40,b) 1,4291,4317,29986,30948,10,0.2,1287,25.6,8110,193,7917,0.6,26.2,10033,6896,3137,22.3,32.4,-1923,-6.2,52.4,0,1065,1073,6370
2005,40,c) 2,3682,3709,26937,27186,115,2.9,711,17.7,5996,598,5398,2.2,22.1,6493,3437,3056,12.6,23.9,-497,-1.8,44.2,0,594,594,3157
2005,40,d) 3,3374,3460,29761,31656,122,3.3,507,13.8,4936,613,4323,1.9,15.6,8725,5011,3714,15.8,27.6,-3789,-12,31.2,0,416,416,4493
2005,40,e) 4,2948,3071,24755,24791,103,3.2,392,12.2,4389,555,3834,2.2,17.7,4460,2024,2436,8.2,18,-71,-0.3,35.4,0,314,314,1817
2005,40,f) 5,2667,2869,26565,26795,196,6.6,377,12.7,4972,908,4064,3.4,18.6,5432,2347,3085,8.8,20.3,-460,-1.7,37.2,0,303,303,1970
2005,40,g) 6 to 10,11141,12005,119243,121536,474,3.8,1205,9.7,16812,2239,14573,1.8,13.8,21398,8743,12655,7.2,17.6,-4586,-3.8,27.6,0,926,926,6568
2005,40,h) 11 to 15,7682,8353,93432,93396,312,3.7,640,7.5,13503,3287,10216,3.5,14.5,13430,4595,8835,4.9,14.4,73,0.1,28.8,0,481,481,3064
2005,40,i) 16 to 20,5690,6590,97721,101076,261,3.9,449,6.7,11119,3059,8060,3,11,17828,6926,10902,6.9,17.6,-6709,-6.6,22,0,324,324,2349
2005,40,j) 21 to 25,5748,6950,105570,106363,201,2.9,322,4.6,11611,2185,9426,2.1,10.9,13196,3194,10002,3,12.4,-1585,-1.5,21.8,0,229,229,2526
2005,40,k) 26+,2626,4216,92684,90151,263,6.3,176,4.2,13988,5011,8977,5.6,15.5,8922,1310,7612,1.5,9.9,5066,5.6,19.8,0,106,107,676
2005,40,l) Left Censored,7874,17961,521104,519348,850,4.7,916,5.1,53524,17952,35572,3.5,10.3,50011,12961,37050,2.5,9.6,3513,0.7,19.2,0,250,250,2708
2005,41,a) 0,8515,8597,43089,21605,8539,198.7,0,0,42968,42968,0,198.9,198.9,0,0,0,0,0,42968,198.9,0,0,,,
2005,41,b) 1,5754,5829,39476,39842,22,0.3,1612,24,10244,317,9927,0.8,25.7,10976,6889,4087,17.3,27.5,-732,-1.8,51.4,0,1238,1238,5966
2005,41,c) 2,4861,4975,31338,31758,235,4.4,833,15.7,6686,960,5726,3,21.1,7525,3830,3695,12.1,23.7,-839,-2.6,42.2,0,688,688,3170
2005,41,d) 3,4313,4423,32682,32904,185,4,629,13.5,5838,1041,4797,3.2,17.7,6281,3242,3039,9.9,19.1,-443,-1.4,35.4,0,494,494,2740
2005,41,e) 4,3962,4077,30866,30727,206,4.9,503,11.9,5515,852,4663,2.8,17.9,5236,2004,3232,6.5,17,279,0.9,34,0,374,374,1581
2005,41,f) 5,3510,3610,30062,30582,152,4,441,11.7,4745,824,3921,2.7,15.5,5784,2335,3449,7.6,18.9,-1039,-3.4,31,0,337,337,1908
2005,41,g) 6 to 10,14782,15667,159296,158746,723,4.5,1431,8.9,23124,5156,17968,3.2,14.6,22024,6894,15130,4.3,13.9,1100,0.7,27.8,0,1073,1073,5306
2005,41,h) 11 to 15,9738,10550,114847,113916,437,4.1,832,7.7,17038,3104,13934,2.7,15,15176,4943,10233,4.3,13.3,1862,1.7,26.6,0,592,592,3694
2005,41,i) 16 to 20,6789,7931,117609,116186,331,4.1,494,6.2,14973,2933,12040,2.5,12.9,12126,4360,7766,3.8,10.4,2847,2.5,20.8,0,336,336,3104
2005,41,j) 21 to 25,5229,6728,120918,119898,246,3.6,370,5.4,13476,2471,11005,2.1,11.2,11435,3286,8149,2.7,9.5,2041,1.7,19,0,228,228,1803
2005,41,k) 26+,2921,4412,91278,88410,197,4.5,218,4.9,11943,3524,8419,4,13.5,6207,1430,4777,1.6,7,5736,6.5,14,0,123,123,657
2005,41,l) Left Censored,7916,18561,590938,585051,1138,6.1,1172,6.3,68258,25479,42779,4.4,11.7,56483,17716,38767,3,9.7,11775,2,19.4,0,265,270,4072
2005,42,a) 0,17941,18124,129498,64952,18028,198.9,0,0,129092,129092,0,198.7,198.7,0,0,0,0,0,129092,198.7,0,0,,,
2005,42,b) 1,13223,13402,98697,102057,37,0.2,3407,22.4,23733,317,23416,0.3,23.3,30452,16074,14378,15.8,29.8,-6719,-6.5,46.6,0,2620,2620,13606
2005,42,c) 2,11080,11223,98011,100819,375,3.1,1911,15.9,16939,1705,15234,1.7,16.8,22555,10630,11925,10.5,22.4,-5616,-5.6,33.6,0,1568,1568,9608
2005,42,d) 3,10493,10762,111685,114731,365,3.2,1387,12.3,16968,1835,15133,1.6,14.8,23059,11520,11539,10,20.1,-6091,-5.3,29.6,0,1127,1127,10706
2005,42,e) 4,9432,9715,84770,86050,330,3.3,1182,11.6,12782,1491,11291,1.7,14.9,15341,6185,9156,7.2,17.8,-2559,-2.9,29.8,0,936,936,5076
2005,42,f) 5,8788,9089,93779,94989,305,3.2,1053,11.1,13186,2086,11100,2.2,13.9,15605,6286,9319,6.6,16.4,-2419,-2.5,27.8,0,795,796,4756
2005,42,g) 6 to 10,36483,39195,424913,430663,1294,3.2,3559,8.8,55373,9640,45733,2.2,12.9,66873,24975,41898,5.8,15.5,-11500,-2.6,25.8,0,2678,2680,18289
2005,42,h) 11 to 15,25635,27551,335161,338908,837,3,2109,7.5,42020,6460,35560,1.9,12.4,49514,16856,32658,5,14.6,-7494,-2.2,24.8,0,1547,1563,13259
2005,42,i) 16 to 20,23826,27378,432551,436719,773,2.8,1778,6.4,42676,8810,33866,2,9.8,51012,17681,33331,4,11.7,-8336,-1.9,19.6,0,1211,1214,8677
2005,42,j) 21 to 25,16879,21052,378199,377165,699,3.3,1129,5.3,40922,8011,32911,2.1,10.8,38855,9836,29019,2.6,10.3,2067,0.5,20.6,0,736,745,4542
2005,42,k) 26+,8688,13594,293376,293109,509,3.7,682,5,33831,11648,22183,4,11.5,33296,7286,26010,2.5,11.4,535,0.1,22.8,0,400,404,3511
2005,42,l) Left Censored,33164,74287,2590252,2622642,4262,5.7,4272,5.7,244525,79324,165201,3,9.3,309304,88048,221256,3.4,11.8,-64779,-2.5,18.6,0,1252,1264,18145
2005,44,a) 0,1992,1997,11000,5547,1977,198,0,0,10906,10906,0,196.6,196.6,0,0,0,0,0,10906,196.6,0,0,,,
2005,44,b) 1,1584,1593,10428,10941,4,0.2,483,26.1,2217,57,2160,0.5,20.3,3242,1648,1594,15.1,29.6,-1025,-9.3,40.6,0,361,361,1344
2005,44,c) 2,1254,1263,9013,9404,43,3.1,240,17.6,1368,202,1166,2.1,14.5,2149,876,1273,9.3,22.9,-781,-8.4,29,0,188,188,775
2005,44,d) 3,1111,1119,7768,8046,49,4.2,160,13.6,1270,340,930,4.2,15.8,1826,938,888,11.7,22.7,-556,-6.9,31.6,0,123,123,752
2005,44,e) 4,1012,1030,7238,7650,37,3.4,121,11.3,1185,155,1030,2,15.5,2008,1155,853,15.1,26.2,-823,-10.7,31,0,90,90,1000
2005,44,f) 5,897,925,7927,8057,36,3.8,99,10.3,1038,88,950,1.1,12.9,1298,403,895,5,16.1,-260,-3.2,25.8,0,69,69,345
2005,44,g) 6 to 10,3776,3943,37833,38469,136,3.3,407,10,5048,923,4125,2.4,13.1,6320,2129,4191,5.5,16.4,-1272,-3.3,26.2,0,295,295,1791
2005,44,h) 11 to 15,2665,2779,30756,31469,104,3.7,220,7.7,3828,1061,2767,3.4,12.2,5254,1791,3463,5.7,16.7,-1426,-4.5,24.4,0,154,154,1570
2005,44,i) 16 to 20,2534,2774,39968,39936,80,2.8,179,6.3,3959,916,3043,2.3,9.9,3895,1177,2718,2.9,9.8,64,0.1,19.6,0,126,126,928
2005,44,j) 21 to 25,1608,1876,30576,30569,47,2.5,103,5.4,3411,784,2627,2.6,11.2,3397,886,2511,2.9,11.1,14,0.1,22.2,0,63,63,455
2005,44,k) 26+,925,1181,23852,23399,58,4.9,48,4.1,2718,515,2203,2.2,11.6,1811,313,1498,1.3,7.7,907,3.9,15.4,0,28,28,137
2005,44,l) Left Censored,3808,6195,219915,219636,346,5.6,339,5.5,18742,5872,12870,2.7,8.5,18183,3541,14642,1.6,8.3,559,0.2,16.6,0,127,127,845
2005,45,a) 0,7577,7657,47425,23778,7606,198.7,0,0,47294,47294,0,198.9,198.9,0,0,0,0,0,47294,198.9,0,0,,,
2005,45,b) 1,5414,5478,40582,41009,32,0.5,1497,23.9,11957,609,11348,1.5,29.2,12810,8022,4788,19.6,31.2,-853,-2,58.4,0,1234,1234,6720
2005,45,c) 2,4584,4642,43136,44253,175,3.5,831,16.7,9331,883,8448,2,21.1,11564,5481,6083,12.4,26.1,-2233,-5,42.2,0,697,697,4724
2005,45,d) 3,4082,4175,33584,35296,143,3.2,653,14.7,5665,851,4814,2.4,16,9088,4128,4960,11.7,25.7,-3423,-9.7,32,0,516,516,3126
2005,45,e) 4,3573,3728,38751,38863,150,3.9,461,11.9,5708,817,4891,2.1,14.7,5932,2358,3574,6.1,15.3,-224,-0.6,29.4,0,374,374,2070
2005,45,f) 5,3393,3551,35619,35826,122,3.3,398,10.8,6378,856,5522,2.4,17.8,6792,2398,4394,6.7,19,-414,-1.2,35.6,0,321,321,1939
2005,45,g) 6 to 10,13205,14045,168020,169053,562,3.9,1395,9.6,25905,5442,20463,3.2,15.3,27970,9388,18582,5.6,16.5,-2065,-1.2,30.6,0,1077,1078,6630
2005,45,h) 11 to 15,8297,9133,115425,116512,391,4.2,712,7.7,16723,3140,13583,2.7,14.4,18897,5167,13730,4.4,16.2,-2174,-1.8,28.8,0,539,539,3780
2005,45,i) 16 to 20,6756,8624,133799,134582,307,3.5,619,7,15783,3188,12595,2.4,11.7,17348,4877,12471,3.6,12.9,-1565,-1.2,23.4,0,410,415,2553
2005,45,j) 21 to 25,5130,6274,101702,101302,184,2.9,289,4.6,11723,2972,8751,2.9,11.6,10922,2346,8576,2.3,10.8,801,0.8,21.6,0,188,188,1678
2005,45,k) 26+,2462,4315,84295,83390,183,4.3,155,3.6,10845,3592,7253,4.3,13,9035,1603,7432,1.9,10.8,1810,2.2,21.6,0,87,87,381
2005,45,l) Left Censored,8488,21542,731424,727573,1402,6.6,966,4.5,73778,24946,48832,3.4,10.1,66076,11494,54582,1.6,9.1,7702,1,18.2,0,267,274,1854
2005,46,a) 0,1636,1653,7871,3964,1640,198.4,0,0,7814,7814,0,197.1,197.1,0,0,0,0,0,7814,197.1,0,0,,,
2005,46,b) 1,1216,1225,8215,7633,7,0.5,344,24.4,3129,24,3105,0.3,41,1964,1310,654,17.2,25.7,1165,15.3,51.4,0,257,257,1090
2005,46,c) 2,1035,1052,6409,6651,35,3.1,157,14,1000,110,890,1.7,15,1484,564,920,8.5,22.3,-484,-7.3,30,0,129,129,492
2005,46,d) 3,1026,1038,7323,7433,29,2.6,145,13.2,1149,87,1062,1.2,15.5,1368,511,857,6.9,18.4,-219,-2.9,31,0,120,120,463
2005,46,e) 4,856,895,6758,6791,37,4,106,11.4,1035,172,863,2.5,15.2,1101,432,669,6.4,16.2,-66,-1,30.4,0,80,80,358
2005,46,f) 5,810,833,7432,7445,34,4,75,8.8,1195,197,998,2.6,16.1,1221,474,747,6.4,16.4,-26,-0.3,32.2,0,52,52,275
2005,46,g) 6 to 10,3282,3442,30199,30501,109,3.1,299,8.4,3977,490,3487,1.6,13,4580,1334,3246,4.4,15,-603,-2,26,0,217,217,1031
2005,46,h) 11 to 15,2234,2337,24141,24326,86,3.6,188,7.8,2640,485,2155,2,10.9,3010,880,2130,3.6,12.4,-370,-1.5,21.8,0,126,126,695
2005,46,i) 16 to 20,1682,1844,25503,25633,59,3.2,109,5.8,2890,300,2590,1.2,11.3,3149,765,2384,3,12.3,-259,-1,22.6,0,76,76,284
2005,46,j) 21 to 25,1402,1740,20027,20310,51,2.9,92,5.2,2114,662,1452,3.3,10.4,2679,775,1904,3.8,13.2,-565,-2.8,20.8,0,62,62,462
2005,46,k) 26+,775,1077,16524,16576,43,4,47,4.4,1770,601,1169,3.6,10.7,1873,323,1550,1.9,11.3,-103,-0.6,21.4,0,31,31,88
2005,46,l) Left Censored,2936,5202,147592,146948,241,4.6,240,4.6,13094,2544,10550,1.7,8.9,11805,3100,8705,2.1,8,1289,0.9,16,0,67,67,492
2005,47,a) 0,8844,8930,60462,30301,8890,199.1,0,0,60322,60322,0,199.1,199.1,0,0,0,0,0,60322,199.1,0,0,,,
2005,47,b) 1,6464,6536,51638,54287,21,0.3,1935,25.5,15187,110,15077,0.2,28,20484,12629,7855,23.3,37.7,-5297,-9.7,56,0,1641,1641,11130
2005,47,c) 2,5289,5369,45316,48869,183,3.2,1019,17.6,8917,983,7934,2,18.2,16023,6094,9929,12.5,32.8,-7106,-14.6,36.4,0,872,872,5551
2005,47,d) 3,4558,4726,46590,48232,145,2.9,741,14.7,7688,741,6947,1.5,15.9,10971,5476,5495,11.4,22.7,-3283,-6.8,31.8,0,623,623,5018
2005,47,e) 4,3998,4152,39278,40377,145,3.3,588,13.4,6065,818,5247,2,15,8263,3207,5056,7.9,20.5,-2198,-5.5,30,0,479,479,2760
2005,47,f) 5,3695,3874,41654,43286,159,3.9,465,11.5,5965,1157,4808,2.7,13.8,9229,3152,6077,7.3,21.3,-3264,-7.5,27.6,0,380,380,2619
2005,47,g) 6 to 10,15952,17436,211497,211759,699,3.9,1674,9.3,35591,6314,29277,3,16.8,36115,11420,24695,5.4,17.1,-524,-0.3,33.6,0,1300,1301,8864
2005,47,h) 11 to 15,11007,12340,167620,170275,472,3.7,994,7.9,21360,3657,17703,2.1,12.5,26669,7877,18792,4.6,15.7,-5309,-3.2,25,0,754,754,5930
2005,47,i) 16 to 20,9210,11192,192173,191809,385,3.4,781,6.8,24591,7573,17018,3.9,12.8,23862,8440,15422,4.4,12.4,729,0.4,24.8,0,531,538,5392
2005,47,j) 21 to 25,7252,8992,160961,159521,278,3.1,461,5.1,19159,3580,15579,2.2,12,16279,5151,11128,3.2,10.2,2880,1.8,20.4,0,326,326,2472
2005,47,k) 26+,3736,6762,170967,170382,208,3,377,5.5,19938,6030,13908,3.5,11.7,18767,3854,14913,2.3,11,1171,0.7,22,0,162,163,1003
2005,47,l) Left Censored,12046,31560,1176262,1172300,2074,6.6,1670,5.3,130145,35230,94915,3,11.1,122222,25880,96342,2.2,10.4,7923,0.7,20.8,0,439,443,3055
2005,48,a) 0,36816,37479,285845,144076,37240,198.7,0,0,283539,283539,0,196.8,196.8,0,0,0,0,0,283539,196.8,0,0,,,
2005,48,b) 1,27131,27468,226501,239947,115,0.4,7934,24.9,60807,1389,59418,0.6,25.3,87700,50602,37098,21.1,36.5,-26893,-11.2,50.6,0,6628,6628,45393
2005,48,c) 2,22615,23050,212336,218733,892,3.6,4401,17.6,46671,6441,40230,2.9,21.3,59466,30436,29030,13.9,27.2,-12795,-5.9,42.6,0,3704,3706,27090
2005,48,d) 3,19478,20245,221109,229248,677,3.1,3184,14.8,42226,6265,35961,2.7,18.4,58505,29544,28961,12.9,25.5,-16279,-7.1,36.8,0,2736,2736,27615
2005,48,e) 4,17184,18008,183359,188434,737,3.9,2492,13.1,30495,5250,25245,2.8,16.2,40644,18048,22596,9.6,21.6,-10149,-5.4,32.4,0,2014,2043,15847
2005,48,f) 5,15473,16266,176119,180060,567,3.3,2053,12,29615,4795,24820,2.7,16.4,37497,14706,22791,8.2,20.8,-7882,-4.4,32.8,0,1611,1632,12076
2005,48,g) 6 to 10,61835,67482,872419,880918,2779,4,6987,10,144163,34847,109316,4,16.4,161160,57877,103283,6.6,18.3,-16997,-1.9,32.8,0,5419,5448,45420
2005,48,h) 11 to 15,41219,46224,637100,645714,1802,3.8,3823,8.1,94359,19161,75198,3,14.6,111587,32775,78812,5.1,17.3,-17228,-2.7,29.2,0,2829,2834,24198
2005,48,i) 16 to 20,29608,37023,676258,681443,1611,4.3,2733,7.3,84634,23521,61113,3.5,12.4,95003,28436,66567,4.2,13.9,-10369,-1.5,24.8,0,1736,1741,15464
2005,48,j) 21 to 25,26019,34043,595400,605229,1250,3.6,1854,5.4,71705,17460,54245,2.9,11.8,91363,17647,73716,2.9,15.1,-19658,-3.3,23.6,0,1215,1221,10290
2005,48,k) 26+,11500,20456,475567,467988,869,4.2,1046,5.1,68193,22011,46182,4.7,14.6,53034,13634,39400,2.9,11.3,15159,3.3,22.6,0,535,541,5602
2005,48,l) Left Censored,30251,100936,3653494,3615606,7537,7.5,5647,5.6,450575,158206,292369,4.4,12.5,374799,99391,275408,2.7,10.4,75776,2.1,20.8,0,1106,1122,10960
2005,49,a) 0,6174,6204,36090,18106,6165,198.7,0,0,35968,35968,0,198.7,198.7,0,0,0,0,0,35968,198.7,0,0,,,
2005,49,b) 1,4268,4300,33884,32901,13,0.3,1387,27.4,12328,267,12061,0.8,37.5,10362,6780,3582,20.6,31.5,1966,6,63,0,1047,1047,5592
2005,49,c) 2,3599,3632,33925,34114,196,5,735,18.8,8337,822,7515,2.4,24.4,8715,5036,3679,14.8,25.5,-378,-1.1,48.8,0,581,581,4543
2005,49,d) 3,3083,3157,27657,27966,137,4.1,436,13.1,5237,397,4840,1.4,18.7,5854,2530,3324,9,20.9,-617,-2.2,37.4,0,347,347,2249
2005,49,e) 4,2587,2677,24806,24775,132,4.8,317,11.4,4805,653,4152,2.6,19.4,4742,2089,2653,8.4,19.1,63,0.3,38.2,0,247,247,1491
2005,49,f) 5,2219,2263,20358,20737,92,3.9,285,12,3494,461,3033,2.2,16.8,4252,2027,2225,9.8,20.5,-758,-3.7,33.6,0,214,214,1883
2005,49,g) 6 to 10,8390,8804,108916,111016,394,4.3,934,10.3,15590,3024,12566,2.7,14,19790,6381,13409,5.7,17.8,-4200,-3.8,28,0,681,681,5051
2005,49,h) 11 to 15,4627,4996,87734,84976,206,4.1,352,6.9,17898,2875,15023,3.4,21.1,12382,4607,7775,5.4,14.6,5516,6.5,29.2,0,238,238,3540
2005,49,i) 16 to 20,2960,3617,72920,72011,130,3.5,228,6.2,9529,2063,7466,2.9,13.2,7711,2484,5227,3.4,10.7,1818,2.5,21.4,0,154,154,1624
2005,49,j) 21 to 25,2296,2988,64025,66070,112,3.7,168,5.6,6723,1374,5349,2.1,10.2,10813,1618,9195,2.4,16.4,-4090,-6.2,20.4,0,112,112,998
2005,49,k) 26+,1387,2120,49170,48728,88,4.1,100,4.7,5597,1454,4143,3,11.5,4713,735,3978,1.5,9.7,884,1.8,19.4,0,49,53,397
2005,49,l) Left Censored,4007,10333,413433,412657,970,9.5,774,7.6,54416,18567,35849,4.5,13.2,52864,15273,37591,3.7,12.8,1552,0.4,25.6,0,103,109,1097
2005,50,a) 0,1300,1303,6517,3266,1297,199.1,0,0,6502,,,,199.1,0,0,0,0,0,6502,199.1,0,1,,,
2005,50,b) 1,1021,1029,6375,6151,3,0.3,253,21.6,2065,,,,33.6,1617,970,647,15.8,26.3,448,7.3,52.6,1,174,174,577
2005,50,c) 2,892,900,5461,5712,33,3.4,160,16.6,976,62,914,1.1,17.1,1477,692,785,12.1,25.9,-501,-8.8,34.2,0,133,133,583
2005,50,d) 3,767,778,5282,5404,25,3,105,12.7,735,57,678,1.1,13.6,978,439,539,8.1,18.1,-243,-4.5,27.2,0,75,75,341
2005,50,e) 4,728,737,4645,4700,24,3.1,83,10.8,776,222,554,4.7,16.5,885,348,537,7.4,18.8,-109,-2.3,33,0,67,67,316
2005,50,f) 5,712,732,8188,7307,27,3.5,86,11.3,2993,62,2931,0.8,41,1230,523,707,7.2,16.8,1763,24.2,33.6,0,68,68,429
2005,50,g) 6 to 10,2979,3100,24614,24761,103,3.2,276,8.6,3411,425,2986,1.7,13.8,3704,1268,2436,5.1,15,-293,-1.2,27.6,0,202,202,1116
2005,50,h) 11 to 15,2231,2358,19139,19237,78,3.3,149,6.2,2321,435,1886,2.3,12.1,2517,770,1747,4,13.1,-196,-1,24.2,0,112,112,655
2005,50,i) 16 to 20,2054,2210,25024,25117,75,3.3,163,7.2,2567,378,2189,1.5,10.2,2753,1044,1709,4.2,11,-186,-0.8,20.4,0,101,101,723
2005,50,j) 21 to 25,1363,1630,27634,27755,32,1.9,89,5.4,2043,310,1733,1.1,7.4,2285,677,1608,2.4,8.2,-242,-0.8,14.8,0,60,60,421
2005,50,k) 26+,660,900,16600,16679,47,5.2,48,5.3,1823,656,1167,3.9,10.9,1981,641,1340,3.8,11.9,-158,-1,21.8,0,27,27,221
2005,50,l) Left Censored,2275,3941,110737,110660,179,4.5,205,5.2,9323,2415,6908,2.2,8.4,9168,2312,6856,2.1,8.3,155,0.1,16.6,0,74,77,678
2005,51,a) 0,14027,14087,82333,41372,13990,198.6,0,0,81922,81922,0,198,198,0,0,0,0,0,81922,198,0,0,,,
2005,51,b) 1,10262,10333,72417,74935,45,0.4,2880,24.2,19008,702,18306,0.9,25.4,24044,11945,12099,15.9,32.1,-5036,-6.7,50.8,0,2263,2263,10250
2005,51,c) 2,8093,8172,63399,64104,295,3.4,1449,16.5,14003,1254,12749,2,21.8,15413,7047,8366,11,24,-1410,-2.2,43.6,0,1154,1154,5996
2005,51,d) 3,7288,7468,60854,61951,284,3.6,1013,12.9,11442,1651,9791,2.7,18.5,13636,6524,7112,10.5,22,-2194,-3.5,37,0,813,813,4944
2005,51,e) 4,6319,6618,59436,60006,258,3.7,833,12,10924,1876,9048,3.1,18.2,12064,5079,6985,8.5,20.1,-1140,-1.9,36.4,0,647,647,3582
2005,51,f) 5,5861,6091,56608,57425,229,3.6,737,11.6,8919,1307,7612,2.3,15.5,10552,3860,6692,6.7,18.4,-1633,-2.9,31,0,575,578,3274
2005,51,g) 6 to 10,24297,25865,291522,293736,901,3.4,2336,8.8,43261,6725,36536,2.3,14.7,47688,14880,32808,5.1,16.2,-4427,-1.5,29.4,0,1710,1726,11085
2005,51,h) 11 to 15,16266,17699,251748,252354,579,3.2,1234,6.8,32927,5960,26967,2.4,13,34138,7927,26211,3.1,13.5,-1211,-0.5,26,0,889,889,5991
2005,51,i) 16 to 20,13385,16136,282657,283393,573,3.5,981,6,33276,9236,24040,3.3,11.7,34747,9616,25131,3.4,12.3,-1471,-0.6,23.4,0,589,599,3820
2005,51,j) 21 to 25,9147,11627,221799,223353,369,3.1,584,5,23063,5971,17092,2.7,10.3,26171,4925,21246,2.2,11.7,-3108,-1.4,20.6,0,356,364,2025
2005,51,k) 26+,4387,7349,164990,161262,328,4.5,344,4.7,20962,5935,15027,3.7,13,13505,2460,11045,1.5,8.4,7457,4.6,16.8,0,173,183,1060
2005,51,l) Left Censored,14748,40859,1437342,1444298,2785,6.9,2198,5.4,158295,53786,104509,3.7,11,172208,38315,133893,2.7,11.9,-13913,-0.9,22,0,499,503,5650
2005,53,a) 0,14165,14258,69771,35044,14145,198.4,0,0,69455,69455,0,198.2,198.2,0,0,0,0,0,69455,198.2,0,0,,,
2005,53,b) 1,9651,9723,60858,62731,38,0.3,2873,25.4,15246,462,14784,0.7,24.3,18991,11992,6999,19.1,30.3,-3745,-6,48.6,0,2265,2265,10541
2005,53,c) 2,7998,8059,54494,57216,442,5.1,1496,17.4,12312,1649,10663,2.9,21.5,17756,10808,6948,18.9,31,-5444,-9.5,43,0,1202,1202,9893
2005,53,d) 3,7194,7374,56678,56812,340,4.4,1053,13.6,10471,1332,9139,2.3,18.4,10738,4602,6136,8.1,18.9,-267,-0.5,36.8,0,838,838,3874
2005,53,e) 4,6323,6517,51590,51832,308,4.5,813,12,8760,1147,7613,2.2,16.9,9244,3579,5665,6.9,17.8,-484,-0.9,33.8,0,646,646,2968
2005,53,f) 5,5876,6106,52363,52669,299,4.7,719,11.4,8580,1136,7444,2.2,16.3,9191,4040,5151,7.7,17.5,-611,-1.2,32.6,0,560,560,3436
2005,53,g) 6 to 10,23433,24912,239344,242720,1236,4.8,2570,10,35322,6725,28597,2.8,14.6,42073,14092,27981,5.8,17.3,-6751,-2.7,29.2,0,1881,1881,11334
2005,53,h) 11 to 15,15793,17094,190136,189347,735,4.2,1463,8.4,26671,4886,21785,2.6,14.1,25092,7225,17867,3.8,13.3,1579,0.8,26.6,0,1052,1052,5176
2005,53,i) 16 to 20,10638,12477,205107,203166,470,3.7,856,6.7,24790,5609,19181,2.8,12.2,20907,5486,15421,2.7,10.3,3883,1.9,20.6,0,565,566,3344
2005,53,j) 21 to 25,8299,10784,207188,207431,420,3.9,583,5.4,20108,3116,16992,1.5,9.7,20593,5671,14922,2.7,9.9,-485,-0.2,19.4,0,363,363,2650
2005,53,k) 26+,4321,6642,138113,137930,267,4,328,4.9,14316,3392,10924,2.5,10.4,13950,2329,11621,1.7,10.1,366,0.3,20.2,0,181,184,976
2005,53,l) Left Censored,11858,29488,984394,978950,2116,7.2,1903,6.5,125128,42361,82767,4.3,12.8,114239,37069,77170,3.8,11.7,10889,1.1,23.4,0,386,387,5951
2005,54,a) 0,2475,2500,14496,7316,2489,199.1,0,0,14361,14361,0,196.3,196.3,0,0,0,0,0,14361,196.3,0,0,,,
2005,54,b) 1,1769,1799,12336,12322,13,0.6,509,24.5,3437,88,3349,0.7,27.9,3408,1859,1549,15.1,27.7,29,0.2,55.4,0,398,398,1575
2005,54,c) 2,1397,1428,11864,12428,62,4,274,17.8,2251,172,2079,1.4,18.1,3378,1498,1880,12.1,27.2,-1127,-9.1,36.2,0,229,229,1380
2005,54,d) 3,1300,1336,11276,11662,52,3.7,212,15,1727,338,1389,2.9,14.8,2498,894,1604,7.7,21.4,-771,-6.6,29.6,0,174,174,738
2005,54,e) 4,1140,1158,10120,10513,34,2.8,143,11.7,1426,91,1335,0.9,13.6,2212,925,1287,8.8,21,-786,-7.4,27.2,0,107,107,714
2005,54,f) 5,1162,1215,10490,10819,40,3.1,154,12.1,1607,301,1306,2.8,14.9,2265,868,1397,8,20.9,-658,-6,29.8,0,129,129,691
2005,54,g) 6 to 10,4831,5261,48184,49056,219,4,563,10.3,7157,1271,5886,2.6,14.6,8901,3116,5785,6.4,18.1,-1744,-3.5,29.2,0,434,434,2637
2005,54,h) 11 to 15,3489,3706,36204,37439,130,3.4,314,8.2,4792,418,4374,1.1,12.8,7261,1666,5595,4.4,19.4,-2469,-6.6,25.6,0,240,240,1134
2005,54,i) 16 to 20,2999,3438,56227,57054,90,2.6,236,6.7,5282,829,4453,1.5,9.3,6935,2159,4776,3.8,12.2,-1653,-2.9,18.6,0,175,176,941
2005,54,j) 21 to 25,2563,2897,37854,37953,68,2.3,144,4.9,3936,413,3523,1.1,10.4,4134,774,3360,2,10.9,-198,-0.5,20.8,0,101,103,485
2005,54,k) 26+,1281,2297,37132,37430,203,8.9,156,6.9,4923,1828,3095,4.9,13.2,5519,1460,4059,3.9,14.7,-596,-1.5,26.4,0,61,61,292
2005,54,l) Left Censored,5003,10301,277305,277036,467,4.5,489,4.7,26328,6914,19414,2.5,9.5,25789,5826,19963,2.1,9.3,539,0.2,18.6,0,165,166,720
2005,55,a) 0,8595,8624,53211,26680,8577,198.9,0,0,53063,53063,0,198.9,198.9,0,0,0,0,0,53063,198.9,0,0,,,
2005,55,b) 1,6240,6300,49048,51193,19,0.3,1674,23.3,11156,171,10985,0.3,21.8,15446,9209,6237,18,30.2,-4290,-8.4,43.6,0,1287,1287,8115
2005,55,c) 2,5390,5476,41511,44537,214,3.7,896,15.4,6950,896,6054,2,15.6,13002,7194,5808,16.2,29.2,-6052,-13.6,31.2,0,717,717,6409
2005,55,d) 3,5166,5308,45726,46698,181,3.2,690,12.4,7321,1176,6145,2.5,15.7,9265,3272,5993,7,19.8,-1944,-4.1,31.4,0,541,541,2873
2005,55,e) 4,4538,4771,52500,52517,184,3.7,556,11.2,7712,1647,6065,3.1,14.7,7746,3128,4618,6,14.7,-34,0,29.4,0,422,422,2697
2005,55,f) 5,4423,4600,43953,44409,171,3.6,461,9.7,6524,850,5674,1.9,14.7,7435,2695,4740,6.1,16.7,-911,-2,29.4,0,344,344,1733
2005,55,g) 6 to 10,18072,19353,208367,210668,729,3.7,1679,8.5,27768,4504,23264,2.1,13.2,32370,9837,22533,4.7,15.4,-4602,-2.2,26.4,0,1278,1278,7873
2005,55,h) 11 to 15,13013,14053,164020,164504,440,3.1,1079,7.5,20994,3644,17350,2.2,12.8,21961,6275,15686,3.8,13.3,-967,-0.5,25.6,0,754,754,4382
2005,55,i) 16 to 20,10411,12277,199869,201747,323,2.6,729,5.8,20484,4291,16193,2.1,10.2,24240,7217,17023,3.6,12,-3756,-1.8,20.4,0,499,505,4107
2005,55,j) 21 to 25,7609,9238,156629,156431,246,2.6,451,4.8,16898,2603,14295,1.7,10.8,16502,4042,12460,2.6,10.5,396,0.3,21,0,334,334,3098
2005,55,k) 26+,4216,6856,148051,145620,301,4.4,319,4.6,17913,4789,13124,3.3,12.3,13050,2842,10208,2,9,4863,3.3,18,0,178,179,1276
2005,55,l) Left Censored,16055,33246,1283182,1285831,1520,4.6,1552,4.7,121169,32638,88531,2.5,9.4,126467,33334,93133,2.6,9.8,-5298,-0.4,18.8,0,523,555,5804
2005,56,a) 0,1499,1505,6628,3326,1495,198.7,0,0,6604,6604,0,198.6,198.6,0,0,0,0,0,6604,198.6,0,0,,,
2005,56,b) 1,1049,1055,5473,5689,11,0.9,302,24.9,1496,121,1375,2.1,26.3,1928,1269,659,22.3,33.9,-432,-7.6,52.6,0,233,233,1113
2005,56,c) 2,896,898,5572,5865,39,4,165,17,1091,218,873,3.7,18.6,1677,967,710,16.5,28.6,-586,-10,37.2,0,123,123,872
2005,56,d) 3,923,934,6702,6756,45,4.6,121,12.4,1230,135,1095,2,18.2,1337,525,812,7.8,19.8,-107,-1.6,36.4,0,102,102,484
2005,56,e) 4,724,733,4929,4884,38,5,99,12.9,1028,121,907,2.5,21,937,457,480,9.4,19.2,91,1.8,38.4,0,73,73,384
2005,56,f) 5,702,716,5046,5139,14,1.9,85,11.3,784,62,722,1.2,15.3,969,414,555,8.1,18.9,-185,-3.6,30.6,0,64,64,348
2005,56,g) 6 to 10,2694,2823,22159,22669,110,3.8,263,9,3215,407,2808,1.8,14.2,4234,1153,3081,5.1,18.7,-1019,-4.5,28.4,0,197,197,881
2005,56,h) 11 to 15,1694,1774,15820,16082,82,4.6,126,7,2176,362,1814,2.3,13.5,2700,499,2201,3.1,16.8,-524,-3.3,27,0,88,88,360
2005,56,i) 16 to 20,1187,1336,19555,19384,61,4.5,88,6.5,2438,718,1720,3.7,12.6,2096,511,1585,2.6,10.8,342,1.8,21.6,0,62,62,407
2005,56,j) 21 to 25,1130,1341,16124,16360,57,4.2,70,5.2,1928,512,1416,3.1,11.8,2399,709,1690,4.3,14.7,-471,-2.9,23.6,0,46,46,257
2005,56,k) 26+,644,904,14493,14312,34,3.7,48,5.3,1674,302,1372,2.1,11.7,1311,274,1037,1.9,9.2,363,2.5,18.4,0,28,28,120
2005,56,l) Left Censored,1786,3272,66782,66569,187,5.7,153,4.7,6852,1791,5061,2.7,10.3,6426,1185,5241,1.8,9.7,426,0.6,19.4,0,51,51,211
2006,01,a) 0,6781,6958,50965,25573,6909,198.6,0,0,50785,50785,0,198.6,198.6,0,0,0,0,0,50785,198.6,0,0,,,
2006,01,b) 1,5004,5108,42986,43014,45,0.8,1480,25,11895,1208,10687,2.8,27.7,11950,6938,5012,16.1,27.8,-55,-0.1,55.4,0,1230,1230,5517
2006,01,c) 2,4241,4295,37248,37794,141,3,827,17.8,7734,742,6992,2,20.5,8825,4815,4010,12.7,23.4,-1091,-2.9,41,0,684,686,4176
2006,01,d) 3,3615,3663,32449,34268,96,2.4,648,16.4,5202,589,4613,1.7,15.2,8839,4767,4072,13.9,25.8,-3637,-10.6,30.4,0,537,537,3499
2006,01,e) 4,3243,3362,32355,33289,106,3,440,12.4,5125,602,4523,1.8,15.4,6992,2970,4022,8.9,21,-1867,-5.6,30.8,0,352,352,1773
2006,01,f) 5,2865,3051,35007,34413,112,3.5,376,11.8,6769,899,5870,2.6,19.7,5581,1890,3691,5.5,16.2,1188,3.5,32.4,0,294,301,1621
2006,01,g) 6 to 10,12751,13763,162952,162115,491,3.4,1482,10.4,28922,8092,20830,5,17.8,27247,10361,16886,6.4,16.8,1675,1,33.6,0,1170,1170,8228
2006,01,h) 11 to 15,8811,9669,126518,126427,280,2.8,811,8.1,17829,3574,14255,2.8,14.1,17647,5564,12083,4.4,14,182,0.1,28,0,583,595,3534
2006,01,i) 16 to 20,6744,8103,167539,165163,324,3.9,549,6.7,21743,5642,16101,3.4,13.2,16991,4211,12780,2.5,10.3,4752,2.9,20.6,0,382,382,2273
2006,01,j) 21 to 25,5684,7211,136056,135787,261,3.6,410,5.6,15281,4145,11136,3.1,11.3,14742,4207,10535,3.1,10.9,539,0.4,21.8,0,229,233,1849
2006,01,k) 26+,3510,5936,116302,113985,297,5,309,5.2,15930,6191,9739,5.4,14,11296,3747,7549,3.3,9.9,4634,4.1,19.8,0,145,145,940
2006,01,l) Left Censored,8705,23008,761396,764922,1391,6.1,1203,5.2,85393,26481,58912,3.5,11.2,92444,30605,61839,4,12.1,-7051,-0.9,22.4,0,300,300,8839
2006,02,a) 0,1364,1379,6475,3307,1362,197.5,0,0,6337,,,,191.6,0,0,0,0,0,6337,191.6,0,1,,,
2006,02,b) 1,864,869,5139,5158,4,0.4,364,33.9,1646,,,,31.9,1684,1100,584,21.3,32.6,-38,-0.7,63.8,1,261,261,788
2006,02,c) 2,821,830,5239,5250,48,5.3,184,20.4,1431,142,1289,2.7,27.3,1453,783,670,14.9,27.7,-22,-0.4,54.6,0,132,132,648
2006,02,d) 3,702,733,5142,5245,50,6.5,115,15,1060,182,878,3.5,20.2,1266,398,868,7.6,24.1,-206,-3.9,40.4,0,80,80,318
2006,02,e) 4,721,760,6683,6948,36,4.5,118,14.7,1024,171,853,2.5,14.7,1553,768,785,11.1,22.4,-529,-7.7,29.4,0,79,79,582
2006,02,f) 5,563,582,4034,4582,30,4.9,86,14.1,690,59,631,1.3,15.1,1785,386,1399,8.4,39,-1095,-23.9,30.2,0,53,53,279
2006,02,g) 6 to 10,2418,2589,29307,29143,114,4.2,310,11.5,4637,638,3999,2.2,15.9,4309,1719,2590,5.9,14.8,328,1.1,29.6,0,190,190,1092
2006,02,h) 11 to 15,1604,1709,13802,14170,85,4.8,182,10.3,2052,472,1580,3.3,14.5,2788,939,1849,6.6,19.7,-736,-5.2,29,0,101,101,461
2006,02,i) 16 to 20,1271,1405,21858,21753,55,3.8,104,7.3,2393,349,2044,1.6,11,2182,740,1442,3.4,10,211,1,20,0,75,75,623
2006,02,j) 21 to 25,1137,1464,20459,20290,80,5.5,80,5.5,3242,1028,2214,5.1,16,2903,992,1911,4.9,14.3,339,1.7,28.6,0,40,40,214
2006,02,k) 26+,707,1181,28230,27610,60,5.1,54,4.6,3774,957,2817,3.5,13.7,2533,654,1879,2.4,9.2,1241,4.5,18.4,0,20,20,257
2006,02,l) Left Censored,1342,3194,92594,90100,221,7,141,4.5,13118,1706,11412,1.9,14.6,8130,1864,6266,2.1,9,4988,5.6,18,0,38,38,343
2006,04,a) 0,12786,12921,86908,43991,12812,198.3,0,0,85835,85835,0,195.1,195.1,0,0,0,0,0,85835,195.1,0,0,,,
2006,04,b) 1,8604,8807,78992,77721,57,0.6,2348,23.3,23189,742,22447,1,29.8,20647,11850,8797,15.2,26.6,2542,3.2,53.2,0,1831,1831,10081
2006,04,c) 2,6773,6903,67142,65216,250,3.4,1224,16.5,16920,1561,15359,2.4,25.9,13067,6514,6553,10,20,3853,5.9,40,0,992,992,5818
2006,04,d) 3,5618,5759,61745,60374,226,3.7,864,14.2,14525,1892,12633,3.1,24.1,11782,5619,6163,9.3,19.5,2743,4.6,39,0,692,692,4901
2006,04,e) 4,4962,5109,60889,59911,212,4,695,13,12521,994,11527,1.7,20.9,10565,5129,5436,8.6,17.6,1956,3.3,35.2,0,544,544,4235
2006,04,f) 5,4477,4712,52783,51509,176,3.6,564,11.5,9814,872,8942,1.7,19.1,7266,2715,4551,5.3,14.1,2548,5,28.2,0,430,430,2129
2006,04,g) 6 to 10,16857,18189,280408,276819,776,4.1,1997,10.6,44124,7129,36995,2.6,15.9,36946,14442,22504,5.2,13.3,7178,2.6,26.6,0,1411,1413,10791
2006,04,h) 11 to 15,10034,11049,184461,182224,484,4.3,1019,9,29333,5419,23914,3,16.1,24859,8183,16676,4.5,13.6,4474,2.5,27.2,0,748,748,5944
2006,04,i) 16 to 20,7187,9642,197603,193833,533,5.5,646,6.7,28921,7817,21104,4,14.9,21380,5101,16279,2.6,11,7541,3.9,22,0,430,430,3025
2006,04,j) 21 to 25,5462,7890,177230,172912,460,5.8,492,6.2,27152,7557,19595,4.4,15.7,18515,5781,12734,3.3,10.7,8637,5,21.4,0,301,308,2925
2006,04,k) 26+,3206,5732,160660,156005,410,7.2,369,6.5,26559,9451,17108,6.1,17,17249,5006,12243,3.2,11.1,9310,5.9,22.2,0,160,162,1133
2006,04,l) Left Censored,6378,22584,906969,881605,2545,11.6,1227,5.6,138164,50688,87476,5.7,15.7,87436,22247,65189,2.5,9.9,50728,5.8,19.8,0,216,230,3032
2006,05,a) 0,4620,4790,29398,14740,4751,198.4,0,0,29317,29317,0,198.9,198.9,0,0,0,0,0,29317,198.9,0,0,,,
2006,05,b) 1,3395,3447,24099,25013,19,0.5,1073,26.6,5931,108,5823,0.4,23.7,7758,4470,3288,17.9,31,-1827,-7.3,47.4,0,864,864,3747
2006,05,c) 2,2790,2833,20704,21020,82,2.6,583,18.8,4079,400,3679,1.9,19.4,4711,2420,2291,11.5,22.4,-632,-3,38.8,0,490,490,2032
2006,05,d) 3,2449,2482,19375,19801,89,3.3,423,15.9,3871,384,3487,1.9,19.5,4723,2595,2128,13.1,23.9,-852,-4.4,39,0,348,348,2347
2006,05,e) 4,2246,2361,21465,21717,129,5.3,290,11.8,4070,1033,3037,4.8,18.7,4574,1898,2676,8.7,21.1,-504,-2.4,37.4,0,246,246,1588
2006,05,f) 5,1920,2019,17155,17303,63,3,277,13,3006,377,2629,2.2,17.4,3301,1736,1565,10,19.1,-295,-1.7,34.8,0,223,223,1505
2006,05,g) 6 to 10,8034,8798,83110,83932,353,3.9,980,10.7,12237,2260,9977,2.7,14.6,13881,5199,8682,6.2,16.5,-1644,-1.9,29.2,0,721,721,4145
2006,05,h) 11 to 15,5751,6336,68400,68209,224,3.4,606,9.3,9734,2080,7654,3,14.3,9351,3734,5617,5.5,13.7,383,0.6,27.4,0,469,469,2986
2006,05,i) 16 to 20,3977,4767,77681,77282,189,3.9,338,7,9379,1912,7467,2.5,12.1,8580,2048,6532,2.7,11.1,799,1,22.2,0,250,250,1614
2006,05,j) 21 to 25,3621,4405,86817,87123,160,3.6,298,6.6,7669,1550,6119,1.8,8.8,8280,1855,6425,2.1,9.5,-611,-0.7,17.6,0,182,183,1267
2006,05,k) 26+,2387,3569,84319,81570,172,4.8,188,5.2,12546,6136,6410,7.5,15.4,7047,1619,5428,2,8.6,5499,6.8,17.2,0,118,118,894
2006,05,l) Left Censored,5827,14292,508948,506462,777,5.5,652,4.6,49026,12468,36558,2.5,9.7,44053,9958,34095,2,8.7,4973,1,17.4,0,203,218,3025
2006,06,a) 0,74615,75659,478083,239973,75052,198.4,0,0,476220,476220,0,198.4,198.4,0,0,0,0,0,476220,198.4,0,0,,,
2006,06,b) 1,53075,54958,459293,456462,399,0.6,15190,24.1,130440,5473,124967,1.2,28.6,124778,69096,55682,15.1,27.3,5662,1.3,54.6,0,11853,11853,56286
2006,06,c) 2,42572,43128,380273,387116,1562,3.3,8511,18.2,84391,10893,73498,2.8,21.8,98078,52851,45227,13.7,25.3,-13687,-3.5,43.6,0,6742,6756,45174
2006,06,d) 3,36773,37378,366390,367614,1354,3.4,6569,16.4,76874,6885,69989,1.9,20.9,79322,40184,39138,10.9,21.6,-2448,-0.7,41.8,0,5151,5152,33646
2006,06,e) 4,32739,33914,348152,348398,1363,3.8,5021,14,66140,9005,57135,2.6,19,66631,29714,36917,8.5,19.1,-491,-0.1,38,0,3867,3886,24224
2006,06,f) 5,28732,30087,302758,303755,1191,3.8,4108,13,52385,6085,46300,2,17.2,54379,24429,29950,8,17.9,-1994,-0.7,34.4,0,3130,3134,20056
2006,06,g) 6 to 10,107112,115314,1433344,1443099,4507,3.8,13395,11.2,224632,33672,190960,2.3,15.6,244143,94801,149342,6.6,16.9,-19511,-1.3,31.2,0,9769,9795,71505
2006,06,h) 11 to 15,66200,72586,1060926,1067448,2728,3.6,7364,9.8,163182,27831,135351,2.6,15.3,176225,70941,105284,6.6,16.5,-13043,-1.2,30.6,0,5316,5325,49091
2006,06,i) 16 to 20,57270,69062,1267148,1261847,2811,4,5696,8.1,172454,37319,135135,3,13.7,161851,53087,108764,4.2,12.8,10603,0.9,25.6,0,3884,3906,32999
2006,06,j) 21 to 25,42841,55936,1106724,1105771,2143,3.8,3828,6.7,130724,39406,91318,3.6,11.8,128817,38301,90516,3.5,11.6,1907,0.2,23.2,0,2390,2410,22802
2006,06,k) 26+,27263,43065,1010721,1006064,2175,5,2862,6.6,135710,50088,85622,5,13.5,126396,31170,95226,3.1,12.6,9314,0.9,25.2,0,1510,1526,12413
2006,06,l) Left Censored,47983,139601,5457012,5398576,9643,7,7368,5.3,681440,218473,462967,4,12.6,564567,135528,429039,2.5,10.5,116873,2.1,21,0,2307,2336,28976
2006,08,a) 0,12787,12954,68488,34390,12821,197.9,0,0,68197,68197,0,198.3,198.3,0,0,0,0,0,68197,198.3,0,0,,,
2006,08,b) 1,9393,9512,62126,63715,41,0.4,2886,26,15814,396,15418,0.6,24.8,18991,11110,7881,17.4,29.8,-3177,-5,49.6,0,2160,2160,9479
2006,08,c) 2,7421,7509,51614,52308,377,4.6,1558,19.1,12033,1670,10363,3.2,23,13421,7896,5525,15.1,25.7,-1388,-2.7,46,0,1177,1177,6835
2006,08,d) 3,6432,6572,49783,49826,261,3.7,1228,17.4,10438,1806,8632,3.6,20.9,10524,5435,5089,10.9,21.1,-86,-0.2,41.8,0,920,920,4611
2006,08,e) 4,5821,5982,47335,47220,281,4.5,865,13.7,9015,1554,7461,3.3,19.1,8784,4462,4322,9.4,18.6,231,0.5,37.2,0,651,651,3698
2006,08,f) 5,5321,5516,49807,49502,229,3.9,795,13.7,9626,1080,8546,2.2,19.4,9015,4695,4320,9.5,18.2,611,1.2,36.4,0,550,555,3732
2006,08,g) 6 to 10,20472,21715,217081,218552,950,4.2,2475,11,34292,6217,28075,2.8,15.7,37233,18021,19212,8.2,17,-2941,-1.3,31.4,0,1709,1713,14637
2006,08,h) 11 to 15,12849,13762,162469,160252,581,4.1,1380,9.7,26232,6075,20157,3.8,16.4,21798,8478,13320,5.3,13.6,4434,2.8,27.2,0,904,905,5790
2006,08,i) 16 to 20,8463,10158,175297,175617,490,4.8,763,7.4,22890,6371,16519,3.6,13,23529,6592,16937,3.8,13.4,-639,-0.4,26,0,497,498,3983
2006,08,j) 21 to 25,6540,8626,168032,166352,385,4.4,583,6.7,24067,7779,16288,4.7,14.5,20707,5283,15424,3.2,12.4,3360,2.1,24.8,0,296,303,2970
2006,08,k) 26+,4113,6649,153020,148910,405,6.1,371,5.6,25183,11027,14156,7.4,16.9,16962,4610,12352,3.1,11.4,8221,5.5,22.8,0,184,184,1700
2006,08,l) Left Censored,8350,23034,791523,783434,1804,7.9,1324,5.8,95078,30555,64523,3.9,12.1,78900,21603,57297,2.8,10.1,16178,2,20.2,0,244,244,3073
2006,09,a) 0,5424,5615,32028,16105,5566,198.3,0,0,31847,31847,0,197.7,197.7,0,0,0,0,0,31847,197.7,0,0,,,
2006,09,b) 1,4182,4252,32433,34053,22,0.4,1234,25,7661,250,7411,0.7,22.5,10901,5822,5079,17.1,32,-3240,-9.5,45,0,994,994,4879
2006,09,c) 2,3391,3412,23751,24318,148,4,773,20.7,4931,504,4427,2.1,20.3,6064,3363,2701,13.8,24.9,-1133,-4.6,40.6,0,629,630,2995
2006,09,d) 3,2902,2936,24643,24793,120,3.8,483,15.4,4399,502,3897,2,17.7,4699,2498,2201,10.1,19,-300,-1.3,35.4,0,399,399,2224
2006,09,e) 4,2914,3009,28451,28506,109,3.4,425,13.4,4581,588,3993,2.1,16.1,4690,2338,2352,8.2,16.5,-109,-0.4,32.2,0,351,351,1922
2006,09,f) 5,2559,2622,23517,23444,84,3,366,13.2,4594,1010,3584,4.3,19.6,4447,2180,2267,9.3,19,147,0.6,38,0,284,284,1915
2006,09,g) 6 to 10,11063,11685,134567,135735,409,3.4,1207,10,17386,3057,14329,2.3,12.8,19721,7544,12177,5.6,14.5,-2335,-1.7,25.6,0,925,925,6180
2006,09,h) 11 to 15,8092,8512,94454,93504,281,3.2,695,8,15680,2936,12744,3.1,16.8,13780,5818,7962,6.2,14.7,1900,2.1,29.4,0,491,491,4541
2006,09,i) 16 to 20,7684,8536,132271,132373,302,3.5,666,7.6,13075,2853,10222,2.2,9.9,13278,4294,8984,3.2,10,-203,-0.1,19.8,0,439,439,2548
2006,09,j) 21 to 25,5698,6884,102980,103454,260,3.7,393,5.6,12149,3765,8384,3.6,11.7,13097,4030,9067,3.9,12.7,-948,-1,23.4,0,237,237,1709
2006,09,k) 26+,3600,4965,97282,95785,198,4,265,5.3,12272,4245,8027,4.4,12.8,9278,3073,6205,3.2,9.7,2994,3.1,19.4,0,156,157,1624
2006,09,l) Left Censored,10974,21474,822008,819059,1113,5.2,1217,5.6,82082,24995,57087,3.1,10,76183,18838,57345,2.3,9.3,5899,0.7,18.6,0,399,399,5105
2006,10,a) 0,1672,1688,9811,4943,1665,197.3,0,0,9736,9736,0,197,197,0,0,0,0,0,9736,197,0,0,,,
2006,10,b) 1,1255,1259,7574,8136,4,0.3,350,24.1,2006,12,1994,0.1,24.7,3129,1839,1290,22.6,38.5,-1123,-13.8,49.4,0,273,273,1658
2006,10,c) 2,1108,1115,7921,8171,37,3.1,220,18.2,1462,186,1276,2.3,17.9,1961,998,963,12.2,24,-499,-6.1,35.8,0,166,166,867
2006,10,d) 3,1022,1024,7764,7895,29,2.6,216,19.4,1659,232,1427,2.9,21,1920,618,1302,7.8,24.3,-261,-3.3,42,0,158,158,548
2006,10,e) 4,848,875,7075,7017,19,2,152,16.1,1129,48,1081,0.7,16.1,1012,437,575,6.2,14.4,117,1.7,28.8,0,103,103,350
2006,10,f) 5,820,826,6157,5990,36,4.1,140,15.9,1199,219,980,3.7,20,865,456,409,7.6,14.4,334,5.6,28.8,0,90,90,342
2006,10,g) 6 to 10,3111,3253,31511,32262,111,3.2,457,13.3,4329,572,3757,1.8,13.4,5831,2747,3084,8.5,18.1,-1502,-4.7,26.8,0,315,315,2293
2006,10,h) 11 to 15,2012,2188,26048,25934,77,3.4,209,9.3,3418,534,2884,2.1,13.2,3190,1176,2014,4.5,12.3,228,0.9,24.6,0,143,143,969
2006,10,i) 16 to 20,1641,1850,25265,25835,74,3.9,134,7.1,3571,1572,1999,6.1,13.8,4710,2603,2107,10.1,18.2,-1139,-4.4,27.6,0,82,82,305
2006,10,j) 21 to 25,1144,1404,28863,28798,62,4.3,101,7.1,3223,544,2679,1.9,11.2,3093,1021,2072,3.5,10.7,130,0.5,21.4,0,53,53,570
2006,10,k) 26+,778,1113,27277,29907,53,4.7,74,6.6,3796,1748,2048,5.8,12.7,9055,6569,2486,22,30.3,-5259,-17.6,25.4,0,31,31,857
2006,10,l) Left Censored,2756,5827,196972,199817,386,6.6,359,6.2,20777,5728,15049,2.9,10.4,26467,6222,20245,3.1,13.2,-5690,-2.8,20.8,0,79,95,740
2006,11,a) 0,1174,1185,8079,4061,1178,198.8,0,0,8037,8037,0,197.9,197.9,0,0,0,0,0,8037,197.9,0,0,,,
2006,11,b) 1,1210,1210,9145,9227,4,0.3,257,19,2294,20,2274,0.2,24.9,2458,1360,1098,14.7,26.6,-164,-1.7,49.8,0,198,198,1035
2006,11,c) 2,420,420,4066,4207,22,5,57,12.9,1071,115,956,2.7,25.5,1353,1034,319,24.6,32.2,-282,-6.7,51,0,46,46,212
2006,11,d) 3,591,607,5633,5443,26,4.1,72,11.3,1138,203,935,3.7,20.9,758,245,513,4.5,13.9,380,7,27.8,0,57,57,187
2006,11,e) 4,679,694,8461,9202,27,3.8,72,10.1,990,71,919,0.8,10.8,2471,1306,1165,14.2,26.9,-1481,-16.1,21.6,0,55,55,808
2006,11,f) 5,581,599,8615,8657,16,2.5,75,11.9,1149,65,1084,0.8,13.3,1232,663,569,7.7,14.2,-83,-0.9,26.6,0,48,48,566
2006,11,g) 6 to 10,2432,2582,39108,39064,90,3.4,212,8,5494,727,4767,1.9,14.1,5406,1509,3897,3.9,13.8,88,0.3,27.6,0,150,150,1044
2006,11,h) 11 to 15,1705,1815,33686,33643,66,3.6,141,7.6,4001,853,3148,2.5,11.9,3915,1293,2622,3.8,11.6,86,0.3,23.2,0,107,107,817
2006,11,i) 16 to 20,1449,1654,27820,28557,59,3.5,159,9.3,3277,445,2832,1.6,11.5,4751,2087,2664,7.3,16.6,-1474,-5.1,23,0,83,89,1327
2006,11,j) 21 to 25,1360,1620,32928,32220,57,3.5,98,6,3729,1032,2697,3.2,11.6,2312,469,1843,1.5,7.2,1417,4.4,14.4,0,57,57,242
2006,11,k) 26+,870,1167,49022,46089,91,7.8,77,6.6,8629,1380,7249,3,18.7,2762,827,1935,1.8,6,5867,12.7,12,0,25,25,145
2006,11,l) Left Censored,3111,5802,224156,225991,455,7.9,307,5.4,26262,7271,18991,3.2,11.6,29932,4195,25737,1.9,13.2,-3670,-1.6,23.2,0,57,57,723
2006,12,a) 0,50249,50740,284834,143190,50294,198.2,0,0,283289,283289,0,197.8,197.8,0,0,0,0,0,283289,197.8,0,0,,,
2006,12,b) 1,36848,37316,244151,252883,188,0.4,12011,27.3,65729,2620,63109,1,26,83193,48042,35151,19,32.9,-17464,-6.9,52,0,9478,9478,40337
2006,12,c) 2,32024,32311,216577,221352,1229,3.5,6355,18.1,46937,6123,40814,2.8,21.2,56486,30967,25519,14,25.5,-9549,-4.3,42.4,0,4999,4999,26904
2006,12,d) 3,23312,23587,200217,200842,935,3.7,4160,16.4,40338,5193,35145,2.6,20.1,41587,23078,18509,11.5,20.7,-1249,-0.6,40.2,0,3251,3262,18742
2006,12,e) 4,19341,19852,181978,182479,781,3.7,2922,13.9,32931,4237,28694,2.3,18,33932,14727,19205,8.1,18.6,-1001,-0.6,36,0,2250,2254,11986
2006,12,f) 5,16475,16956,169675,170108,644,3.6,2366,13.3,28997,3732,25265,2.2,17,29865,12236,17629,7.2,17.6,-868,-0.6,34,0,1815,1818,10016
2006,12,g) 6 to 10,61802,65990,703087,705967,2566,3.7,7432,10.8,112353,17086,95267,2.4,15.9,118113,53327,64786,7.6,16.7,-5760,-0.8,31.8,0,5419,5423,38259
2006,12,h) 11 to 15,40458,43930,653310,645311,1603,3.5,4012,8.9,111730,18320,93410,2.8,17.3,95731,42187,53544,6.5,14.8,15999,2.5,29.6,0,2872,2896,34151
2006,12,i) 16 to 20,29155,34941,635699,630030,1583,4.5,2623,7.4,86955,21314,65641,3.4,13.8,75616,25368,50248,4,12,11339,1.8,24,0,1762,1763,14549
2006,12,j) 21 to 25,19749,25808,518061,512548,1094,4.2,1695,6.5,65722,16584,49138,3.2,12.8,54695,19749,34946,3.9,10.7,11027,2.1,21.4,0,1063,1067,8262
2006,12,k) 26+,10772,18360,420415,416083,996,5.4,1311,7.1,57940,20923,37017,5,13.9,49275,14195,35080,3.4,11.8,8665,2.1,23.6,0,590,596,4620
2006,12,l) Left Censored,20710,74552,2887938,2821321,5837,7.9,4437,6,418912,110751,308161,3.9,14.8,285678,73907,211771,2.6,10.1,133234,4.7,20.2,0,827,830,10098
2006,13,a) 0,18153,18401,119276,59803,18266,198.5,0,0,118947,118947,0,198.9,198.9,0,0,0,0,0,118947,198.9,0,0,,,
2006,13,b) 1,13369,13580,105311,107965,80,0.5,3873,24.7,28160,1093,27067,1,26.1,33468,22026,11442,20.4,31,-5308,-4.9,52.2,0,3046,3047,18647
2006,13,c) 2,10838,11010,93930,94542,386,3.2,2201,18.4,20676,1619,19057,1.7,21.9,21899,12978,8921,13.7,23.2,-1223,-1.3,43.8,0,1718,1723,10357
2006,13,d) 3,9120,9261,75946,77246,321,3.2,1561,15.8,15914,1827,14087,2.4,20.6,18513,9492,9021,12.3,24,-2599,-3.4,41.2,0,1213,1213,8295
2006,13,e) 4,8132,8424,92710,88640,361,4.1,1236,13.9,21961,6617,15344,7.5,24.8,13820,5886,7934,6.6,15.6,8141,9.2,31.2,0,924,924,4803
2006,13,f) 5,7248,7543,85222,84008,296,3.7,970,12.3,15684,1923,13761,2.3,18.7,13256,5514,7742,6.6,15.8,2428,2.9,31.6,0,728,728,4556
2006,13,g) 6 to 10,28860,30993,363790,361744,1207,3.8,3289,10.2,61422,12198,49224,3.4,17,57330,23370,33960,6.5,15.8,4092,1.2,31.6,0,2439,2439,18770
2006,13,h) 11 to 15,17567,19398,263526,261591,748,3.8,1676,8.4,40115,8279,31836,3.2,15.3,36244,13629,22615,5.2,13.9,3871,1.4,27.8,0,1151,1151,8446
2006,13,i) 16 to 20,12372,15243,291872,291875,694,4.5,1187,7.7,36002,10333,25669,3.5,12.3,36008,12815,23193,4.4,12.3,-6,0,24.6,0,737,737,7115
2006,13,j) 21 to 25,9766,12493,232631,230527,506,4,770,6.1,31754,8177,23577,3.5,13.8,27546,7166,20380,3.1,11.9,4208,1.9,23.8,0,441,441,4177
2006,13,k) 26+,5646,9577,258280,253905,599,6.2,647,6.7,34696,14640,20056,5.8,13.7,25945,8879,17066,3.5,10.2,8751,3.5,20.4,0,262,266,2289
2006,13,l) Left Censored,13548,42237,1619829,1613648,3010,7.2,2380,5.7,195233,61894,133339,3.8,12.1,182870,52596,130274,3.3,11.3,12363,0.8,22.6,0,493,499,11163
2006,15,a) 0,2103,2161,15114,7580,2144,198.4,0,0,15068,,,,198.8,0,0,0,0,0,15068,198.8,0,1,,,
2006,15,b) 1,1583,1591,14458,14359,2,0.1,399,22,3409,,,,23.7,3211,1632,1579,11.4,22.4,198,1.3,44.8,1,338,338,1476
2006,15,c) 2,1359,1397,12005,11874,45,3,236,15.7,2367,193,2174,1.6,19.9,2104,967,1137,8.1,17.7,263,2.2,35.4,0,195,195,848
2006,15,d) 3,1198,1277,13514,13158,42,3.1,164,12.2,2538,300,2238,2.3,19.3,1826,820,1006,6.2,13.9,712,5.4,27.8,0,134,134,741
2006,15,e) 4,1101,1144,11599,11149,38,3.2,128,10.8,2242,276,1966,2.5,20.1,1342,439,903,3.9,12,900,8.1,24,0,93,93,343
2006,15,f) 5,938,976,9511,9668,30,2.9,116,11.4,1262,208,1054,2.2,13.1,1575,742,833,7.7,16.3,-313,-3.2,26.2,0,90,90,681
2006,15,g) 6 to 10,3776,4051,44986,44634,137,3.3,346,8.3,7597,713,6884,1.6,17,6892,2487,4405,5.6,15.4,705,1.6,30.8,0,252,252,2022
2006,15,h) 11 to 15,2741,2956,38961,39404,114,3.8,196,6.5,5145,1393,3752,3.5,13.1,6032,1954,4078,5,15.3,-887,-2.2,26.2,0,151,151,1214
2006,15,i) 16 to 20,2323,2741,40917,40917,115,4.1,161,5.8,5095,1937,3158,4.7,12.5,5094,2186,2908,5.3,12.4,1,0.1,24.8,0,87,87,607
2006,15,j) 21 to 25,1961,2532,44974,44869,98,3.9,117,4.6,5332,2000,3332,4.5,11.9,5121,1750,3371,3.9,11.4,211,0.5,22.8,0,70,70,798
2006,15,k) 26+,1426,2061,38155,36762,89,4.3,84,4.1,5791,1190,4601,3.2,15.8,3005,1101,1904,3,8.2,2786,7.6,16.4,0,49,49,600
2006,15,l) Left Censored,3234,7147,226230,223985,439,6.2,311,4.4,22050,5780,16270,2.6,9.8,17560,3713,13847,1.7,7.8,4490,2,15.6,0,81,81,1104
2006,16,a) 0,4666,4734,23148,11635,4678,197.6,0,0,23027,23027,0,197.9,197.9,0,0,0,0,0,23027,197.9,0,0,,,
2006,16,b) 1,2948,2963,18994,18825,8,0.2,837,24.4,6190,22,6168,0.1,32.9,5852,3715,2137,19.7,31.1,338,1.8,62.2,0,609,609,2660
2006,16,c) 2,2246,2269,16881,17681,93,3.8,436,17.9,3325,340,2985,1.9,18.8,4925,2917,2008,16.5,27.9,-1600,-9.1,37.6,0,325,325,1474
2006,16,d) 3,1869,1918,14967,15056,97,4.8,287,14.3,3046,519,2527,3.4,20.2,3224,1685,1539,11.2,21.4,-178,-1.2,40.4,0,208,208,1419
2006,16,e) 4,1638,1675,20518,20541,60,3.4,246,13.9,2984,245,2739,1.2,14.5,3030,1810,1220,8.8,14.8,-46,-0.3,29,0,181,181,1527
2006,16,f) 5,1529,1598,13396,14018,59,3.6,164,9.9,2411,171,2240,1.2,17.2,3655,941,2714,6.7,26.1,-1244,-8.9,34.4,0,121,121,831
2006,16,g) 6 to 10,6070,6425,63317,64591,273,4.1,708,10.7,10127,1522,8605,2.4,15.7,12675,7170,5505,11.1,19.6,-2548,-3.9,31.4,0,448,448,5976
2006,16,h) 11 to 15,3587,3752,37649,37838,140,3.6,389,10,5501,519,4982,1.4,14.5,5878,2352,3526,6.2,15.5,-377,-1,29,0,262,262,1899
2006,16,i) 16 to 20,2369,2784,50540,50107,119,4.2,202,7.2,4971,1168,3803,2.3,9.9,4105,913,3192,1.8,8.2,866,1.7,16.4,0,147,147,791
2006,16,j) 21 to 25,1837,2382,42272,40130,108,4.5,157,6.5,7855,3615,4240,9,19.6,3571,874,2697,2.2,8.9,4284,10.7,17.8,0,99,99,674
2006,16,k) 26+,1262,1789,44774,42998,98,5.4,133,7.4,7678,1390,6288,3.2,17.9,4125,2127,1998,4.9,9.6,3553,8.3,19.2,0,68,68,574
2006,16,l) Left Censored,2951,6778,196380,193091,395,5.9,320,4.7,21654,4863,16791,2.5,11.2,15076,2813,12263,1.5,7.8,6578,3.4,15.6,0,103,105,1165
2006,17,a) 0,20618,20927,130608,65692,20723,198.1,0,0,129832,129832,0,197.6,197.6,0,0,0,0,0,129832,197.6,0,0,,,
2006,17,b) 1,15635,15882,123919,127114,89,0.5,4345,23.8,29468,1143,28325,0.9,23.2,35858,21668,14190,17,28.2,-6390,-5,46.4,0,3275,3275,18067
2006,17,c) 2,13217,13348,102013,103735,527,3.7,2407,16.8,20346,2311,18035,2.2,19.6,23789,11781,12008,11.4,22.9,-3443,-3.3,39.2,0,1861,1861,10148
2006,17,d) 3,11250,11655,110846,108285,500,4.1,1772,14.4,24752,4430,20322,4.1,22.9,19629,8608,11021,7.9,18.1,5123,4.8,36.2,0,1357,1357,7373
2006,17,e) 4,10038,10336,98492,98665,389,3.6,1383,12.7,16865,2242,14623,2.3,17.1,17210,7228,9982,7.3,17.4,-345,-0.3,34.2,0,1000,1000,5913
2006,17,f) 5,9089,9480,87403,87519,342,3.5,1138,11.5,16139,2029,14110,2.3,18.4,16370,8456,7914,9.7,18.7,-231,-0.3,36.8,0,814,814,7147
2006,17,g) 6 to 10,38958,41291,484589,488942,1581,3.7,4403,10.3,78970,17493,61477,3.6,16.2,87676,41178,46498,8.4,17.9,-8706,-1.7,32.4,0,3021,3033,24859
2006,17,h) 11 to 15,27699,29742,379975,379587,1025,3.3,2664,8.7,55708,11922,43786,3.1,14.7,54931,20162,34769,5.3,14.5,777,0.2,29,0,1790,1792,15641
2006,17,i) 16 to 20,21858,25189,437331,437457,966,3.8,1850,7.2,50076,10992,39084,2.5,11.4,50327,16284,34043,3.7,11.5,-251,-0.1,22.8,0,1172,1179,11270
2006,17,j) 21 to 25,17225,21357,439264,435850,701,3.2,1391,6.4,52614,13039,39575,3,12.1,45785,13060,32725,3,10.5,6829,1.6,21,0,848,851,7911
2006,17,k) 26+,10859,16108,364628,365065,588,3.6,945,5.8,40697,12094,28603,3.3,11.1,41570,14889,26681,4.1,11.4,-873,-0.3,22.2,0,544,544,9529
2006,17,l) Left Censored,29863,68330,2584778,2575350,4336,6.3,4230,6.2,293064,90367,202697,3.5,11.4,274208,83565,190643,3.2,10.6,18856,0.8,21.2,0,1143,1150,15514
2006,18,a) 0,9276,9520,67097,33726,9422,197.9,0,0,66742,66742,0,197.9,197.9,0,0,0,0,0,66742,197.9,0,0,,,
2006,18,b) 1,6626,6730,56840,59710,44,0.6,1942,25,13633,688,12945,1.2,22.8,19372,11984,7388,20.1,32.4,-5739,-9.6,45.6,0,1492,1514,10662
2006,18,c) 2,5692,5751,46005,47445,198,3.2,1165,18.6,8556,845,7711,1.8,18,11435,6130,5305,12.9,24.1,-2879,-6.1,36,0,917,917,5046
2006,18,d) 3,4822,4943,48731,47559,195,3.7,831,15.8,13056,1021,12035,2.1,27.5,10712,6023,4689,12.7,22.5,2344,5,45,0,634,634,4001
2006,18,e) 4,4684,4809,48463,49013,166,3.3,657,13,8116,872,7244,1.8,16.6,9216,3923,5293,8,18.8,-1100,-2.2,33.2,0,508,509,3336
2006,18,f) 5,4080,4344,42513,43410,139,3.1,531,11.7,6203,1367,4836,3.1,14.3,7997,2939,5058,6.8,18.4,-1794,-4.1,28.6,0,395,395,2438
2006,18,g) 6 to 10,17585,18972,217922,220434,599,3,1961,10,30716,5372,25344,2.4,13.9,35739,14830,20909,6.7,16.2,-5023,-2.3,27.8,0,1416,1416,12096
2006,18,h) 11 to 15,12859,14015,172846,174479,428,3,1144,7.9,24235,5884,18351,3.4,13.9,27501,9587,17914,5.5,15.8,-3266,-1.9,27.8,0,797,797,5906
2006,18,i) 16 to 20,10096,12320,230673,228463,546,4.4,869,7,29433,9480,19953,4.1,12.9,25012,8052,16960,3.5,10.9,4421,2,21.8,0,547,547,4950
2006,18,j) 21 to 25,8373,10574,191381,190087,368,3.4,655,6.1,22528,6053,16475,3.2,11.9,19940,5253,14687,2.8,10.5,2588,1.4,21,0,364,369,2559
2006,18,k) 26+,5263,8276,178498,176190,311,3.7,473,5.7,22483,6071,16412,3.4,12.8,17866,4878,12988,2.8,10.1,4617,2.7,20.2,0,216,216,2152
2006,18,l) Left Censored,14952,36671,1361145,1355777,2175,6,1851,5.1,138396,37509,100887,2.8,10.2,127661,29005,98656,2.1,9.4,10735,0.8,18.8,0,479,484,7507
2006,19,a) 0,4751,4977,28528,14317,4932,198.2,0,0,28422,28422,0,198.5,198.5,0,0,0,0,0,28422,198.5,0,0,,,
2006,19,b) 1,3487,3527,28488,29159,22,0.5,938,23.2,6102,294,5808,1,20.9,7443,4081,3362,14,25.5,-1341,-4.6,41.8,0,693,693,3503
2006,19,c) 2,2941,2989,21064,21485,118,3.7,525,16.4,4074,482,3592,2.2,19,4916,2370,2546,11,22.9,-842,-3.9,38,0,397,397,2124
2006,19,d) 3,2536,2634,21146,21543,108,3.8,449,15.9,3410,557,2853,2.6,15.8,4204,1930,2274,9,19.5,-794,-3.7,31.6,0,324,324,1583
2006,19,e) 4,2322,2434,27778,27606,85,3.3,346,13.5,4253,328,3925,1.2,15.4,3908,1803,2105,6.5,14.2,345,1.2,28.4,0,236,236,1481
2006,19,f) 5,2075,2161,19486,19508,63,2.8,278,12.2,2793,505,2288,2.6,14.3,2837,1277,1560,6.5,14.5,-44,-0.2,28.6,0,186,186,1030
2006,19,g) 6 to 10,9103,9767,99838,100241,379,3.7,1172,11.5,14462,2016,12446,2,14.4,15267,6149,9118,6.1,15.2,-805,-0.8,28.8,0,754,754,5224
2006,19,h) 11 to 15,6799,7297,76831,76930,276,3.7,762,10.1,11302,3047,8255,4,14.7,11499,4296,7203,5.6,14.9,-197,-0.2,29.4,0,471,471,3232
2006,19,i) 16 to 20,5171,6128,103611,103545,255,4.1,488,7.8,10717,3058,7659,3,10.4,10585,3805,6780,3.7,10.2,132,0.2,20.4,0,313,313,2924
2006,19,j) 21 to 25,4791,6069,91712,91715,248,4,424,6.9,8506,2591,5915,2.8,9.3,8511,2249,6262,2.5,9.3,-5,0,18.6,0,200,200,1213
2006,19,k) 26+,3469,5793,93413,90922,297,5.1,277,4.8,14243,7152,7091,7.9,15.7,9261,2941,6320,3.2,10.2,4982,5.5,20.4,0,174,174,1382
2006,19,l) Left Censored,10094,20373,676109,672019,965,4.7,964,4.7,63647,17090,46557,2.5,9.5,55467,11543,43924,1.7,8.3,8180,1.2,16.6,0,361,361,3736
2006,20,a) 0,4735,4821,27537,13824,4774,198.1,0,0,27426,27426,0,198.4,198.4,0,0,0,0,0,27426,198.4,0,0,,,
2006,20,b) 1,3562,3599,27651,27664,21,0.5,1097,26.2,8340,240,8100,0.9,30.1,8366,5652,2714,20.4,30.2,-26,-0.1,60.2,0,842,842,4800
2006,20,c) 2,3069,3112,23283,24071,106,3.2,563,16.8,4409,555,3854,2.3,18.3,5984,2678,3306,11.1,24.9,-1575,-6.6,36.6,0,434,434,2303
2006,20,d) 3,2639,2684,25541,25416,91,3.2,495,17.1,5030,570,4460,2.2,19.8,4780,2625,2155,10.3,18.8,250,1,37.6,0,385,385,2241
2006,20,e) 4,2398,2478,23400,23542,84,3.2,409,15.4,3689,467,3222,2,15.7,3973,2083,1890,8.8,16.9,-284,-1.2,31.4,0,309,309,1724
2006,20,f) 5,2202,2270,20249,20043,81,3.4,309,12.9,3471,288,3183,1.4,17.3,3058,1418,1640,7.1,15.3,413,2,30.6,0,240,240,1280
2006,20,g) 6 to 10,9359,9995,112907,112044,326,3.1,1116,10.7,15923,2940,12983,2.6,14.2,14197,5402,8795,4.8,12.7,1726,1.5,25.4,0,750,750,3946
2006,20,h) 11 to 15,6314,6797,81607,80873,245,3.5,618,8.8,12236,4110,8126,5.1,15.1,10767,4047,6720,5,13.3,1469,1.8,26.6,0,403,403,2466
2006,20,i) 16 to 20,4792,5645,83236,84432,240,4.2,448,7.8,10016,2469,7547,2.9,11.9,12408,3162,9246,3.7,14.7,-2392,-2.8,23.8,0,281,287,2305
2006,20,j) 21 to 25,4391,5356,78695,77414,193,3.5,391,7.2,9226,2308,6918,3,11.9,6664,1935,4729,2.5,8.6,2562,3.3,17.2,0,208,208,1010
2006,20,k) 26+,2892,4566,89590,89483,177,3.8,298,6.4,10972,4184,6788,4.7,12.3,10758,3023,7735,3.4,12,214,0.3,24,0,128,129,1390
2006,20,l) Left Censored,8166,17500,539321,541263,955,5.5,860,4.9,49989,13206,36783,2.4,9.2,53873,13333,40540,2.5,10,-3884,-0.8,18.4,0,253,269,3213
2006,21,a) 0,5681,5830,40075,20287,5792,198.7,0,0,39577,39577,0,195.1,195.1,0,0,0,0,0,39577,195.1,0,0,,,
2006,21,b) 1,4454,4515,35638,37855,33,0.6,1247,24.1,9359,696,8663,1.8,24.7,13792,8542,5250,22.6,36.4,-4433,-11.7,49.4,0,1036,1036,7644
2006,21,c) 2,3650,3697,28635,30187,106,2.6,731,18.2,4978,402,4576,1.3,16.5,8081,4855,3226,16.1,26.8,-3103,-10.3,33,0,609,609,3882
2006,21,d) 3,2999,3077,27718,27851,130,4,528,16.1,5442,687,4755,2.5,19.5,5707,2746,2961,9.9,20.5,-265,-1,39,0,431,431,2073
2006,21,e) 4,2784,2868,28529,29152,95,3.1,385,12.7,4326,426,3900,1.5,14.8,5572,2305,3267,7.9,19.1,-1246,-4.3,29.6,0,324,324,1947
2006,21,f) 5,2652,2737,23870,24554,70,2.4,349,12.1,3668,549,3119,2.2,14.9,5036,2335,2701,9.5,20.5,-1368,-5.6,29.8,0,275,275,1925
2006,21,g) 6 to 10,11234,12238,129585,130426,396,3.1,1228,9.7,18088,3136,14952,2.4,13.9,19769,7930,11839,6.1,15.2,-1681,-1.3,27.8,0,902,902,6467
2006,21,h) 11 to 15,7906,8724,107873,107270,303,3.4,792,8.8,16380,3611,12769,3.4,15.3,15174,6573,8601,6.1,14.1,1206,1.2,28.2,0,572,572,5370
2006,21,i) 16 to 20,6433,7715,141908,141978,292,3.7,520,6.6,15912,4092,11820,2.9,11.2,16052,5264,10788,3.7,11.3,-140,-0.1,22.4,0,346,347,3742
2006,21,j) 21 to 25,5267,6412,110363,110174,218,3.3,422,6.5,13714,2425,11289,2.2,12.4,13335,4298,9037,3.9,12.1,379,0.3,24.2,0,250,250,1723
2006,21,k) 26+,3084,5073,110717,109468,253,5,310,6.1,14967,5223,9744,4.8,13.7,12469,3945,8524,3.6,11.4,2498,2.3,22.8,0,136,139,1730
2006,21,l) Left Censored,8895,21688,750958,746579,1163,5.4,1000,4.6,79605,20554,59051,2.8,10.7,70846,16152,54694,2.2,9.5,8759,1.2,19,0,309,309,4625
2006,22,a) 0,6366,6527,49516,24829,6467,198.2,0,0,49375,49375,0,198.9,198.9,0,0,0,0,0,49375,198.9,0,0,,,
2006,22,b) 1,4612,4692,40326,41049,33,0.6,1521,27.4,11837,195,11642,0.5,28.8,13283,8801,4482,21.4,32.4,-1446,-3.6,57.6,0,1206,1206,7701
2006,22,c) 2,3944,4020,36233,37757,165,3.7,989,22.1,8118,1304,6814,3.5,21.5,11165,6142,5023,16.3,29.6,-3047,-8.1,43,0,777,777,5141
2006,22,d) 3,3439,3510,34794,35649,107,2.8,757,19.5,7618,791,6827,2.2,21.4,9327,4303,5024,12.1,26.2,-1709,-4.8,42.8,0,561,561,3378
2006,22,e) 4,3189,3308,36874,36998,109,3,628,17.5,7963,1368,6595,3.7,21.5,8211,4150,4061,11.2,22.2,-248,-0.7,43,0,452,452,3096
2006,22,f) 5,2911,3029,32077,33759,89,2.7,505,15.5,5217,687,4530,2,15.5,8580,3628,4952,10.7,25.4,-3363,-9.9,31,0,370,371,2931
2006,22,g) 6 to 10,12063,12910,158064,162819,431,3.1,1934,14,25816,4834,20982,3,15.9,35326,13611,21715,8.4,21.7,-9510,-5.8,31.8,0,1344,1344,9468
2006,22,h) 11 to 15,8627,9477,121448,126382,284,2.8,1277,12.7,17305,2590,14715,2,13.7,27172,9555,17617,7.6,21.5,-9867,-7.8,27.4,0,837,837,6116
2006,22,i) 16 to 20,6248,7521,141432,143415,289,3.7,828,10.6,18594,2876,15718,2,13,22560,6075,16485,4.2,15.7,-3966,-2.7,26,0,502,504,3669
2006,22,j) 21 to 25,6309,7850,125352,129271,292,3.6,740,9.1,16565,4133,12432,3.2,12.8,24402,6119,18283,4.7,18.9,-7837,-6.1,25.6,0,419,419,3405
2006,22,k) 26+,3892,5750,116925,117139,224,3.8,544,9.2,19629,6341,13288,5.4,16.8,20057,5554,14503,4.7,17.1,-428,-0.3,33.6,0,248,248,1403
2006,22,l) Left Censored,9251,22269,673723,683680,1437,6.4,1844,8.2,86557,24784,61773,3.6,12.7,106470,27488,78982,4,15.6,-19913,-2.9,25.4,0,537,540,5436
2006,23,a) 0,2901,2983,15412,7720,2963,198.7,0,0,15385,15385,0,199.3,199.3,0,0,0,0,0,15385,199.3,0,0,,,
2006,23,b) 1,1998,2006,10827,11181,5,0.2,664,28.1,2610,45,2565,0.4,23.3,3317,2183,1134,19.5,29.7,-707,-6.4,46.6,0,495,495,1774
2006,23,c) 2,1723,1730,11356,11355,70,3.7,352,18.7,2247,531,1716,4.7,19.8,2244,1007,1237,8.9,19.8,3,0,39.6,0,275,275,868
2006,23,d) 3,1391,1413,12124,12603,61,4,254,16.8,1789,204,1585,1.6,14.2,2746,1197,1549,9.5,21.8,-957,-7.6,28.4,0,195,195,1052
2006,23,e) 4,1434,1474,10827,11057,48,3.1,198,12.7,1646,280,1366,2.5,14.9,2105,905,1200,8.2,19,-459,-4.1,29.8,0,149,149,817
2006,23,f) 5,1363,1402,9813,9982,60,4.1,168,11.5,1380,108,1272,1.1,13.8,1718,610,1108,6.1,17.2,-338,-3.4,27.6,0,117,117,465
2006,23,g) 6 to 10,5452,5791,48004,48625,205,3.4,654,10.9,6589,826,5763,1.7,13.6,7830,3450,4380,7.1,16.1,-1241,-2.5,27.2,0,458,463,2518
2006,23,h) 11 to 15,3504,3787,36288,36282,145,3.7,319,8.2,4929,1465,3464,4,13.6,4916,1442,3474,4,13.5,13,0.1,27,0,219,219,1130
2006,23,i) 16 to 20,3158,3584,48124,48131,147,4,276,7.6,5286,1205,4081,2.5,11,5300,1659,3641,3.4,11,-14,0,22,0,183,183,985
2006,23,j) 21 to 25,2194,2755,41948,41795,107,3.8,195,7,4025,1042,2983,2.5,9.6,3718,1089,2629,2.6,8.9,307,0.7,17.8,0,122,122,758
2006,23,k) 26+,1418,2221,33529,34367,81,3.6,128,5.7,3638,1228,2410,3.6,10.6,5313,2917,2396,8.5,15.5,-1675,-4.9,21.2,0,71,71,542
2006,23,l) Left Censored,3611,7302,221443,220740,337,4.6,325,4.5,20287,7643,12644,3.5,9.2,18881,5254,13627,2.4,8.6,1406,0.6,17.2,0,133,133,3170
2006,24,a) 0,9899,10088,61123,30686,10002,198.3,0,0,60874,60874,0,198.4,198.4,0,0,0,0,0,60874,198.4,0,0,,,
2006,24,b) 1,7358,7432,51675,51342,21,0.2,2061,24.1,14575,136,14439,0.3,28.4,13909,8557,5352,16.7,27.1,666,1.3,54.2,0,1585,1585,6950
2006,24,c) 2,6169,6238,46028,48000,224,3.3,1160,17.2,9741,848,8893,1.8,20.3,13684,7963,5721,16.6,28.5,-3943,-8.2,40.6,0,868,868,6890
2006,24,d) 3,5213,5307,48100,48159,191,3.4,844,14.9,9241,925,8316,1.9,19.2,9359,4018,5341,8.3,19.4,-118,-0.2,38.4,0,654,655,3179
2006,24,e) 4,4982,5095,51572,51284,161,3,657,12.2,9049,1395,7654,2.7,17.6,8472,3947,4525,7.7,16.5,577,1.1,33,0,485,485,3079
2006,24,f) 5,4354,4483,42570,42430,166,3.5,574,12.2,7070,963,6107,2.3,16.7,6790,3142,3648,7.4,16,280,0.7,32,0,436,436,2734
2006,24,g) 6 to 10,17736,18949,215174,213445,726,3.7,1860,9.5,35446,6496,28950,3,16.6,31987,11730,20257,5.5,15,3459,1.6,30,0,1303,1303,8419
2006,24,h) 11 to 15,12099,13075,172224,172292,407,3,1062,7.9,23870,5189,18681,3,13.9,24006,6966,17040,4,13.9,-136,0,27.8,0,726,732,3862
2006,24,i) 16 to 20,10164,11807,213163,213341,476,4,858,7.1,26644,7147,19497,3.4,12.5,27000,9479,17521,4.4,12.7,-356,-0.2,25,0,555,555,7171
2006,24,j) 21 to 25,6963,8772,149902,149520,318,3.6,503,5.7,18364,3170,15194,2.1,12.3,17599,5005,12594,3.3,11.8,765,0.5,23.6,0,302,302,2253
2006,24,k) 26+,4089,6217,149252,148028,265,4.2,396,6.3,17029,5612,11417,3.8,11.5,14581,4664,9917,3.2,9.9,2448,1.6,19.8,0,190,192,1442
2006,24,l) Left Censored,11063,27233,1017334,1010756,1727,6.4,1443,5.3,118086,35150,82936,3.5,11.7,104932,32240,72692,3.2,10.4,13154,1.3,20.8,0,426,434,5608
2006,25,a) 0,11053,11177,62563,31363,11085,198.4,0,0,62400,62400,0,199,199,0,0,0,0,0,62400,199,0,0,,,
2006,25,b) 1,8193,8275,54838,56201,43,0.5,2265,23.9,13290,589,12701,1,23.6,16015,9571,6444,17,28.5,-2725,-4.9,47.2,0,1712,1712,8239
2006,25,c) 2,6902,6984,56053,53604,282,3.8,1232,16.4,14887,6070,8817,11.3,27.8,9988,5109,4879,9.5,18.6,4899,9.2,37.2,0,971,971,4421
2006,25,d) 3,5956,6053,48615,49498,230,3.6,996,15.4,9020,1101,7919,2.2,18.2,10785,6174,4611,12.5,21.8,-1765,-3.6,36.4,0,776,776,5642
2006,25,e) 4,5665,5826,57857,57799,227,3.7,792,13,10137,1674,8463,2.9,17.5,10020,4489,5531,7.8,17.3,117,0.2,34.6,0,627,627,3953
2006,25,f) 5,5185,5348,50368,50990,168,3,630,11.3,7854,1165,6689,2.3,15.4,9097,3674,5423,7.2,17.8,-1243,-2.4,30.8,0,507,509,3292
2006,25,g) 6 to 10,21819,22946,246054,248080,792,3.3,2420,10.2,35815,4917,30898,2,14.4,39866,18234,21632,7.4,16.1,-4051,-1.7,28.8,0,1774,1774,13708
2006,25,h) 11 to 15,14778,15766,199211,199944,483,3,1308,8.1,26875,5132,21743,2.6,13.4,28341,10921,17420,5.5,14.2,-1466,-0.8,26.8,0,935,936,7419
2006,25,i) 16 to 20,13400,15603,280351,276673,583,3.7,1046,6.6,34081,8179,25902,3,12.3,26724,8224,18500,3,9.7,7357,2.6,19.4,0,665,665,4862
2006,25,j) 21 to 25,9995,12631,266372,263953,551,4.3,711,5.6,31212,12291,18921,4.7,11.8,26374,9907,16467,3.8,10,4838,1.8,20,0,434,434,4994
2006,25,k) 26+,6033,9101,229647,228572,355,3.9,488,5.3,23766,7379,16387,3.2,10.4,21615,5625,15990,2.5,9.5,2151,0.9,19,0,279,279,2418
2006,25,l) Left Censored,18538,38258,1502011,1495382,2149,5.6,2086,5.5,179228,56307,122921,3.8,12,165971,40519,125452,2.7,11.1,13257,0.9,22.2,0,633,637,7877
2006,26,a) 0,14304,14379,105034,52898,14258,198.3,0,0,104272,104272,0,197.1,197.1,0,0,0,0,0,104272,197.1,0,0,,,
2006,26,b) 1,10789,10942,102002,103775,63,0.5,3345,26.2,24576,562,24014,0.5,23.7,28122,16722,11400,16.1,27.1,-3546,-3.4,47.4,0,2576,2576,14278
2006,26,c) 2,9022,9111,97349,99974,333,3.4,1891,19,17512,1906,15606,1.9,17.5,22762,10606,12156,10.6,22.8,-5250,-5.3,35,0,1448,1448,8743
2006,26,d) 3,7872,8048,77729,81599,296,3.4,1456,16.9,11232,969,10263,1.2,13.8,18971,8858,10113,10.9,23.2,-7739,-9.4,27.6,0,1113,1113,7562
2006,26,e) 4,7519,7711,102956,105999,246,3,1186,14.4,12827,1984,10843,1.9,12.1,18913,9023,9890,8.5,17.8,-6086,-5.7,24.2,0,929,929,7531
2006,26,f) 5,6474,6765,60079,61621,259,3.6,1038,14.5,8722,1008,7714,1.6,14.2,11805,4910,6895,8,19.2,-3083,-5,28.4,0,777,777,4060
2006,26,g) 6 to 10,28520,30310,323946,331204,1107,3.5,3578,11.3,41438,6328,35110,1.9,12.5,55954,21361,34593,6.4,16.9,-14516,-4.4,25,0,2554,2559,17749
2006,26,h) 11 to 15,20712,22452,253306,258082,715,3.1,1988,8.6,28855,5169,23686,2,11.2,38407,10763,27644,4.2,14.9,-9552,-3.7,22.4,0,1325,1337,7536
2006,26,i) 16 to 20,16786,19786,317036,318644,711,3.5,1492,7.4,39897,10433,29464,3.3,12.5,43113,14050,29063,4.4,13.5,-3216,-1,25,0,958,958,9320
2006,26,j) 21 to 25,13021,16598,283740,283514,530,3.1,991,5.9,32252,5509,26743,1.9,11.4,31800,8150,23650,2.9,11.2,452,0.2,22.4,0,589,592,3505
2006,26,k) 26+,8151,11655,219156,218793,370,3.1,660,5.6,26081,8464,17617,3.9,11.9,25355,5797,19558,2.6,11.6,726,0.3,23.2,0,395,400,2763
2006,26,l) Left Censored,21527,51285,1829740,1830132,2999,5.9,2478,4.9,200115,50706,149409,2.8,10.9,200899,45597,155302,2.5,11,-784,-0.1,21.8,0,786,797,8114
2006,27,a) 0,9804,10122,64609,32436,10002,197.6,0,0,64346,64346,0,198.4,198.4,0,0,0,0,0,64346,198.4,0,0,,,
2006,27,b) 1,7183,7286,53410,56134,36,0.4,2151,25.4,12018,408,11610,0.7,21.4,17465,9974,7491,17.8,31.1,-5447,-9.7,42.8,0,1544,1544,8423
2006,27,c) 2,6221,6289,44725,46969,293,4.3,1251,18.4,8114,1351,6763,2.9,17.3,12601,8113,4488,17.3,26.8,-4487,-9.5,34.6,0,908,908,5082
2006,27,d) 3,5502,5614,44862,45695,289,4.9,900,15.1,8516,1634,6882,3.6,18.6,10181,5956,4225,13,22.3,-1665,-3.7,37.2,0,644,644,5090
2006,27,e) 4,5034,5178,48003,49041,227,4.2,743,13.6,7295,786,6509,1.6,14.9,9370,4415,4955,9,19.1,-2075,-4.2,29.8,0,513,513,2855
2006,27,f) 5,4535,4697,42060,42440,204,4.2,605,12.3,6214,884,5330,2.1,14.6,6973,3241,3732,7.6,16.4,-759,-1.8,29.2,0,415,415,2621
2006,27,g) 6 to 10,18922,20322,221931,223220,830,4,2051,9.8,29201,5407,23794,2.4,13.1,31778,12860,18918,5.8,14.2,-2577,-1.1,26.2,0,1337,1342,9730
2006,27,h) 11 to 15,12842,14012,168229,169388,547,3.8,1224,8.5,24729,5869,18860,3.5,14.6,27047,11247,15800,6.6,16,-2318,-1.4,29.2,0,775,775,7266
2006,27,i) 16 to 20,9491,11268,201365,199732,364,3.2,810,7,24548,4356,20192,2.2,12.3,21282,6037,15245,3,10.7,3266,1.6,21.4,0,512,513,4845
2006,27,j) 21 to 25,7267,9501,194943,195226,308,3.2,594,6.1,18063,4102,13961,2.1,9.3,18628,5416,13212,2.8,9.5,-565,-0.2,18.6,0,332,334,3503
2006,27,k) 26+,4906,7313,165417,164816,315,4.3,456,6.2,16997,3837,13160,2.3,10.3,15795,4564,11231,2.8,9.6,1202,0.7,19.2,0,229,229,1554
2006,27,l) Left Censored,13436,30239,1228740,1221204,1737,5.8,1342,4.5,137450,37096,100354,3,11.3,122378,29795,92583,2.4,10,15072,1.3,20,0,395,396,5745
2006,28,a) 0,3969,4062,30171,15147,4018,197.8,0,0,30048,30048,0,198.4,198.4,0,0,0,0,0,30048,198.4,0,0,,,
2006,28,b) 1,2807,2846,24240,24580,18,0.5,1003,29.6,8044,484,7560,2,32.7,8723,6169,2554,25.1,35.5,-679,-2.8,65.4,0,808,808,5128
2006,28,c) 2,2397,2442,18890,19796,90,3.4,520,19.4,4141,474,3667,2.4,20.9,5953,2319,3634,11.7,30.1,-1812,-9.2,41.8,0,415,415,1922
2006,28,d) 3,2158,2193,18956,19748,66,2.8,423,17.7,3016,351,2665,1.8,15.3,4600,2337,2263,11.8,23.3,-1584,-8,30.6,0,333,333,2091
2006,28,e) 4,1892,1951,21111,21042,62,3,334,16,4318,431,3887,2,20.5,4179,1977,2202,9.4,19.9,139,0.6,39.8,0,270,270,1471
2006,28,f) 5,1753,1817,18476,18644,59,3.1,273,14.2,2897,555,2342,3,15.5,3232,1466,1766,7.9,17.3,-335,-1.8,31,0,211,211,1188
2006,28,g) 6 to 10,7220,7780,77949,80270,251,3.1,1000,12.2,10845,1432,9413,1.8,13.5,15487,6002,9485,7.5,19.3,-4642,-5.8,27,0,711,711,4117
2006,28,h) 11 to 15,4910,5449,69177,69614,180,3.2,607,10.7,9621,1828,7793,2.6,13.8,10494,3785,6709,5.4,15.1,-873,-1.3,27.6,0,432,432,2703
2006,28,i) 16 to 20,3640,4124,75030,74970,149,3.5,377,8.9,8920,2008,6912,2.7,11.9,8799,2815,5984,3.8,11.7,121,0.2,23.4,0,263,263,2198
2006,28,j) 21 to 25,3537,4370,63614,62762,190,4.3,298,6.7,8305,2010,6295,3.2,13.2,6600,1533,5067,2.4,10.5,1705,2.7,21,0,173,173,986
2006,28,k) 26+,2235,3218,69791,69507,179,5.5,239,7.3,10446,4461,5985,6.4,15,9878,2467,7411,3.5,14.2,568,0.8,28.4,0,120,120,1048
2006,28,l) Left Censored,5860,14488,448012,449623,810,5.6,846,5.8,46059,12662,33397,2.8,10.2,49280,11294,37986,2.5,11,-3221,-0.8,20.4,0,196,201,2857
2006,29,a) 0,10750,10992,62220,31280,10905,198.4,0,0,61880,61880,0,197.8,197.8,0,0,0,0,0,61880,197.8,0,0,,,
2006,29,b) 1,8169,8285,57759,61201,47,0.5,3265,32.5,14995,619,14376,1,24.5,21879,15230,6649,24.9,35.7,-6884,-11.2,49,0,2647,2647,13237
2006,29,c) 2,6822,6901,51821,53721,215,2.8,1900,24.4,10664,684,9980,1.3,19.9,14463,7700,6763,14.3,26.9,-3799,-7,39.8,0,1536,1536,6826
2006,29,d) 3,5575,5664,41915,43461,195,3.2,1202,19.4,7127,984,6143,2.3,16.4,10219,5261,4958,12.1,23.5,-3092,-7.1,32.8,0,958,958,4437
2006,29,e) 4,4987,5123,47971,49543,148,2.7,890,16.1,6559,682,5877,1.4,13.2,9703,4443,5260,9,19.6,-3144,-6.4,26.4,0,702,702,3880
2006,29,f) 5,4253,4438,43525,43616,134,2.9,590,12.6,8084,1545,6539,3.5,18.5,8265,3454,4811,7.9,18.9,-181,-0.4,37,0,453,453,2570
2006,29,g) 6 to 10,18111,19428,208634,211323,657,3.2,2206,10.9,31814,4703,27111,2.2,15.1,37192,16325,20867,7.7,17.6,-5378,-2.5,30.2,0,1572,1575,10861
2006,29,h) 11 to 15,12423,13589,166705,167644,452,3.2,1381,9.8,22724,4665,18059,2.8,13.6,24601,8755,15846,5.2,14.7,-1877,-1.1,27.2,0,996,996,6423
2006,29,i) 16 to 20,9955,12025,194813,194256,541,4.4,897,7.3,24544,6934,17610,3.6,12.6,23430,5771,17659,3,12.1,1114,0.5,24.2,0,585,589,4173
2006,29,j) 21 to 25,8153,10355,197267,198546,416,4,713,6.8,19635,4318,15317,2.2,9.9,22192,5621,16571,2.8,11.2,-2557,-1.3,19.8,0,400,428,3578
2006,29,k) 26+,5034,8263,187302,184560,544,6.6,479,5.8,23033,9048,13985,4.9,12.5,17548,4152,13396,2.2,9.5,5485,3,19,0,255,255,1503
2006,29,l) Left Censored,13849,32988,1183311,1177578,1891,5.7,1763,5.4,131645,43306,88339,3.7,11.2,120179,31518,88661,2.7,10.2,11466,1,20.4,0,509,518,6314
2006,30,a) 0,3160,3220,14550,7316,3194,198.4,0,0,14468,14468,0,197.8,197.8,0,0,0,0,0,14468,197.8,0,0,,,
2006,30,b) 1,2140,2145,11394,11707,3,0.1,603,24.3,3059,6,3053,0.1,26.1,3685,2035,1650,17.4,31.5,-626,-5.4,52.2,0,448,448,1760
2006,30,c) 2,1825,1851,10470,10463,88,4.4,336,17,2330,391,1939,3.7,22.3,2316,1159,1157,11.1,22.1,14,0.2,44.2,0,251,251,989
2006,30,d) 3,1426,1446,8705,8877,70,4.6,235,15.4,1757,250,1507,2.8,19.8,2101,1023,1078,11.5,23.7,-344,-3.9,39.6,0,174,174,770
2006,30,e) 4,1344,1383,9861,9912,47,3.2,178,12.2,1666,214,1452,2.2,16.8,1767,779,988,7.9,17.8,-101,-1,33.6,0,118,118,457
2006,30,f) 5,1194,1212,7809,7956,44,3.5,154,12.1,1159,176,983,2.2,14.6,1452,595,857,7.5,18.3,-293,-3.7,29.2,0,99,99,455
2006,30,g) 6 to 10,4958,5206,43595,44058,225,4.2,566,10.5,8332,3437,4895,7.8,18.9,9257,4241,5016,9.6,21,-925,-2.1,37.8,0,376,376,3350
2006,30,h) 11 to 15,3150,3290,29450,28946,129,3.8,293,8.7,4705,1329,3376,4.6,16.3,3697,1377,2320,4.8,12.8,1008,3.5,25.6,0,200,200,1038
2006,30,i) 16 to 20,2088,2327,27967,27654,117,4.9,195,8.2,3655,1273,2382,4.6,13.2,3028,1032,1996,3.7,10.9,627,2.3,21.8,0,129,129,629
2006,30,j) 21 to 25,1774,2143,28054,27947,92,4.2,148,6.8,3024,829,2195,3,10.8,2810,754,2056,2.7,10.1,214,0.7,20.2,0,88,88,394
2006,30,k) 26+,1282,1905,28381,28058,55,2.8,113,5.8,3146,615,2531,2.2,11.2,2500,740,1760,2.6,8.9,646,2.3,17.8,0,57,57,413
2006,30,l) Left Censored,2663,5281,117466,115826,273,5.2,258,4.9,13010,2672,10338,2.3,11.2,9729,2983,6746,2.6,8.4,3281,2.8,16.8,0,69,69,1042
2006,31,a) 0,3114,3201,17205,8629,3171,198.1,0,0,17152,17152,0,198.8,198.8,0,0,0,0,0,17152,198.8,0,0,,,
2006,31,b) 1,2360,2383,15560,16482,18,0.7,613,22.6,3496,106,3390,0.6,21.2,5339,3285,2054,19.9,32.4,-1843,-11.2,42.4,0,457,457,2718
2006,31,c) 2,2027,2055,14662,14991,80,3.6,343,15.6,2657,545,2112,3.6,17.7,3315,1586,1729,10.6,22.1,-658,-4.4,35.4,0,253,253,1375
2006,31,d) 3,1700,1728,11941,12504,45,2.4,295,15.9,1720,129,1591,1,13.8,2846,1349,1497,10.8,22.8,-1126,-9,27.6,0,217,217,1174
2006,31,e) 4,1620,1676,13280,14117,69,3.9,272,15.2,1741,175,1566,1.2,12.3,3414,2184,1230,15.5,24.2,-1673,-11.9,24.6,0,178,178,1306
2006,31,f) 5,1511,1564,13984,14187,48,2.9,192,11.7,1922,137,1785,1,13.5,2328,1041,1287,7.3,16.4,-406,-2.9,27,0,137,137,837
2006,31,g) 6 to 10,6239,6676,75211,75244,197,2.8,688,9.9,9351,1446,7905,1.9,12.4,9416,3156,6260,4.2,12.5,-65,-0.1,24.8,0,431,431,2391
2006,31,h) 11 to 15,4308,4690,48862,49291,155,3.2,450,9.3,6640,2263,4377,4.6,13.5,7498,2346,5152,4.8,15.2,-858,-1.7,27,0,271,275,1488
2006,31,i) 16 to 20,3406,3962,69245,69014,136,3.4,304,7.5,7014,1770,5244,2.6,10.2,6551,2040,4511,3,9.5,463,0.7,19,0,194,194,1537
2006,31,j) 21 to 25,3071,3778,75954,75612,155,4,257,6.7,6501,1928,4573,2.5,8.6,5817,1748,4069,2.3,7.7,684,0.9,15.4,0,148,148,1287
2006,31,k) 26+,2076,3206,62627,60227,185,5.8,181,5.6,9866,5414,4452,9,16.4,5065,1366,3699,2.3,8.4,4801,8,16.8,0,93,93,601
2006,31,l) Left Censored,5990,11662,370268,367982,530,4.5,573,4.9,39838,11402,28436,3.1,10.8,35268,7023,28245,1.9,9.6,4570,1.2,19.2,0,210,213,2092
2006,32,a) 0,6359,6471,50099,25106,6429,198.7,0,0,49986,49986,0,199.1,199.1,0,0,0,0,0,49986,199.1,0,0,,,
2006,32,b) 1,4420,4539,46581,46369,47,0.9,1418,26.8,12736,503,12233,1.1,27.5,12312,7317,4995,15.8,26.6,424,0.9,53.2,0,1137,1137,6346
2006,32,c) 2,3493,3524,38433,38986,152,4,744,19.4,7872,783,7089,2,20.2,8977,4461,4516,11.4,23,-1105,-2.8,40.4,0,611,611,3710
2006,32,d) 3,2819,2932,33485,34749,133,4.2,588,18.5,7397,603,6794,1.7,21.3,9925,5472,4453,15.7,28.6,-2528,-7.3,42.6,0,466,466,4008
2006,32,e) 4,2384,2446,34615,33697,111,4.3,366,14.2,8274,1550,6724,4.6,24.6,6437,2820,3617,8.4,19.1,1837,5.5,38.2,0,278,278,2426
2006,32,f) 5,2009,2084,41258,37152,83,3.8,281,12.9,13069,451,12618,1.2,35.2,4856,1702,3154,4.6,13.1,8213,22.1,26.2,0,214,214,1442
2006,32,g) 6 to 10,7290,7888,126791,126092,385,4.7,969,11.8,25118,4007,21111,3.2,19.9,23720,7868,15852,6.2,18.8,1398,1.1,37.6,0,705,705,6609
2006,32,h) 11 to 15,3809,4215,87814,86895,180,4.2,394,9.1,12956,1540,11416,1.8,14.9,11117,3762,7355,4.3,12.8,1839,2.1,25.6,0,291,292,2475
2006,32,i) 16 to 20,2707,3466,82457,80537,203,5.8,268,7.6,13372,3788,9584,4.7,16.6,9532,2850,6682,3.5,11.8,3840,4.8,23.6,0,193,194,1839
2006,32,j) 21 to 25,1916,2893,76098,75878,177,6.1,184,6.4,10497,3875,6622,5.1,13.8,10057,2823,7234,3.7,13.3,440,0.5,26.6,0,107,107,1878
2006,32,k) 26+,1407,2353,76245,72943,166,7,161,6.8,12877,6030,6847,8.3,17.7,6273,1375,4898,1.9,8.6,6604,9.1,17.2,0,66,66,865
2006,32,l) Left Censored,3164,9212,462371,454944,844,9.3,478,5.3,56007,19979,36028,4.4,12.3,41152,11610,29542,2.6,9,14855,3.3,18,0,92,93,1885
2006,33,a) 0,2692,2760,15523,7788,2736,198.3,0,0,15471,15471,0,198.7,198.7,0,0,0,0,0,15471,198.7,0,0,,,
2006,33,b) 1,1976,2004,13857,14316,10,0.4,596,25.6,3062,46,3016,0.3,21.4,3979,2359,1620,16.5,27.8,-917,-6.4,42.8,0,465,465,2101
2006,33,c) 2,1672,1688,10458,10727,59,3.2,344,18.7,1994,196,1798,1.8,18.6,2531,1418,1113,13.2,23.6,-537,-5,37.2,0,281,281,1272
2006,33,d) 3,1382,1416,9798,10053,43,2.8,249,16.4,1610,105,1505,1,16,2120,978,1142,9.7,21.1,-510,-5.1,32,0,202,202,873
2006,33,e) 4,1228,1246,10602,11079,37,2.8,208,15.6,1657,231,1426,2.1,15,2610,794,1816,7.2,23.6,-953,-8.6,30,0,157,157,635
2006,33,f) 5,1116,1168,11028,10878,49,4,186,15,1828,461,1367,4.2,16.8,1528,665,863,6.1,14,300,2.8,28,0,132,132,472
2006,33,g) 6 to 10,5190,5437,51964,51890,184,3.3,542,9.6,7108,817,6291,1.6,13.7,6960,2896,4064,5.6,13.4,148,0.3,26.8,0,417,417,2539
2006,33,h) 11 to 15,3536,3696,43338,43166,94,2.5,332,8.7,5738,1256,4482,2.9,13.3,5393,2217,3176,5.1,12.5,345,0.8,25,0,240,240,1858
2006,33,i) 16 to 20,3231,3641,55527,55357,155,4.2,276,7.4,7492,2013,5479,3.6,13.5,7151,2473,4678,4.5,12.9,341,0.6,25.8,0,175,175,1225
2006,33,j) 21 to 25,2093,2496,40315,41358,85,3.4,159,6.3,3754,785,2969,1.9,9.1,5839,2815,3024,6.8,14.1,-2085,-5,18.2,0,103,104,1031
2006,33,k) 26+,1262,1926,41429,40795,68,3.5,103,5.3,6301,2662,3639,6.5,15.4,5032,1958,3074,4.8,12.3,1269,3.1,24.6,0,54,54,478
2006,33,l) Left Censored,3587,7559,258917,256695,432,5.7,393,5.2,29917,8317,21600,3.2,11.7,25473,5613,19860,2.2,9.9,4444,1.8,19.8,0,116,116,1980
2006,34,a) 0,17718,17992,98385,49390,17823,198.1,0,0,97990,97990,0,198.4,198.4,0,0,0,0,0,97990,198.4,0,0,,,
2006,34,b) 1,13443,13581,88464,90824,53,0.3,3921,24.9,22181,849,21332,0.9,24.4,26901,14831,12070,16.3,29.6,-4720,-5.2,48.8,0,3107,3107,11981
2006,34,c) 2,10937,11010,78295,79645,375,3.1,2203,18.4,15890,1350,14540,1.7,20,18590,10595,7995,13.3,23.3,-2700,-3.3,40,0,1812,1812,9362
2006,34,d) 3,9401,9500,80110,80035,362,3.6,1587,15.6,15617,1969,13648,2.5,19.5,15467,8024,7443,10,19.3,150,0.2,38.6,0,1253,1253,6717
2006,34,e) 4,8436,8570,80134,81163,360,4,1244,13.8,12339,1694,10645,2.1,15.2,14397,6154,8243,7.6,17.7,-2058,-2.5,30.4,0,969,969,4872
2006,34,f) 5,7948,8144,74806,75949,313,3.7,1053,12.3,12024,1467,10557,1.9,15.8,14309,6947,7362,9.1,18.8,-2285,-3,31.6,0,782,782,3718
2006,34,g) 6 to 10,32839,34202,366952,369086,1206,3.4,3744,10.5,50531,8347,42184,2.3,13.7,54799,21845,32954,5.9,14.8,-4268,-1.1,27.4,0,2877,2881,18059
2006,34,h) 11 to 15,20943,21926,259965,260644,698,3.1,1969,8.7,34379,6900,27479,2.6,13.2,35737,11766,23971,4.5,13.7,-1358,-0.5,26.4,0,1448,1448,8363
2006,34,i) 16 to 20,17486,19517,291597,289618,818,4.1,1550,7.8,37902,11657,26245,4,13.1,33943,9920,24023,3.4,11.7,3959,1.4,23.4,0,1081,1081,6277
2006,34,j) 21 to 25,12581,15024,287206,287566,513,3.3,1067,7,33130,8642,24488,3,11.5,33849,10366,23483,3.6,11.8,-719,-0.3,23,0,680,680,5797
2006,34,k) 26+,7982,10702,237431,237091,452,4.2,694,6.4,27253,7709,19544,3.3,11.5,26572,7642,18930,3.2,11.2,681,0.3,22.4,0,394,396,2640
2006,34,l) Left Censored,21162,43883,1659666,1665339,2529,5.7,2884,6.5,193342,61050,132292,3.7,11.6,204688,58381,146307,3.5,12.3,-11346,-0.7,23.2,0,1017,1025,11769
2006,35,a) 0,3345,3386,20054,10080,3351,197.9,0,0,19949,19949,0,197.9,197.9,0,0,0,0,0,19949,197.9,0,0,,,
2006,35,b) 1,2390,2422,17801,17672,16,0.6,655,23.5,5279,118,5161,0.7,29.9,5020,3286,1734,18.6,28.4,259,1.5,56.8,0,494,494,2896
2006,35,c) 2,1937,2000,16641,17130,88,4,428,19.6,3389,279,3110,1.6,19.8,4367,2594,1773,15.1,25.5,-978,-5.7,39.6,0,330,330,2280
2006,35,d) 3,1637,1665,13834,13919,54,3,274,15.4,2584,129,2455,0.9,18.6,2754,1506,1248,10.8,19.8,-170,-1.2,37.2,0,215,215,1173
2006,35,e) 4,1535,1584,17022,17161,69,4.1,248,14.8,2868,276,2592,1.6,16.7,3145,1897,1248,11.1,18.3,-277,-1.6,33.4,0,169,169,1552
2006,35,f) 5,1465,1591,15482,15641,83,5,196,11.9,2540,331,2209,2.1,16.2,2858,1244,1614,8,18.3,-318,-2.1,32.4,0,141,141,1022
2006,35,g) 6 to 10,5757,6066,75218,74316,243,3.9,653,10.4,12362,1874,10488,2.5,16.6,10557,3998,6559,5.4,14.2,1805,2.4,28.4,0,485,485,2937
2006,35,h) 11 to 15,4072,4499,51700,51682,196,4.3,400,8.7,7571,1454,6117,2.8,14.6,7535,2955,4580,5.7,14.6,36,0,29.2,0,286,286,2414
2006,35,i) 16 to 20,2931,3441,60142,59841,131,3.7,236,6.7,7545,1971,5574,3.3,12.6,6943,2675,4268,4.5,11.6,602,1,23.2,0,154,158,2206
2006,35,j) 21 to 25,2528,3307,47998,47789,138,4.1,218,6.5,5664,1460,4204,3.1,11.9,5246,1376,3870,2.9,11,418,0.9,22,0,138,138,878
2006,35,k) 26+,1707,2655,52080,50508,160,6,204,7.6,10232,3967,6265,7.9,20.3,7088,2676,4412,5.3,14,3144,6.3,28,0,88,88,581
2006,35,l) Left Censored,3608,8226,233980,228402,511,6.3,386,4.7,31342,9444,21898,4.1,13.7,20186,5194,14992,2.3,8.8,11156,4.9,17.6,0,114,115,943
2006,36,a) 0,39119,39735,215534,108095,39441,198.5,0,0,214878,214878,0,198.8,198.8,0,0,0,0,0,214878,198.8,0,0,,,
2006,36,b) 1,29199,29481,195628,204527,100,0.3,8569,25.1,44831,900,43931,0.4,21.9,62629,34749,27880,17,30.6,-17798,-8.7,43.8,0,6803,6803,29659
2006,36,c) 2,24538,24697,162830,167817,862,3.2,5137,19.1,32772,3091,29681,1.8,19.5,42745,25311,17434,15.1,25.5,-9973,-6,39,0,4164,4164,22310
2006,36,d) 3,21073,21295,154726,157254,694,3,3807,16.6,29749,2944,26805,1.9,18.9,34804,17892,16912,11.4,22.1,-5055,-3.2,37.8,0,3111,3111,15410
2006,36,e) 4,18628,18975,161633,165593,676,3.4,2958,14.7,23577,2405,21172,1.5,14.2,31497,14760,16737,8.9,19,-7920,-4.8,28.4,0,2382,2384,12824
2006,36,f) 5,16781,17103,144012,147333,643,3.6,2417,13.4,22951,3690,19261,2.5,15.6,29593,15177,14416,10.3,20.1,-6642,-4.5,31.2,0,1910,1910,13593
2006,36,g) 6 to 10,66831,70041,719844,726005,2291,3.1,8225,11.2,99433,11432,88001,1.6,13.7,111756,45429,66327,6.3,15.4,-12323,-1.7,27.4,0,6272,6272,36715
2006,36,h) 11 to 15,42821,44925,510808,519854,1284,2.8,4189,9,62076,12338,49738,2.4,11.9,80167,30975,49192,6,15.4,-18091,-3.5,23.8,0,3070,3072,23468
2006,36,i) 16 to 20,36905,40547,623660,624053,1336,3.2,3140,7.6,69065,18264,50801,2.9,11.1,69851,20635,49216,3.3,11.2,-786,-0.1,22.2,0,2156,2169,13847
2006,36,j) 21 to 25,27069,32121,557306,562151,1049,3.2,2115,6.5,54815,12918,41897,2.3,9.8,64505,19404,45101,3.5,11.5,-9690,-1.7,19.6,0,1399,1402,12350
2006,36,k) 26+,15873,22793,509395,508083,822,3.6,1355,5.9,53365,15648,37717,3.1,10.5,50740,14205,36535,2.8,10,2625,0.5,20,0,784,786,6679
2006,36,l) Left Censored,46053,93291,3541157,3541035,4757,5.1,5272,5.6,379935,101946,277989,2.9,10.7,379693,103058,276635,2.9,10.7,242,0,21.4,0,2200,2224,32379
2006,37,a) 0,16287,16668,102421,51605,16531,198.4,0,0,101633,101633,0,196.9,196.9,0,0,0,0,0,101633,196.9,0,0,,,
2006,37,b) 1,12163,12334,94999,95192,59,0.4,3333,23.5,25643,872,24771,0.9,26.9,26029,14869,11160,15.6,27.3,-386,-0.4,53.8,0,2625,2627,12573
2006,37,c) 2,9653,9797,79661,81049,336,3.2,1850,17.4,18332,1624,16708,2,22.6,21108,9933,11175,12.3,26,-2776,-3.4,45.2,0,1486,1486,8930
2006,37,d) 3,8184,8340,75721,76744,276,3.1,1310,14.8,13582,1464,12118,1.9,17.7,15628,7144,8484,9.3,20.4,-2046,-2.7,35.4,0,1043,1043,5882
2006,37,e) 4,7275,7530,72975,72623,257,3.3,993,12.6,13755,1901,11854,2.6,18.9,13051,6161,6890,8.5,18,704,0.9,36,0,767,767,4773
2006,37,f) 5,6942,7263,68056,68595,272,3.6,931,12.2,11095,1583,9512,2.3,16.2,12173,5219,6954,7.6,17.7,-1078,-1.5,32.4,0,706,706,4431
2006,37,g) 6 to 10,27986,30387,336287,336374,1133,3.6,3214,10.2,52374,8639,43735,2.6,15.6,52547,20313,32234,6,15.6,-173,0,31.2,0,2329,2332,16511
2006,37,h) 11 to 15,17089,18783,248977,245959,674,3.5,1636,8.5,38703,6792,31911,2.8,15.7,32666,11690,20976,4.8,13.3,6037,2.4,26.6,0,1176,1176,8459
2006,37,i) 16 to 20,13739,16657,304229,299939,713,4.2,1203,7.1,41316,16149,25167,5.4,13.8,32735,9332,23403,3.1,10.9,8581,2.9,21.8,0,859,859,6437
2006,37,j) 21 to 25,11683,14970,242641,242759,697,4.6,917,6.1,27452,7232,20220,3,11.3,27688,8832,18856,3.6,11.4,-236,-0.1,22.6,0,545,545,4665
2006,37,k) 26+,6405,10663,253038,248146,590,5.5,578,5.4,35435,13904,21531,5.6,14.3,25650,6488,19162,2.6,10.3,9785,4,20.6,0,276,280,1896
2006,37,l) Left Censored,16183,44943,1638684,1629889,2788,6.2,2292,5.1,192639,60871,131768,3.7,11.8,175050,53631,121419,3.3,10.7,17589,1.1,21.4,0,678,692,11452
2006,38,a) 0,1289,1334,7341,3687,1316,197.3,0,0,7309,7309,0,198.2,198.2,0,0,0,0,0,7309,198.2,0,0,,,
2006,38,b) 1,924,937,6228,6581,7,0.7,243,22.8,1359,134,1225,2,20.7,2064,1156,908,17.6,31.4,-705,-10.7,41.4,0,166,166,948
2006,38,c) 2,757,775,5881,5995,46,5.5,158,18.9,972,106,866,1.8,16.2,1199,599,600,10,20,-227,-3.8,32.4,0,115,115,452
2006,38,d) 3,618,633,4133,4413,24,3.6,104,15.4,565,63,502,1.4,12.8,1125,432,693,9.8,25.5,-560,-12.7,25.6,0,72,72,340
2006,38,e) 4,602,630,4921,4999,11,1.6,81,12.1,648,38,610,0.8,13,803,284,519,5.7,16.1,-155,-3.1,26,0,55,55,231
2006,38,f) 5,526,542,5294,5231,17,3,74,12.9,793,63,730,1.2,15.2,667,318,349,6.1,12.8,126,2.4,25.6,0,46,46,243
2006,38,g) 6 to 10,2304,2428,21950,22171,78,3.1,270,10.6,3183,703,2480,3.2,14.4,3625,1729,1896,7.8,16.4,-442,-2,28.8,0,176,176,1381
2006,38,h) 11 to 15,1852,1935,22371,22438,60,3,181,9,2815,499,2316,2.2,12.5,2950,1278,1672,5.7,13.1,-135,-0.6,25,0,112,112,1053
2006,38,i) 16 to 20,1448,1649,20251,19921,81,4.8,140,8.3,2664,814,1850,4.1,13.4,2004,634,1370,3.2,10.1,660,3.3,20.2,0,81,81,501
2006,38,j) 21 to 25,1382,1681,21264,21277,63,3.7,126,7.3,3245,551,2694,2.6,15.3,3270,1864,1406,8.8,15.4,-25,-0.1,30.6,0,51,51,468
2006,38,k) 26+,942,1280,22379,22113,43,3.3,85,6.5,2772,606,2166,2.7,12.5,2239,398,1841,1.8,10.1,533,2.4,20.2,0,41,41,269
2006,38,l) Left Censored,2738,4999,135212,133819,201,4,212,4.2,12621,3029,9592,2.3,9.4,9835,2076,7759,1.6,7.3,2786,2.1,14.6,0,85,85,664
2006,39,a) 0,14689,14993,113387,56898,14868,198.3,0,0,112979,112979,0,198.6,198.6,0,0,0,0,0,112979,198.6,0,0,,,
2006,39,b) 1,11125,11338,102617,104684,59,0.5,3219,24.6,25608,1176,24432,1.1,24.5,29742,17275,12467,16.5,28.4,-4134,-3.9,49,0,2551,2551,15037
2006,39,c) 2,9424,9554,85789,88333,331,3.2,1836,17.7,16269,2301,13968,2.6,18.4,21357,11216,10141,12.7,24.2,-5088,-5.8,36.8,0,1461,1465,9839
2006,39,d) 3,8159,8367,77151,79369,247,2.8,1320,14.8,12771,1377,11394,1.7,16.1,17206,7665,9541,9.7,21.7,-4435,-5.6,32.2,0,1021,1021,6347
2006,39,e) 4,7820,8244,87577,89037,304,3.5,1208,13.9,12334,1354,10980,1.5,13.9,15253,6879,8374,7.7,17.1,-2919,-3.2,27.8,0,936,936,5897
2006,39,f) 5,7034,7375,68637,70167,246,3.2,943,12.2,9946,1318,8628,1.9,14.2,13006,5811,7195,8.3,18.5,-3060,-4.3,28.4,0,704,707,4668
2006,39,g) 6 to 10,30596,33367,386761,389962,1200,3.5,3657,10.5,55677,9308,46369,2.4,14.3,62078,26967,35111,6.9,15.9,-6401,-1.6,28.6,0,2540,2540,20536
2006,39,h) 11 to 15,22952,25308,310668,312242,858,3.3,2288,8.8,42441,7315,35126,2.3,13.6,45588,15293,30295,4.9,14.6,-3147,-1,27.2,0,1559,1559,11277
2006,39,i) 16 to 20,18818,22673,380826,379902,828,3.6,1692,7.3,46073,11250,34823,3,12.1,44224,14556,29668,3.8,11.6,1849,0.5,23.2,0,1095,1095,9426
2006,39,j) 21 to 25,14792,19055,350833,352672,580,3,1213,6.3,33584,5995,27589,1.7,9.5,37261,10660,26601,3,10.6,-3677,-1.1,19,0,720,725,6854
2006,39,k) 26+,10074,15543,339296,336071,548,3.5,964,6.1,40827,12371,28456,3.7,12.1,34377,9464,24913,2.8,10.2,6450,1.9,20.4,0,508,513,3959
2006,39,l) Left Censored,28924,69851,2496065,2497012,3989,5.7,3842,5.5,270825,88180,182645,3.5,10.8,272720,82429,190291,3.3,10.9,-1895,-0.1,21.6,0,1198,1260,19849
2006,40,a) 0,6308,6454,43080,21640,6393,198.1,0,0,42881,42881,0,198.2,198.2,0,0,0,0,0,42881,198.2,0,0,,,
2006,40,b) 1,4577,4667,40537,38946,31,0.6,1397,25.7,13716,3612,10104,9.3,35.2,10534,6855,3679,17.6,27,3182,8.2,54,0,1118,1124,5811
2006,40,c) 2,3640,3678,29121,29305,127,3.2,719,18,5778,452,5326,1.5,19.7,6145,3146,2999,10.7,21,-367,-1.3,39.4,0,579,579,2747
2006,40,d) 3,3199,3235,26741,26981,103,3,541,15.6,5434,437,4997,1.6,20.1,5913,3134,2779,11.6,21.9,-479,-1.8,40.2,0,425,425,2692
2006,40,e) 4,2939,3042,28128,28557,94,2.9,478,14.7,4364,619,3745,2.2,15.3,5222,2442,2780,8.6,18.3,-858,-3,30.6,0,380,380,2069
2006,40,f) 5,2652,2779,25321,24921,87,3,353,12.1,5365,826,4539,3.3,21.5,4564,1983,2581,8,18.3,801,3.2,36.6,0,269,269,1737
2006,40,g) 6 to 10,11092,12139,130843,128969,452,3.6,1252,10,23976,5155,18821,4,18.6,20228,8440,11788,6.5,15.7,3748,2.9,31.4,0,879,881,6248
2006,40,h) 11 to 15,7526,8137,89595,88969,255,3,703,8.4,12089,2061,10028,2.3,13.6,10836,3770,7066,4.2,12.2,1253,1.4,24.4,0,490,490,2651
2006,40,i) 16 to 20,5571,6386,103267,100652,234,3.6,500,7.7,16841,4477,12364,4.4,16.7,11610,3997,7613,4,11.5,5231,5.2,23,0,329,333,2451
2006,40,j) 21 to 25,5725,7007,108430,107941,218,3.1,443,6.2,12857,3173,9684,2.9,11.9,11879,3812,8067,3.5,11,978,0.9,22,0,266,266,1832
2006,40,k) 26+,3343,5123,110830,109010,248,4.8,344,6.6,15711,6741,8970,6.2,14.4,12070,3094,8976,2.8,11.1,3641,3.3,22.2,0,156,167,1253
2006,40,l) Left Censored,7533,17885,538398,529064,985,5.5,848,4.8,67003,20847,46156,3.9,12.7,48337,13915,34422,2.6,9.1,18666,3.6,18.2,0,276,283,2888
2006,41,a) 0,8906,9163,45946,23056,9095,198.5,0,0,45781,45781,0,198.6,198.6,0,0,0,0,0,45781,198.6,0,0,,,
2006,41,b) 1,6426,6527,41377,41681,27,0.4,1872,24.8,10833,286,10547,0.7,26,11441,6959,4482,16.7,27.4,-608,-1.4,52,0,1478,1478,5784
2006,41,c) 2,4921,5017,36406,37580,216,4,971,17.9,8066,1102,6964,2.9,21.5,10414,6037,4377,16.1,27.7,-2348,-6.2,43,0,726,726,5269
2006,41,d) 3,4242,4373,29299,30280,152,3.3,727,15.5,5555,753,4802,2.5,18.3,7516,4267,3249,14.1,24.8,-1961,-6.5,36.6,0,552,552,3721
2006,41,e) 4,3807,3925,31324,31909,133,3.2,588,14.1,5355,560,4795,1.8,16.8,6525,3598,2927,11.3,20.4,-1170,-3.6,33.6,0,437,437,2764
2006,41,f) 5,3585,3721,31103,30870,151,3.9,474,12.2,5576,670,4906,2.2,18.1,5109,2289,2820,7.4,16.6,467,1.5,33.2,0,356,356,1823
2006,41,g) 6 to 10,14496,15447,158442,160687,611,3.8,1660,10.4,21874,3269,18605,2,13.6,26364,9197,17167,5.7,16.4,-4490,-2.8,27.2,0,1205,1205,7587
2006,41,h) 11 to 15,9856,10652,111546,112392,424,3.9,959,8.8,15899,3334,12565,3,14.1,17591,6728,10863,6,15.7,-1692,-1.6,28.2,0,656,656,5382
2006,41,i) 16 to 20,6935,8033,121025,120100,297,3.6,592,7.2,16559,4501,12058,3.7,13.8,14709,4385,10324,3.7,12.2,1850,1.6,24.4,0,390,390,3137
2006,41,j) 21 to 25,5219,6988,134451,132117,335,4.8,390,5.5,17476,4866,12610,3.7,13.2,12808,2907,9901,2.2,9.7,4668,3.5,19.4,0,252,252,2030
2006,41,k) 26+,3730,5472,107644,107293,225,4.1,361,6.5,12407,3273,9134,3.1,11.6,11704,4283,7421,4,10.9,703,0.7,21.8,0,211,211,2030
2006,41,l) Left Censored,7642,18459,602463,595655,1040,5.7,838,4.6,66833,18185,48648,3.1,11.2,53216,12540,40676,2.1,8.9,13617,2.3,17.8,0,245,245,3373
2006,42,a) 0,17459,17880,125159,62887,17757,198.6,0,0,124544,124544,0,198,198,0,0,0,0,0,124544,198,0,0,,,
2006,42,b) 1,13626,13859,107979,111602,69,0.4,3920,24.5,23830,918,22912,0.8,21.4,31076,18414,12662,16.5,27.8,-7246,-6.4,42.8,0,3080,3080,16600
2006,42,c) 2,11437,11651,90205,93409,438,3.5,2088,16.7,16453,1583,14870,1.7,17.6,22860,12541,10319,13.4,24.5,-6407,-6.9,35.2,0,1661,1661,10788
2006,42,d) 3,9769,9947,93729,95017,331,3.1,1542,14.6,15875,1571,14304,1.7,16.7,18450,9756,8694,10.3,19.4,-2575,-2.7,33.4,0,1211,1222,8498
2006,42,e) 4,9438,9731,104260,107491,295,2.9,1270,12.4,13673,2252,11421,2.1,12.7,20135,10280,9855,9.6,18.7,-6462,-6,25.4,0,940,940,8946
2006,42,f) 5,8583,8886,83483,83691,296,3.2,1056,11.4,13580,3139,10441,3.8,16.2,13996,6127,7869,7.3,16.7,-416,-0.5,32.4,0,803,803,5299
2006,42,g) 6 to 10,35961,38821,443352,445090,1258,3.1,3859,9.6,59780,10759,49021,2.4,13.4,63256,24021,39235,5.4,14.2,-3476,-0.8,26.8,0,2795,2796,19321
2006,42,h) 11 to 15,25097,27272,327926,329040,984,3.5,2290,8.2,43960,10944,33016,3.3,13.4,46187,18086,28101,5.5,14,-2227,-0.6,26.8,0,1652,1653,13530
2006,42,i) 16 to 20,23005,25940,381943,381670,945,3.6,2059,7.8,49092,13587,35505,3.6,12.9,48546,18401,30145,4.8,12.7,546,0.2,25.4,0,1411,1416,10828
2006,42,j) 21 to 25,17476,22610,438523,443132,839,3.7,1428,6.2,43256,11389,31867,2.6,9.8,52474,15456,37018,3.5,11.8,-9218,-2,19.6,0,836,838,7616
2006,42,k) 26+,10917,16415,355152,353465,637,3.8,935,5.6,40093,12956,27137,3.7,11.3,36719,9281,27438,2.6,10.4,3374,0.9,20.8,0,494,494,5209
2006,42,l) Left Censored,31616,73482,2602545,2592652,3663,5,3577,4.9,257778,71973,185805,2.8,9.9,237991,66843,171148,2.6,9.2,19787,0.7,18.4,0,1265,1418,23445
2006,44,a) 0,2033,2082,10129,5075,2069,198.8,0,0,10108,10108,0,199.2,199.2,0,0,0,0,0,10108,199.2,0,0,,,
2006,44,b) 1,1519,1527,9991,10448,3,0.2,422,24,1964,8,1956,0.1,18.8,2878,1594,1284,15.3,27.5,-914,-8.7,37.6,0,341,341,1266
2006,44,c) 2,1326,1338,10353,10414,58,4,298,20.3,2104,344,1760,3.3,20.2,2225,1195,1030,11.5,21.4,-121,-1.2,40.4,0,236,236,997
2006,44,d) 3,1121,1134,8361,8680,52,4.3,172,14.3,1147,102,1045,1.2,13.2,1784,648,1136,7.5,20.6,-637,-7.4,26.4,0,131,131,508
2006,44,e) 4,1011,1021,7561,7683,33,3.1,123,11.5,1101,153,948,2,14.3,1345,648,697,8.4,17.5,-244,-3.2,28.6,0,88,88,404
2006,44,f) 5,906,925,6633,6933,36,3.7,136,13.9,937,103,834,1.5,13.5,1536,660,876,9.5,22.2,-599,-8.7,27,0,98,98,522
2006,44,g) 6 to 10,3761,3961,37752,38383,154,3.8,405,9.9,4763,529,4234,1.4,12.4,6024,1987,4037,5.2,15.7,-1261,-3.3,24.8,0,299,299,1478
2006,44,h) 11 to 15,2658,2753,29596,30265,83,2.9,208,7.4,3080,328,2752,1.1,10.2,4418,1485,2933,4.9,14.6,-1338,-4.4,20.4,0,150,150,1197
2006,44,i) 16 to 20,2478,2686,38952,39409,73,2.7,184,6.7,3993,738,3255,1.9,10.1,4907,1480,3427,3.8,12.5,-914,-2.4,20.2,0,127,132,1171
2006,44,j) 21 to 25,1675,1973,34058,32934,76,3.8,126,6.3,5438,2632,2806,8,16.5,3190,764,2426,2.3,9.7,2248,6.8,19.4,0,87,87,391
2006,44,k) 26+,1116,1447,26822,27107,64,4.4,99,6.8,2814,1132,1682,4.2,10.4,3383,787,2596,2.9,12.5,-569,-2.1,20.8,0,65,65,631
2006,44,l) Left Censored,3697,6136,216556,217931,376,6.1,369,6,23366,7334,16032,3.4,10.7,26116,5740,20376,2.6,12,-2750,-1.3,21.4,0,102,102,858
2006,45,a) 0,7737,7841,48934,24529,7787,198.6,0,0,48810,48810,0,199,199,0,0,0,0,0,48810,199,0,0,,,
2006,45,b) 1,5813,5930,45575,46167,47,0.7,1606,23.6,12139,494,11645,1.1,26.3,13322,8282,5040,17.9,28.9,-1183,-2.6,52.6,0,1296,1296,7149
2006,45,c) 2,4563,4636,37870,38845,136,2.7,920,18.2,7375,531,6844,1.4,19,9324,4601,4723,11.8,24,-1949,-5,38,0,737,737,4065
2006,45,d) 3,4016,4113,42997,42907,159,3.6,659,15.1,8217,1024,7193,2.4,19.2,8037,3666,4371,8.5,18.7,180,0.5,37.4,0,522,522,2983
2006,45,e) 4,3655,3752,32885,33030,134,3.4,522,13.2,6114,1033,5081,3.1,18.5,6403,3071,3332,9.3,19.4,-289,-0.9,37,0,403,403,2381
2006,45,f) 5,3237,3406,38833,38730,119,3.3,417,11.7,5746,961,4785,2.5,14.8,5540,1993,3547,5.1,14.3,206,0.5,28.6,0,318,319,1679
2006,45,g) 6 to 10,13382,14390,168609,170120,538,3.6,1438,9.7,26392,4771,21621,2.8,15.5,29414,11926,17488,7,17.3,-3022,-1.8,31,0,1045,1045,9512
2006,45,h) 11 to 15,8349,9221,124423,124982,298,3.1,819,8.6,17022,2923,14099,2.3,13.6,18141,6168,11973,4.9,14.5,-1119,-0.9,27.2,0,575,575,4380
2006,45,i) 16 to 20,6501,8064,127981,127968,310,3.8,593,7.2,17447,4641,12806,3.6,13.6,17421,4777,12644,3.7,13.6,26,0,27.2,0,386,386,2879
2006,45,j) 21 to 25,5372,6785,114740,114291,263,3.8,475,6.9,12968,3255,9713,2.8,11.3,12071,2798,9273,2.4,10.6,897,0.7,21.2,0,269,269,1518
2006,45,k) 26+,3105,5237,108290,105443,245,4.6,335,6.3,15726,4774,10952,4.5,14.9,10032,3717,6315,3.5,9.5,5694,5.4,19,0,165,167,1262
2006,45,l) Left Censored,8158,21490,733014,727144,1242,5.8,988,4.6,76931,24374,52557,3.4,10.6,65190,15011,50179,2.1,9,11741,1.6,18,0,287,294,2668
2006,46,a) 0,1764,1781,9383,4722,1762,197.9,0,0,9323,9323,0,197.4,197.4,0,0,0,0,0,9323,197.4,0,0,,,
2006,46,b) 1,1208,1227,6883,7248,4,0.3,383,26.6,1699,40,1659,0.6,23.4,2428,1634,794,22.5,33.5,-729,-10.1,46.8,0,277,277,1303
2006,46,c) 2,1059,1071,6594,6575,53,4.6,193,16.8,1604,131,1473,2,24.4,1565,790,775,12,23.8,39,0.6,47.6,0,149,149,685
2006,46,d) 3,906,921,6132,6228,27,2.7,147,15,1010,138,872,2.2,16.2,1201,550,651,8.8,19.3,-191,-3.1,32.4,0,102,102,418
2006,46,e) 4,910,923,6979,7088,27,2.8,133,13.6,1096,149,947,2.1,15.5,1313,599,714,8.5,18.5,-217,-3,31,0,96,96,436
2006,46,f) 5,771,816,5969,6310,28,3.3,105,12.2,683,50,633,0.8,10.8,1365,575,790,9.1,21.6,-682,-10.8,21.6,0,65,65,322
2006,46,g) 6 to 10,3241,3388,30290,30587,115,3.3,354,10.1,3936,471,3465,1.5,12.9,4530,1956,2574,6.4,14.8,-594,-1.9,25.8,0,247,247,1726
2006,46,h) 11 to 15,2224,2355,24953,25139,68,2.8,227,9.3,3036,725,2311,2.9,12.1,3407,1272,2135,5.1,13.6,-371,-1.5,24.2,0,148,148,937
2006,46,i) 16 to 20,1592,1743,25430,25729,61,3.4,163,9.1,3495,818,2677,3.2,13.6,4092,839,3253,3.3,15.9,-597,-2.3,27.2,0,87,87,457
2006,46,j) 21 to 25,1420,1752,20685,20648,37,2.1,128,7.1,2135,185,1950,0.9,10.3,2061,668,1393,3.2,10,74,0.3,20,0,57,57,285
2006,46,k) 26+,982,1331,20424,20285,55,4.1,89,6.6,2050,554,1496,2.7,10.1,1772,354,1418,1.7,8.7,278,1.4,17.4,0,45,45,180
2006,46,l) Left Censored,2834,5151,155291,152350,235,4.6,247,4.8,15345,3665,11680,2.4,10.1,9463,2312,7151,1.5,6.2,5882,3.9,12.4,0,93,94,1026
2006,47,a) 0,8977,9155,65681,32925,9090,198.6,0,0,65513,65513,0,199,199,0,0,0,0,0,65513,199,0,0,,,
2006,47,b) 1,6699,6823,61743,60525,53,0.7,1968,25,19703,579,19124,1,32.6,17267,9537,7730,15.8,28.5,2436,4.1,57,0,1645,1649,8577
2006,47,c) 2,5416,5516,50075,50149,189,3.1,1145,19,10839,1059,9780,2.1,21.6,10987,6024,4963,12,21.9,-148,-0.3,43.2,0,948,953,5445
2006,47,d) 3,4627,4734,45229,44989,161,3.2,754,14.9,8405,1024,7381,2.3,18.7,7924,3492,4432,7.8,17.6,481,1.1,35.2,0,609,609,3020
2006,47,e) 4,4051,4257,45820,45867,164,3.7,605,13.5,8518,1119,7399,2.4,18.6,8612,3926,4686,8.6,18.8,-94,-0.2,37.2,0,477,477,2698
2006,47,f) 5,3548,3708,38682,39097,108,2.7,522,13.3,5860,576,5284,1.5,15,6689,3553,3136,9.1,17.1,-829,-2.1,30,0,405,405,3180
2006,47,g) 6 to 10,15557,17108,225753,222427,633,3.6,1837,10.4,38204,6620,31584,3,17.2,31551,11607,19944,5.2,14.2,6653,3,28.4,0,1317,1322,9007
2006,47,h) 11 to 15,11033,12354,170451,168054,463,3.6,1109,8.7,27026,5858,21168,3.5,16.1,22232,8741,13491,5.2,13.2,4794,2.9,26.4,0,783,783,6349
2006,47,i) 16 to 20,8794,10769,204395,202962,446,4.1,783,7.1,26672,7080,19592,3.5,13.1,23806,5768,18038,2.8,11.7,2866,1.4,23.4,0,510,511,3499
2006,47,j) 21 to 25,7626,9658,175032,174155,373,3.8,585,6,20966,7719,13247,4.4,12,19211,5001,14210,2.9,11,1755,1,22,0,326,327,2663
2006,47,k) 26+,4549,8031,199726,194355,572,7.2,461,5.8,35667,12280,23387,6.3,18.4,24925,7367,17558,3.8,12.8,10742,5.6,25.6,0,210,217,2072
2006,47,l) Left Censored,11564,31245,1178707,1171178,1963,6.3,1821,5.8,123075,38392,84683,3.3,10.5,108018,28552,79466,2.4,9.2,15057,1.3,18.4,0,415,419,4246
2006,48,a) 0,37580,38501,273526,137475,38151,198.2,0,0,272102,272102,0,197.9,197.9,0,0,0,0,0,272102,197.9,0,0,,,
2006,48,b) 1,27625,28548,274173,278577,293,0.9,8252,25,75696,3450,72246,1.2,27.2,84503,49840,34663,17.9,30.3,-8807,-3.1,54.4,0,6668,6668,42305
2006,48,c) 2,22922,23350,218650,220331,789,3.1,4683,18.4,49453,5135,44318,2.3,22.4,52815,30126,22689,13.7,24,-3362,-1.6,44.8,0,3805,3805,26258
2006,48,d) 3,19570,20145,205138,210058,676,3.1,3469,16.1,45168,5032,40136,2.4,21.5,55008,25675,29333,12.2,26.2,-9840,-4.7,43,0,2779,2779,22016
2006,48,e) 4,17295,18178,210911,212615,621,3.2,2550,13.3,38651,5375,33276,2.5,18.2,42058,21869,20189,10.3,19.8,-3407,-1.6,36.4,0,2030,2032,19027
2006,48,f) 5,15382,16295,188260,186435,552,3.2,2154,12.6,34091,4100,29991,2.2,18.3,30440,13387,17053,7.2,16.3,3651,2,32.6,0,1680,1705,10965
2006,48,g) 6 to 10,61586,67650,895366,892683,2603,3.7,7201,10.3,153795,31854,121941,3.6,17.2,148428,55761,92667,6.2,16.6,5367,0.6,33.2,0,5321,5327,44335
2006,48,h) 11 to 15,41191,46107,665567,655762,1749,3.7,4282,9,116511,20288,96223,3.1,17.8,96900,36273,60627,5.5,14.8,19611,3,29.6,0,3028,3051,24348
2006,48,i) 16 to 20,29261,36587,701079,696890,1706,4.6,2690,7.2,98430,26130,72300,3.7,14.1,90053,26247,63806,3.8,12.9,8377,1.2,25.8,0,1708,1709,14112
2006,48,j) 21 to 25,28073,37188,666687,662667,1395,3.7,2293,6.1,84259,19742,64517,3,12.7,76218,23090,53128,3.5,11.5,8041,1.2,23,0,1359,1376,11086
2006,48,k) 26+,13127,23006,536912,522734,1379,6,1381,6,81622,33258,48364,6.4,15.6,53266,14046,39220,2.7,10.2,28356,5.4,20.4,0,673,678,4376
2006,48,l) Left Censored,28851,101730,3747190,3693067,7992,7.9,6041,6,489003,158893,330110,4.3,13.2,380758,111801,268957,3,10.3,108245,2.9,20.6,0,1209,1229,14355
2006,49,a) 0,6878,6994,39588,19901,6932,198.2,0,0,39375,39375,0,197.9,197.9,0,0,0,0,0,39375,197.9,0,0,,,
2006,49,b) 1,4589,4643,35326,35738,28,0.5,1429,26.3,9744,359,9385,1,27.3,10567,6564,4003,18.4,29.6,-823,-2.3,54.6,0,1089,1089,5583
2006,49,c) 2,3630,3687,34727,34038,202,5.1,770,19.3,9131,1374,7757,4,26.8,7752,4434,3318,13,22.8,1379,4,45.6,0,584,584,3543
2006,49,d) 3,3181,3226,33620,33564,155,4.5,519,15.1,6057,625,5432,1.9,18,5945,2340,3605,7,17.7,112,0.3,35.4,0,388,388,1941
2006,49,e) 4,2775,2864,29404,28450,128,4.3,396,13.2,7266,1072,6194,3.8,25.5,5357,2723,2634,9.6,18.8,1909,6.7,37.6,0,294,294,2193
2006,49,f) 5,2356,2452,24946,24817,101,3.9,312,12.2,4832,270,4562,1.1,19.5,4573,2243,2330,9,18.4,259,1.1,36.8,0,226,228,1804
2006,49,g) 6 to 10,8706,9159,118564,116723,445,4.7,935,9.9,19627,3874,15753,3.3,16.8,15945,6313,9632,5.4,13.7,3682,3.1,27.4,0,655,655,4926
2006,49,h) 11 to 15,4896,5276,85886,86208,211,3.9,456,8.4,10460,1462,8998,1.7,12.1,11104,3627,7477,4.2,12.9,-644,-0.8,24.2,0,324,324,3045
2006,49,i) 16 to 20,2996,3564,72571,71965,152,4.2,255,7,10410,1382,9028,1.9,14.5,9198,2770,6428,3.8,12.8,1212,1.7,25.6,0,168,168,1857
2006,49,j) 21 to 25,2310,3185,68997,69381,191,6,184,5.8,9077,3100,5977,4.5,13.1,9844,1829,8015,2.6,14.2,-767,-1.1,26.2,0,116,116,1243
2006,49,k) 26+,1746,2582,60971,59660,151,5.9,138,5.4,8092,3003,5089,5,13.6,5469,1389,4080,2.3,9.2,2623,4.4,18.4,0,60,81,807
2006,49,l) Left Censored,3887,10414,429697,420885,804,7.8,611,5.9,56688,17738,38950,4.2,13.5,39063,12595,26468,3,9.3,17625,4.2,18.6,0,141,160,1749
2006,50,a) 0,1342,1358,6569,3297,1344,197.9,0,0,6545,,,,198.5,0,0,0,0,0,6545,198.5,0,1,,,
2006,50,b) 1,980,984,5769,6148,1,0.1,299,26.1,1089,,,,17.7,1847,1182,665,19.2,30,-758,-12.3,35.4,1,232,232,993
2006,50,c) 2,908,917,5336,5853,41,4.2,143,14.7,842,69,773,1.2,14.4,1876,873,1003,14.9,32.1,-1034,-17.7,28.8,0,103,103,810
2006,50,d) 3,787,797,4993,5223,32,3.8,139,16.4,682,65,617,1.2,13.1,1141,614,527,11.8,21.8,-459,-8.7,26.2,0,112,112,563
2006,50,e) 4,707,718,5003,5127,26,3.5,87,11.6,600,69,531,1.3,11.7,848,315,533,6.1,16.5,-248,-4.8,23.4,0,64,64,259
2006,50,f) 5,667,679,4392,4487,22,3.1,74,10.5,632,55,577,1.2,14.1,822,309,513,6.9,18.3,-190,-4.2,28.2,0,55,55,255
2006,50,g) 6 to 10,2959,3096,26896,27102,95,3,313,9.7,3189,296,2893,1.1,11.8,3600,1141,2459,4.2,13.3,-411,-1.5,23.6,0,224,224,952
2006,50,h) 11 to 15,2117,2254,20236,20538,68,2.9,196,8.4,2145,195,1950,0.9,10.4,2748,931,1817,4.5,13.4,-603,-3,20.8,0,129,129,793
2006,50,i) 16 to 20,2032,2155,22992,23072,72,3.3,176,8,2244,426,1818,1.8,9.7,2403,720,1683,3.1,10.4,-159,-0.7,19.4,0,116,116,564
2006,50,j) 21 to 25,1439,1746,30645,30442,59,3.3,99,5.6,3070,606,2464,2,10.1,2664,798,1866,2.6,8.8,406,1.3,17.6,0,64,66,441
2006,50,k) 26+,835,1119,19128,18782,44,3.9,65,5.7,2229,888,1341,4.7,11.9,1537,252,1285,1.3,8.2,692,3.7,16.4,0,42,42,188
2006,50,l) Left Censored,2184,3864,110048,110570,171,4.4,190,4.9,8500,1704,6796,1.5,7.7,9544,2304,7240,2.1,8.6,-1044,-0.9,15.4,0,73,77,653
2006,51,a) 0,14498,14772,86029,43272,14662,198.5,0,0,85515,85515,0,197.6,197.6,0,0,0,0,0,85515,197.6,0,0,,,
2006,51,b) 1,10728,10830,83345,82710,60,0.5,3010,24.1,22469,795,21674,1,27.2,21199,12139,9060,14.7,25.6,1270,1.6,51.2,0,2385,2385,10110
2006,51,c) 2,8796,8897,70990,71186,320,3.3,1671,17.4,14668,1141,13527,1.6,20.6,15060,7096,7964,10,21.2,-392,-0.6,41.2,0,1322,1322,6111
2006,51,d) 3,7073,7169,59462,60428,250,3.3,1212,15.8,12367,1258,11109,2.1,20.5,14299,7079,7220,11.7,23.7,-1932,-3.2,41,0,970,970,6055
2006,51,e) 4,6559,6752,63459,61831,228,3.2,902,12.7,13729,1662,12067,2.7,22.2,10473,4701,5772,7.6,16.9,3256,5.3,33.8,0,689,689,3791
2006,51,f) 5,5735,6049,60224,59750,198,3.1,712,11.2,11193,913,10280,1.5,18.7,10245,4630,5615,7.7,17.1,948,1.6,34.2,0,537,537,3767
2006,51,g) 6 to 10,24034,25958,304754,301799,1021,3.8,2582,9.6,51410,8440,42970,2.8,17,45499,17415,28084,5.8,15.1,5911,1.9,30.2,0,1892,1892,13466
2006,51,h) 11 to 15,16360,17801,243690,245798,579,3.2,1503,8.2,31998,6059,25939,2.5,13,36214,13366,22848,5.4,14.7,-4216,-1.7,26,0,1065,1065,8927
2006,51,i) 16 to 20,13079,15428,270746,267606,627,4,1026,6.6,35074,9305,25769,3.5,13.1,28793,7497,21296,2.8,10.8,6281,2.3,21.6,0,684,684,5028
2006,51,j) 21 to 25,9825,12846,254673,253918,480,3.7,689,5.3,28851,7022,21829,2.8,11.4,27341,6006,21335,2.4,10.8,1510,0.6,21.6,0,397,397,3062
2006,51,k) 26+,5621,9099,193740,193307,489,5.4,508,5.6,25448,8579,16869,4.4,13.2,24581,8001,16580,4.1,12.7,867,0.5,25.4,0,251,251,1711
2006,51,l) Left Censored,14146,41073,1461055,1445163,2927,7.2,2054,5,181820,55088,126732,3.8,12.6,150037,39053,110984,2.7,10.4,31783,2.2,20.8,0,480,494,6705
2006,53,a) 0,15106,15330,79491,39927,15167,197.9,0,0,79128,79128,0,198.2,198.2,0,0,0,0,0,79128,198.2,0,0,,,
2006,53,b) 1,10414,10548,67310,68122,55,0.4,3361,27.1,18124,655,17469,1,26.6,19747,12499,7248,18.3,29,-1623,-2.4,53.2,0,2531,2531,9955
2006,53,c) 2,8180,8285,57020,57852,342,3.8,1697,18.9,12069,1777,10292,3.1,20.9,13732,7004,6728,12.1,23.7,-1663,-2.8,41.8,0,1325,1325,5907
2006,53,d) 3,6974,7060,52672,53019,295,3.9,1251,16.5,10361,985,9376,1.9,19.5,11055,5709,5346,10.8,20.9,-694,-1.4,39,0,935,935,4711
2006,53,e) 4,6438,6640,56100,56297,231,3.3,950,13.6,10572,1215,9357,2.2,18.8,10965,4856,6109,8.6,19.5,-393,-0.7,37.6,0,710,710,3995
2006,53,f) 5,5736,5938,52770,52141,221,3.6,778,12.5,9517,754,8763,1.4,18.3,8259,3504,4755,6.7,15.8,1258,2.5,31.6,0,572,574,2908
2006,53,g) 6 to 10,23426,25120,254956,252826,1086,4.2,2802,10.8,42458,5668,36790,2.2,16.8,38198,15460,22738,6.1,15.1,4260,1.7,30.2,0,1940,1940,11510
2006,53,h) 11 to 15,15484,16741,190703,189491,698,4,1643,9.5,29915,4721,25194,2.5,15.8,27491,11036,16455,5.8,14.5,2424,1.3,29,0,1133,1133,8434
2006,53,i) 16 to 20,10968,12710,201215,201537,541,4.2,1040,8,24592,5012,19580,2.5,12.2,25235,9103,16132,4.5,12.5,-643,-0.3,24.4,0,681,681,5501
2006,53,j) 21 to 25,8466,11279,232523,227308,482,4.2,685,6,32293,9163,23130,4,14.2,21863,5285,16578,2.3,9.6,10430,4.6,19.2,0,393,393,3373
2006,53,k) 26+,5446,8143,168384,166574,365,4.4,562,6.8,21422,6790,14632,4.1,12.9,17801,6896,10905,4.1,10.7,3621,2.2,21.4,0,317,317,3332
2006,53,l) Left Censored,11404,29338,988060,984893,1755,6,1440,4.9,115679,31602,84077,3.2,11.7,109345,21760,87585,2.2,11.1,6334,0.6,22.2,0,392,395,4425
2006,54,a) 0,2393,2455,16956,8503,2428,197.8,0,0,16907,16907,0,198.8,198.8,0,0,0,0,0,16907,198.8,0,0,,,
2006,54,b) 1,1868,1898,14500,14229,8,0.4,539,24.5,3912,84,3828,0.6,27.5,3369,1751,1618,12.3,23.7,543,3.8,47.4,0,422,422,1464
2006,54,c) 2,1505,1537,11066,11368,61,3.7,293,17.6,2243,201,2042,1.8,19.7,2847,1360,1487,12,25,-604,-5.3,39.4,0,240,240,1217
2006,54,d) 3,1198,1239,10511,10843,47,3.5,215,16.2,1772,330,1442,3,16.3,2435,1014,1421,9.4,22.5,-663,-6.2,32.6,0,168,168,913
2006,54,e) 4,1130,1165,10518,10734,32,2.6,185,14.9,1608,121,1487,1.1,15,2040,897,1143,8.4,19,-432,-4,30,0,142,142,669
2006,54,f) 5,1018,1041,9965,9987,45,4.1,153,13.9,2218,202,2016,2,22.2,2261,1149,1112,11.5,22.6,-43,-0.4,44.4,0,120,120,1073
2006,54,g) 6 to 10,4639,5078,48572,49127,156,2.9,573,10.8,6716,1158,5558,2.4,13.7,7825,3264,4561,6.6,15.9,-1109,-2.2,27.4,0,416,416,2625
2006,54,h) 11 to 15,3446,3740,37519,37438,154,4,357,9.3,6131,1374,4757,3.7,16.4,5969,2124,3845,5.7,15.9,162,0.5,31.8,0,248,248,1464
2006,54,i) 16 to 20,2816,3138,47902,47992,97,3,299,9.2,5745,955,4790,2,12,5925,1957,3968,4.1,12.3,-180,-0.3,24,0,206,206,1644
2006,54,j) 21 to 25,2549,3046,49174,48023,98,3.1,214,6.9,6628,1701,4927,3.5,13.8,4326,1060,3266,2.2,9,2302,4.8,18,0,114,114,803
2006,54,k) 26+,1584,2642,44359,43787,103,3.8,190,7.1,5989,1579,4410,3.6,13.7,4845,1353,3492,3.1,11.1,1144,2.6,22.2,0,84,84,380
2006,54,l) Left Censored,4801,10133,278524,278092,476,4.7,549,5.4,27378,8147,19231,2.9,9.8,26513,7317,19196,2.6,9.5,865,0.3,19,0,190,197,1570
2006,55,a) 0,8710,8956,58880,29508,8883,198.4,0,0,58744,58744,0,199.1,199.1,0,0,0,0,0,58744,199.1,0,0,,,
2006,55,b) 1,6559,6618,47101,49653,42,0.6,1850,24.3,10480,447,10033,0.9,21.1,15584,9938,5646,20,31.4,-5104,-10.3,42.2,0,1413,1413,8625
2006,55,c) 2,5320,5392,46422,47390,184,3.1,1035,17.7,7609,490,7119,1,16.1,9544,4427,5117,9.3,20.1,-1935,-4,32.2,0,779,779,3630
2006,55,d) 3,4726,4836,41200,41251,174,3.4,783,15.2,7461,1236,6225,3,18.1,7562,3402,4160,8.2,18.3,-101,-0.2,36.2,0,601,601,2903
2006,55,e) 4,4612,4749,43022,43959,163,3.2,675,13.4,6441,741,5700,1.7,14.7,8315,3700,4615,8.4,18.9,-1874,-4.2,29.4,0,505,505,2848
2006,55,f) 5,4068,4294,44764,45177,127,2.8,555,12.3,7086,1006,6080,2.2,15.7,7911,3263,4648,7.2,17.5,-825,-1.8,31.4,0,413,413,2842
2006,55,g) 6 to 10,17768,19099,208512,210030,608,3.1,2023,10.2,26851,3896,22955,1.9,12.8,29886,10789,19097,5.1,14.2,-3035,-1.4,25.6,0,1402,1403,8347
2006,55,h) 11 to 15,12887,13953,162658,163661,450,3.1,1233,8.6,20964,5170,15794,3.2,12.8,22970,8029,14941,4.9,14,-2006,-1.2,25.6,0,796,796,6270
2006,55,i) 16 to 20,10055,11776,191792,193259,345,2.9,888,7.4,20806,3198,17608,1.7,10.8,23740,7235,16505,3.7,12.3,-2934,-1.5,21.6,0,584,584,4881
2006,55,j) 21 to 25,7814,9894,171131,172675,368,3.7,609,6.1,18671,5340,13331,3.1,10.8,21758,6982,14776,4,12.6,-3087,-1.8,21.6,0,373,375,4172
2006,55,k) 26+,5207,7986,170002,171144,272,3.3,574,7,16840,4304,12536,2.5,9.8,19124,6135,12989,3.6,11.2,-2284,-1.4,19.6,0,246,246,2505
2006,55,l) Left Censored,15367,33067,1283526,1282513,1729,5.2,1520,4.6,122006,34929,87077,2.7,9.5,119980,24964,95016,1.9,9.4,2026,0.1,18.8,0,554,557,8470
2006,56,a) 0,1662,1692,8605,4340,1665,196.8,0,0,8531,8531,0,196.6,196.6,0,0,0,0,0,8531,196.6,0,0,,,
2006,56,b) 1,1150,1161,6953,6719,6,0.5,314,23.6,2227,13,2214,0.2,33.1,1759,1052,707,15.7,26.2,468,6.9,52.4,0,244,244,877
2006,56,c) 2,885,894,4965,5182,41,4.2,183,18.8,947,131,816,2.5,18.3,1380,655,725,12.6,26.6,-433,-8.3,36.6,0,138,138,534
2006,56,d) 3,778,782,5132,5271,31,3.7,141,16.8,860,77,783,1.5,16.3,1138,573,565,10.9,21.6,-278,-5.3,32.6,0,107,107,452
2006,56,e) 4,816,826,6231,6434,26,3,127,14.4,1064,99,965,1.5,16.5,1469,869,600,13.5,22.8,-405,-6.3,33,0,102,102,675
2006,56,f) 5,660,670,4745,4856,26,3.7,83,11.8,702,86,616,1.8,14.5,923,336,587,6.9,19,-221,-4.5,29,0,50,50,231
2006,56,g) 6 to 10,2772,2907,22838,23103,105,3.5,296,9.8,3450,488,2962,2.1,14.9,3980,1474,2506,6.4,17.2,-530,-2.3,29.8,0,193,193,1114
2006,56,h) 11 to 15,1706,1771,16408,16493,53,2.9,156,8.5,2303,253,2050,1.5,14,2472,652,1820,4,15,-169,-1,28,0,110,110,506
2006,56,i) 16 to 20,1154,1300,19300,19074,60,4.5,92,7,2412,263,2149,1.4,12.6,1960,702,1258,3.7,10.3,452,2.3,20.6,0,70,70,662
2006,56,j) 21 to 25,1101,1310,17497,17218,44,3.3,103,7.7,2357,361,1996,2.1,13.7,1798,708,1090,4.1,10.4,559,3.3,20.8,0,55,55,277
2006,56,k) 26+,798,1114,17821,17410,54,4.8,64,5.7,2375,859,1516,4.9,13.6,1553,350,1203,2,8.9,822,4.7,17.8,0,39,39,248
2006,56,l) Left Censored,1728,3200,71452,68912,168,5.2,224,6.9,10265,3551,6714,5.2,14.9,5185,1652,3533,2.4,7.5,5080,7.4,15,0,54,58,675
2007,01,a) 0,6776,6867,43383,22038,6718,195.7,0,0,42691,42691,0,193.7,193.7,0,0,0,0,0,42691,193.7,0,0,,,
2007,01,b) 1,5141,5318,44940,47274,42,0.7,1519,24.8,13385,2102,11283,4.4,28.3,18052,8544,9508,18.1,38.2,-4667,-9.9,56.6,0,1266,1294,7696
2007,01,c) 2,4348,4478,39938,41083,166,3.5,807,16.9,7407,1090,6317,2.7,18,9697,3970,5727,9.7,23.6,-2290,-5.6,36,0,666,666,3370
2007,01,d) 3,3785,3913,35503,36288,179,4.4,594,14.5,6605,764,5841,2.1,18.2,8175,3880,4295,10.7,22.5,-1570,-4.3,36.4,0,497,497,3550
2007,01,e) 4,3377,3534,32620,32631,132,3.6,414,11.3,5952,975,4977,3,18.2,5973,2596,3377,8,18.3,-21,-0.1,36.4,0,344,345,2130
2007,01,f) 5,3024,3143,29746,30771,116,3.6,325,10.1,4041,758,3283,2.5,13.1,6091,2455,3636,8,19.8,-2050,-6.7,26.2,0,251,251,1649
2007,01,g) 6 to 10,12434,13437,166262,167240,495,3.6,1367,9.9,27263,5023,22240,3,16.3,29219,9618,19601,5.8,17.5,-1956,-1.2,32.6,0,995,1007,5982
2007,01,h) 11 to 15,9001,9747,118570,119956,306,3.1,809,8.1,16071,1946,14125,1.6,13.4,18842,6941,11901,5.8,15.7,-2771,-2.3,26.8,0,565,578,3308
2007,01,i) 16 to 20,6663,8037,151721,154323,309,3.8,519,6.4,16406,3241,13165,2.1,10.6,21609,5233,16376,3.4,14,-5203,-3.4,21.2,0,318,321,2211
2007,01,j) 21 to 25,5889,7603,144811,145138,378,4.9,466,6.1,19514,4400,15114,3,13.4,20168,6015,14153,4.1,13.9,-654,-0.5,26.8,0,225,229,1523
2007,01,k) 26+,4286,7148,144253,143165,370,5.2,366,5.1,19784,5093,14691,3.6,13.8,17608,3991,13617,2.8,12.3,2176,1.5,24.6,0,179,182,1730
2007,01,l) Left Censored,8518,23301,766422,766460,1878,8.1,1481,6.4,96150,34778,61372,4.5,12.5,96225,27644,68581,3.6,12.6,-75,-0.1,25,0,290,315,3945
2007,02,a) 0,1307,1319,6140,3159,1258,190.8,0,0,5963,5963,0,188.8,188.8,0,0,0,0,0,5963,188.8,0,0,,,
2007,02,b) 1,977,1010,6114,6281,11,0.9,352,29.4,1591,151,1440,2.4,25.3,1925,1006,919,16,30.6,-334,-5.3,50.6,0,230,230,646
2007,02,c) 2,771,786,4802,5056,43,5.2,140,16.9,1085,187,898,3.7,21.5,1593,698,895,13.8,31.5,-508,-10,43,0,101,101,573
2007,02,d) 3,738,754,4563,4851,40,5,130,16.4,792,133,659,2.7,16.3,1368,499,869,10.3,28.2,-576,-11.9,32.6,0,89,89,354
2007,02,e) 4,630,669,5315,5242,29,4.1,111,15.7,1208,159,1049,3,23,1061,480,581,9.2,20.2,147,2.8,40.4,0,72,72,343
2007,02,f) 5,638,666,5493,6037,30,4.2,114,16.1,776,85,691,1.4,12.9,1864,706,1158,11.7,30.9,-1088,-18,25.8,0,76,76,486
2007,02,g) 6 to 10,2425,2582,28813,29297,143,5.4,281,10.6,4111,699,3412,2.4,14,5078,1405,3673,4.8,17.3,-967,-3.3,28,0,165,167,928
2007,02,h) 11 to 15,1601,1676,13315,13677,70,4,183,10.6,1972,262,1710,1.9,14.4,2695,921,1774,6.7,19.7,-723,-5.3,28.8,0,107,108,522
2007,02,i) 16 to 20,1229,1349,19872,20369,43,3.1,125,9,2463,218,2245,1.1,12.1,3456,666,2790,3.3,17,-993,-4.9,24.2,0,68,69,277
2007,02,j) 21 to 25,1168,1442,21063,21415,58,3.9,127,8.6,2615,710,1905,3.3,12.2,3318,1058,2260,4.9,15.5,-703,-3.3,24.4,0,59,63,381
2007,02,k) 26+,841,1414,33018,32654,80,5.6,99,6.9,7970,4351,3619,13.3,24.4,7242,1038,6204,3.2,22.2,728,2.2,44.4,0,32,34,230
2007,02,l) Left Censored,1331,3267,93412,92271,228,7,175,5.4,13701,2539,11162,2.8,14.8,11419,2561,8858,2.8,12.4,2282,2.4,24.8,0,29,30,195
2007,04,a) 0,11958,12039,70219,35767,11724,194.8,0,0,68905,68905,0,192.6,192.6,0,0,0,0,0,68905,192.6,0,0,,,
2007,04,b) 1,9647,9868,77677,81632,112,1,2842,24.9,21075,2961,18114,3.6,25.8,28984,17356,11628,21.3,35.5,-7909,-9.7,51.6,0,2237,2237,13937
2007,04,c) 2,7412,7658,68621,73067,316,3.8,1428,17.3,13249,2147,11102,2.9,18.1,22141,10436,11705,14.3,30.3,-8892,-12.2,36.2,0,1138,1138,9021
2007,04,d) 3,6073,6272,61566,64275,233,3.5,937,14.2,10891,1484,9407,2.3,16.9,16308,7564,8744,11.8,25.4,-5417,-8.5,33.8,0,742,746,6198
2007,04,e) 4,5137,5450,60914,61154,254,4.5,763,13.4,13541,3103,10438,5.1,22.1,14020,6037,7983,9.9,22.9,-479,-0.8,44.2,0,579,580,4623
2007,04,f) 5,4497,4615,54170,56902,147,3,581,12,7929,708,7221,1.2,13.9,13393,5328,8065,9.4,23.5,-5464,-9.6,27.8,0,448,448,3025
2007,04,g) 6 to 10,17193,18449,283749,287321,838,4.4,2077,10.9,47722,10298,37424,3.6,16.6,54866,17973,36893,6.3,19.1,-7144,-2.5,33.2,0,1410,1420,11103
2007,04,h) 11 to 15,10318,11370,173062,178085,480,4.1,1099,9.4,22874,4806,18068,2.7,12.8,32919,9088,23831,5.1,18.5,-10045,-5.7,25.6,0,701,701,5484
2007,04,i) 16 to 20,7108,9515,198024,198074,520,5.4,724,7.5,31272,7621,23651,3.8,15.8,31372,8781,22591,4.4,15.8,-100,0,31.6,0,383,389,3553
2007,04,j) 21 to 25,5685,8325,182447,183233,501,5.9,680,8.1,28415,6590,21825,3.6,15.5,29986,5660,24326,3.1,16.4,-1571,-0.9,31,0,292,302,2844
2007,04,k) 26+,3998,6813,210600,200833,505,7.4,460,6.8,45265,12462,32803,6.2,22.5,25731,6044,19687,3,12.8,19534,9.7,25.6,0,198,214,2022
2007,04,l) Left Censored,6341,23386,933415,919804,2442,10.6,1739,7.5,157375,44547,112828,4.8,17.1,130152,38579,91573,4.2,14.1,27223,3,28.2,0,195,216,1579
2007,05,a) 0,4304,4323,24920,12574,4226,195.5,0,0,24692,24692,0,196.4,196.4,0,0,0,0,0,24692,196.4,0,0,,,
2007,05,b) 1,3450,3642,26458,27784,33,0.8,1067,25.3,6561,882,5679,3.2,23.6,9213,5151,4062,18.5,33.2,-2652,-9.6,47.2,0,878,878,4410
2007,05,c) 2,2909,2965,21761,22488,115,3.6,577,18,4185,829,3356,3.7,18.6,5639,2655,2984,11.8,25.1,-1454,-6.5,37.2,0,463,463,2240
2007,05,d) 3,2482,2588,19821,20548,96,3.5,417,15.2,3615,780,2835,3.8,17.6,5069,2069,3000,10.1,24.7,-1454,-7.1,35.2,0,337,337,1638
2007,05,e) 4,2236,2340,19391,19750,65,2.7,292,11.9,3961,1037,2924,5.3,20.1,4679,2151,2528,10.9,23.7,-718,-3.6,40.2,0,241,241,1974
2007,05,f) 5,2038,2164,20345,20732,68,3,266,11.8,3414,1110,2304,5.4,16.5,4187,1946,2241,9.4,20.2,-773,-3.7,33,0,211,211,1549
2007,05,g) 6 to 10,7944,8638,75056,77075,336,3.8,866,9.7,10906,2069,8837,2.7,14.1,14943,5868,9075,7.6,19.4,-4037,-5.3,28.2,0,622,627,4159
2007,05,h) 11 to 15,5799,6346,71570,72155,192,2.9,530,8.1,9363,1692,7671,2.3,13,10533,2611,7922,3.6,14.6,-1170,-1.6,26,0,385,386,1823
2007,05,i) 16 to 20,4033,4890,78422,78736,174,3.5,359,7.2,9814,1881,7933,2.4,12.5,10442,3116,7326,4,13.3,-628,-0.8,25,0,223,226,1512
2007,05,j) 21 to 25,3624,4453,73886,78914,215,4.8,276,6.1,7040,2122,4918,2.7,8.9,17096,4550,12546,5.8,21.7,-10056,-12.8,17.8,0,144,146,831
2007,05,k) 26+,2877,4328,97597,98985,212,4.9,219,5.1,10203,3275,6928,3.3,10.3,12978,2839,10139,2.9,13.1,-2775,-2.8,20.6,0,105,109,945
2007,05,l) Left Censored,5703,14356,501153,503508,998,7,772,5.4,57795,15311,42484,3,11.5,62506,13187,49319,2.6,12.4,-4711,-0.9,23,0,182,187,1355
2007,06,a) 0,68483,68801,376016,190690,67287,195.6,0,0,370652,370652,0,194.4,194.4,0,0,0,0,0,370652,194.4,0,0,,,
2007,06,b) 1,56462,57769,439640,455338,418,0.6,16272,24.4,108862,6430,102432,1.4,23.9,140257,73359,66898,16.1,30.8,-31395,-6.9,47.8,0,13009,13015,59741
2007,06,c) 2,45642,47610,400380,423022,1942,3.8,9065,17.7,79736,13851,65885,3.3,18.8,125019,50884,74135,12,29.6,-45283,-10.8,37.6,0,7099,7192,40682
2007,06,d) 3,37505,38322,347934,362296,1409,3.4,6370,15.6,64254,9841,54413,2.7,17.7,92977,41179,51798,11.4,25.7,-28723,-8,35.4,0,5036,5036,33152
2007,06,e) 4,33254,34557,349248,359769,1429,3.9,4979,13.7,66807,11046,55761,3.1,18.6,87849,32710,55139,9.1,24.4,-21042,-5.8,37.2,0,3861,3862,23940
2007,06,f) 5,29833,30860,320839,331261,1183,3.7,3962,12.3,50345,7828,42517,2.4,15.2,71188,26382,44806,8,21.5,-20843,-6.3,30.4,0,2868,2877,17983
2007,06,g) 6 to 10,109540,117058,1393669,1426009,4992,4.1,13410,11.1,220097,43763,176334,3.1,15.4,284776,103889,180887,7.3,20,-64679,-4.6,30.8,0,8950,9134,66572
2007,06,h) 11 to 15,66599,72302,1033319,1055014,2866,3.9,6962,9.4,150004,30746,119258,2.9,14.2,193393,62745,130648,5.9,18.3,-43389,-4.1,28.4,0,4747,4791,34341
2007,06,i) 16 to 20,55801,66509,1200785,1209277,3066,4.5,5710,8.4,168247,36062,132185,3,13.9,185230,54969,130261,4.5,15.3,-16983,-1.4,27.8,0,3447,3490,25439
2007,06,j) 21 to 25,43277,56519,1115219,1123225,2687,4.7,4669,8.1,159996,51056,108940,4.5,14.2,176008,52747,123261,4.7,15.7,-16012,-1.5,28.4,0,2322,2368,20231
2007,06,k) 26+,33914,52157,1241698,1242330,2642,5,3822,7.2,164225,41386,122839,3.3,13.2,165489,43726,121763,3.5,13.3,-1264,-0.1,26.4,0,1720,1769,12517
2007,06,l) Left Censored,46786,140627,5489418,5481422,11516,8.2,10819,7.7,708451,215186,493265,3.9,12.9,692461,203006,489455,3.7,12.6,15990,0.3,25.2,0,1939,2059,21112
2007,08,a) 0,12449,12470,64245,32661,12086,193.8,0,0,63169,63169,0,193.4,193.4,0,0,0,0,0,63169,193.4,0,0,,,
2007,08,b) 1,9513,9698,62916,64613,70,0.6,2940,26,16482,1262,15220,2,25.5,19876,11430,8446,17.7,30.8,-3394,-5.3,51,0,2183,2183,9102
2007,08,c) 2,8089,8204,57932,58726,358,4.1,1605,18.2,12544,2048,10496,3.5,21.4,14132,6983,7149,11.9,24.1,-1588,-2.7,42.8,0,1203,1203,5613
2007,08,d) 3,6605,6730,47971,49268,312,4.4,1125,15.8,9678,1414,8264,2.9,19.6,12271,5993,6278,12.2,24.9,-2593,-5.3,39.2,0,853,853,4780
2007,08,e) 4,5909,6135,49174,49413,298,4.7,837,13.1,10554,1800,8754,3.6,21.4,11031,5758,5273,11.7,22.3,-477,-0.9,42.8,0,615,615,4796
2007,08,f) 5,5283,5447,44344,45402,254,4.5,756,13.3,7511,1301,6210,2.9,16.5,9627,3906,5721,8.6,21.2,-2116,-4.7,33,0,515,520,2575
2007,08,g) 6 to 10,20848,22014,216701,222508,984,4.3,2549,11.2,34326,6531,27795,2.9,15.4,45940,18982,26958,8.5,20.6,-11614,-5.2,30.8,0,1621,1632,11739
2007,08,h) 11 to 15,13119,14076,161790,163885,597,4.1,1371,9.5,22916,4970,17946,3,14,27106,9968,17138,6.1,16.5,-4190,-2.5,28,0,875,878,6054
2007,08,i) 16 to 20,8526,10267,167427,168624,505,4.8,879,8.4,23088,6376,16712,3.8,13.7,25482,7718,17764,4.6,15.1,-2394,-1.4,27.4,0,472,474,3826
2007,08,j) 21 to 25,6663,8813,166259,166090,504,5.7,639,7.2,27963,10443,17520,6.3,16.8,27624,7734,19890,4.7,16.6,339,0.2,33.2,0,303,307,3406
2007,08,k) 26+,5124,8117,190196,189174,541,6.7,540,6.7,29259,9790,19469,5.2,15.5,27215,6701,20514,3.5,14.4,2044,1.1,28.8,0,231,255,1273
2007,08,l) Left Censored,8198,23357,811215,802613,2158,9.3,1752,7.6,116687,38871,77816,4.8,14.5,99482,26898,72584,3.4,12.4,17205,2.1,24.8,0,266,280,3244
2007,09,a) 0,4930,4958,34948,17741,4822,194.5,0,0,34414,34414,0,194,194,0,0,0,0,0,34414,194,0,0,,,
2007,09,b) 1,4134,4326,30566,30907,27,0.5,1143,23.1,7589,491,7098,1.6,24.6,8270,4180,4090,13.5,26.8,-681,-2.2,49.2,0,879,879,3333
2007,09,c) 2,3658,3727,30929,31545,133,3.3,672,16.9,5910,671,5239,2.1,18.7,7142,2868,4274,9.1,22.6,-1232,-3.9,37.4,0,554,554,2337
2007,09,d) 3,3042,3100,22574,23450,130,4,494,15.1,4524,501,4023,2.1,19.3,6276,3898,2378,16.6,26.8,-1752,-7.5,38.6,0,385,385,3579
2007,09,e) 4,2632,2710,24789,25493,111,3.9,401,14.1,5251,1025,4226,4,20.6,6658,3785,2873,14.8,26.1,-1407,-5.5,41.2,0,312,312,1460
2007,09,f) 5,2624,2714,25832,26782,107,3.8,367,12.9,4203,1175,3028,4.4,15.7,6103,3253,2850,12.1,22.8,-1900,-7.1,31.4,0,262,263,1823
2007,09,g) 6 to 10,10845,11456,136433,137025,406,3.4,1220,10.3,22137,4525,17612,3.3,16.2,23321,8187,15134,6,17,-1184,-0.8,32.4,0,856,858,5249
2007,09,h) 11 to 15,8054,8449,90876,92477,279,3.2,707,8.2,11452,2110,9342,2.3,12.4,14654,4915,9739,5.3,15.8,-3202,-3.4,24.8,0,489,492,2920
2007,09,i) 16 to 20,7286,8099,121302,123854,266,3.2,604,7.3,15320,4253,11067,3.4,12.4,20424,4887,15537,3.9,16.5,-5104,-4.1,24.8,0,373,374,2749
2007,09,j) 21 to 25,5900,7102,103484,104537,291,4,476,6.6,12014,4261,7753,4.1,11.5,14119,3585,10534,3.4,13.5,-2105,-2,23,0,265,271,2080
2007,09,k) 26+,4404,6144,124394,124642,351,5.7,411,6.7,17353,5079,12274,4.1,13.9,17849,4114,13735,3.3,14.3,-496,-0.4,27.8,0,189,198,1026
2007,09,l) Left Censored,10716,21405,791037,802536,1446,6.8,1368,6.4,85770,24610,61160,3.1,10.7,108767,21595,87172,2.7,13.6,-22997,-2.9,21.4,0,328,358,3555
2007,10,a) 0,1497,1521,11588,5856,1479,194.5,0,0,11465,11465,0,195.8,195.8,0,0,0,0,0,11465,195.8,0,0,,,
2007,10,b) 1,1234,1252,8452,8947,9,0.6,383,26.2,1992,130,1862,1.5,22.3,2982,1779,1203,19.9,33.3,-990,-11,44.6,0,283,283,1370
2007,10,c) 2,1055,1059,6877,7231,28,2.4,222,19.2,1383,137,1246,1.9,19.1,2090,1181,909,16.3,28.9,-707,-9.8,38.2,0,168,168,842
2007,10,d) 3,940,953,7545,7686,27,2.6,171,16.8,1369,133,1236,1.7,17.8,1651,854,797,11.1,21.5,-282,-3.7,35.6,0,123,123,679
2007,10,e) 4,895,921,7017,7367,38,3.9,130,13.4,1118,207,911,2.8,15.2,1817,790,1027,10.7,24.7,-699,-9.5,30.4,0,102,102,712
2007,10,f) 5,746,776,5989,6475,24,2.9,102,12.5,747,231,516,3.6,11.5,1719,655,1064,10.1,26.5,-972,-15,23,0,80,80,554
2007,10,g) 6 to 10,3046,3181,29600,30789,162,4.9,398,12.1,4033,1044,2989,3.4,13.1,6411,2461,3950,8,20.8,-2378,-7.7,26.2,0,288,289,1585
2007,10,h) 11 to 15,1998,2196,26062,27172,99,4.4,191,8.5,3293,1155,2138,4.3,12.1,5512,2699,2813,9.9,20.3,-2219,-8.2,24.2,0,137,137,2223
2007,10,i) 16 to 20,1608,1800,23479,24101,75,4.1,148,8.1,2952,775,2177,3.2,12.2,4195,1666,2529,6.9,17.4,-1243,-5.2,24.4,0,95,96,794
2007,10,j) 21 to 25,1229,1510,24542,24589,79,5.2,106,7,3160,543,2617,2.2,12.9,3254,655,2599,2.7,13.2,-94,-0.3,25.8,0,40,40,143
2007,10,k) 26+,965,1354,33048,33834,67,4.9,104,7.6,2649,608,2041,1.8,7.8,4220,936,3284,2.8,12.5,-1571,-4.7,15.6,0,36,36,351
2007,10,l) Left Censored,2823,6112,198551,197833,607,10,467,7.7,34810,14736,20074,7.4,17.6,33373,11553,21820,5.8,16.9,1437,0.7,33.8,0,41,41,429
2007,11,a) 0,1083,1084,6178,3147,1063,196.1,0,0,6062,6062,0,192.6,192.6,0,0,0,0,0,6062,192.6,0,0,,,
2007,11,b) 1,922,933,7531,7653,4,0.4,225,21.3,2277,17,2260,0.2,29.8,2520,1412,1108,18.5,32.9,-243,-3.1,59.6,0,179,179,1216
2007,11,c) 2,1068,1076,8286,8370,40,3.5,169,14.8,1772,113,1659,1.4,21.2,1940,666,1274,8,23.2,-168,-2,42.4,0,137,137,522
2007,11,d) 3,400,402,5372,5137,16,3.9,42,10.1,1076,189,887,3.7,20.9,605,283,322,5.5,11.8,471,9.1,23.6,0,34,34,231
2007,11,e) 4,571,596,6601,6127,23,3.8,62,10.1,1639,566,1073,9.2,26.8,691,256,435,4.2,11.3,948,15.5,22.6,0,44,44,210
2007,11,f) 5,605,622,7321,7566,16,2.4,87,13.3,1227,154,1073,2,16.2,1716,843,873,11.1,22.7,-489,-6.5,32.4,0,62,62,395
2007,11,g) 6 to 10,2445,2596,42462,41889,104,3.9,245,9.2,6990,960,6030,2.3,16.7,5844,1984,3860,4.7,14,1146,2.7,28,0,168,169,1387
2007,11,h) 11 to 15,1701,1802,32979,33454,64,3.5,154,8.3,4713,1063,3650,3.2,14.1,5662,1386,4276,4.1,16.9,-949,-2.8,28.2,0,91,92,978
2007,11,i) 16 to 20,1444,1630,29903,29436,104,6.4,113,6.9,5042,1280,3762,4.3,17.1,4107,1063,3044,3.6,14,935,3.1,28,0,57,57,395
2007,11,j) 21 to 25,1333,1601,30256,29566,91,5.6,133,8.2,4923,761,4162,2.6,16.7,3542,1445,2097,4.9,12,1381,4.7,24,0,46,46,516
2007,11,k) 26+,1109,1470,62016,60934,82,5.6,90,6.1,6926,1000,5926,1.6,11.4,4762,929,3833,1.5,7.8,2164,3.6,15.6,0,33,33,379
2007,11,l) Left Censored,3023,5855,227841,224802,534,9.2,459,7.9,33219,11592,21627,5.2,14.8,27140,9109,18031,4.1,12.1,6079,2.7,24.2,0,84,86,1133
2007,12,a) 0,45958,46322,252242,128078,44901,193.9,0,0,248329,248329,0,193.9,193.9,0,0,0,0,0,248329,193.9,0,0,,,
2007,12,b) 1,35885,36433,241571,259337,162,0.4,12850,29.5,58693,3288,55405,1.3,22.6,94225,49196,45029,19,36.3,-35532,-13.7,45.2,0,10300,10345,41747
2007,12,c) 2,30811,31456,216764,229112,1273,3.7,7141,20.8,49417,5931,43486,2.6,21.6,74112,30533,43579,13.3,32.3,-24695,-10.7,43.2,0,5754,5754,25967
2007,12,d) 3,27840,28286,189304,202631,1017,3.3,5173,17,33973,6461,27512,3.2,16.8,60627,29023,31604,14.3,29.9,-26654,-13.1,33.6,0,4109,4113,24528
2007,12,e) 4,20916,21542,191554,196654,845,3.7,3352,14.7,33398,6028,27370,3.1,17,43598,17635,25963,9,22.2,-10200,-5.2,34,0,2614,2615,13556
2007,12,f) 5,17443,17955,173189,175509,727,3.9,2481,13.2,31475,7856,23619,4.5,17.9,36115,14154,21961,8.1,20.6,-4640,-2.7,35.8,0,1869,1874,9520
2007,12,g) 6 to 10,62754,66351,700696,720077,2712,3.9,7824,11.4,103309,26245,77064,3.6,14.3,142072,59157,82915,8.2,19.7,-38763,-5.4,28.6,0,5478,5525,43241
2007,12,h) 11 to 15,40802,44367,614589,631775,1713,3.8,4133,9.1,81114,20912,60202,3.3,12.8,115485,30263,85222,4.8,18.3,-34371,-5.5,25.6,0,2860,2877,19628
2007,12,i) 16 to 20,29189,34962,570679,574619,1509,4.2,2898,8.1,79076,19627,59449,3.4,13.8,86956,23545,63411,4.1,15.1,-7880,-1.3,27.6,0,1771,1795,11701
2007,12,j) 21 to 25,20535,26724,560804,568199,1433,5.3,2085,7.7,70558,19710,50848,3.5,12.4,85347,25837,59510,4.5,15,-14789,-2.6,24.8,0,1041,1077,7802
2007,12,k) 26+,13473,22294,521617,519417,1464,6.5,1659,7.4,78867,25327,53540,4.9,15.2,74467,17641,56826,3.4,14.3,4400,0.9,28.6,0,703,738,5425
2007,12,l) Left Censored,20207,76281,2855584,2882059,7661,10.2,5835,7.7,396804,120456,276348,4.2,13.8,449755,154887,294868,5.4,15.6,-52951,-1.8,27.6,0,830,899,8412
2007,13,a) 0,18076,18219,105733,53646,17724,194.6,0,0,104175,104175,0,194.2,194.2,0,0,0,0,0,104175,194.2,0,0,,,
2007,13,b) 1,13732,14001,104788,111282,87,0.5,4000,24.7,24115,1511,22604,1.4,21.7,37103,18749,18354,16.8,33.3,-12988,-11.6,43.4,0,3114,3135,14791
2007,13,c) 2,11581,11891,98354,100899,503,3.9,2179,17.1,22165,4363,17802,4.3,22,27254,13055,14199,12.9,27,-5089,-5,44,0,1758,1758,9882
2007,13,d) 3,9706,9884,85233,88494,383,3.7,1597,15.3,14508,2127,12381,2.4,16.4,21029,10202,10827,11.5,23.8,-6521,-7.4,32.8,0,1259,1259,7687
2007,13,e) 4,8293,8625,77585,77913,323,3.6,1210,13.4,15553,2226,13327,2.9,20,16208,7131,9077,9.2,20.8,-655,-0.8,40,0,941,941,5146
2007,13,f) 5,7418,7745,85483,88330,353,4.4,1010,12.5,12220,3058,9162,3.5,13.8,17913,5713,12200,6.5,20.3,-5693,-6.5,27.6,0,768,769,4268
2007,13,g) 6 to 10,28914,30959,371554,376731,1236,3.9,3599,11.2,57946,10774,47172,2.9,15.4,68300,26506,41794,7,18.1,-10354,-2.7,30.8,0,2386,2464,17417
2007,13,h) 11 to 15,18179,19944,258278,263655,896,4.4,1762,8.6,35998,9068,26930,3.4,13.7,46752,14951,31801,5.7,17.7,-10754,-4,27.4,0,1189,1201,7867
2007,13,i) 16 to 20,12229,15177,287868,289186,651,4.2,1210,7.8,38597,9550,29047,3.3,13.3,41233,13187,28046,4.6,14.3,-2636,-1,26.6,0,714,735,6014
2007,13,j) 21 to 25,10154,12918,249491,249999,606,4.6,909,7,33542,7030,26512,2.8,13.4,34558,9500,25058,3.8,13.8,-1016,-0.4,26.8,0,442,453,3498
2007,13,k) 26+,6943,11505,312373,304189,713,6.2,778,6.7,57156,11936,45220,3.9,18.8,40787,10727,30060,3.5,13.4,16369,5.4,26.8,0,331,336,4259
2007,13,l) Left Censored,13254,43090,1608992,1612303,3723,8.7,2718,6.4,199963,68499,131464,4.2,12.4,206585,55991,150594,3.5,12.8,-6622,-0.4,24.8,0,423,488,7161
2007,15,a) 0,2016,2020,12206,6145,1968,194.9,0,0,12123,12123,0,197.3,197.3,0,0,0,0,0,12123,197.3,0,0,,,
2007,15,b) 1,1613,1678,13878,14044,20,1,446,23.3,3586,324,3262,2.3,25.5,3918,2120,1798,15.1,27.9,-332,-2.4,51,0,356,356,1785
2007,15,c) 2,1364,1379,12678,13285,47,3.2,252,17,2670,576,2094,4.3,20.1,3884,1695,2189,12.8,29.2,-1214,-9.1,40.2,0,215,216,1525
2007,15,d) 3,1209,1248,10197,10703,41,3.1,187,14.2,2033,160,1873,1.5,19,3044,1683,1361,15.7,28.4,-1011,-9.4,38,0,149,149,997
2007,15,e) 4,1108,1225,12583,12981,52,4.1,144,11.4,2053,427,1626,3.3,15.8,2849,1019,1830,7.8,21.9,-796,-6.1,31.6,0,96,99,648
2007,15,f) 5,1032,1076,11007,11375,36,3.3,104,9.4,1835,381,1454,3.3,16.1,2570,957,1613,8.4,22.6,-735,-6.5,32.2,0,83,83,564
2007,15,g) 6 to 10,3788,4030,42052,44182,154,3.7,391,9.4,5707,938,4769,2.1,12.9,9966,5085,4881,11.5,22.6,-4259,-9.7,25.8,0,264,271,4248
2007,15,h) 11 to 15,2691,2902,38932,38621,91,3.1,224,7.5,6244,977,5267,2.5,16.2,5622,1302,4320,3.4,14.6,622,1.6,29.2,0,143,146,816
2007,15,i) 16 to 20,2372,2762,42362,41672,109,3.9,199,7.1,6971,1218,5753,2.9,16.7,5591,2388,3203,5.7,13.4,1380,3.3,26.8,0,114,114,1206
2007,15,j) 21 to 25,1891,2345,39851,40536,92,3.8,184,7.7,5306,1665,3641,4.1,13.1,6676,3555,3121,8.8,16.5,-1370,-3.4,26.2,0,82,82,1378
2007,15,k) 26+,1809,2644,52448,52140,135,5.1,189,7.1,6120,928,5192,1.8,11.7,5504,2247,3257,4.3,10.6,616,1.1,21.2,0,46,48,525
2007,15,l) Left Censored,3169,7069,229056,227315,431,6.1,484,6.8,27061,8256,18805,3.6,11.9,23578,7319,16259,3.2,10.4,3483,1.5,20.8,0,88,93,553
2007,16,a) 0,4349,4365,21156,10737,4249,194.7,0,0,20838,20838,0,194.1,194.1,0,0,0,0,0,20838,194.1,0,0,,,
2007,16,b) 1,3525,3590,22140,22500,19,0.5,1035,24.9,6216,431,5785,1.9,27.6,6935,3894,3041,17.3,30.8,-719,-3.2,55.2,0,798,800,3267
2007,16,c) 2,2611,2642,18207,18769,119,4.2,438,15.6,3758,497,3261,2.6,20,4882,2060,2822,11,26,-1124,-6,40,0,338,338,1650
2007,16,d) 3,2051,2092,16045,16424,88,4,296,13.5,2885,307,2578,1.9,17.6,3642,1747,1895,10.6,22.2,-757,-4.6,35.2,0,226,226,1532
2007,16,e) 4,1704,1791,13783,14367,71,3.8,252,13.4,2463,366,2097,2.5,17.1,3631,2035,1596,14.2,25.3,-1168,-8.2,34.2,0,186,186,1022
2007,16,f) 5,1513,1551,21090,20741,55,3.4,179,11.1,3111,403,2708,1.9,15,2412,933,1479,4.5,11.6,699,3.4,23.2,0,135,135,738
2007,16,g) 6 to 10,6101,6482,61090,63236,293,4.4,683,10.2,9995,1770,8225,2.8,15.8,14287,6484,7803,10.3,22.6,-4292,-6.8,31.6,0,452,455,4545
2007,16,h) 11 to 15,3833,4005,39673,40516,188,4.6,357,8.7,5464,1217,4247,3,13.5,7149,2474,4675,6.1,17.6,-1685,-4.1,27,0,214,214,1360
2007,16,i) 16 to 20,2419,2796,38512,38370,149,5.3,228,8,6177,1624,4553,4.2,16.1,5893,1970,3923,5.1,15.4,284,0.7,30.8,0,150,150,972
2007,16,j) 21 to 25,1859,2405,45681,49593,127,5.2,167,6.9,8694,1423,7271,2.9,17.5,16518,1589,14929,3.2,33.3,-7824,-15.8,35,0,92,94,480
2007,16,k) 26+,1542,2222,53983,53006,128,5.8,125,5.6,6950,1414,5536,2.7,13.1,4996,1026,3970,1.9,9.4,1954,3.7,18.8,0,66,68,465
2007,16,l) Left Censored,2953,6967,194777,195675,535,7.8,387,5.6,23700,8819,14881,4.5,12.1,25495,6750,18745,3.4,13,-1795,-0.9,24.2,0,71,75,2564
2007,17,a) 0,19724,19824,115225,58358,19245,194.2,0,0,113735,113735,0,194.9,194.9,0,0,0,0,0,113735,194.9,0,0,,,
2007,17,b) 1,15733,16126,120381,123481,111,0.6,4417,23.9,28836,1502,27334,1.2,23.4,35035,19090,15945,15.5,28.4,-6199,-5,46.8,0,3178,3178,15084
2007,17,c) 2,13683,13984,116403,118685,528,3.5,2428,16.3,23659,4320,19339,3.6,19.9,28222,13913,14309,11.7,23.8,-4563,-3.9,39.8,0,1862,1862,11538
2007,17,d) 3,11851,12060,96248,98874,452,3.6,1854,14.6,17404,2504,14900,2.5,17.6,22656,11124,11532,11.3,22.9,-5252,-5.3,35.2,0,1409,1409,9275
2007,17,e) 4,10383,11015,106046,110245,420,3.7,1366,11.9,21483,3205,18278,2.9,19.5,29880,11924,17956,10.8,27.1,-8397,-7.6,39,0,1010,1010,9869
2007,17,f) 5,9189,9473,88452,91929,373,3.8,1194,12.1,14212,2040,12172,2.2,15.5,21166,9152,12014,10,23,-6954,-7.5,31,0,816,831,6434
2007,17,g) 6 to 10,38351,40832,467378,477631,1551,3.7,4294,10.2,73694,12731,60963,2.7,15.4,94199,36046,58153,7.5,19.7,-20505,-4.3,30.8,0,2812,2836,21029
2007,17,h) 11 to 15,27780,29569,353651,364362,1053,3.5,2593,8.6,43885,9649,34236,2.6,12,65307,22759,42548,6.2,17.9,-21422,-5.9,24,0,1690,1699,15287
2007,17,i) 16 to 20,21646,25177,425799,427793,1030,4,1858,7.3,50990,10405,40585,2.4,11.9,54978,14612,40366,3.4,12.9,-3988,-1,23.8,0,1135,1142,7985
2007,17,j) 21 to 25,17496,21619,444905,447342,943,4.3,1586,7.2,53899,13789,40110,3.1,12,58773,15917,42856,3.6,13.1,-4874,-1.1,24,0,831,861,6108
2007,17,k) 26+,13297,19448,457068,454755,937,4.8,1277,6.5,57514,18215,39299,4,12.6,52888,13432,39456,3,11.6,4626,1,23.2,0,595,629,5345
2007,17,l) Left Censored,29013,67926,2570478,2572392,4621,6.8,4465,6.6,314832,88776,226056,3.5,12.2,318660,83038,235622,3.2,12.4,-3828,-0.2,24.4,0,967,1016,10900
2007,18,a) 0,8635,8717,56343,28465,8509,195.2,0,0,55756,55756,0,195.9,195.9,0,0,0,0,0,55756,195.9,0,0,,,
2007,18,b) 1,7116,7399,57169,61336,53,0.6,1968,23.3,13336,1065,12271,1.7,21.7,21669,11989,9680,19.5,35.3,-8333,-13.6,43.4,0,1541,1541,10368
2007,18,c) 2,5774,5918,49548,53477,224,3.5,1063,16.8,8911,1419,7492,2.7,16.7,16768,10160,6608,19,31.4,-7857,-14.7,33.4,0,838,843,5850
2007,18,d) 3,5093,5193,43110,44492,189,3.4,837,15.2,6938,1085,5853,2.4,15.6,9701,4485,5216,10.1,21.8,-2763,-6.2,31.2,0,674,674,3779
2007,18,e) 4,4454,4650,41924,42856,197,4.1,626,12.9,7649,1097,6552,2.6,17.8,9512,4521,4991,10.5,22.2,-1863,-4.4,35.6,0,481,481,3603
2007,18,f) 5,4285,4404,44328,45775,157,3.4,566,12.3,5870,1122,4748,2.5,12.8,8764,3859,4905,8.4,19.1,-2894,-6.3,25.6,0,418,421,2770
2007,18,g) 6 to 10,17144,18574,204948,208683,672,3.5,2006,10.4,31243,6422,24821,3.1,15,38713,12884,25829,6.2,18.6,-7470,-3.6,30,0,1408,1423,8867
2007,18,h) 11 to 15,12766,13861,167102,173480,441,3.1,1219,8.6,20976,4418,16558,2.5,12.1,33731,8171,25560,4.7,19.4,-12755,-7.3,24.2,0,844,846,4709
2007,18,i) 16 to 20,10026,12162,206231,211688,549,4.5,867,7,23729,5152,18577,2.4,11.2,34643,12730,21913,6,16.4,-10914,-5.2,22.4,0,522,529,4885
2007,18,j) 21 to 25,8640,11031,201822,200508,485,4.3,799,7.1,29321,7143,22178,3.6,14.6,26693,6895,19798,3.4,13.3,2628,1.3,26.6,0,375,400,3668
2007,18,k) 26+,6304,9896,221784,220354,651,6.6,605,6.1,29830,7955,21875,3.6,13.5,26969,6575,20394,3,12.2,2861,1.3,24.4,0,291,304,2933
2007,18,l) Left Censored,14540,36564,1347714,1354681,2268,6.2,2169,5.9,157475,43570,113905,3.2,11.6,171410,37749,133661,2.8,12.7,-13935,-1.1,23.2,0,460,492,4499
2007,19,a) 0,4236,4249,25966,13156,4100,193,0,0,25621,25621,0,194.7,194.7,0,0,0,0,0,25621,194.7,0,0,,,
2007,19,b) 1,3749,3995,27595,28043,54,1.2,912,20.3,7346,714,6632,2.5,26.2,8241,4259,3982,15.2,29.4,-895,-3.2,52.4,0,673,673,3292
2007,19,c) 2,3077,3122,25988,26964,118,3.6,514,15.5,4447,767,3680,2.8,16.5,6398,3077,3321,11.4,23.7,-1951,-7.2,33,0,410,410,2081
2007,19,d) 3,2686,2737,19577,20225,97,3.4,363,12.7,3284,308,2976,1.5,16.2,4580,2127,2453,10.5,22.6,-1296,-6.4,32.4,0,289,289,1832
2007,19,e) 4,2347,2526,21053,21346,113,4.3,317,12.1,3404,719,2685,3.4,15.9,3990,1701,2289,8,18.7,-586,-2.8,31.8,0,240,240,1127
2007,19,f) 5,2115,2232,25701,26655,73,3.1,260,11.2,3423,387,3036,1.5,12.8,5330,1604,3726,6,20,-1907,-7.2,25.6,0,188,190,1412
2007,19,g) 6 to 10,8958,9635,96556,98292,402,4.1,958,9.7,13258,2721,10537,2.8,13.5,16730,5423,11307,5.5,17,-3472,-3.5,27,0,644,650,3446
2007,19,h) 11 to 15,6814,7291,73741,75010,241,3.2,577,7.7,10183,1807,8376,2.4,13.6,12720,3861,8859,5.1,17,-2537,-3.4,27.2,0,391,395,3025
2007,19,i) 16 to 20,5181,5930,92740,92219,192,3.2,418,6.9,11758,2278,9480,2.5,12.8,10716,2860,7856,3.1,11.6,1042,1.2,23.2,0,259,265,1480
2007,19,j) 21 to 25,4719,6166,105012,104613,254,4.1,404,6.5,11660,2164,9496,2.1,11.1,10861,2446,8415,2.3,10.4,799,0.7,20.8,0,204,206,1148
2007,19,k) 26+,4133,6708,113307,112840,276,4.1,430,6.3,13719,3070,10649,2.7,12.2,12784,2733,10051,2.4,11.3,935,0.9,22.6,0,188,199,982
2007,19,l) Left Censored,9821,20102,664130,668966,970,4.8,1130,5.6,63049,13581,49468,2,9.4,72720,19637,53083,2.9,10.9,-9671,-1.5,18.8,0,305,316,3196
2007,20,a) 0,4443,4461,25061,12715,4325,193.9,0,0,24693,24693,0,194.2,194.2,0,0,0,0,0,24693,194.2,0,0,,,
2007,20,b) 1,3632,3748,24535,25893,38,0.9,1012,23.6,5925,382,5543,1.5,22.9,8640,5383,3257,20.8,33.4,-2715,-10.5,45.8,0,798,798,4736
2007,20,c) 2,3113,3182,25184,26212,135,4,595,17.5,5249,568,4681,2.2,20,7304,3180,4124,12.1,27.9,-2055,-7.9,40,0,479,479,2294
2007,20,d) 3,2744,2797,22140,22688,93,3.1,432,14.6,3835,919,2916,4.1,16.9,4930,2554,2376,11.3,21.7,-1095,-4.8,33.8,0,342,342,1983
2007,20,e) 4,2399,2441,25180,25139,89,3.5,349,13.6,4288,712,3576,2.8,17.1,4206,1859,2347,7.4,16.7,82,0.4,33.4,0,275,275,1187
2007,20,f) 5,2215,2287,22060,22588,79,3.3,271,11.4,3385,696,2689,3.1,15,4440,1867,2573,8.3,19.7,-1055,-4.7,30,0,201,201,1419
2007,20,g) 6 to 10,9242,9904,113860,113822,436,4.3,1013,9.9,18495,5594,12901,4.9,16.2,18418,7167,11251,6.3,16.2,77,0,32.4,0,710,724,4963
2007,20,h) 11 to 15,6410,6863,77829,78214,230,3.3,586,8.3,10712,2322,8390,3,13.7,11481,3190,8291,4.1,14.7,-769,-1,27.4,0,400,405,2085
2007,20,i) 16 to 20,4761,5611,85956,85499,247,4.3,422,7.4,11650,2567,9083,3,13.6,10735,2368,8367,2.8,12.6,915,1,25.2,0,268,269,1451
2007,20,j) 21 to 25,4381,5366,77724,78097,249,4.6,393,7.2,9630,2341,7289,3,12.3,10375,3647,6728,4.7,13.3,-745,-1,24.6,0,175,182,1241
2007,20,k) 26+,3579,5491,109317,108146,254,4.6,323,5.8,14441,5246,9195,4.9,13.4,12099,2882,9217,2.7,11.2,2342,2.2,22.4,0,129,133,726
2007,20,l) Left Censored,7990,17377,540388,538876,1122,6.5,1094,6.3,61378,21191,40187,3.9,11.4,58354,14098,44256,2.6,10.8,3024,0.6,21.6,0,226,237,1960
2007,21,a) 0,5395,5436,37278,18978,5312,195.4,0,0,36601,36601,0,192.9,192.9,0,0,0,0,0,36601,192.9,0,0,,,
2007,21,b) 1,4323,4470,33439,36001,31,0.6,1205,23.5,8452,277,8175,0.8,23.5,13576,7033,6543,19.5,37.7,-5124,-14.2,47,0,969,969,5837
2007,21,c) 2,3803,3881,31316,33702,121,2.9,746,17.8,6329,1298,5031,3.9,18.8,11101,4215,6886,12.5,32.9,-4772,-14.1,37.6,0,628,628,3696
2007,21,d) 3,3218,3332,28264,28459,119,3.4,538,15.2,5604,800,4804,2.8,19.7,5993,3011,2982,10.6,21.1,-389,-1.4,39.4,0,427,427,2523
2007,21,e) 4,2744,2849,26591,27041,106,3.6,387,13,4915,884,4031,3.3,18.2,5814,2278,3536,8.4,21.5,-899,-3.3,36.4,0,314,314,1985
2007,21,f) 5,2517,2606,26127,26964,85,3.1,338,12.4,4020,923,3097,3.4,14.9,5693,2137,3556,7.9,21.1,-1673,-6.2,29.8,0,259,259,1631
2007,21,g) 6 to 10,11147,12059,124115,125584,481,3.9,1202,9.7,19651,4052,15599,3.2,15.6,22589,7874,14715,6.3,18,-2938,-2.4,31.2,0,837,845,5358
2007,21,h) 11 to 15,7966,8793,109705,111807,330,3.7,753,8.4,14850,4384,10466,3.9,13.3,19054,5335,13719,4.8,17,-4204,-3.7,26.6,0,510,512,3524
2007,21,i) 16 to 20,6230,7452,124839,126003,257,3.4,523,6.9,14824,2983,11841,2.4,11.8,17151,4449,12702,3.5,13.6,-2327,-1.8,23.6,0,338,344,2560
2007,21,j) 21 to 25,5445,6707,125355,123626,267,3.9,459,6.7,19094,4224,14870,3.4,15.4,15636,5089,10547,4.1,12.6,3458,2.8,25.2,0,240,249,1668
2007,21,k) 26+,3766,6091,132233,131172,305,5,334,5.5,16003,3684,12319,2.8,12.2,13880,3125,10755,2.4,10.6,2123,1.6,21.2,0,143,155,963
2007,21,l) Left Censored,8679,21692,740687,745203,1375,6.4,1252,5.8,84847,27326,57521,3.7,11.4,93878,18921,74957,2.5,12.6,-9031,-1.2,22.8,0,282,295,4104
2007,22,a) 0,6897,6929,45736,23203,6731,194.3,0,0,45066,45066,0,194.2,194.2,0,0,0,0,0,45066,194.2,0,0,,,
2007,22,b) 1,4932,5163,45714,46897,57,1,1283,21.9,12707,670,12037,1.4,27.1,15072,7519,7553,16,32.1,-2365,-5,54.2,0,1020,1020,6121
2007,22,c) 2,4171,4272,39729,39703,202,4.5,651,14.5,9687,1435,8252,3.6,24.4,9634,4262,5372,10.7,24.3,53,0.1,48.6,0,514,514,3274
2007,22,d) 3,3675,3776,37115,36443,189,4.8,515,13.2,9111,1420,7691,3.9,25,7766,4136,3630,11.3,21.3,1345,3.7,42.6,0,416,416,3472
2007,22,e) 4,3319,3551,37035,35940,221,6.1,390,10.8,8563,1899,6664,5.3,23.8,6373,2758,3615,7.7,17.7,2190,6.1,35.4,0,299,300,2055
2007,22,f) 5,3023,3124,36298,36644,136,4.3,321,10,6863,1043,5820,2.8,18.7,7555,2655,4900,7.2,20.6,-692,-1.9,37.4,0,232,232,1587
2007,22,g) 6 to 10,12404,13151,161329,161030,706,5.3,1187,8.9,27677,4638,23039,2.9,17.2,27078,9713,17365,6,16.8,599,0.4,33.6,0,823,834,6796
2007,22,h) 11 to 15,8943,9630,125411,124323,482,5,738,7.6,19924,3668,16256,3,16,17747,5263,12484,4.2,14.3,2177,1.7,28.6,0,500,506,3477
2007,22,i) 16 to 20,6298,7684,145001,144056,367,4.7,502,6.5,22877,3853,19024,2.7,15.9,20986,3763,17223,2.6,14.6,1891,1.3,29.2,0,298,298,1946
2007,22,j) 21 to 25,6357,7903,138461,134092,404,5.1,507,6.4,26446,8909,17537,6.6,19.7,17708,3931,13777,2.9,13.2,8738,6.5,26.4,0,268,282,1438
2007,22,k) 26+,4972,7295,140244,138998,434,6,427,5.9,21745,6127,15618,4.4,15.6,19252,4809,14443,3.5,13.9,2493,1.7,27.8,0,212,213,1114
2007,22,l) Left Censored,9105,22353,679493,675334,1636,7.4,1340,6,87783,22415,65368,3.3,13,79464,18343,61121,2.7,11.8,8319,1.2,23.6,0,299,315,3235
2007,23,a) 0,2638,2646,11281,5721,2560,193.5,0,0,11120,11120,0,194.4,194.4,0,0,0,0,0,11120,194.4,0,0,,,
2007,23,b) 1,2186,2272,13518,14375,23,0.9,669,25.4,3224,204,3020,1.4,22.4,4938,2665,2273,18.5,34.4,-1714,-12,44.8,0,466,466,2048
2007,23,c) 2,1751,1765,9568,10221,74,3.9,323,17.1,1506,249,1257,2.4,14.7,2812,1281,1531,12.5,27.5,-1306,-12.8,29.4,0,247,247,983
2007,23,d) 3,1565,1595,10282,10784,58,3.5,228,13.6,1520,242,1278,2.2,14.1,2523,914,1609,8.5,23.4,-1003,-9.3,28.2,0,178,178,750
2007,23,e) 4,1240,1285,8903,10622,43,3.1,202,14.8,1466,100,1366,0.9,13.8,4903,3842,1061,36.2,46.2,-3437,-32.4,27.6,0,152,152,3717
2007,23,f) 5,1323,1363,9981,10330,42,3,152,10.7,1383,290,1093,2.8,13.4,2080,861,1219,8.3,20.1,-697,-6.7,26.8,0,100,100,609
2007,23,g) 6 to 10,5423,5724,47519,48146,209,3.5,632,10.6,6314,1015,5299,2.1,13.1,7567,2644,4923,5.5,15.7,-1253,-2.6,26.2,0,404,405,1703
2007,23,h) 11 to 15,3617,3843,35351,36336,117,3,332,8.4,3990,1072,2918,3,11,5959,1785,4174,4.9,16.4,-1969,-5.4,22,0,218,218,1172
2007,23,i) 16 to 20,2982,3388,42966,43499,141,4.1,277,8,5412,1387,4025,3.2,12.4,6478,1972,4506,4.5,14.9,-1066,-2.5,24.8,0,173,179,1229
2007,23,j) 21 to 25,2342,2882,44081,43345,107,3.7,178,6.1,5716,2778,2938,6.4,13.2,4243,821,3422,1.9,9.8,1473,3.4,19.6,0,99,99,472
2007,23,k) 26+,1703,2715,44429,44368,132,4.8,179,6.5,6107,1714,4393,3.9,13.8,5984,1358,4626,3.1,13.5,123,0.3,27,0,76,78,372
2007,23,l) Left Censored,3527,7406,219833,219985,558,7.6,435,5.9,25546,8790,16756,4,11.6,25849,8824,17025,4,11.8,-303,-0.2,23.2,0,103,103,880
2007,24,a) 0,8880,8938,49830,25422,8681,194.2,0,0,48817,48817,0,192,192,0,0,0,0,0,48817,192,0,0,,,
2007,24,b) 1,7390,7608,55359,57207,44,0.5,2247,25.4,14023,859,13164,1.5,24.5,17718,9993,7725,17.5,31,-3695,-6.5,49,0,1739,1739,7935
2007,24,c) 2,6518,6656,47283,49644,270,3.8,1099,15.5,8818,1397,7421,2.8,17.8,13539,5222,8317,10.5,27.3,-4721,-9.5,35.6,0,876,876,4486
2007,24,d) 3,5611,5714,45327,45620,246,4.1,837,14,8735,1619,7116,3.5,19.1,9321,3736,5585,8.2,20.4,-586,-1.3,38.2,0,643,643,2915
2007,24,e) 4,4746,4920,49505,48836,183,3.5,693,13.4,12022,1321,10701,2.7,24.6,10684,5276,5408,10.8,21.9,1338,2.7,43.8,0,504,520,3628
2007,24,f) 5,4569,4676,48405,49745,161,3.3,573,11.8,7267,1000,6267,2,14.6,9947,3184,6763,6.4,20,-2680,-5.4,29.2,0,425,426,2421
2007,24,g) 6 to 10,17820,18990,211427,215475,737,3.8,1936,9.9,30638,5470,25168,2.5,14.2,38734,13508,25226,6.3,18,-8096,-3.8,28.4,0,1250,1253,7304
2007,24,h) 11 to 15,12165,12999,161654,165811,454,3.4,1103,8.3,19224,3772,15452,2.3,11.6,27538,9867,17671,6,16.6,-8314,-5,23.2,0,745,751,6181
2007,24,i) 16 to 20,9918,11494,205583,207670,390,3.3,908,7.7,24247,3772,20475,1.8,11.7,28420,7112,21308,3.4,13.7,-4173,-2,23.4,0,500,503,2880
2007,24,j) 21 to 25,7398,9153,155092,155822,360,3.9,713,7.6,21362,4798,16564,3.1,13.7,22822,7310,15512,4.7,14.6,-1460,-0.9,27.4,0,309,314,2255
2007,24,k) 26+,5070,7558,179768,179682,409,5.4,492,6.5,22209,6130,16079,3.4,12.4,22037,5683,16354,3.2,12.3,172,0.1,24.6,0,197,213,1251
2007,24,l) Left Censored,10736,27306,1004016,1010270,2208,8.1,1883,6.9,120252,41296,78956,4.1,11.9,132760,33430,99330,3.3,13.1,-12508,-1.2,23.8,0,353,366,5971
2007,25,a) 0,9787,9807,51762,26142,9570,195.2,0,0,51241,51241,0,196,196,0,0,0,0,0,51241,196,0,0,,,
2007,25,b) 1,8506,8662,64145,66645,51,0.5,2319,23.4,13434,517,12917,0.8,20.2,18436,9577,8859,14.4,27.7,-5002,-7.5,40.4,0,1725,1725,7721
2007,25,c) 2,7082,7178,56481,55950,282,3.7,1331,17.2,13270,1596,11674,2.9,23.7,12208,6004,6204,10.7,21.8,1062,1.9,43.6,0,1005,1005,4747
2007,25,d) 3,6174,6309,58032,56946,226,3.4,977,14.7,14280,1075,13205,1.9,25.1,12108,4187,7921,7.4,21.3,2172,3.8,42.6,0,751,751,3293
2007,25,e) 4,5501,5753,50678,50391,255,4.3,774,12.9,10523,2043,8480,4.1,20.9,9948,4509,5439,8.9,19.7,575,1.2,39.4,0,538,538,3110
2007,25,f) 5,5129,5274,52598,53751,175,3.2,667,12.1,8127,1536,6591,2.9,15.1,10432,4517,5915,8.4,19.4,-2305,-4.3,30.2,0,481,486,2393
2007,25,g) 6 to 10,21450,22480,243530,246137,759,3.3,2435,10.4,36604,4626,31978,1.9,14.9,41817,17913,23904,7.3,17,-5213,-2.1,29.8,0,1590,1618,11492
2007,25,h) 11 to 15,15152,16033,187949,190831,521,3.2,1354,8.2,24718,3671,21047,1.9,13,30481,10024,20457,5.3,16,-5763,-3,26,0,917,931,5627
2007,25,i) 16 to 20,12691,14635,246121,249728,546,3.7,1080,7.3,28261,6300,21961,2.5,11.3,35474,10066,25408,4,14.2,-7213,-2.9,22.6,0,651,667,5308
2007,25,j) 21 to 25,10501,13303,286859,288641,527,3.9,899,6.7,33281,7614,25667,2.6,11.5,36845,9326,27519,3.2,12.8,-3564,-1.3,23,0,429,429,2626
2007,25,k) 26+,7427,11001,280406,280742,603,5.4,751,6.8,32045,7737,24308,2.8,11.4,32717,9404,23313,3.3,11.7,-672,-0.3,22.8,0,335,351,1817
2007,25,l) Left Censored,17988,37964,1488973,1493630,2380,6.3,2619,6.9,164172,44320,119852,3,11,173486,42665,130821,2.9,11.6,-9314,-0.6,22,0,657,688,6756
2007,26,a) 0,13094,13186,86412,43849,12745,193.3,0,0,85127,85127,0,194.1,194.1,0,0,0,0,0,85127,194.1,0,0,,,
2007,26,b) 1,10608,10715,96424,98491,63,0.5,3358,26.8,27719,1055,26664,1.1,28.1,31853,17197,14656,17.5,32.3,-4134,-4.2,56.2,0,2572,2572,14482
2007,26,c) 2,9275,9434,88784,94419,335,3.3,1872,18.4,15240,2470,12770,2.6,16.1,26509,12293,14216,13,28.1,-11269,-12,32.2,0,1434,1437,10021
2007,26,d) 3,8048,8186,88178,91750,334,3.9,1356,15.6,13571,3294,10277,3.6,14.8,20715,7935,12780,8.6,22.6,-7144,-7.8,29.6,0,1066,1066,6422
2007,26,e) 4,7057,7399,75873,77639,344,4.4,1167,15,15257,2741,12516,3.5,19.7,18789,7791,10998,10,24.2,-3532,-4.5,39.4,0,873,873,5221
2007,26,f) 5,6769,6962,71760,75410,235,3.2,968,13.2,8985,1640,7345,2.2,11.9,16284,7063,9221,9.4,21.6,-7299,-9.7,23.8,0,713,716,5247
2007,26,g) 6 to 10,27231,29037,299846,310261,1108,3.7,3631,12,40230,8181,32049,2.6,13,61059,22852,38207,7.4,19.7,-20829,-6.7,26,0,2468,2492,14583
2007,26,h) 11 to 15,20691,22091,244673,252471,836,3.7,2185,9.6,30234,6951,23283,2.8,12,45830,15221,30609,6,18.2,-15596,-6.2,24,0,1462,1471,9522
2007,26,i) 16 to 20,16485,19560,297375,301865,807,4,1615,8.1,39049,8395,30654,2.8,12.9,48028,14462,33566,4.8,15.9,-8979,-3,25.8,0,944,966,6942
2007,26,j) 21 to 25,13280,16862,286822,290439,683,4,1253,7.3,32956,7813,25143,2.7,11.3,40189,11804,28385,4.1,13.8,-7233,-2.5,22.6,0,565,578,4088
2007,26,k) 26+,9947,14035,259101,264593,665,4.7,985,6.9,29808,8647,21161,3.3,11.3,40791,10389,30402,3.9,15.4,-10983,-4.1,22.6,0,448,464,3265
2007,26,l) Left Censored,20833,50858,1768183,1806292,3179,6.3,3203,6.3,183337,52378,130959,2.9,10.1,259555,76329,183226,4.2,14.4,-76218,-4.3,20.2,0,779,921,7668
2007,27,a) 0,8828,8867,54777,27706,8551,192.9,0,0,54143,54143,0,195.4,195.4,0,0,0,0,0,54143,195.4,0,0,,,
2007,27,b) 1,7278,7650,51466,57508,68,0.8,2267,25.5,11380,1020,10360,1.8,19.8,23464,12180,11284,21.2,40.8,-12084,-21,39.6,0,1598,1598,9879
2007,27,c) 2,6246,6372,47279,49911,260,3.8,1165,17.1,9130,1276,7854,2.6,18.3,14394,8241,6153,16.5,28.8,-5264,-10.5,36.6,0,877,877,7012
2007,27,d) 3,5528,5694,43036,43751,315,5.3,914,15.3,7870,1861,6009,4.3,18,9300,5006,4294,11.4,21.3,-1430,-3.3,36,0,655,655,3821
2007,27,e) 4,5004,5255,43610,43778,226,4.1,731,13.3,7667,1852,5815,4.2,17.5,8003,3618,4385,8.3,18.3,-336,-0.8,35,0,522,524,2593
2007,27,f) 5,4546,4682,44803,45796,163,3.3,610,12.4,6003,786,5217,1.7,13.1,7989,3280,4709,7.2,17.4,-1986,-4.3,26.2,0,433,433,2297
2007,27,g) 6 to 10,18756,20041,214966,218368,772,3.7,2147,10.4,30208,7194,23014,3.3,13.8,37012,13748,23264,6.3,16.9,-6804,-3.1,27.6,0,1301,1312,8062
2007,27,h) 11 to 15,12995,14065,170923,172999,498,3.5,1229,8.5,22801,4793,18008,2.8,13.2,26953,9208,17745,5.3,15.6,-4152,-2.4,26.4,0,760,771,5589
2007,27,i) 16 to 20,9578,11267,187722,186650,481,4.2,807,7.1,25732,5373,20359,2.9,13.8,23587,7135,16452,3.8,12.6,2145,1.2,25.2,0,442,450,3018
2007,27,j) 21 to 25,7476,9595,195887,197403,365,3.7,682,7,23195,6251,16944,3.2,11.8,26227,7865,18362,4,13.3,-3032,-1.5,23.6,0,290,296,2157
2007,27,k) 26+,5941,8932,217968,216444,432,4.8,552,6.1,26552,6415,20137,3,12.3,23503,5445,18058,2.5,10.9,3049,1.4,21.8,0,233,235,1737
2007,27,l) Left Censored,13145,29961,1258722,1239420,1997,6.6,2196,7.3,171398,44829,126569,3.6,13.8,132793,34596,98197,2.8,10.7,38605,3.1,21.4,0,362,377,4377
2007,28,a) 0,4018,4070,22044,11239,3968,195,0,0,21610,21610,0,192.3,192.3,0,0,0,0,0,21610,192.3,0,0,,,
2007,28,b) 1,3020,3129,26928,28466,24,0.7,881,24.5,6372,246,6126,0.9,22.4,9448,4768,4680,16.7,33.2,-3076,-10.8,44.8,0,723,723,3735
2007,28,c) 2,2473,2522,22104,23066,129,4.8,472,17.6,3403,624,2779,2.7,14.8,5327,2114,3213,9.2,23.1,-1924,-8.3,29.6,0,378,378,1694
2007,28,d) 3,2151,2228,18115,18725,96,4.1,372,15.8,3562,1016,2546,5.4,19,4781,2382,2399,12.7,25.5,-1219,-6.5,38,0,293,293,1694
2007,28,e) 4,2020,2114,17864,18139,108,5,267,12.3,3410,940,2470,5.2,18.8,3960,1678,2282,9.3,21.8,-550,-3,37.6,0,201,201,1022
2007,28,f) 5,1704,1747,18464,19669,54,2.9,237,12.9,2596,467,2129,2.4,13.2,5005,2040,2965,10.4,25.4,-2409,-12.2,26.4,0,185,188,1540
2007,28,g) 6 to 10,7309,7906,81454,81819,385,4.8,736,9.1,12343,2663,9680,3.3,15.1,13073,3909,9164,4.8,16,-730,-0.9,30.2,0,529,529,2770
2007,28,h) 11 to 15,5039,5486,67619,69284,212,3.8,489,8.7,9147,1687,7460,2.4,13.2,12477,4131,8346,6,18,-3330,-4.8,26.4,0,340,347,2150
2007,28,i) 16 to 20,3673,4236,76140,76775,191,4.5,302,7,8985,2354,6631,3.1,11.7,10254,1896,8358,2.5,13.4,-1269,-1.7,23.4,0,210,211,1298
2007,28,j) 21 to 25,3574,4378,59415,59729,217,4.9,259,5.9,7652,1635,6017,2.7,12.8,8279,1911,6368,3.2,13.9,-627,-1.1,25.6,0,123,126,863
2007,28,k) 26+,2682,3937,82126,82327,186,4.7,258,6.5,11250,3062,8188,3.7,13.7,11651,2540,9111,3.1,14.2,-401,-0.5,27.4,0,142,142,710
2007,28,l) Left Censored,5703,14519,443254,444968,941,6.5,812,5.6,48913,11562,37351,2.6,11,52340,13291,39049,3,11.8,-3427,-0.8,22,0,196,205,1444
2007,29,a) 0,9857,9929,58354,29542,9658,194.5,0,0,57625,57625,0,195.1,195.1,0,0,0,0,0,57625,195.1,0,0,,,
2007,29,b) 1,7995,8269,57369,59364,50,0.5,2492,25.9,13825,565,13260,1,23.3,17814,9761,8053,16.4,30,-3989,-6.7,46.6,0,2007,2007,8062
2007,29,c) 2,6920,7076,54890,56234,281,3.7,1519,19.8,11724,1416,10308,2.5,20.8,14412,7005,7407,12.5,25.6,-2688,-4.8,41.6,0,1227,1227,6007
2007,29,d) 3,5900,6004,50120,51128,225,3.5,1144,17.7,9777,1423,8354,2.8,19.1,11793,6443,5350,12.6,23.1,-2016,-4,38.2,0,940,940,5715
2007,29,e) 4,5035,5285,41824,42247,208,3.7,779,14,7897,1386,6511,3.3,18.7,8742,3683,5059,8.7,20.7,-845,-2,37.4,0,621,621,2792
2007,29,f) 5,4436,4570,43967,45170,171,3.5,675,14,6369,689,5680,1.5,14.1,8775,3714,5061,8.2,19.4,-2406,-5.3,28.2,0,518,520,3074
2007,29,g) 6 to 10,17748,19036,195794,201230,758,3.8,2142,10.9,27785,5735,22050,2.8,13.8,38656,15182,23474,7.5,19.2,-10871,-5.4,27.6,0,1475,1497,9697
2007,29,h) 11 to 15,12555,13541,164644,168504,490,3.5,1183,8.5,21916,4690,17226,2.8,13,29636,9199,20437,5.5,17.6,-7720,-4.6,26,0,822,832,4910
2007,29,i) 16 to 20,9667,11780,179181,182358,593,5,885,7.4,22415,5716,16699,3.1,12.3,28768,7715,21053,4.2,15.8,-6353,-3.5,24.6,0,556,572,4532
2007,29,j) 21 to 25,8388,10860,207380,207287,514,4.7,738,6.7,23672,6894,16778,3.3,11.4,23486,5287,18199,2.6,11.3,186,0.1,22.6,0,379,418,2545
2007,29,k) 26+,6124,9802,220839,219866,485,4.9,634,6.4,27105,6112,20993,2.8,12.3,25158,5601,19557,2.5,11.4,1947,0.9,22.8,0,277,285,1536
2007,29,l) Left Censored,13447,32965,1182763,1182446,2080,6.3,1913,5.8,135209,35117,100092,3,11.4,134575,30933,103642,2.6,11.4,634,0,22.8,0,445,464,3482
2007,30,a) 0,2966,2978,11791,5999,2877,193.2,0,0,11585,11585,0,193.1,193.1,0,0,0,0,0,11585,193.1,0,0,,,
2007,30,b) 1,2441,2501,18471,17261,18,0.6,626,21.9,6304,125,6179,0.7,36.5,3884,2030,1854,11.8,22.5,2420,14,45,0,442,442,1610
2007,30,c) 2,1870,1885,10677,10997,74,3.7,343,17,2409,378,2031,3.4,21.9,3048,1201,1847,10.9,27.7,-639,-5.8,43.8,0,247,247,973
2007,30,d) 3,1683,1729,10617,10516,74,4.1,217,12.1,2123,247,1876,2.3,20.2,1921,794,1127,7.6,18.3,202,1.9,36.6,0,145,145,563
2007,30,e) 4,1342,1371,8977,8839,64,4.5,158,11.2,1754,378,1376,4.3,19.8,1477,531,946,6,16.7,277,3.1,33.4,0,113,113,381
2007,30,f) 5,1245,1263,9056,9334,38,2.9,140,10.7,1382,109,1273,1.2,14.8,1938,827,1111,8.9,20.8,-556,-6,29.6,0,95,95,432
2007,30,g) 6 to 10,4947,5162,40291,40680,224,4.2,542,10.2,5987,907,5080,2.2,14.7,6764,2844,3920,7,16.6,-777,-1.9,29.4,0,365,365,1927
2007,30,h) 11 to 15,3305,3435,30088,30875,101,2.9,291,8.2,3647,778,2869,2.5,11.8,5220,1790,3430,5.8,16.9,-1573,-5.1,23.6,0,186,189,1000
2007,30,i) 16 to 20,2105,2326,26750,27122,86,3.6,189,8,4102,1133,2969,4.2,15.1,4845,1259,3586,4.6,17.9,-743,-2.8,30.2,0,115,122,794
2007,30,j) 21 to 25,1776,2170,29519,29501,110,5,145,6.6,3624,768,2856,2.6,12.3,3587,1334,2253,4.5,12.2,37,0.1,24.4,0,78,81,470
2007,30,k) 26+,1549,2254,36655,35565,104,4.6,113,5,5473,2240,3233,6.3,15.4,3293,643,2650,1.8,9.3,2180,6.1,18.6,0,65,68,456
2007,30,l) Left Censored,2627,5351,118415,117575,343,6.4,281,5.3,14118,3395,10723,2.9,12,12438,2413,10025,2.1,10.6,1680,1.4,21.2,0,80,87,520
2007,31,a) 0,2926,2959,15204,7701,2876,194.4,0,0,15007,15007,0,194.9,194.9,0,0,0,0,0,15007,194.9,0,0,,,
2007,31,b) 1,2410,2507,16161,16454,8,0.3,627,22,3983,64,3919,0.4,24.2,4568,2578,1990,15.7,27.8,-585,-3.6,48.4,0,475,475,2199
2007,31,c) 2,2046,2061,12718,13330,67,3,359,16.3,2349,648,1701,4.9,17.6,3572,1907,1665,14.3,26.8,-1223,-9.2,35.2,0,283,283,1494
2007,31,d) 3,1832,1861,13681,14219,60,3.1,261,13.3,2279,246,2033,1.7,16,3354,1760,1594,12.4,23.6,-1075,-7.6,32,0,197,197,1056
2007,31,e) 4,1599,1663,11677,11806,66,3.8,181,10.5,2055,546,1509,4.6,17.4,2313,787,1526,6.7,19.6,-258,-2.2,34.8,0,132,132,657
2007,31,f) 5,1520,1576,12835,13175,61,3.8,172,10.6,1548,305,1243,2.3,11.7,2228,840,1388,6.4,16.9,-680,-5.2,23.4,0,116,117,612
2007,31,g) 6 to 10,6255,6680,73561,74834,232,3.4,636,9.2,8641,1378,7263,1.8,11.5,11187,4188,6999,5.6,14.9,-2546,-3.4,23,0,421,422,3026
2007,31,h) 11 to 15,4318,4656,46571,47533,179,3.7,428,8.9,5813,1600,4213,3.4,12.2,7736,2375,5361,5,16.3,-1923,-4.1,24.4,0,295,295,1559
2007,31,i) 16 to 20,3343,3926,66014,67013,151,3.8,266,6.7,8683,2837,5846,4.2,13,10680,2813,7867,4.2,15.9,-1997,-2.9,26,0,166,166,1354
2007,31,j) 21 to 25,3075,3846,71524,72568,194,5,265,6.8,7399,2373,5026,3.3,10.2,9486,2619,6867,3.6,13.1,-2087,-2.9,20.4,0,147,149,1410
2007,31,k) 26+,2488,3832,81270,81458,135,3.5,227,5.8,7123,1205,5918,1.5,8.7,7498,1727,5771,2.1,9.2,-375,-0.5,17.4,0,101,101,583
2007,31,l) Left Censored,5830,11535,372569,369388,638,5.5,655,5.7,45982,11375,34607,3.1,12.4,39621,8068,31553,2.2,10.7,6361,1.7,21.4,0,159,163,1202
2007,32,a) 0,5955,6011,44511,22508,5874,195.4,0,0,44006,44006,0,195.5,195.5,0,0,0,0,0,44006,195.5,0,0,,,
2007,32,b) 1,4675,4798,44214,46568,43,0.8,1533,27.3,11941,648,11293,1.4,25.6,16648,7078,9570,15.2,35.7,-4707,-10.1,51.2,0,1265,1265,5978
2007,32,c) 2,3740,3871,38562,41300,162,3.9,806,19.2,7162,840,6322,2,17.3,12638,4429,8209,10.7,30.6,-5476,-13.3,34.6,0,645,647,3585
2007,32,d) 3,3022,3087,34645,35361,123,3.7,600,18.1,6947,925,6022,2.6,19.6,8378,3381,4997,9.6,23.7,-1431,-4.1,39.2,0,485,485,2665
2007,32,e) 4,2507,2655,33423,33918,136,4.8,464,16.5,7490,1075,6415,3.2,22.1,8480,3548,4932,10.5,25,-990,-2.9,44.2,0,366,368,3096
2007,32,f) 5,2102,2161,31395,32571,98,4.3,333,14.6,5654,499,5155,1.5,17.4,8006,2963,5043,9.1,24.6,-2352,-7.2,34.8,0,260,260,2415
2007,32,g) 6 to 10,7510,8023,136741,138700,376,4.5,983,11.8,20714,5039,15675,3.6,14.9,24631,6999,17632,5,17.8,-3917,-2.9,29.8,0,662,668,4679
2007,32,h) 11 to 15,3934,4393,84809,86729,244,5.5,408,9.1,12801,2821,9980,3.3,14.8,16640,6082,10558,7,19.2,-3839,-4.4,29.6,0,267,270,3036
2007,32,i) 16 to 20,2759,3580,81585,82532,229,6.4,264,7.3,11794,2780,9014,3.4,14.3,13687,3024,10663,3.7,16.6,-1893,-2.3,28.6,0,157,157,1599
2007,32,j) 21 to 25,1945,3056,89268,84568,272,9,231,7.6,19095,5890,13205,7,22.6,9695,2087,7608,2.5,11.5,9400,11.1,23,0,112,114,1191
2007,32,k) 26+,1732,2950,95654,95025,218,7.4,223,7.6,13400,2742,10658,2.9,14.1,12142,3306,8836,3.5,12.8,1258,1.3,25.6,0,85,87,1160
2007,32,l) Left Censored,3208,9436,474552,468085,995,10.7,800,8.6,75178,25314,49864,5.4,16.1,62243,18014,44229,3.8,13.3,12935,2.8,26.6,0,79,85,1053
2007,33,a) 0,2313,2323,11369,5731,2271,195.5,0,0,11277,11277,0,196.8,196.8,0,0,0,0,0,11277,196.8,0,0,,,
2007,33,b) 1,2065,2154,14951,15340,22,0.9,581,23.6,3224,146,3078,1,21,4001,1989,2012,13,26.1,-777,-5.1,42,0,427,427,1533
2007,33,c) 2,1697,1722,12622,13130,72,3.9,342,18.4,2274,402,1872,3.1,17.3,3289,1462,1827,11.1,25,-1015,-7.7,34.6,0,285,285,1151
2007,33,d) 3,1471,1500,9937,10177,57,3.6,254,15.9,1756,304,1452,3,17.3,2235,981,1254,9.6,22,-479,-4.7,34.6,0,208,208,844
2007,33,e) 4,1280,1333,9683,9914,58,4.2,159,11.5,1649,381,1268,3.8,16.6,2110,680,1430,6.9,21.3,-461,-4.7,33.2,0,127,127,554
2007,33,f) 5,1108,1126,9743,9955,43,3.6,159,13.4,1498,122,1376,1.2,15,1922,790,1132,7.9,19.3,-424,-4.3,30,0,118,118,574
2007,33,g) 6 to 10,4965,5243,48953,50703,190,3.5,569,10.5,6229,1234,4995,2.4,12.3,9728,3547,6181,7,19.2,-3499,-6.9,24.6,0,400,401,2456
2007,33,h) 11 to 15,3640,3770,40799,42844,115,3,321,8.3,3878,692,3186,1.6,9.1,7967,2448,5519,5.7,18.6,-4089,-9.5,18.2,0,216,216,1724
2007,33,i) 16 to 20,2990,3329,49443,49931,132,3.9,227,6.7,5257,1137,4120,2.3,10.5,6233,1488,4745,3,12.5,-976,-2,21,0,143,143,900
2007,33,j) 21 to 25,2350,2871,45917,46128,144,5,210,7.2,5975,2173,3802,4.7,13,6397,2107,4290,4.6,13.9,-422,-0.9,26,0,119,120,1071
2007,33,k) 26+,1534,2296,49163,48922,140,6.1,164,7.1,6312,2111,4201,4.3,12.9,5829,1550,4279,3.2,11.9,483,1,23.8,0,66,74,1001
2007,33,l) Left Censored,3505,7545,261105,259547,526,7,498,6.6,30407,6803,23604,2.6,11.7,27290,5741,21549,2.2,10.5,3117,1.2,21,0,124,125,1227
2007,34,a) 0,16531,16578,90598,46241,16073,193.9,0,0,88714,88714,0,191.9,191.9,0,0,0,0,0,88714,191.9,0,0,,,
2007,34,b) 1,13247,13525,90581,92932,76,0.5,4012,25.5,22875,839,22036,0.9,24.6,27577,14490,13087,15.6,29.7,-4702,-5.1,49.2,0,3086,3086,11171
2007,34,c) 2,11658,11830,85102,86584,449,3.5,2177,17.1,17588,3325,14263,3.8,20.3,20552,10568,9984,12.2,23.7,-2964,-3.4,40.6,0,1778,1778,8757
2007,34,d) 3,9723,9843,78034,79300,316,3,1631,15.6,13774,2014,11760,2.5,17.4,16306,7572,8734,9.5,20.6,-2532,-3.2,34.8,0,1274,1274,5409
2007,34,e) 4,8520,8758,77315,79649,339,3.7,1311,14.2,13524,2039,11485,2.6,17,18192,7400,10792,9.3,22.8,-4668,-5.8,34,0,1012,1012,4791
2007,34,f) 5,7641,7754,76766,77233,291,3.6,1063,13.1,11892,1699,10193,2.2,15.4,12825,5229,7596,6.8,16.6,-933,-1.2,30.8,0,803,808,3457
2007,34,g) 6 to 10,32322,33634,361834,369999,1145,3.3,3846,11,48763,8642,40121,2.3,13.2,65093,23959,41134,6.5,17.6,-16330,-4.4,26.4,0,2787,2790,17401
2007,34,h) 11 to 15,21421,22434,266799,271599,679,2.9,2006,8.7,33115,4626,28489,1.7,12.2,42715,13310,29405,4.9,15.7,-9600,-3.5,24.4,0,1429,1434,9045
2007,34,i) 16 to 20,16823,18748,271114,272250,673,3.5,1517,7.9,36942,8988,27954,3.3,13.6,39216,13105,26111,4.8,14.4,-2274,-0.8,27.2,0,979,989,7003
2007,34,j) 21 to 25,13049,15571,305392,304472,628,4,1249,7.9,39630,8757,30873,2.9,13,37789,11753,26036,3.9,12.4,1841,0.6,24.8,0,690,699,5183
2007,34,k) 26+,9689,12772,275708,279245,672,5.2,1075,8.3,32837,9180,23657,3.3,11.8,39910,13355,26555,4.8,14.3,-7073,-2.5,23.6,0,527,547,3026
2007,34,l) Left Censored,20341,43530,1647563,1650783,3141,7.2,3366,7.7,208999,65331,143668,4,12.7,215438,55783,159655,3.4,13.1,-6439,-0.4,25.4,0,935,949,9135
2007,35,a) 0,3178,3186,27277,13964,3096,194.4,0,0,26626,26626,0,190.7,190.7,0,0,0,0,0,26626,190.7,0,0,,,
2007,35,b) 1,2556,2629,19655,19747,29,1,715,23.7,5541,553,4988,2.8,28.1,5725,3139,2586,15.9,29,-184,-0.9,56.2,0,541,541,2439
2007,35,c) 2,2107,2160,16722,17131,89,3.9,354,15.5,3217,326,2891,1.9,18.8,4035,1770,2265,10.3,23.6,-818,-4.8,37.6,0,283,283,1296
2007,35,d) 3,1754,1826,17148,17050,100,5.2,273,14.3,4168,636,3532,3.7,24.4,3971,1922,2049,11.3,23.3,197,1.1,46.6,0,200,203,1474
2007,35,e) 4,1514,1553,14712,14889,67,4.1,212,13.1,2654,434,2220,2.9,17.8,3008,1351,1657,9.1,20.2,-354,-2.4,35.6,0,161,161,1076
2007,35,f) 5,1390,1464,17966,17373,62,4.1,185,12.1,4080,528,3552,3,23.5,2894,1263,1631,7.3,16.7,1186,6.8,33.4,0,123,123,669
2007,35,g) 6 to 10,5860,6223,76409,77558,276,4.3,611,9.5,11283,3184,8099,4.1,14.5,13581,3958,9623,5.1,17.5,-2298,-3,29,0,427,432,2390
2007,35,h) 11 to 15,3998,4284,49445,50647,159,3.6,410,9.3,6163,1025,5138,2,12.2,8567,2916,5651,5.8,16.9,-2404,-4.7,24.4,0,270,272,1808
2007,35,i) 16 to 20,2988,3631,58432,58912,169,4.6,252,6.9,8502,1991,6511,3.4,14.4,9462,2123,7339,3.6,16.1,-960,-1.7,28.8,0,159,162,1082
2007,35,j) 21 to 25,2506,3248,48764,48836,154,4.7,216,6.6,6129,2026,4103,4.1,12.6,6273,1211,5062,2.5,12.8,-144,-0.2,25.2,0,108,108,577
2007,35,k) 26+,2056,3241,58160,59261,162,5,200,6.1,7241,2017,5224,3.4,12.2,9443,2178,7265,3.7,15.9,-2202,-3.7,24.4,0,99,105,1191
2007,35,l) Left Censored,3544,8320,234865,234656,545,6.6,507,6.1,30010,9654,20356,4.1,12.8,29592,6561,23031,2.8,12.6,418,0.2,25.2,0,98,101,654
2007,36,a) 0,37199,37259,184496,93634,36236,194.5,0,0,181725,181725,0,194.1,194.1,0,0,0,0,0,181725,194.1,0,0,,,
2007,36,b) 1,29711,30426,197399,204154,126,0.4,8325,23.7,45218,1822,43396,0.9,22.1,58727,32358,26369,15.8,28.8,-13509,-6.7,44.2,0,6464,6464,27585
2007,36,c) 2,25266,25623,182160,186471,935,3.4,4748,17.2,35850,5586,30264,3,19.2,44472,23612,20860,12.7,23.8,-8622,-4.6,38.4,0,3815,3816,19979
2007,36,d) 3,21627,21863,157231,159844,775,3.3,3676,15.8,28832,4418,24414,2.8,18,34058,17683,16375,11.1,21.3,-5226,-3.3,36,0,2979,2989,13553
2007,36,e) 4,18871,19380,154588,154786,675,3.3,2884,14.1,31348,5356,25992,3.5,20.3,31743,14770,16973,9.5,20.5,-395,-0.2,40.6,0,2259,2259,10457
2007,36,f) 5,16825,17166,156383,160360,569,3.2,2277,12.6,23136,3563,19573,2.2,14.4,31090,14424,16666,9,19.4,-7954,-5,28.8,0,1744,1744,11884
2007,36,g) 6 to 10,66711,69634,702767,716796,2283,3.2,7767,10.7,99569,15308,84261,2.1,13.9,127628,46590,81038,6.5,17.8,-28059,-3.9,27.8,0,5654,5673,30452
2007,36,h) 11 to 15,43224,45185,516450,522990,1368,2.9,4005,8.6,63285,10806,52479,2.1,12.1,76365,28307,48058,5.4,14.6,-13080,-2.5,24.2,0,2877,2900,20224
2007,36,i) 16 to 20,35805,39249,607415,614619,1225,3.1,2966,7.4,67312,11533,55779,1.9,11,81719,23474,58245,3.8,13.3,-14407,-2.3,22,0,1890,1906,13392
2007,36,j) 21 to 25,28138,33159,535835,542930,1137,3.4,2397,7.1,61718,14750,46968,2.7,11.4,75908,26388,49520,4.9,14,-14190,-2.6,22.8,0,1335,1345,9510
2007,36,k) 26+,19427,27444,620096,621294,1141,4.1,1813,6.5,68370,15846,52524,2.6,11,70765,16193,54572,2.6,11.4,-2395,-0.4,22,0,958,1004,7723
2007,36,l) Left Censored,44399,92105,3505880,3521310,5719,6.2,6684,7.2,412021,128381,283640,3.6,11.7,442882,136161,306721,3.9,12.6,-30861,-0.9,23.4,0,1841,1922,18491
2007,37,a) 0,15847,15926,87419,44281,15523,194.9,0,0,86276,86276,0,194.8,194.8,0,0,0,0,0,86276,194.8,0,0,,,
2007,37,b) 1,12459,12898,94382,98508,90,0.6,3501,23.7,24474,1172,23302,1.2,24.8,32725,15723,17002,16,33.2,-8251,-8.4,49.6,0,2662,2691,12532
2007,37,c) 2,10680,10855,86638,90002,390,3.4,1855,16,18426,2319,16107,2.6,20.5,25153,14027,11126,15.6,27.9,-6727,-7.4,41,0,1498,1506,11709
2007,37,d) 3,8761,8986,77513,77994,355,3.8,1295,13.7,16281,2953,13328,3.8,20.9,17242,6902,10340,8.8,22.1,-961,-1.2,41.8,0,1038,1038,5679
2007,37,e) 4,7580,8024,76447,76105,341,4.1,969,11.7,14500,2440,12060,3.2,19.1,13815,5769,8046,7.6,18.2,685,0.9,36.4,0,783,784,4586
2007,37,f) 5,6626,6832,66579,68805,226,3.2,865,12.1,10450,1621,8829,2.4,15.2,14902,5790,9112,8.4,21.7,-4452,-6.5,30.4,0,642,642,4010
2007,37,g) 6 to 10,28198,30358,335024,340559,1197,3.8,3146,10.1,51204,10185,41019,3,15,62273,21917,40356,6.4,18.3,-11069,-3.3,30,0,2204,2222,13707
2007,37,h) 11 to 15,17650,19363,252101,250726,783,4,1709,8.6,41687,8053,33634,3.2,16.6,38937,13033,25904,5.2,15.5,2750,1.1,31,0,1156,1171,7590
2007,37,i) 16 to 20,13519,16287,292839,293607,716,4.3,1176,7.1,36690,9972,26718,3.4,12.5,38226,9494,28732,3.2,13,-1536,-0.5,25,0,709,717,5007
2007,37,j) 21 to 25,12175,15319,239378,240332,667,4.3,1066,6.9,30871,8168,22703,3.4,12.8,32778,8986,23792,3.7,13.6,-1907,-0.8,25.6,0,512,534,3693
2007,37,k) 26+,7797,13043,322442,321867,888,6.8,857,6.6,38800,11174,27626,3.5,12.1,37649,10605,27044,3.3,11.7,1151,0.4,23.4,0,341,344,2962
2007,37,l) Left Censored,15758,45877,1646193,1636828,3881,8.6,2852,6.3,219694,70217,149477,4.3,13.4,200963,52439,148524,3.2,12.3,18731,1.1,24.6,0,571,629,7720
2007,38,a) 0,1221,1231,7254,3650,1202,195.3,0,0,7209,7209,0,197.5,197.5,0,0,0,0,0,7209,197.5,0,0,,,
2007,38,b) 1,1000,1046,8486,8567,4,0.3,273,22.8,2161,71,2090,0.8,25.2,2324,1420,904,16.6,27.1,-163,-1.9,50.4,0,190,190,1048
2007,38,c) 2,814,829,5426,5683,35,4,138,15.7,990,188,802,3.3,17.4,1503,755,748,13.3,26.4,-513,-9,34.8,0,100,100,604
2007,38,d) 3,683,706,5221,5553,32,4.3,108,14.5,964,293,671,5.3,17.4,1628,499,1129,9,29.3,-664,-11.9,34.8,0,79,79,391
2007,38,e) 4,580,598,4052,4078,26,4.2,69,11.2,707,162,545,4,17.3,758,308,450,7.6,18.6,-51,-1.3,34.6,0,48,48,246
2007,38,f) 5,567,593,4810,4768,29,4.8,58,9.6,860,196,664,4.1,18,776,280,496,5.9,16.3,84,1.7,32.6,0,38,38,208
2007,38,g) 6 to 10,2303,2444,24664,24541,93,3.7,233,9.3,4238,1165,3073,4.7,17.3,3992,1421,2571,5.8,16.3,246,1,32.6,0,151,151,1114
2007,38,h) 11 to 15,1783,1849,19885,19940,64,3.4,144,7.6,2470,584,1886,2.9,12.4,2579,656,1923,3.3,12.9,-109,-0.5,24.8,0,94,94,409
2007,38,i) 16 to 20,1467,1619,21789,21637,56,3.4,95,5.8,2786,404,2382,1.9,12.9,2481,808,1673,3.7,11.5,305,1.4,23,0,46,46,563
2007,38,j) 21 to 25,1377,1700,19756,19983,58,3.4,95,5.5,2171,502,1669,2.5,10.9,2624,690,1934,3.5,13.1,-453,-2.2,21.8,0,46,47,483
2007,38,k) 26+,1175,1615,27413,27871,72,4.4,84,5.2,3285,692,2593,2.5,11.8,4200,1253,2947,4.5,15.1,-915,-3.3,23.6,0,40,40,1009
2007,38,l) Left Censored,2675,4940,139168,136952,252,5.1,306,6.2,18037,6308,11729,4.6,13.2,13605,3417,10188,2.5,9.9,4432,3.3,19.8,0,80,90,777
2007,39,a) 0,13135,13268,94258,47739,12916,194.7,0,0,93038,93038,0,194.9,194.9,0,0,0,0,0,93038,194.9,0,0,,,
2007,39,b) 1,11210,11581,103285,105763,97,0.7,3152,23.8,27094,1481,25613,1.4,25.6,32050,17412,14638,16.5,30.3,-4956,-4.7,51.2,0,2468,2477,14082
2007,39,c) 2,9613,9874,94395,97152,344,3.2,1755,16.6,18012,3264,14748,3.4,18.5,23526,10275,13251,10.6,24.2,-5514,-5.7,37,0,1398,1398,8704
2007,39,d) 3,8425,8676,76377,80332,304,3.3,1338,14.6,12807,1505,11302,1.9,15.9,20716,10985,9731,13.7,25.8,-7909,-9.9,31.8,0,1063,1063,9596
2007,39,e) 4,7393,7913,78345,78346,322,3.9,1106,13.3,15559,2990,12569,3.8,19.9,15560,6979,8581,8.9,19.9,-1,0,39.8,0,875,875,5498
2007,39,f) 5,7069,7434,81162,83403,272,3.5,972,12.5,11652,2260,9392,2.7,14,16134,6399,9735,7.7,19.3,-4482,-5.3,28,0,714,721,4345
2007,39,g) 6 to 10,29709,32306,361242,372999,1319,3.9,3670,11,50387,11842,38545,3.2,13.5,73901,27215,46686,7.3,19.8,-23514,-6.3,27,0,2461,2484,17728
2007,39,h) 11 to 15,22757,25022,303570,310326,892,3.5,2380,9.2,36597,7751,28846,2.5,11.8,50109,16282,33827,5.2,16.1,-13512,-4.3,23.6,0,1546,1607,11073
2007,39,i) 16 to 20,18311,22323,357207,360955,884,3.9,1783,7.8,44524,9851,34673,2.7,12.3,52020,15869,36151,4.4,14.4,-7496,-2.1,24.6,0,1068,1076,8461
2007,39,j) 21 to 25,15030,19240,343355,345041,798,4.1,1474,7.5,41557,10304,31253,3,12,44928,15526,29402,4.5,13,-3371,-1,24,0,686,716,4875
2007,39,k) 26+,12135,18440,402757,405947,915,4.9,1233,6.6,47254,13917,33337,3.4,11.6,53634,12057,41577,3,13.2,-6380,-1.6,23.2,0,536,566,4143
2007,39,l) Left Censored,28129,69736,2478573,2488488,4883,7,4437,6.4,280022,90460,189562,3.6,11.3,299853,71759,228094,2.9,12,-19831,-0.7,22.6,0,961,1028,10500
2007,40,a) 0,6082,6114,36793,18659,5950,194.6,0,0,36268,36268,0,194.4,194.4,0,0,0,0,0,36268,194.4,0,0,,,
2007,40,b) 1,4760,4920,38278,40208,40,0.7,1406,24.7,10052,731,9321,1.8,25,13911,8379,5532,20.8,34.6,-3859,-9.6,50,0,1126,1126,7146
2007,40,c) 2,4021,4133,38565,39140,148,3.4,659,15,7267,1171,6096,3,18.6,8416,3623,4793,9.3,21.5,-1149,-2.9,37.2,0,534,534,2943
2007,40,d) 3,3241,3300,27562,28173,123,3.5,527,15.1,5034,925,4109,3.3,17.9,6255,2918,3337,10.4,22.2,-1221,-4.3,35.8,0,426,426,2191
2007,40,e) 4,2964,3052,28429,28041,104,3.3,381,12,5818,878,4940,3.1,20.7,5041,2393,2648,8.5,18,777,2.7,36,0,320,320,2033
2007,40,f) 5,2734,2852,26125,26729,111,3.8,312,10.6,3833,491,3342,1.8,14.3,5041,2366,2675,8.9,18.9,-1208,-4.6,28.6,0,236,238,1655
2007,40,g) 6 to 10,11000,12125,131177,133159,519,4.2,1238,9.9,21553,5126,16427,3.8,16.2,25517,9357,16160,7,19.2,-3964,-3,32.4,0,883,889,6520
2007,40,h) 11 to 15,7629,8173,84752,87171,251,3,694,8.3,10714,1863,8851,2.1,12.3,15552,5336,10216,6.1,17.8,-4838,-5.5,24.6,0,469,470,3242
2007,40,i) 16 to 20,5467,6461,109973,107472,303,4.6,481,7.3,20169,4568,15601,4.3,18.8,15166,4659,10507,4.3,14.1,5003,4.7,28.2,0,298,299,2513
2007,40,j) 21 to 25,5684,6841,105187,103657,250,3.6,429,6.2,14502,2510,11992,2.4,14,11442,3086,8356,3,11,3060,3,22,0,222,236,1197
2007,40,k) 26+,4127,6296,134751,134281,310,4.9,407,6.4,16048,3511,12537,2.6,12,15107,3107,12000,2.3,11.3,941,0.7,22.6,0,192,197,989
2007,40,l) Left Censored,7323,17965,535348,535747,1274,7.1,1037,5.8,70259,18981,51278,3.5,13.1,71057,16444,54613,3.1,13.3,-798,-0.2,26.2,0,234,251,1963
2007,41,a) 0,8342,8376,40138,20359,8197,195.7,0,0,39558,39558,0,194.3,194.3,0,0,0,0,0,39558,194.3,0,0,,,
2007,41,b) 1,6778,7045,42825,44089,38,0.5,1893,23.4,9948,323,9625,0.7,22.6,12475,7320,5155,16.6,28.3,-2527,-5.7,45.2,0,1485,1485,6250
2007,41,c) 2,5568,5693,35969,37891,219,3.6,1065,17.4,7486,1081,6405,2.9,19.8,11330,5375,5955,14.2,29.9,-3844,-10.1,39.6,0,810,810,4135
2007,41,d) 3,4457,4558,35619,35617,204,4.3,696,14.5,7621,1964,5657,5.5,21.4,7616,3737,3879,10.5,21.4,5,0,42.8,0,513,533,2904
2007,41,e) 4,3959,4243,31492,30785,214,4.9,486,11.1,7364,2055,5309,6.7,23.9,5950,2781,3169,9,19.3,1414,4.6,38.6,0,376,376,2152
2007,41,f) 5,3544,3624,31041,31282,143,3.8,417,11.1,5266,568,4698,1.8,16.8,5748,2265,3483,7.2,18.4,-482,-1.6,33.6,0,298,298,1476
2007,41,g) 6 to 10,14631,15546,144791,146086,666,4.2,1574,9.8,22543,4049,18494,2.8,15.4,25132,9431,15701,6.5,17.2,-2589,-1.8,30.8,0,1044,1050,6305
2007,41,h) 11 to 15,10052,10726,124695,125871,420,3.8,970,8.8,17006,3035,13971,2.4,13.5,19358,6743,12615,5.4,15.4,-2352,-1.9,27,0,588,600,3330
2007,41,i) 16 to 20,6939,8129,118179,118577,351,4.3,592,7.2,15345,3775,11570,3.2,12.9,16141,3971,12170,3.3,13.6,-796,-0.7,25.8,0,378,384,2407
2007,41,j) 21 to 25,5331,7070,135179,136411,289,4,474,6.6,16090,3530,12560,2.6,11.8,18555,3930,14625,2.9,13.6,-2465,-1.8,23.6,0,237,243,1324
2007,41,k) 26+,4562,6570,130696,130768,331,5,480,7.2,15436,3638,11798,2.8,11.8,15580,3507,12073,2.7,11.9,-144,-0.1,23.6,0,210,225,1398
2007,41,l) Left Censored,7555,18721,600800,601115,1268,6.8,1035,5.6,65877,17665,48212,2.9,11,66507,16486,50021,2.7,11.1,-630,-0.1,22,0,225,231,2203
2007,42,a) 0,16122,16200,92166,46753,15797,195,0,0,90827,90827,0,194.3,194.3,0,0,0,0,0,90827,194.3,0,0,,,
2007,42,b) 1,13469,13925,112780,117302,80,0.5,3539,22.3,25305,1339,23966,1.1,21.6,34348,19653,14695,16.8,29.3,-9043,-7.7,43.2,0,2681,2681,16070
2007,42,c) 2,11999,12275,101739,103961,425,3.3,1944,14.9,17411,2111,15300,2,16.7,21854,10036,11818,9.7,21,-4443,-4.3,33.4,0,1545,1545,8109
2007,42,d) 3,10182,10477,87236,87550,355,3.2,1547,13.9,17149,2659,14490,3,19.6,17776,8149,9627,9.3,20.3,-627,-0.7,39.2,0,1224,1224,6057
2007,42,e) 4,8974,9372,94189,93525,323,3.3,1157,11.8,17098,3055,14043,3.3,18.3,15769,6912,8857,7.4,16.9,1329,1.4,33.8,0,859,860,4762
2007,42,f) 5,8666,8921,98855,100344,292,3.1,1041,11.2,13859,2237,11622,2.2,13.8,16837,6320,10517,6.3,16.8,-2978,-3,27.6,0,754,754,4202
2007,42,g) 6 to 10,35768,38458,436667,439822,1357,3.4,3712,9.4,63333,15302,48031,3.5,14.4,69643,24176,45467,5.5,15.8,-6310,-1.4,28.8,0,2498,2507,15320
2007,42,h) 11 to 15,24878,26791,335262,339915,842,3.1,2247,8.2,38826,8409,30417,2.5,11.4,48131,15242,32889,4.5,14.2,-9305,-2.8,22.8,0,1519,1532,9312
2007,42,i) 16 to 20,22377,25477,363808,367563,926,3.6,1790,6.9,39996,8143,31853,2.2,10.9,47506,14093,33413,3.8,12.9,-7510,-2,21.8,0,1148,1158,7435
2007,42,j) 21 to 25,18129,23277,449123,451468,1056,4.5,1823,7.7,60237,17701,42536,3.9,13.3,64927,21872,43055,4.8,14.4,-4690,-1.1,26.6,0,837,879,5878
2007,42,k) 26+,13275,19450,425428,423175,955,4.9,1404,7.1,52702,13921,38781,3.3,12.5,48195,14332,33863,3.4,11.4,4507,1.1,22.8,0,616,655,4797
2007,42,l) Left Censored,30683,72897,2592113,2589638,4689,6.4,4779,6.6,299840,86464,213376,3.3,11.6,294889,78409,216480,3,11.4,4951,0.2,22.8,0,1046,1131,9903
2007,44,a) 0,1768,1774,11329,5690,1742,196.4,0,0,11278,11278,0,198.2,198.2,0,0,0,0,0,11278,198.2,0,0,,,
2007,44,b) 1,1498,1552,9153,9532,4,0.2,496,27.3,1959,22,1937,0.2,20.6,2717,1437,1280,15.1,28.5,-758,-7.9,41.2,0,364,364,1137
2007,44,c) 2,1324,1333,8467,8838,44,3.1,237,16.6,1278,143,1135,1.6,14.5,2019,962,1057,10.9,22.8,-741,-8.3,29,0,176,176,754
2007,44,d) 3,1177,1196,9822,10047,40,3.1,203,16,1407,164,1243,1.6,14,1857,747,1110,7.4,18.5,-450,-4.5,28,0,166,166,614
2007,44,e) 4,1031,1061,8542,8612,37,3.3,143,12.9,1371,207,1164,2.4,15.9,1511,633,878,7.4,17.5,-140,-1.6,31.8,0,106,108,546
2007,44,f) 5,894,903,6632,6905,26,2.7,136,14.2,1037,243,794,3.5,15,1583,651,932,9.4,22.9,-546,-7.9,30,0,103,103,491
2007,44,g) 6 to 10,3690,3893,34175,35062,142,3.5,466,11.5,4499,660,3839,1.9,12.8,6273,2491,3782,7.1,17.9,-1774,-5.1,25.6,0,304,306,1777
2007,44,h) 11 to 15,2643,2704,27958,28733,77,2.8,257,9.2,3402,663,2739,2.3,11.8,4952,2054,2898,7.1,17.2,-1550,-5.4,23.6,0,179,181,1625
2007,44,i) 16 to 20,2367,2605,38973,39146,106,4,180,6.8,5160,861,4299,2.2,13.2,5505,1839,3666,4.7,14.1,-345,-0.9,26.4,0,114,120,1420
2007,44,j) 21 to 25,1780,2129,32272,32832,82,3.8,123,5.7,3820,1101,2719,3.4,11.6,4940,1124,3816,3.4,15,-1120,-3.4,23.2,0,66,66,609
2007,44,k) 26+,1369,1747,35085,34780,76,4.3,105,6,4026,774,3252,2.2,11.6,3416,747,2669,2.1,9.8,610,1.8,19.6,0,51,53,329
2007,44,l) Left Censored,3591,6067,218913,217963,358,5.9,369,6.1,23097,4577,18520,2.1,10.6,21196,4946,16250,2.3,9.7,1901,0.9,19.4,0,119,120,1012
2007,45,a) 0,7462,7525,46339,23410,7365,195.7,0,0,45859,45859,0,195.9,195.9,0,0,0,0,0,45859,195.9,0,0,,,
2007,45,b) 1,5916,6116,45040,46547,104,1.5,1646,23.6,11143,708,10435,1.5,23.9,14158,7461,6697,16,30.4,-3015,-6.5,47.8,0,1296,1296,6481
2007,45,c) 2,5081,5211,44334,44691,185,3.3,906,16.3,10208,1192,9016,2.7,22.8,10921,5402,5519,12.1,24.4,-713,-1.6,45.6,0,754,754,4472
2007,45,d) 3,4125,4231,36870,37390,172,3.9,627,14.1,7103,1225,5878,3.3,19,8142,3884,4258,10.4,21.8,-1039,-2.8,38,0,507,507,3351
2007,45,e) 4,3642,3845,40329,41792,161,4,546,13.5,6674,1674,5000,4,16,9600,3188,6412,7.6,23,-2926,-7,32,0,429,429,2356
2007,45,f) 5,3324,3398,31475,31773,125,3.5,443,12.5,5601,827,4774,2.6,17.6,6196,2884,3312,9.1,19.5,-595,-1.9,35.2,0,334,334,1926
2007,45,g) 6 to 10,13387,14313,174626,176967,506,3.4,1493,10.1,24908,4120,20788,2.3,14.1,29589,11695,17894,6.6,16.7,-4681,-2.6,28.2,0,1057,1063,7758
2007,45,h) 11 to 15,8498,9277,121686,123037,373,3.9,823,8.7,14549,2682,11867,2.2,11.8,17251,5146,12105,4.2,14,-2702,-2.2,23.6,0,585,601,3508
2007,45,i) 16 to 20,6387,7967,128600,129676,342,4.2,619,7.6,16411,4172,12239,3.2,12.7,18563,4397,14166,3.4,14.3,-2152,-1.6,25.4,0,410,417,2392
2007,45,j) 21 to 25,5623,7258,121683,118992,333,4.5,460,6.3,22344,6137,16207,5.2,18.8,16961,5350,11611,4.5,14.3,5383,4.5,28.6,0,237,242,1815
2007,45,k) 26+,3757,6189,124165,124530,376,6.1,372,6,16418,4510,11908,3.6,13.2,17147,3205,13942,2.6,13.8,-729,-0.6,26.4,0,141,154,1235
2007,45,l) Left Censored,7938,22032,724630,727496,1702,7.8,1179,5.4,90035,29926,60109,4.1,12.4,95767,22916,72851,3.1,13.2,-5732,-0.8,24.8,0,285,326,3012
2007,46,a) 0,1660,1675,8089,4119,1618,193.2,0,0,7941,7941,0,192.8,192.8,0,0,0,0,0,7941,192.8,0,0,,,
2007,46,b) 1,1374,1401,8724,9072,17,1.1,352,22.1,2188,272,1916,3,24.1,2883,1790,1093,19.7,31.8,-695,-7.7,48.2,0,254,254,1496
2007,46,c) 2,1041,1057,5914,6279,45,4,203,17.9,1208,140,1068,2.2,19.2,1937,966,971,15.4,30.8,-729,-11.6,38.4,0,154,154,802
2007,46,d) 3,959,982,6268,6423,43,4.2,129,12.5,1111,187,924,2.9,17.3,1421,686,735,10.7,22.1,-310,-4.8,34.6,0,99,99,585
2007,46,e) 4,850,898,7071,6754,44,4.8,88,9.6,1788,474,1314,7,26.5,1154,467,687,6.9,17.1,634,9.4,34.2,0,68,68,380
2007,46,f) 5,841,855,6790,6838,34,3.8,98,11.1,1122,225,897,3.3,16.4,1217,479,738,7,17.8,-95,-1.4,32.8,0,62,62,356
2007,46,g) 6 to 10,3220,3367,30729,31004,110,3.2,321,9.2,4667,1218,3449,3.9,15.1,5216,1962,3254,6.3,16.8,-549,-1.7,30.2,0,195,195,1089
2007,46,h) 11 to 15,2293,2392,25415,24921,76,3.1,186,7.6,4067,1315,2752,5.3,16.3,3079,1010,2069,4.1,12.4,988,3.9,24.8,0,123,123,710
2007,46,i) 16 to 20,1608,1784,24728,25327,77,4.2,148,8.1,2920,1054,1866,4.2,11.5,4118,1443,2675,5.7,16.3,-1198,-4.8,23,0,82,82,552
2007,46,j) 21 to 25,1414,1735,21540,21569,65,3.7,108,6.2,2765,1056,1709,4.9,12.8,2822,996,1826,4.6,13.1,-57,-0.3,25.6,0,66,69,433
2007,46,k) 26+,1180,1609,23968,24074,63,3.9,95,5.8,2539,781,1758,3.2,10.5,2751,611,2140,2.5,11.4,-212,-0.9,21,0,45,45,241
2007,46,l) Left Censored,2756,5156,155279,154989,279,5.4,266,5.2,15742,3324,12418,2.1,10.2,15161,3718,11443,2.4,9.8,581,0.4,19.6,0,81,82,776
2007,47,a) 0,8718,8818,56327,28448,8651,196.2,0,0,55758,55758,0,196,196,0,0,0,0,0,55758,196,0,0,,,
2007,47,b) 1,6874,7121,59105,61715,89,1.1,1917,23.6,16772,1544,15228,2.5,27.2,21992,10616,11376,17.2,35.6,-5220,-8.4,54.4,0,1568,1568,8923
2007,47,c) 2,5723,5885,54508,57844,181,2.8,1106,17.4,10932,1498,9434,2.6,18.9,17604,5941,11663,10.3,30.4,-6672,-11.5,37.8,0,949,950,5233
2007,47,d) 3,4835,4986,46503,47545,177,3.4,779,14.8,10175,1282,8893,2.7,21.4,12259,5607,6652,11.8,25.8,-2084,-4.4,42.8,0,642,642,4756
2007,47,e) 4,4218,4439,48412,48061,159,3.4,586,12.6,10778,1904,8874,4,22.4,10077,5499,4578,11.4,21,701,1.4,42,0,475,476,2943
2007,47,f) 5,3658,3867,41786,43361,159,3.9,518,12.8,7047,1829,5218,4.2,16.3,10197,4873,5324,11.2,23.5,-3150,-7.2,32.6,0,384,398,3240
2007,47,g) 6 to 10,15193,16671,209200,215295,656,3.8,1633,9.5,31125,5230,25895,2.4,14.5,43315,14178,29137,6.6,20.1,-12190,-5.6,29,0,1159,1171,9108
2007,47,h) 11 to 15,11173,12382,170780,171623,495,3.9,1110,8.8,32254,5938,26316,3.5,18.8,33939,11889,22050,6.9,19.8,-1685,-1,37.6,0,769,778,5527
2007,47,i) 16 to 20,8556,10645,210687,206128,449,4.2,785,7.3,35572,6912,28660,3.4,17.3,26453,8203,18250,4,12.8,9119,4.5,25.6,0,495,496,3369
2007,47,j) 21 to 25,7941,9999,173946,176989,422,4.2,669,6.6,20906,3707,17199,2.1,11.8,26991,7017,19974,4,15.3,-6085,-3.5,23.6,0,335,344,2338
2007,47,k) 26+,5497,9449,233180,232786,593,6.2,819,8.6,38733,10563,28170,4.5,16.6,37944,12866,25078,5.5,16.3,789,0.3,32.6,0,253,263,1632
2007,47,l) Left Censored,11301,31497,1183588,1180996,2363,7.6,1884,6,141196,41181,100015,3.5,12,136011,30355,105656,2.6,11.5,5185,0.5,23,0,372,412,3147
2007,48,a) 0,37266,37572,257737,130186,36800,195.9,0,0,255103,255103,0,196,196,0,0,0,0,0,255103,196,0,0,,,
2007,48,b) 1,28594,29685,255446,261390,252,0.7,8040,23.6,71005,3890,67115,1.5,27.2,82892,48984,33908,18.7,31.7,-11887,-4.5,54.4,0,6635,6635,41351
2007,48,c) 2,23811,24906,270389,270471,989,3.7,4533,17,65697,8057,57640,3,24.3,65860,33687,32173,12.5,24.4,-163,-0.1,48.6,0,3758,3758,28527
2007,48,d) 3,20418,20997,217590,216796,768,3.5,3318,14.9,46569,5671,40898,2.6,21.5,44981,22270,22711,10.3,20.7,1588,0.8,41.4,0,2727,2735,17123
2007,48,e) 4,17883,19140,212019,209544,811,4.1,2569,12.9,46006,8573,37433,4.1,22,41055,17558,23497,8.4,19.6,4951,2.4,39.2,0,2050,2054,12806
2007,48,f) 5,15689,16600,204009,204867,666,3.8,2135,12.3,37860,6725,31135,3.3,18.5,39575,18889,20686,9.2,19.3,-1715,-0.8,37,0,1601,1614,11558
2007,48,g) 6 to 10,61501,67323,914468,920200,2929,4.2,7243,10.4,154988,30887,124101,3.4,16.8,166452,64452,102000,7,18.1,-11464,-1.3,33.6,0,5105,5177,41459
2007,48,h) 11 to 15,41722,46828,680480,680391,2003,4.2,4060,8.5,111998,29217,82781,4.3,16.5,111820,33453,78367,4.9,16.4,178,0.1,32.8,0,2755,2790,19428
2007,48,i) 16 to 20,29498,36778,718426,712377,1965,5.3,2862,7.7,116407,25391,91016,3.6,16.3,104310,29512,74798,4.1,14.6,12097,1.7,29.2,0,1668,1721,15245
2007,48,j) 21 to 25,26052,35489,651389,646454,1993,5.6,2582,7.2,104526,31535,72991,4.9,16.2,94655,27040,67615,4.2,14.6,9871,1.6,29.2,0,1249,1283,9369
2007,48,k) 26+,19040,31760,705866,698083,2027,6.4,1984,6.3,104522,36214,68308,5.2,15,88956,19271,69685,2.8,12.7,15566,2.3,25.4,0,866,893,5250
2007,48,l) Left Censored,28120,102151,3820782,3775258,9088,9,7365,7.3,583727,194720,389007,5.2,15.5,492679,154444,338235,4.1,13.1,91048,2.4,26.2,0,1069,1178,17634
2007,49,a) 0,7147,7173,36910,18826,6938,193.4,0,0,36168,36168,0,192.1,192.1,0,0,0,0,0,36168,192.1,0,0,,,
2007,49,b) 1,5200,5340,38492,38365,41,0.7,1502,24.4,11165,380,10785,1,29.1,10911,6337,4574,16.5,28.4,254,0.7,56.8,0,1135,1135,5122
2007,49,c) 2,4013,4080,33863,34067,180,4.1,754,17.3,7422,1023,6399,3,21.8,7829,3987,3842,11.7,23,-407,-1.2,43.6,0,576,576,3108
2007,49,d) 3,3264,3327,28249,28716,162,4.6,523,14.9,6198,1499,4699,5.2,21.6,7132,3781,3351,13.2,24.8,-934,-3.2,43.2,0,411,411,3012
2007,49,e) 4,2874,2940,34380,33641,126,4.1,458,14.8,8029,1230,6799,3.7,23.9,6550,3561,2989,10.6,19.5,1479,4.4,39,0,351,351,2724
2007,49,f) 5,2572,2656,28775,28519,111,4,295,10.8,5635,528,5107,1.9,19.8,5123,1872,3251,6.6,18,512,1.8,36,0,214,214,1405
2007,49,g) 6 to 10,9018,9531,124038,122877,446,4.6,931,9.5,22221,3106,19115,2.5,18.1,19899,7388,12511,6,16.2,2322,1.9,32.4,0,605,607,4479
2007,49,h) 11 to 15,5257,5611,82845,83018,217,3.8,436,7.6,11763,1961,9802,2.4,14.2,12108,3875,8233,4.7,14.6,-345,-0.4,28.4,0,278,284,2316
2007,49,i) 16 to 20,3180,3781,95191,93644,180,4.7,235,6.2,13003,2598,10405,2.8,13.9,9908,2446,7462,2.6,10.6,3095,3.3,21.2,0,130,130,1257
2007,49,j) 21 to 25,2334,3254,74434,70676,221,6.8,214,6.6,14557,4407,10150,6.2,20.6,7041,2051,4990,2.9,10,7516,10.6,20,0,112,113,1073
2007,49,k) 26+,2095,3192,75712,75936,196,6.1,175,5.5,9626,2404,7222,3.2,12.7,10074,1678,8396,2.2,13.3,-448,-0.6,25.4,0,82,84,553
2007,49,l) Left Censored,3875,10452,433471,429343,858,8.2,796,7.6,60807,14971,45836,3.5,14.2,52550,14940,37610,3.5,12.2,8257,2,24.4,0,114,121,1386
2007,50,a) 0,1298,1306,7706,3888,1270,194.5,0,0,7637,,,,196.4,0,0,0,0,0,7637,196.4,0,1,,,
2007,50,b) 1,1057,1072,5690,6083,2,0.2,261,21.5,1228,,,,20.2,2013,1276,737,21,33.1,-785,-12.9,40.4,1,190,190,689
2007,50,c) 2,846,851,5235,5456,34,3.7,150,16.4,1002,153,849,2.8,18.4,1443,722,721,13.2,26.4,-441,-8,36.8,0,118,118,635
2007,50,d) 3,827,841,5215,5337,35,4,126,14.2,840,126,714,2.4,15.7,1084,489,595,9.2,20.3,-244,-4.6,31.4,0,94,94,419
2007,50,e) 4,727,744,4706,4708,26,3.4,88,11.3,697,146,551,3.1,14.8,701,287,414,6.1,14.9,-4,-0.1,29.6,0,64,64,228
2007,50,f) 5,656,666,4730,4834,28,4.1,82,11.9,614,61,553,1.3,12.7,822,275,547,5.7,17,-208,-4.3,25.4,0,54,54,204
2007,50,g) 6 to 10,2910,3032,26029,26332,96,3.1,280,9,3179,337,2842,1.3,12.1,3785,1227,2558,4.7,14.4,-606,-2.3,24.2,0,178,179,772
2007,50,h) 11 to 15,2124,2256,20196,20713,68,2.9,174,7.5,2152,212,1940,1,10.4,3186,746,2440,3.6,15.4,-1034,-5,20.8,0,121,123,535
2007,50,i) 16 to 20,1955,2082,27527,24476,79,3.7,167,7.8,9025,446,8579,1.8,36.9,2923,882,2041,3.6,11.9,6102,25,23.8,0,103,103,416
2007,50,j) 21 to 25,1530,1794,31942,31952,71,3.9,133,7.3,3304,819,2485,2.6,10.3,3324,971,2353,3,10.4,-20,-0.1,20.6,0,56,56,221
2007,50,k) 26+,1024,1354,22224,22581,56,4.1,107,7.8,2011,446,1565,2,8.9,2724,651,2073,2.9,12.1,-713,-3.2,17.8,0,40,45,289
2007,50,l) Left Censored,2140,3851,109611,109891,264,6.8,293,7.6,10400,2755,7645,2.5,9.5,10962,3179,7783,2.9,10,-562,-0.5,19,0,70,70,639
2007,51,a) 0,13358,13402,67372,34135,13070,195,0,0,66474,66474,0,194.7,194.7,0,0,0,0,0,66474,194.7,0,0,,,
2007,51,b) 1,11065,11474,79433,81710,98,0.7,3104,23.6,20165,1389,18776,1.7,24.7,24718,12548,12170,15.4,30.3,-4553,-5.6,49.4,0,2385,2385,9760
2007,51,c) 2,9291,9470,69381,74905,330,3.2,1715,16.9,14152,2730,11422,3.6,18.9,25199,15987,9212,21.3,33.6,-11047,-14.7,37.8,0,1357,1357,13664
2007,51,d) 3,7851,7984,63965,65981,300,3.5,1276,15.1,12195,2120,10075,3.2,18.5,16227,7453,8774,11.3,24.6,-4032,-6.1,37,0,1007,1007,4948
2007,51,e) 4,6474,6731,63275,62204,304,4.3,890,12.7,14521,3697,10824,5.9,23.3,12378,4759,7619,7.7,19.9,2143,3.4,39.8,0,670,670,3501
2007,51,f) 5,6018,6204,55958,58309,222,3.4,735,11.4,8912,1699,7213,2.9,15.3,13614,5104,8510,8.8,23.3,-4702,-8,30.6,0,555,557,3559
2007,51,g) 6 to 10,23808,25672,293524,299978,981,3.7,2678,10.1,44613,8071,36542,2.7,14.9,57521,19494,38027,6.5,19.2,-12908,-4.3,29.8,0,1773,1799,12966
2007,51,h) 11 to 15,16421,17760,225299,231164,588,3.2,1572,8.6,29442,5528,23914,2.4,12.7,41172,12013,29159,5.2,17.8,-11730,-5.1,25.4,0,1060,1073,7469
2007,51,i) 16 to 20,12786,15154,259277,261017,561,3.6,1067,6.9,34271,6073,28198,2.3,13.1,37750,9761,27989,3.7,14.5,-3479,-1.4,26.2,0,619,629,3979
2007,51,j) 21 to 25,10373,13479,250426,253562,609,4.5,980,7.2,31810,8682,23128,3.4,12.5,38082,8513,29569,3.4,15,-6272,-2.5,25,0,426,437,2776
2007,51,k) 26+,6903,10976,251993,252270,599,5.4,693,6.3,31786,7923,23863,3.1,12.6,32339,7804,24535,3.1,12.8,-553,-0.2,25.2,0,317,340,2537
2007,51,l) Left Censored,13814,41571,1472337,1470587,3422,8.3,2834,6.9,207969,59490,148479,4,14.1,204470,54044,150426,3.7,13.9,3499,0.2,27.8,0,421,447,4130
2007,53,a) 0,14364,14435,70229,35631,14027,194.3,0,0,69197,69197,0,194.2,194.2,0,0,0,0,0,69197,194.2,0,0,,,
2007,53,b) 1,11330,11621,73163,75358,77,0.6,3379,25.1,18791,661,18130,0.9,24.9,23180,13157,10023,17.5,30.8,-4389,-5.9,49.8,0,2565,2566,10656
2007,53,c) 2,9217,9395,63581,65096,464,4.6,1643,16.5,13263,2340,10923,3.6,20.4,16293,7648,8645,11.7,25,-3030,-4.6,40.8,0,1283,1284,6166
2007,53,d) 3,7347,7488,55649,55919,320,4.1,1181,14.9,11551,1779,9772,3.2,20.7,12090,5808,6282,10.4,21.6,-539,-0.9,41.4,0,881,881,4399
2007,53,e) 4,6395,6623,54347,54300,344,5,976,14.1,11748,2068,9680,3.8,21.6,11653,5006,6647,9.2,21.5,95,0.1,43,0,745,745,3910
2007,53,f) 5,5944,6109,55088,55501,216,3.4,719,11.3,9820,886,8934,1.6,17.7,10646,4365,6281,7.9,19.2,-826,-1.5,35.4,0,540,541,3373
2007,53,g) 6 to 10,23438,24916,258188,257894,1105,4.3,2851,11.1,47757,9386,38371,3.6,18.5,47169,16743,30426,6.5,18.3,588,0.2,36.6,0,1858,1880,9786
2007,53,h) 11 to 15,15667,16923,189236,190550,698,4,1532,8.8,26872,6229,20643,3.3,14.1,29500,9159,20341,4.8,15.5,-2628,-1.4,28.2,0,1013,1015,5660
2007,53,i) 16 to 20,11112,12896,209484,206522,622,4.7,1066,8.1,31209,5867,25342,2.8,15.1,25285,8151,17134,3.9,12.2,5924,2.9,24.4,0,646,658,4246
2007,53,j) 21 to 25,8778,11329,230824,230696,529,4.6,785,6.9,24929,5725,19204,2.5,10.8,24673,7568,17105,3.3,10.7,256,0.1,21.4,0,375,383,2413
2007,53,k) 26+,6623,10017,211744,209935,608,6.1,681,6.8,28284,6990,21294,3.3,13.5,24665,6536,18129,3.1,11.7,3619,1.8,23.4,0,309,316,2169
2007,53,l) Left Censored,11187,29542,1014489,1002320,2212,7.5,1997,6.8,134800,34229,100571,3.4,13.4,110461,35555,74906,3.5,11,24339,2.4,22,0,347,361,4817
2007,54,a) 0,2074,2078,11720,5922,2032,195.6,0,0,11597,11597,0,195.8,195.8,0,0,0,0,0,11597,195.8,0,0,,,
2007,54,b) 1,1834,1934,15647,16237,22,1,494,22.4,4344,200,4144,1.2,26.8,5524,3301,2223,20.3,34,-1180,-7.2,53.6,0,397,397,2884
2007,54,c) 2,1608,1648,12525,13397,60,3.4,318,17.9,2181,386,1795,2.9,16.3,3924,1306,2618,9.7,29.3,-1743,-13,32.6,0,261,261,1086
2007,54,d) 3,1354,1427,10625,10931,61,4.1,192,12.8,2107,494,1613,4.5,19.3,2718,1191,1527,10.9,24.9,-611,-5.6,38.6,0,159,159,1054
2007,54,e) 4,1113,1190,8989,9679,56,4.5,149,12.1,1325,185,1140,1.9,13.7,2705,1318,1387,13.6,27.9,-1380,-14.2,27.4,0,117,117,863
2007,54,f) 5,1034,1049,9676,10026,35,3.2,137,12.5,1740,715,1025,7.1,17.4,2439,1102,1337,11,24.3,-699,-6.9,34.8,0,106,106,497
2007,54,g) 6 to 10,4470,4861,47069,48294,178,3.5,539,10.7,7020,1332,5688,2.8,14.5,9471,3758,5713,7.8,19.6,-2451,-5.1,29,0,371,383,2693
2007,54,h) 11 to 15,3427,3687,37372,38475,136,3.6,338,8.9,4726,1106,3620,2.9,12.3,6932,2206,4726,5.7,18,-2206,-5.7,24.6,0,230,234,1697
2007,54,i) 16 to 20,2746,3062,41360,42039,103,3.3,243,7.8,4735,920,3815,2.2,11.3,6092,1540,4552,3.7,14.5,-1357,-3.2,22.6,0,169,173,966
2007,54,j) 21 to 25,2602,3181,52407,52901,122,3.8,236,7.3,5608,1419,4189,2.7,10.6,6595,2191,4404,4.1,12.5,-987,-1.9,21.2,0,126,133,898
2007,54,k) 26+,1941,3070,49790,50086,129,4.2,164,5.3,6308,2332,3976,4.7,12.6,6899,1615,5284,3.2,13.8,-591,-1.2,25.2,0,82,85,592
2007,54,l) Left Censored,4683,10117,281089,280042,666,6.6,606,6,33980,11586,22394,4.1,12.1,31885,6338,25547,2.3,11.4,2095,0.7,22.8,0,145,154,903
2007,55,a) 0,7992,8053,47447,23947,7849,194.9,0,0,47001,47001,0,196.3,196.3,0,0,0,0,0,47001,196.3,0,0,,,
2007,55,b) 1,6706,6994,52927,55710,75,0.9,1811,22.7,11651,1009,10642,1.8,20.9,17216,8447,8769,15.2,30.9,-5565,-10,41.8,0,1340,1340,6649
2007,55,c) 2,5713,5790,43417,44941,201,3.2,995,16,7415,1087,6328,2.4,16.5,10462,4440,6022,9.9,23.3,-3047,-6.8,33,0,799,799,3693
2007,55,d) 3,4764,4911,44567,45377,205,4,732,14.1,7435,901,6534,2,16.4,9055,3926,5129,8.7,20,-1620,-3.6,32.8,0,578,579,3286
2007,55,e) 4,4284,4473,39677,40888,129,2.7,597,12.7,6071,1065,5006,2.6,14.8,8493,3132,5361,7.7,20.8,-2422,-6,29.6,0,449,449,2500
2007,55,f) 5,4182,4312,38970,40394,155,3.4,576,12.8,5254,1064,4190,2.6,13,8101,3909,4192,9.7,20.1,-2847,-7.1,26,0,413,416,2649
2007,55,g) 6 to 10,17519,18905,208022,211902,687,3.5,1804,9.3,26809,4860,21949,2.3,12.7,34569,10929,23640,5.2,16.3,-7760,-3.6,25.4,0,1147,1150,6509
2007,55,h) 11 to 15,12899,13697,154401,156674,443,3.2,1106,7.9,19787,3978,15809,2.5,12.6,24333,7363,16970,4.7,15.5,-4546,-2.9,25.2,0,724,726,4922
2007,55,i) 16 to 20,10025,12000,190810,190054,520,4.3,854,7,24454,4764,19690,2.5,12.9,22942,5963,16979,3.1,12.1,1512,0.8,24.2,0,520,532,3695
2007,55,j) 21 to 25,7944,10041,172277,174858,374,3.7,707,6.9,19414,4421,14993,2.5,11.1,24575,6683,17892,3.8,14.1,-5161,-3,22.2,0,346,348,3089
2007,55,k) 26+,6267,9493,204724,204688,398,4.2,591,6.2,23009,5993,17016,2.9,11.2,22937,5448,17489,2.7,11.2,72,0,22.4,0,276,284,2316
2007,55,l) Left Censored,14905,32617,1281975,1281192,1921,5.9,2174,6.6,128668,35721,92947,2.8,10,127102,30676,96426,2.4,9.9,1566,0.1,19.8,0,493,539,5104
2007,56,a) 0,1607,1612,7121,3630,1579,195.9,0,0,6983,,,,192.4,0,0,0,0,0,6983,192.4,0,1,,,
2007,56,b) 1,1310,1347,8443,8131,15,1,321,21.1,2432,,,,29.9,1808,971,837,11.9,22.2,624,7.7,44.4,1,245,245,648
2007,56,c) 2,1008,1023,6571,6622,38,3.5,161,14.7,1396,177,1219,2.7,21.1,1497,661,836,10,22.6,-101,-1.5,42.2,0,118,118,416
2007,56,d) 3,816,830,4916,4963,39,4.5,113,13,978,125,853,2.5,19.7,1071,471,600,9.5,21.6,-93,-1.9,39.4,0,81,81,370
2007,56,e) 4,720,734,4990,5064,45,5.9,102,13.4,886,141,745,2.8,17.5,1033,508,525,10,20.4,-147,-2.9,35,0,88,88,402
2007,56,f) 5,762,772,6014,6061,31,3.9,80,10.1,953,139,814,2.3,15.7,1046,275,771,4.5,17.3,-93,-1.6,31.4,0,59,59,224
2007,56,g) 6 to 10,2726,2821,23164,23202,96,3.3,320,10.9,3879,379,3500,1.6,16.7,3955,1546,2409,6.7,17,-76,-0.3,33.4,0,207,207,990
2007,56,h) 11 to 15,1822,1897,16335,16785,75,3.9,160,8.2,2077,536,1541,3.2,12.4,2976,1033,1943,6.2,17.7,-899,-5.3,24.8,0,119,120,852
2007,56,i) 16 to 20,1162,1305,20226,20137,54,4.1,92,7,2594,451,2143,2.2,12.9,2415,621,1794,3.1,12,179,0.9,24,0,50,51,284
2007,56,j) 21 to 25,1087,1297,16846,17044,61,4.7,71,5.5,1942,326,1616,1.9,11.4,2337,810,1527,4.8,13.7,-395,-2.3,22.8,0,49,50,513
2007,56,k) 26+,988,1372,21363,21400,80,5.8,89,6.5,2778,640,2138,3,13,2852,834,2018,3.9,13.3,-74,-0.3,26,0,43,48,198
2007,56,l) Left Censored,1682,3228,73990,72296,218,6.8,182,5.7,11382,2936,8446,4.1,15.7,7993,2599,5394,3.6,11.1,3389,4.6,22.2,0,43,43,450
2008,01,a) 0,5970,6059,35205,17888,5917,195.3,0,0,34635,34635,0,193.6,193.6,0,0,0,0,0,34635,193.6,0,0,,,
2008,01,b) 1,5077,5158,39006,40567,24,0.4,1554,25.9,9433,268,9165,0.7,23.3,12555,7139,5416,17.6,30.9,-3122,-7.6,46.6,0,1331,1331,6180
2008,01,c) 2,4345,4537,37996,41274,122,2.5,884,18,6815,766,6049,1.9,16.5,13371,7532,5839,18.2,32.4,-6556,-15.9,33,0,753,753,6881
2008,01,d) 3,3817,3945,37412,38441,115,2.7,640,15.2,6253,953,5300,2.5,16.3,8313,3160,5153,8.2,21.6,-2060,-5.3,32.6,0,538,538,2823
2008,01,e) 4,3315,3475,33771,34711,95,2.6,549,14.9,5306,456,4850,1.3,15.3,7185,3257,3928,9.4,20.7,-1879,-5.4,30.6,0,483,484,3071
2008,01,f) 5,3047,3220,31346,32328,83,2.5,399,11.8,3934,501,3433,1.5,12.2,5898,2648,3250,8.2,18.2,-1964,-6,24.4,0,336,336,2392
2008,01,g) 6 to 10,12149,13161,158078,162323,375,2.7,1355,9.9,23506,5268,18238,3.2,14.5,31995,14113,17882,8.7,19.7,-8489,-5.2,29,0,1095,1098,7674
2008,01,h) 11 to 15,9229,9859,116287,119238,294,2.9,821,8.1,13655,2615,11040,2.2,11.5,19557,5645,13912,4.7,16.4,-5902,-4.9,23,0,601,602,3763
2008,01,i) 16 to 20,6548,7662,123105,123846,202,2.6,504,6.4,13869,2481,11388,2,11.2,15350,4160,11190,3.4,12.4,-1481,-1.2,22.4,0,317,318,2016
2008,01,j) 21 to 25,6067,7798,173399,173006,228,2.9,385,4.9,16669,3962,12707,2.3,9.6,15883,3102,12781,1.8,9.2,786,0.4,18.4,0,286,286,2344
2008,01,k) 26+,4887,8041,165062,164776,272,3.4,385,4.8,18836,4041,14795,2.5,11.4,18264,3140,15124,1.9,11.1,572,0.3,22.2,0,230,230,1579
2008,01,l) Left Censored,8215,23218,759612,757840,1235,5.4,899,3.9,82806,22672,60134,3,10.9,79261,18481,60780,2.4,10.5,3545,0.4,21,0,258,259,2181
2008,02,a) 0,1243,1266,6055,3083,1216,192.1,0,0,5944,5944,0,192.8,192.8,0,0,0,0,0,5944,192.8,0,0,,,
2008,02,b) 1,935,949,5226,5629,2,0.2,315,27.8,1151,,,,20.4,1956,1078,878,19.2,34.7,-805,-14.3,40.8,1,207,207,847
2008,02,c) 2,831,865,6140,6104,41,4.4,170,18.2,1288,122,1166,2,21.1,1216,580,636,9.5,19.9,72,1.2,39.8,0,113,113,444
2008,02,d) 3,682,699,4500,4648,39,5.3,121,16.3,838,112,726,2.4,18,1134,579,555,12.5,24.4,-296,-6.4,36,0,92,92,504
2008,02,e) 4,649,665,4519,4574,33,4.6,123,17.3,832,120,712,2.6,18.2,942,379,563,8.3,20.6,-110,-2.4,36.4,0,88,88,298
2008,02,f) 5,563,610,4538,4931,31,4.8,87,13.6,571,,,,11.6,1356,514,842,10.4,27.5,-785,-15.9,23.2,1,57,57,466
2008,02,g) 6 to 10,2443,2610,30062,30177,98,3.6,300,11.1,4207,485,3722,1.6,13.9,4437,1341,3096,4.4,14.7,-230,-0.8,27.8,0,203,203,1001
2008,02,h) 11 to 15,1618,1678,13826,14202,78,4.5,203,11.6,1800,364,1436,2.6,12.7,2551,768,1783,5.4,18,-751,-5.3,25.4,0,117,117,527
2008,02,i) 16 to 20,1172,1276,14654,14615,58,4.5,99,7.6,1865,213,1652,1.5,12.8,1786,387,1399,2.6,12.2,79,0.6,24.4,0,60,60,263
2008,02,j) 21 to 25,1181,1464,25221,25407,52,3.5,80,5.4,2197,475,1722,1.9,8.6,2568,473,2095,1.9,10.1,-371,-1.5,17.2,0,57,58,319
2008,02,k) 26+,979,1547,36266,36272,47,3,109,6.9,3896,555,3341,1.5,10.7,3907,615,3292,1.7,10.8,-11,-0.1,21.4,0,37,37,196
2008,02,l) Left Censored,1304,3268,94839,93434,164,5.1,124,3.8,11353,2636,8717,2.8,12.2,8543,655,7888,0.7,9.1,2810,3.1,18.2,0,24,24,155
2008,04,a) 0,10820,11017,68263,34585,10734,194.9,0,0,67357,67357,0,194.8,194.8,0,0,0,0,0,67357,194.8,0,0,,,
2008,04,b) 1,8575,8699,61745,65499,47,0.5,3030,29.2,15404,619,14785,0.9,23.5,22911,12165,10746,18.6,35,-7507,-11.5,47,0,2458,2458,10785
2008,04,c) 2,7884,8091,65575,70899,267,3,1914,21.4,12414,2347,10067,3.3,17.5,23062,11350,11712,16,32.5,-10648,-15,35,0,1549,1565,10277
2008,04,d) 3,6304,6563,58082,62603,213,3,1267,17.8,9177,1073,8104,1.7,14.7,18219,7552,10667,12.1,29.1,-9042,-14.4,29.4,0,1061,1061,6633
2008,04,e) 4,5316,5546,54303,57900,174,2.9,889,15,8057,728,7329,1.3,13.9,15251,6741,8510,11.6,26.3,-7194,-12.4,27.8,0,740,740,6185
2008,04,f) 5,4496,4847,53504,57551,195,3.8,749,14.6,7380,1045,6335,1.8,12.8,15473,7210,8263,12.5,26.9,-8093,-14.1,25.6,0,609,613,5521
2008,04,g) 6 to 10,17108,18229,264092,274011,601,3.2,2231,11.7,32781,6975,25806,2.5,12,52620,17577,35043,6.4,19.2,-19839,-7.2,24,0,1768,1768,14666
2008,04,h) 11 to 15,10773,11749,176073,183487,426,3.5,1110,9.2,22400,5639,16761,3.1,12.2,37228,9484,27744,5.2,20.3,-14828,-8.1,24.4,0,791,791,6621
2008,04,i) 16 to 20,6869,9095,170984,175758,380,4.1,756,8.1,22738,4752,17986,2.7,12.9,32285,7871,24414,4.5,18.4,-9547,-5.5,25.8,0,481,481,4011
2008,04,j) 21 to 25,5787,8545,186405,192418,400,4.6,582,6.7,21238,6707,14531,3.5,11,33263,7860,25403,4.1,17.3,-12025,-6.3,22,0,328,329,2576
2008,04,k) 26+,4615,7673,209952,220792,358,4.6,504,6.5,25352,6680,18672,3,11.5,47031,8443,38588,3.8,21.3,-21679,-9.8,23,0,258,260,3017
2008,04,l) Left Censored,6146,23775,934734,933660,1920,8.2,1266,5.4,113181,39304,73877,4.2,12.1,111032,18168,92864,1.9,11.9,2149,0.2,23.8,0,179,183,1579
2008,05,a) 0,3929,3940,22235,11258,3829,194.4,0,0,21955,21955,0,195,195,0,0,0,0,0,21955,195,0,0,,,
2008,05,b) 1,3157,3194,21036,21846,20,0.5,1008,26.8,5459,320,5139,1.5,25,7078,4237,2841,19.4,32.4,-1619,-7.4,50,0,843,843,3778
2008,05,c) 2,2956,3144,23558,24712,106,3.1,564,16.6,4502,1203,3299,4.9,18.2,6810,3539,3271,14.3,27.6,-2308,-9.4,36.4,0,463,463,3119
2008,05,d) 3,2537,2603,20450,21154,91,3.3,456,16.4,3113,357,2756,1.7,14.7,4520,2241,2279,10.6,21.4,-1407,-6.7,29.4,0,387,387,2002
2008,05,e) 4,2214,2328,19009,19385,63,2.6,323,13.1,2836,409,2427,2.1,14.6,3587,1529,2058,7.9,18.5,-751,-3.9,29.2,0,269,269,1378
2008,05,f) 5,2002,2110,18300,18826,53,2.4,278,12.5,2771,272,2499,1.4,14.7,3823,1480,2343,7.9,20.3,-1052,-5.6,29.4,0,227,227,1217
2008,05,g) 6 to 10,7880,8647,78914,80195,263,2.9,934,10.4,10477,2134,8343,2.7,13.1,13038,4924,8114,6.1,16.3,-2561,-3.2,26.2,0,699,708,4004
2008,05,h) 11 to 15,5758,6213,65912,68421,169,2.6,540,8.4,6806,1070,5736,1.6,9.9,11824,3662,8162,5.4,17.3,-5018,-7.4,19.8,0,404,404,3035
2008,05,i) 16 to 20,3978,4636,69840,70625,135,2.8,330,7,6538,1162,5376,1.6,9.3,8107,2068,6039,2.9,11.5,-1569,-2.2,18.6,0,238,238,1525
2008,05,j) 21 to 25,3724,4727,83621,84793,138,2.9,251,5.2,7401,1625,5776,1.9,8.7,9745,1674,8071,2,11.5,-2344,-2.8,17.4,0,155,155,1065
2008,05,k) 26+,3306,4976,119311,119592,167,3.3,230,4.6,10243,1796,8447,1.5,8.6,10804,1709,9095,1.4,9,-561,-0.4,17.2,0,144,144,653
2008,05,l) Left Censored,5522,14210,480622,481467,654,4.6,498,3.5,45432,12464,32968,2.6,9.4,47122,6467,40655,1.3,9.8,-1690,-0.4,18.8,0,150,151,1132
2008,06,a) 0,63228,63770,353341,179248,62259,195.3,0,0,348186,348186,0,194.2,194.2,0,0,0,0,0,348186,194.2,0,0,,,
2008,06,b) 1,50103,50519,341973,358665,136,0.2,16368,27.4,86671,1667,85004,0.5,24.2,120054,69990,50064,19.5,33.5,-33383,-9.3,48.4,0,13151,13151,60139
2008,06,c) 2,47043,48465,385350,407501,1616,3,10491,19.8,69151,8287,60864,2,17,113452,55914,57538,13.7,27.8,-44301,-10.8,34,0,8438,8438,47357
2008,06,d) 3,39331,41381,367153,383452,1470,3.3,7414,16.7,68097,11884,56213,3.1,17.8,100694,46086,54608,12,26.3,-32597,-8.5,35.6,0,5950,5957,39656
2008,06,e) 4,32962,33904,322263,333604,1211,3.4,5487,15.2,51282,7049,44233,2.1,15.4,73963,35048,38915,10.5,22.2,-22681,-6.8,30.8,0,4364,4364,30155
2008,06,f) 5,29768,31329,309897,328766,1157,3.5,4330,13.1,45822,6406,39416,1.9,13.9,83560,43087,40473,13.1,25.4,-37738,-11.5,27.8,0,3427,3427,39542
2008,06,g) 6 to 10,111811,119384,1393705,1432915,4093,3.3,13256,10.7,186980,31427,155553,2.2,13,265400,97295,168105,6.8,18.5,-78420,-5.5,26,0,9935,9952,79188
2008,06,h) 11 to 15,68156,72974,1023448,1046076,2485,3.3,6717,8.9,126536,32966,93570,3.2,12.1,171792,51259,120533,4.9,16.4,-45256,-4.3,24.2,0,4846,4849,36012
2008,06,i) 16 to 20,52983,62876,1023280,1038752,2250,3.5,4932,7.7,137348,27414,109934,2.6,13.2,168292,42542,125750,4.1,16.2,-30944,-3,26.4,0,3349,3352,22255
2008,06,j) 21 to 25,44316,57983,1230112,1235538,2326,4,3859,6.6,138131,29481,108650,2.4,11.2,148982,36340,112642,2.9,12.1,-10851,-0.9,22.4,0,2367,2375,18393
2008,06,k) 26+,39247,59459,1436331,1433220,2434,4.1,3425,5.7,186064,47999,138065,3.3,13,179843,37379,142464,2.6,12.5,6221,0.5,25,0,1969,1984,15118
2008,06,l) Left Censored,44529,139578,5472424,5458737,8371,6,7361,5.3,649008,208068,440940,3.8,11.9,621634,135021,486613,2.5,11.4,27374,0.5,22.8,0,1829,1889,27714
2008,08,a) 0,11730,11785,55527,28394,11427,193.9,0,0,54267,54267,0,191.1,191.1,0,0,0,0,0,54267,191.1,0,0,,,
2008,08,b) 1,9034,9075,58209,60033,30,0.3,3057,28.4,13503,447,13056,0.7,22.5,17151,10242,6909,17.1,28.6,-3648,-6.1,45,0,2291,2291,8705
2008,08,c) 2,8060,8251,56164,58576,354,4,1737,19.4,10330,1312,9018,2.2,17.6,15154,7599,7555,13,25.9,-4824,-8.3,35.2,0,1258,1258,6320
2008,08,d) 3,7117,7247,54627,56299,294,3.8,1230,15.9,9022,1162,7860,2.1,16,12365,5034,7331,8.9,22,-3343,-6,32,0,915,915,4213
2008,08,e) 4,5860,6000,46946,47657,236,3.7,954,15,7849,1587,6262,3.3,16.5,9270,4178,5092,8.8,19.5,-1421,-3,33,0,713,721,3523
2008,08,f) 5,5311,5627,46637,47822,283,4.8,765,13,7912,1649,6263,3.4,16.5,10282,4378,5904,9.2,21.5,-2370,-5,33,0,587,587,3767
2008,08,g) 6 to 10,20970,22029,208129,213805,868,3.8,2567,11.2,29953,5015,24938,2.3,14,41305,17253,24052,8.1,19.3,-11352,-5.3,28,0,1793,1793,12692
2008,08,h) 11 to 15,13554,14615,166069,167998,513,3.4,1344,8.9,22219,4147,18072,2.5,13.2,26077,9128,16949,5.4,15.5,-3858,-2.3,26.4,0,917,917,6223
2008,08,i) 16 to 20,8586,10020,156344,157912,404,4,740,7.3,17894,3588,14306,2.3,11.3,21029,4680,16349,3,13.3,-3135,-2,22.6,0,479,479,2963
2008,08,j) 21 to 25,6686,9162,176335,175263,372,4,577,6.2,23506,6333,17173,3.6,13.4,21362,6321,15041,3.6,12.2,2144,1.2,24.4,0,337,337,3156
2008,08,k) 26+,5933,9032,222008,219803,364,4,524,5.7,29695,6841,22854,3.1,13.5,25285,5830,19455,2.7,11.5,4410,2,23,0,279,279,2705
2008,08,l) Left Censored,7866,23285,829055,818388,1657,7.2,1344,5.8,113101,37266,75835,4.6,13.8,91767,24031,67736,2.9,11.2,21334,2.6,22.4,0,249,256,2882
2008,09,a) 0,4929,4970,30750,15592,4812,193.6,0,0,30317,30317,0,194.4,194.4,0,0,0,0,0,30317,194.4,0,0,,,
2008,09,b) 1,3728,3767,28464,31814,16,0.4,1094,25.1,5911,148,5763,0.5,18.6,12610,5917,6693,18.6,39.6,-6699,-21,37.2,0,878,878,5339
2008,09,c) 2,3604,3785,28921,29589,141,3.5,658,16.3,5093,728,4365,2.5,17.2,6428,2882,3546,9.7,21.7,-1335,-4.5,34.4,0,529,529,2281
2008,09,d) 3,3199,3268,28718,29440,93,2.7,532,15.2,5074,464,4610,1.6,17.2,6518,3414,3104,11.6,22.1,-1444,-4.9,34.4,0,435,435,2170
2008,09,e) 4,2717,2776,21700,22173,99,3.4,401,13.6,3478,364,3114,1.6,15.7,4424,1676,2748,7.6,20,-946,-4.3,31.4,0,316,316,1431
2008,09,f) 5,2381,2464,23419,24166,73,2.8,312,12.1,3098,292,2806,1.2,12.8,4592,1634,2958,6.8,19,-1494,-6.2,25.6,0,251,251,1500
2008,09,g) 6 to 10,10815,11490,146462,144141,383,3.2,1140,9.6,26133,3285,22848,2.3,18.1,21490,7274,14216,5,14.9,4643,3.2,29.8,0,858,858,5790
2008,09,h) 11 to 15,8015,8347,89619,91089,233,2.7,645,7.5,10680,2286,8394,2.5,11.7,13620,4248,9372,4.7,15,-2940,-3.3,23.4,0,464,464,2790
2008,09,i) 16 to 20,6899,7588,100790,100177,220,2.8,528,6.8,14249,2793,11456,2.8,14.2,13022,4389,8633,4.4,13,1227,1.2,26,0,344,344,2398
2008,09,j) 21 to 25,6116,7317,125191,125583,177,2.4,463,6.2,13062,1625,11437,1.3,10.4,13845,4894,8951,3.9,11,-783,-0.6,20.8,0,290,291,2872
2008,09,k) 26+,5088,7112,141229,140830,284,4,408,5.7,16805,4257,12548,3,11.9,16006,4539,11467,3.2,11.4,799,0.5,22.8,0,235,235,1890
2008,09,l) Left Censored,10257,21198,789046,786054,1162,5.5,1033,4.9,98165,36471,61694,4.6,12.5,92181,14680,77501,1.9,11.7,5984,0.8,23.4,0,336,336,2698
2008,10,a) 0,1472,1487,9126,4764,1446,194.5,0,0,8724,8724,0,183.1,183.1,0,0,0,0,0,8724,183.1,0,0,,,
2008,10,b) 1,1098,1128,8605,9547,6,0.5,358,27.1,1423,,,,14.9,3307,1275,2032,13.4,34.6,-1884,-19.7,29.8,1,289,289,1102
2008,10,c) 2,1048,1067,7808,8052,45,3.9,221,19.1,1274,227,1047,2.8,15.8,1762,797,965,9.9,21.9,-488,-6.1,31.6,0,178,178,712
2008,10,d) 3,953,960,6303,6619,36,3.6,145,14.4,1027,148,879,2.2,15.5,1659,671,988,10.1,25.1,-632,-9.6,31,0,120,120,586
2008,10,e) 4,840,855,8706,8182,33,3.7,135,15,2322,467,1855,5.7,28.4,1273,522,751,6.4,15.6,1049,12.8,31.2,0,115,115,463
2008,10,f) 5,797,828,7838,7443,31,3.5,121,13.8,2158,,,,29,1367,635,732,8.5,18.4,791,10.6,36.8,1,101,101,595
2008,10,g) 6 to 10,2973,3125,26972,27605,124,3.8,413,12.6,3757,679,3078,2.5,13.6,5023,1866,3157,6.8,18.2,-1266,-4.6,27.2,0,342,342,1630
2008,10,h) 11 to 15,2048,2194,29478,29490,63,2.8,199,8.8,3810,646,3164,2.2,12.9,3834,843,2991,2.9,13,-24,-0.1,25.8,0,152,152,726
2008,10,i) 16 to 20,1521,1701,20143,20180,47,2.7,132,7.6,2471,511,1960,2.5,12.2,2545,694,1851,3.4,12.6,-74,-0.4,24.4,0,81,81,420
2008,10,j) 21 to 25,1277,1586,23316,23220,47,2.9,79,4.9,2460,544,1916,2.3,10.6,2268,314,1954,1.4,9.8,192,0.8,19.6,0,60,60,259
2008,10,k) 26+,1132,1583,39594,39201,74,4.7,72,4.6,4734,849,3885,2.2,12.1,3947,526,3421,1.3,10.1,787,2,20.2,0,42,42,402
2008,10,l) Left Censored,2704,5978,198327,198971,368,6.2,380,6.4,26490,7949,18541,4,13.3,27778,5092,22686,2.6,14,-1288,-0.7,26.6,0,56,56,720
2008,11,a) 0,1000,1009,7265,3663,985,195.2,0,0,7205,7205,0,196.7,196.7,0,0,0,0,0,7205,196.7,0,0,,,
2008,11,b) 1,857,860,6389,6102,3,0.3,200,20.6,1827,9,1818,0.1,29.9,1252,527,725,8.6,20.5,575,9.4,41,0,167,167,456
2008,11,c) 2,810,825,6988,7277,31,3.5,142,16.2,1221,155,1066,2.1,16.8,1798,751,1047,10.3,24.7,-577,-7.9,33.6,0,106,106,611
2008,11,d) 3,951,963,8858,8550,32,3.1,141,13.8,1870,98,1772,1.1,21.9,1253,491,762,5.7,14.7,617,7.2,29.4,0,116,116,410
2008,11,e) 4,360,365,6614,6337,10,2.6,36,9.4,1052,40,1012,0.6,16.6,498,137,361,2.2,7.9,554,8.7,15.8,0,27,27,105
2008,11,f) 5,532,560,7049,6795,19,3.3,54,9.3,1201,184,1017,2.7,17.7,693,220,473,3.2,10.2,508,7.5,20.4,0,45,45,202
2008,11,g) 6 to 10,2472,2646,43446,42994,115,4.2,217,8,6500,1663,4837,3.9,15.1,5595,1581,4014,3.7,13,905,2.1,26,0,153,153,962
2008,11,h) 11 to 15,1737,1838,29600,29422,70,3.7,128,6.8,3806,930,2876,3.2,12.9,3449,1110,2339,3.8,11.7,357,1.2,23.4,0,93,94,843
2008,11,i) 16 to 20,1411,1568,34179,34106,42,2.6,99,6.2,3987,625,3362,1.8,11.7,3841,640,3201,1.9,11.3,146,0.4,22.6,0,59,59,379
2008,11,j) 21 to 25,1285,1501,28535,28538,55,3.6,106,6.9,3400,680,2720,2.4,11.9,3406,725,2681,2.5,11.9,-6,0,23.8,0,55,55,267
2008,11,k) 26+,1327,1746,68294,68361,79,4.5,116,6.6,5219,1527,3692,2.2,7.6,5353,1236,4117,1.8,7.8,-134,-0.2,15.2,0,37,37,338
2008,11,l) Left Censored,2950,5882,227874,227286,527,9.1,345,6,25513,7329,18184,3.2,11.2,24337,7497,16840,3.3,10.7,1176,0.5,21.4,0,59,59,833
2008,12,a) 0,40489,40771,204403,104283,39520,193.9,0,0,200240,200240,0,192,192,0,0,0,0,0,200240,192,0,0,,,
2008,12,b) 1,31435,31860,212313,228285,95,0.2,12948,33.1,52174,,,,22.9,84117,46942,37175,20.6,36.8,-31943,-13.9,45.8,1,10641,10641,41054
2008,12,c) 2,28324,28928,200020,220198,1089,3.3,8337,25.5,33128,4856,28272,2.2,15,73484,35729,37755,16.2,33.4,-40356,-18.4,30,0,6797,6797,31466
2008,12,d) 3,25091,25820,186997,200362,954,3.3,6286,22,33618,10053,23565,5,16.8,60348,25523,34825,12.7,30.1,-26730,-13.3,33.6,0,5130,5130,22179
2008,12,e) 4,23558,24069,164597,176346,812,3.1,4916,18.8,25187,4297,20890,2.4,14.3,48684,24435,24249,13.9,27.6,-23497,-13.3,28.6,0,3965,3965,21601
2008,12,f) 5,18200,18895,174748,182074,664,3.3,3235,16,28043,,,,15.4,42694,15247,27447,8.4,23.4,-14651,-8,30.8,1,2552,2552,13087
2008,12,g) 6 to 10,63059,66862,706369,739122,2289,3.3,8769,12.5,92247,19948,72299,2.7,12.5,157752,59874,97878,8.1,21.3,-65505,-8.8,25,0,6677,6722,45794
2008,12,h) 11 to 15,40626,43560,502756,519133,1499,3.3,4432,9.8,62735,17462,45273,3.4,12.1,95488,29853,65635,5.8,18.4,-32753,-6.3,24.2,0,3233,3265,20197
2008,12,i) 16 to 20,29157,34514,572900,585574,1277,3.6,2826,8,77338,16892,60446,2.9,13.2,102686,36949,65737,6.3,17.5,-25348,-4.3,26.4,0,1917,1923,18217
2008,12,j) 21 to 25,21069,27701,580816,586724,1097,3.9,1840,6.5,67338,20371,46967,3.5,11.5,79153,15165,63988,2.6,13.5,-11815,-2,23,0,1161,1161,7843
2008,12,k) 26+,15994,26061,618926,624281,1312,5,1563,6,81969,24503,57466,3.9,13.1,92678,18835,73843,3,14.8,-10709,-1.7,26.2,0,837,840,8618
2008,12,l) Left Censored,19382,75801,2830607,2830273,5147,6.8,4133,5.5,327043,102092,224951,3.6,11.6,326376,63649,262727,2.2,11.5,667,0.1,23,0,729,741,8304
2008,13,a) 0,16570,16714,98590,49941,16245,194.4,0,0,97298,97298,0,194.8,194.8,0,0,0,0,0,97298,194.8,0,0,,,
2008,13,b) 1,13066,13230,87917,94783,42,0.3,4510,28.7,20799,890,19909,0.9,21.9,34530,18943,15587,20,36.4,-13731,-14.5,43.8,0,3704,3704,16881
2008,13,c) 2,11415,11737,92851,97906,438,3.4,2645,20.6,16740,1741,14999,1.8,17.1,26850,13414,13436,13.7,27.4,-10110,-10.3,34.2,0,2116,2116,11919
2008,13,d) 3,9850,10198,86983,92031,320,2.9,1985,18,15441,1880,13561,2,16.8,25537,13873,11664,15.1,27.7,-10096,-10.9,33.6,0,1656,1656,12912
2008,13,e) 4,8400,8589,76383,80693,237,2.6,1513,16.4,10678,1334,9344,1.7,13.2,19297,9228,10069,11.4,23.9,-8619,-10.7,26.4,0,1220,1220,8159
2008,13,f) 5,7378,7738,72052,74627,258,3.2,1126,13.8,11642,3010,8632,4,15.6,16792,6661,10131,8.9,22.5,-5150,-6.9,31.2,0,930,930,5911
2008,13,g) 6 to 10,28766,30942,369634,379939,1087,3.4,3625,11.2,51466,10445,41021,2.7,13.5,72075,26916,45159,7.1,19,-20609,-5.5,27,0,2756,2758,18639
2008,13,h) 11 to 15,18638,20225,259349,265673,694,3.3,1931,9.3,34974,10621,24353,4,13.2,47621,15038,32583,5.7,17.9,-12647,-4.7,26.4,0,1387,1394,9796
2008,13,i) 16 to 20,12116,14733,260909,261631,485,3.2,1132,7.5,36969,7693,29276,2.9,14.1,38413,10714,27699,4.1,14.7,-1444,-0.6,28.2,0,776,778,5963
2008,13,j) 21 to 25,10328,13329,264854,264592,549,4.1,785,5.8,33132,9263,23869,3.5,12.5,32607,7437,25170,2.8,12.3,525,0.2,24.6,0,509,509,3483
2008,13,k) 26+,8090,13361,347594,358884,743,5.6,761,5.7,46969,12452,34517,3.5,13.1,69549,32795,36754,9.1,19.4,-22580,-6.3,26.2,0,382,382,3715
2008,13,l) Left Censored,12758,43089,1603360,1596442,3035,7.1,2225,5.2,197236,73150,124086,4.6,12.4,183400,42170,141230,2.6,11.5,13836,0.9,23,0,391,391,4961
2008,15,a) 0,1770,1784,9671,4894,1737,194.7,0,0,9555,9555,0,195.2,195.2,0,0,0,0,0,9555,195.2,0,0,,,
2008,15,b) 1,1538,1545,11143,11499,6,0.3,419,23.5,2847,49,2798,0.4,24.8,3558,2006,1552,17.4,30.9,-711,-6.1,49.6,0,330,330,1724
2008,15,c) 2,1367,1443,12651,13297,47,3,269,17.3,1956,279,1677,2.1,14.7,3248,1756,1492,13.2,24.4,-1292,-9.7,29.4,0,212,212,1220
2008,15,d) 3,1181,1196,11481,12005,24,1.9,206,16,1579,62,1517,0.5,13.2,2627,1358,1269,11.3,21.9,-1048,-8.7,26.4,0,177,177,1265
2008,15,e) 4,1063,1105,9906,9986,32,2.7,166,14.1,1626,117,1509,1.2,16.3,1786,811,975,8.1,17.9,-160,-1.6,32.6,0,130,130,694
2008,15,f) 5,994,1127,11615,12040,55,4.7,143,12.2,1314,204,1110,1.7,10.9,2163,608,1555,5,18,-849,-7.1,21.8,0,108,108,476
2008,15,g) 6 to 10,3861,4114,44150,45195,118,2.8,424,9.9,5765,915,4850,2,12.8,7855,2627,5228,5.8,17.4,-2090,-4.6,25.6,0,335,335,1981
2008,15,h) 11 to 15,2640,2779,35382,36263,61,2.1,252,8.8,3305,399,2906,1.1,9.1,5067,1798,3269,5,14,-1762,-4.9,18.2,0,181,181,1455
2008,15,i) 16 to 20,2279,2681,36153,36646,84,3.1,176,6.4,3856,1093,2763,3,10.5,4842,1089,3753,3,13.2,-986,-2.7,21,0,129,129,695
2008,15,j) 21 to 25,1875,2345,46755,46816,88,3.7,149,6.3,4713,1268,3445,2.7,10.1,4834,991,3843,2.1,10.3,-121,-0.2,20.2,0,99,99,527
2008,15,k) 26+,2075,2947,55286,56601,88,3,128,4.3,4878,855,4023,1.5,8.6,7508,1355,6153,2.4,13.3,-2630,-4.7,17.2,0,73,73,561
2008,15,l) Left Censored,3074,7062,230338,228597,349,5,270,3.8,23710,7427,16283,3.2,10.4,20228,2903,17325,1.3,8.8,3482,1.6,17.6,0,73,75,934
2008,16,a) 0,3521,3536,16067,8239,3436,194.3,0,0,15656,15656,0,190,190,0,0,0,0,0,15656,190,0,0,,,
2008,16,b) 1,3025,3044,17051,18958,5,0.1,1186,32,3793,,,,20,7607,5131,2476,27.1,40.1,-3814,-20.1,40,1,910,910,4458
2008,16,c) 2,2848,2903,17601,19843,96,3,736,22.7,2913,301,2612,1.5,14.7,7397,4096,3301,20.6,37.3,-4484,-22.6,29.4,0,561,561,3569
2008,16,d) 3,2252,2293,16176,17080,83,3.4,425,17.2,2264,269,1995,1.6,13.3,4072,1613,2459,9.4,23.8,-1808,-10.5,26.6,0,319,319,1294
2008,16,e) 4,1828,1882,14739,15384,69,3.5,271,13.6,1943,229,1714,1.5,12.6,3233,1049,2184,6.8,21,-1290,-8.4,25.2,0,204,204,790
2008,16,f) 5,1524,1614,12171,12502,65,3.8,226,13.3,1948,,,,15.6,2609,1003,1606,8,20.9,-661,-5.3,31.2,1,163,163,747
2008,16,g) 6 to 10,6007,6395,66254,68193,215,3.2,689,10.4,7908,1386,6522,2,11.6,11785,3420,8365,5,17.3,-3877,-5.7,23.2,0,481,481,2590
2008,16,h) 11 to 15,4027,4224,42204,43110,161,3.7,379,8.7,5783,1118,4665,2.6,13.4,7594,2392,5202,5.5,17.6,-1811,-4.2,26.8,0,263,263,1895
2008,16,i) 16 to 20,2418,2722,33611,34728,91,3.2,242,8.6,3876,582,3294,1.7,11.2,6109,1777,4332,5.1,17.6,-2233,-6.4,22.4,0,145,160,1140
2008,16,j) 21 to 25,1876,2411,46557,47614,95,3.9,152,6.2,5528,1720,3808,3.6,11.6,7642,1912,5730,4,16,-2114,-4.4,23.2,0,101,101,1373
2008,16,k) 26+,1740,2598,58025,58641,159,6.1,152,5.9,5726,1632,4094,2.8,9.8,6957,1117,5840,1.9,11.9,-1231,-2.1,19.6,0,97,97,485
2008,16,l) Left Censored,2879,7027,195033,194798,375,5.4,236,3.4,18547,5908,12639,3,9.5,18076,2860,15216,1.5,9.3,471,0.2,18.6,0,74,74,698
2008,17,a) 0,18997,19166,106795,54169,18606,194.2,0,0,105253,105253,0,194.3,194.3,0,0,0,0,0,105253,194.3,0,0,,,
2008,17,b) 1,14578,14706,102376,107811,49,0.3,4534,26.3,25338,456,24882,0.4,23.5,36207,20324,15883,18.9,33.6,-10869,-10.1,47,0,3319,3319,16918
2008,17,c) 2,13442,13882,112216,116191,551,3.7,2702,18,18474,2951,15523,2.5,15.9,26424,11693,14731,10.1,22.7,-7950,-6.8,31.8,0,1987,1987,9138
2008,17,d) 3,12024,12330,107626,111588,401,3.1,2035,15.5,14754,1639,13115,1.5,13.2,22677,9090,13587,8.1,20.3,-7923,-7.1,26.4,0,1603,1603,7954
2008,17,e) 4,10542,10769,89365,92573,350,3.1,1601,14,12819,1215,11604,1.3,13.8,19235,8326,10909,9,20.8,-6416,-7,27.6,0,1239,1239,6950
2008,17,f) 5,9382,10084,100425,103357,343,3.3,1225,11.6,14926,3053,11873,3,14.4,20789,7753,13036,7.5,20.1,-5863,-5.7,28.8,0,924,924,6739
2008,17,g) 6 to 10,37357,39789,462225,464010,1274,3.1,4349,10.5,72965,9365,63600,2,15.7,76534,24719,51815,5.3,16.5,-3569,-0.8,31.4,0,3138,3152,19006
2008,17,h) 11 to 15,28121,29758,387514,380027,883,2.9,2490,8.1,68707,31127,37580,8.2,18.1,53732,15431,38301,4.1,14.1,14975,4,28.2,0,1713,1713,10978
2008,17,i) 16 to 20,20965,24087,387146,386223,770,3.1,1849,7.5,51714,10067,41647,2.6,13.4,49867,15265,34602,4,12.9,1847,0.5,25.8,0,1159,1160,9023
2008,17,j) 21 to 25,17716,21925,448337,447621,678,3,1298,5.8,49382,8803,40579,2,11,47949,14526,33423,3.2,10.7,1433,0.3,21.4,0,832,834,8234
2008,17,k) 26+,15491,22572,551215,550105,775,3.4,1201,5.3,57838,10918,46920,2,10.5,55617,12796,42821,2.3,10.1,2221,0.4,20.2,0,723,724,5179
2008,17,l) Left Censored,27899,67585,2590385,2570376,3820,5.7,3164,4.7,292007,78122,213885,3,11.4,251988,52945,199043,2.1,9.8,40019,1.6,19.6,0,922,929,10284
2008,18,a) 0,8049,8132,51968,26190,7946,195.4,0,0,51557,51557,0,196.9,196.9,0,0,0,0,0,51557,196.9,0,0,,,
2008,18,b) 1,6409,6522,49304,52281,37,0.5,2023,26.5,11555,253,11302,0.5,22.1,17509,10544,6965,20.2,33.5,-5954,-11.4,44.2,0,1590,1590,9176
2008,18,c) 2,6072,6387,52990,55065,207,3,1220,17.7,8861,1118,7743,2,16.1,13010,5916,7094,10.7,23.6,-4149,-7.5,32.2,0,972,972,4889
2008,18,d) 3,5058,5209,44583,45988,160,2.9,849,15.3,6601,801,5800,1.7,14.4,9410,4343,5067,9.4,20.5,-2809,-6.1,28.8,0,705,705,3963
2008,18,e) 4,4456,4572,41182,42780,131,2.7,718,14.7,5736,967,4769,2.3,13.4,8932,4298,4634,10,20.9,-3196,-7.5,26.8,0,573,573,3627
2008,18,f) 5,4013,4230,40289,40771,158,3.6,553,12.5,6238,1073,5165,2.6,15.3,7202,3042,4160,7.5,17.7,-964,-2.4,30.6,0,456,456,2597
2008,18,g) 6 to 10,16951,18383,203844,209478,537,2.8,1894,9.9,26410,6242,20168,3,12.6,37678,13996,23682,6.7,18,-11268,-5.4,25.2,0,1452,1454,10760
2008,18,h) 11 to 15,12670,13526,155222,158202,400,2.9,1160,8.3,19368,3095,16273,2,12.2,25327,7529,17798,4.8,16,-5959,-3.8,24.4,0,851,851,5896
2008,18,i) 16 to 20,9801,11653,187474,189316,289,2.4,823,6.9,22350,2890,19460,1.5,11.8,26034,6678,19356,3.5,13.8,-3684,-2,23.6,0,546,546,4299
2008,18,j) 21 to 25,8762,11412,217676,220200,336,2.9,646,5.6,22757,3825,18932,1.7,10.3,27805,6868,20937,3.1,12.6,-5048,-2.3,20.6,0,479,480,3813
2008,18,k) 26+,7229,11338,261550,260793,525,4.6,621,5.5,35536,10222,25314,3.9,13.6,34021,11979,22042,4.6,13,1515,0.6,26,0,298,298,4576
2008,18,l) Left Censored,13988,35849,1304456,1314567,1575,4.4,1488,4.2,116739,27594,89145,2.1,8.9,136960,24644,112316,1.9,10.4,-20221,-1.5,17.8,0,449,449,6468
2008,19,a) 0,4152,4185,25252,12763,4073,194.6,0,0,24978,24978,0,195.7,195.7,0,0,0,0,0,24978,195.7,0,0,,,
2008,19,b) 1,3237,3252,24523,25072,5,0.1,889,23.7,6550,17,6533,0.1,26.1,7647,4308,3339,17.2,30.5,-1097,-4.4,52.2,0,661,661,3765
2008,19,c) 2,3199,3460,25710,26672,101,2.7,616,16.5,4040,521,3519,2,15.1,5964,2247,3717,8.4,22.4,-1924,-7.3,30.2,0,461,461,1875
2008,19,d) 3,2688,2735,21913,22956,74,2.5,467,15.9,3370,187,3183,0.8,14.7,5456,2790,2666,12.2,23.8,-2086,-9.1,29.4,0,357,357,2392
2008,19,e) 4,2365,2422,18901,19176,62,2.4,361,14,2941,239,2702,1.2,15.3,3490,1643,1847,8.6,18.2,-549,-2.9,30.6,0,293,293,1405
2008,19,f) 5,2107,2292,19282,20127,67,2.8,288,12,2417,299,2118,1.5,12,4107,1955,2152,9.7,20.4,-1690,-8.4,24,0,217,217,1734
2008,19,g) 6 to 10,8850,9530,100670,102177,258,2.6,865,8.8,12192,1674,10518,1.6,11.9,15206,3936,11270,3.9,14.9,-3014,-3,23.8,0,607,608,2936
2008,19,h) 11 to 15,6867,7326,75539,76888,218,2.9,605,8,9020,1184,7836,1.5,11.7,11718,3376,8342,4.4,15.2,-2698,-3.5,23.4,0,412,412,2414
2008,19,i) 16 to 20,5085,5653,73783,74186,134,2.3,394,6.8,8159,744,7415,1,11,8965,3094,5871,4.2,12.1,-806,-1.1,22,0,263,263,1557
2008,19,j) 21 to 25,4668,6212,121563,120980,172,2.7,308,4.9,11009,1809,9200,1.5,9.1,9842,1639,8203,1.4,8.1,1167,1,16.2,0,193,193,809
2008,19,k) 26+,4698,7362,123010,123641,173,2.3,342,4.6,11233,1540,9693,1.2,9.1,12495,3323,9172,2.7,10.1,-1262,-1,18.2,0,190,191,1424
2008,19,l) Left Censored,9455,19872,675206,669684,767,3.9,773,3.9,66821,13620,53201,2,10,55777,11507,44270,1.7,8.3,11044,1.7,16.6,0,291,292,2688
2008,20,a) 0,4146,4184,23032,11654,4078,194.9,0,0,22756,22756,0,195.3,195.3,0,0,0,0,0,22756,195.3,0,0,,,
2008,20,b) 1,3395,3434,22619,23562,11,0.3,929,23.5,5432,81,5351,0.3,23.1,7317,4559,2758,19.3,31.1,-1885,-8,46.2,0,725,725,3931
2008,20,c) 2,3157,3279,22905,23704,100,2.8,564,16.1,4303,259,4044,1.1,18.2,5900,2769,3131,11.7,24.9,-1597,-6.7,36.4,0,444,444,2413
2008,20,d) 3,2708,2783,24071,24681,86,2.9,457,15.3,4229,951,3278,3.9,17.1,5449,2717,2732,11,22.1,-1220,-5,34.2,0,382,384,2530
2008,20,e) 4,2432,2480,21753,21806,68,2.6,368,14,3917,311,3606,1.4,18,4022,1709,2313,7.8,18.4,-105,-0.4,36,0,304,304,1568
2008,20,f) 5,2186,2233,23774,24402,83,3.6,293,12.5,3117,748,2369,3.1,12.8,4372,1867,2505,7.7,17.9,-1255,-5.1,25.6,0,209,209,1553
2008,20,g) 6 to 10,9086,9700,109535,111962,286,2.8,967,9.6,12832,1723,11109,1.5,11.5,17685,5775,11910,5.2,15.8,-4853,-4.3,23,0,756,756,5061
2008,20,h) 11 to 15,6488,6915,83267,83313,216,3,588,8.3,11346,3223,8123,3.9,13.6,11437,3338,8099,4,13.7,-91,-0.1,27.2,0,402,402,2428
2008,20,i) 16 to 20,4746,5542,82219,81650,161,2.9,361,6.4,9880,1259,8621,1.5,12.1,8742,1893,6849,2.3,10.7,1138,1.4,21.4,0,264,264,1296
2008,20,j) 21 to 25,4303,5332,79470,79874,186,3.4,321,5.9,8085,1631,6454,2,10.1,8893,2762,6131,3.5,11.1,-808,-1,20.2,0,202,202,1522
2008,20,k) 26+,4152,6224,126243,125065,242,3.9,319,5.1,15829,2991,12838,2.4,12.7,13473,3021,10452,2.4,10.8,2356,1.9,21.6,0,168,168,769
2008,20,l) Left Censored,7741,17209,545930,541760,803,4.7,659,3.8,53722,11486,42236,2.1,9.9,45381,8821,36560,1.6,8.4,8341,1.5,16.8,0,223,225,2270
2008,21,a) 0,4903,5000,34550,17503,4896,195.8,0,0,34095,34095,0,194.8,194.8,0,0,0,0,0,34095,194.8,0,0,,,
2008,21,b) 1,4033,4086,29785,33078,17,0.4,1215,25.5,7150,213,6937,0.6,21.6,13735,6730,7005,20.3,41.5,-6585,-19.9,43.2,0,993,993,6163
2008,21,c) 2,3686,3844,30385,31933,109,2.6,720,17.3,5329,505,4824,1.6,16.7,8425,4354,4071,13.6,26.4,-3096,-9.7,33.4,0,593,593,4063
2008,21,d) 3,3320,3401,28762,29646,101,2.8,556,15.3,4736,429,4307,1.4,16,6504,2818,3686,9.5,21.9,-1768,-5.9,32,0,481,481,2518
2008,21,e) 4,2877,3003,26161,27131,82,2.6,406,12.8,4029,562,3467,2.1,14.9,5968,2421,3547,8.9,22,-1939,-7.1,29.8,0,340,340,2042
2008,21,f) 5,2500,2622,24205,25336,80,2.9,326,11.9,3150,500,2650,2,12.4,5411,2424,2987,9.6,21.4,-2261,-9,24.8,0,263,263,2164
2008,21,g) 6 to 10,10878,11739,126461,129252,290,2.4,1161,9.5,16612,2255,14357,1.7,12.9,22194,8338,13856,6.5,17.2,-5582,-4.3,25.8,0,865,877,6407
2008,21,h) 11 to 15,7920,8545,108324,109027,224,2.5,748,8.5,16107,2655,13452,2.4,14.8,17513,6680,10833,6.1,16.1,-1406,-1.3,29.6,0,563,563,4328
2008,21,i) 16 to 20,6056,7254,108510,109918,199,2.7,534,7.2,12762,2819,9943,2.6,11.6,15577,3645,11932,3.3,14.2,-2815,-2.6,23.2,0,366,368,2598
2008,21,j) 21 to 25,5534,6841,127680,127851,193,2.8,387,5.6,12384,2000,10384,1.6,9.7,12726,2643,10083,2.1,10,-342,-0.3,19.4,0,268,268,1819
2008,21,k) 26+,4370,7010,156813,156966,318,4.5,396,5.6,18298,4612,13686,2.9,11.7,18603,3529,15074,2.2,11.9,-305,-0.2,23.4,0,190,190,1361
2008,21,l) Left Censored,8313,21583,751687,744001,1031,4.8,865,4,88478,35123,53355,4.7,11.9,73105,15240,57865,2,9.8,15373,2.1,19.6,0,323,324,5751
2008,22,a) 0,6252,6373,41309,20991,6233,195.6,0,0,40636,40636,0,193.6,193.6,0,0,0,0,0,40636,193.6,0,0,,,
2008,22,b) 1,5218,5258,42503,43702,11,0.2,1484,24.4,10994,48,10946,0.1,25.2,13391,7142,6249,16.3,30.6,-2397,-5.4,50.4,0,1224,1224,6341
2008,22,c) 2,4249,4530,41778,43310,198,4.1,785,16.2,8871,2377,6494,5.5,20.5,11934,5496,6438,12.7,27.6,-3063,-7.1,41,0,645,645,4179
2008,22,d) 3,3684,3793,36570,38098,125,3.1,597,14.8,5903,646,5257,1.7,15.5,8958,3826,5132,10,23.5,-3055,-8,31,0,510,510,3292
2008,22,e) 4,3322,3434,35723,36126,98,2.7,456,12.7,6056,445,5611,1.2,16.8,6862,2762,4100,7.6,19,-806,-2.2,33.6,0,382,382,2541
2008,22,f) 5,3049,3299,35423,36021,110,3.2,361,10.5,5311,641,4670,1.8,14.7,6506,2531,3975,7,18.1,-1195,-3.4,29.4,0,290,290,1996
2008,22,g) 6 to 10,12431,13231,161983,165406,386,2.8,1115,8.2,22135,4173,17962,2.5,13.4,28980,11451,17529,6.9,17.5,-6845,-4.1,26.8,0,883,884,9378
2008,22,h) 11 to 15,9112,9648,128749,131041,267,2.7,729,7.4,14562,2404,12158,1.8,11.1,19146,4663,14483,3.6,14.6,-4584,-3.5,22.2,0,550,551,3471
2008,22,i) 16 to 20,6363,7586,115078,115975,230,3,458,5.9,13327,1763,11564,1.5,11.5,15120,3131,11989,2.7,13,-1793,-1.5,23,0,312,312,1965
2008,22,j) 21 to 25,6127,7703,146201,146897,239,3.1,399,5.1,16292,3292,13000,2.2,11.1,17683,5764,11919,3.9,12,-1391,-0.9,22.2,0,262,262,3327
2008,22,k) 26+,5869,8522,176887,175988,281,3.3,438,5.1,25364,4738,20626,2.7,14.4,23565,3587,19978,2,13.4,1799,1,26.8,0,256,256,1488
2008,22,l) Left Censored,8787,22273,677086,676221,1119,5.1,902,4.1,69780,17063,52717,2.5,10.3,68051,11130,56921,1.6,10.1,1729,0.2,20.2,0,290,291,2903
2008,23,a) 0,2350,2361,10002,5069,2280,193.1,0,0,9866,9866,0,194.6,194.6,0,0,0,0,0,9866,194.6,0,0,,,
2008,23,b) 1,1927,1936,10658,10904,3,0.1,631,27.5,2886,,,,26.5,3378,2269,1109,20.8,31,-492,-4.5,53,1,425,425,1784
2008,23,c) 2,1838,1926,11892,12658,66,3.1,395,18.8,2047,197,1850,1.6,16.2,3578,1996,1582,15.8,28.3,-1531,-12.1,32.4,0,294,294,1759
2008,23,d) 3,1520,1537,9160,9294,45,2.7,268,16.3,1499,199,1300,2.1,16.1,1766,859,907,9.2,19,-267,-2.9,32.2,0,210,210,723
2008,23,e) 4,1369,1401,9744,9815,40,2.7,222,14.8,1471,114,1357,1.2,15,1612,729,883,7.4,16.4,-141,-1.4,30,0,165,165,590
2008,23,f) 5,1100,1150,8166,8534,41,3.4,171,14,984,,,,11.5,1719,620,1099,7.3,20.1,-735,-8.6,23,1,132,132,516
2008,23,g) 6 to 10,5410,5731,49271,49957,197,3.3,573,9.7,5863,1167,4696,2.3,11.7,7234,2520,4714,5,14.5,-1371,-2.8,23.4,0,399,399,2081
2008,23,h) 11 to 15,3687,3853,34264,34984,131,3.3,368,9.3,3836,661,3175,1.9,11,5276,2253,3023,6.4,15.1,-1440,-4.1,22,0,252,252,1885
2008,23,i) 16 to 20,2794,3186,32806,33204,81,2.5,260,7.9,3629,339,3290,1,10.9,4424,1582,2842,4.8,13.3,-795,-2.4,21.8,0,164,164,1007
2008,23,j) 21 to 25,2446,3018,48697,48252,74,2.4,182,5.9,5211,529,4682,1.1,10.8,4321,1000,3321,2.1,9,890,1.8,18,0,122,122,551
2008,23,k) 26+,1959,2979,54477,54480,104,3.5,159,5.3,6144,1125,5019,2.1,11.3,6150,1267,4883,2.3,11.3,-6,0,22.6,0,79,79,488
2008,23,l) Left Censored,3418,7375,221959,220987,407,5.5,348,4.7,21268,6214,15054,2.8,9.6,19324,4379,14945,2,8.7,1944,0.9,17.4,0,120,121,1372
2008,24,a) 0,8049,8246,45618,23138,8012,194.3,0,0,44960,44960,0,194.3,194.3,0,0,0,0,0,44960,194.3,0,0,,,
2008,24,b) 1,6535,6602,46121,47553,14,0.2,2084,26.8,11986,176,11810,0.4,25.2,14850,8881,5969,18.7,31.2,-2864,-6,50.4,0,1665,1665,7658
2008,24,c) 2,6245,6475,49948,51823,242,3.4,1308,18.6,9883,1177,8706,2.3,19.1,13632,5907,7725,11.4,26.3,-3749,-7.2,38.2,0,1044,1044,5039
2008,24,d) 3,5671,5810,44511,45496,168,2.7,982,15.8,7287,751,6536,1.7,16,9256,4438,4818,9.8,20.3,-1969,-4.3,32,0,797,797,3690
2008,24,e) 4,4972,5102,41512,43244,171,3.2,753,13.9,6118,825,5293,1.9,14.1,9582,3652,5930,8.4,22.2,-3464,-8.1,28.2,0,609,609,3229
2008,24,f) 5,4292,4484,45573,47588,151,3.2,557,11.9,5921,820,5101,1.7,12.4,9950,4099,5851,8.6,20.9,-4029,-8.5,24.8,0,434,434,3541
2008,24,g) 6 to 10,17814,18917,211509,215583,553,2.8,1948,9.9,28364,3711,24653,1.7,13.2,36512,13849,22663,6.4,16.9,-8148,-3.7,26.4,0,1470,1470,11297
2008,24,h) 11 to 15,12346,13028,167195,168615,408,3,1145,8.5,20801,4528,16273,2.7,12.3,23641,6843,16798,4.1,14,-2840,-1.7,24.6,0,808,808,4948
2008,24,i) 16 to 20,9564,11038,190863,189894,323,2.9,808,7.1,23757,6424,17333,3.4,12.5,21819,5544,16275,2.9,11.5,1938,1,23,0,525,525,3191
2008,24,j) 21 to 25,7728,9424,174903,175514,259,2.7,543,5.7,21246,4857,16389,2.8,12.1,22467,5217,17250,3,12.8,-1221,-0.7,24.2,0,355,355,2919
2008,24,k) 26+,5972,8754,206134,205283,299,3.4,456,5.2,23289,5626,17663,2.7,11.3,21586,4856,16730,2.4,10.5,1703,0.8,21,0,213,218,1783
2008,24,l) Left Censored,10325,27099,992462,994275,1609,6,1433,5.3,109514,31404,78110,3.2,11,113139,33010,80129,3.3,11.4,-3625,-0.4,22,0,341,342,4340
2008,25,a) 0,9116,9182,50222,25457,8928,194.5,0,0,49530,49530,0,194.6,194.6,0,0,0,0,0,49530,194.6,0,0,,,
2008,25,b) 1,7373,7408,46468,48753,23,0.3,2195,25.5,11699,315,11384,0.6,24,16268,8668,7600,17.8,33.4,-4569,-9.4,48,0,1664,1664,7478
2008,25,c) 2,7355,7513,58723,60468,276,3.4,1372,17,8861,1179,7682,1.9,14.7,12351,4840,7511,8,20.4,-3490,-5.7,29.4,0,1021,1021,3932
2008,25,d) 3,6299,6399,53049,54637,248,3.7,1000,14.7,9078,929,8149,1.7,16.6,12253,5941,6312,10.9,22.4,-3175,-5.8,33.2,0,788,788,5373
2008,25,e) 4,5536,5685,52902,52587,205,3.4,830,13.8,9493,1646,7847,3.1,18.1,8862,3170,5692,6,16.9,631,1.2,33.8,0,657,657,2627
2008,25,f) 5,4946,5206,50343,50609,174,3.2,704,12.9,7404,647,6757,1.3,14.6,7935,2626,5309,5.2,15.7,-531,-1.1,29.2,0,557,557,2156
2008,25,g) 6 to 10,21167,22260,253873,253638,705,3.1,2278,9.9,37304,8422,28882,3.3,14.7,36834,12777,24057,5,14.5,470,0.2,29,0,1623,1623,9441
2008,25,h) 11 to 15,15466,16129,187919,190454,437,2.6,1345,8.1,23476,4786,18690,2.5,12.3,28545,8241,20304,4.3,15,-5069,-2.7,24.6,0,988,988,6209
2008,25,i) 16 to 20,11729,13493,212214,214251,400,2.9,864,6.3,20226,3624,16602,1.7,9.4,24299,6102,18197,2.8,11.3,-4073,-1.9,18.8,0,577,577,3702
2008,25,j) 21 to 25,10963,13572,265845,266943,414,3,916,6.6,31022,4673,26349,1.8,11.6,33218,12209,21009,4.6,12.4,-2196,-0.8,23.2,0,510,510,6302
2008,25,k) 26+,8699,12998,367970,367176,464,3.5,627,4.8,37621,9015,28606,2.5,10.2,36033,9529,26504,2.6,9.8,1588,0.4,19.6,0,386,387,2920
2008,25,l) Left Censored,17291,37572,1469911,1474181,1819,4.9,1638,4.4,148721,45775,102946,3.1,10.1,157261,33770,123491,2.3,10.7,-8540,-0.6,20.2,0,590,590,7030
2008,26,a) 0,12249,12369,82569,41702,12022,194.4,0,0,81734,81734,0,196,196,0,0,0,0,0,81734,196,0,0,,,
2008,26,b) 1,9543,9646,93329,89126,22,0.2,3183,27.9,36236,233,36003,0.3,40.7,27829,16802,11027,18.9,31.2,8407,9.5,62.4,0,2420,2420,14197
2008,26,c) 2,8885,9030,76933,86186,325,3.3,1933,19.6,13227,1654,11573,1.9,15.3,31733,20814,10919,24.2,36.8,-18506,-21.5,30.6,0,1532,1532,19589
2008,26,d) 3,7904,8067,78221,82452,254,2.9,1570,18,12956,1126,11830,1.4,15.7,21417,11872,9545,14.4,26,-8461,-10.3,31.4,0,1284,1284,10824
2008,26,e) 4,7033,7198,73786,79206,243,3.2,1223,15.9,10346,1553,8793,2,13.1,21185,11045,10140,13.9,26.7,-10839,-13.6,26.2,0,971,971,9553
2008,26,f) 5,6247,6607,66801,71370,228,3.3,1027,14.7,9716,1904,7812,2.7,13.6,18854,10712,8142,15,26.4,-9138,-12.8,27.2,0,821,821,9537
2008,26,g) 6 to 10,26312,28079,296481,304587,918,3.1,3502,11.9,38397,5384,33013,1.8,12.6,54609,22957,31652,7.5,17.9,-16212,-5.3,25.2,0,2611,2618,18761
2008,26,h) 11 to 15,20633,21764,243342,247629,654,2.9,2154,9.6,29927,5547,24380,2.2,12.1,38501,11566,26935,4.7,15.5,-8574,-3.4,24.2,0,1479,1479,8813
2008,26,i) 16 to 20,15719,18395,261951,264242,525,2.8,1447,7.7,35898,10293,25605,3.9,13.6,40480,12337,28143,4.7,15.3,-4582,-1.7,27.2,0,935,937,6634
2008,26,j) 21 to 25,13802,17340,304547,305254,576,3.3,1005,5.7,31560,8145,23415,2.7,10.3,32973,7529,25444,2.5,10.8,-1413,-0.5,20.6,0,691,692,4962
2008,26,k) 26+,11444,16130,303425,303625,528,3.2,852,5.2,34280,7998,26282,2.6,11.3,34680,6624,28056,2.2,11.4,-400,-0.1,22.6,0,531,539,3833
2008,26,l) Left Censored,19995,50604,1733551,1749924,2675,5.3,2293,4.5,174839,55224,119615,3.2,10,207585,39301,168284,2.2,11.9,-32746,-1.9,20,0,722,738,6803
2008,27,a) 0,8031,8090,51443,26051,7797,192.8,0,0,50784,50784,0,194.9,194.9,0,0,0,0,0,50784,194.9,0,0,,,
2008,27,b) 1,6519,6579,50647,53246,24,0.3,2047,26.5,10826,291,10535,0.5,20.3,16023,9571,6452,18,30.1,-5197,-9.8,40.6,0,1448,1448,8250
2008,27,c) 2,6126,6525,47590,49327,285,4,1332,18.8,8728,1840,6888,3.7,17.7,12201,6100,6101,12.4,24.7,-3473,-7,35.4,0,902,902,4919
2008,27,d) 3,5469,5615,44007,45658,231,3.9,975,16.3,7210,1269,5941,2.8,15.8,10512,5498,5014,12,23,-3302,-7.2,31.6,0,739,739,4556
2008,27,e) 4,4887,5066,40413,41641,204,3.8,802,14.9,6136,1072,5064,2.6,14.7,8591,3622,4969,8.7,20.6,-2455,-5.9,29.4,0,611,611,3027
2008,27,f) 5,4468,4727,41481,42300,183,3.7,668,13.4,6458,1261,5197,3,15.3,8095,3542,4553,8.4,19.1,-1637,-3.8,30.6,0,484,484,3221
2008,27,g) 6 to 10,18474,19718,213461,216823,735,3.6,2122,10.4,26374,3999,22375,1.8,12.2,33097,13463,19634,6.2,15.3,-6723,-3.1,24.4,0,1464,1464,10355
2008,27,h) 11 to 15,13231,14399,172273,174537,512,3.5,1220,8.3,22388,5175,17213,3,12.8,26915,7501,19414,4.3,15.4,-4527,-2.6,25.6,0,816,816,5729
2008,27,i) 16 to 20,9521,10746,156493,160747,287,2.6,780,7.1,16252,2088,14164,1.3,10.1,24759,7143,17616,4.4,15.4,-8507,-5.3,20.2,0,500,500,4597
2008,27,j) 21 to 25,7729,9981,212482,211561,297,2.9,526,5.2,23888,4314,19574,2,11.3,22046,4928,17118,2.3,10.4,1842,0.9,20.8,0,300,301,2300
2008,27,k) 26+,6733,10000,249463,247118,327,3.2,486,4.8,27018,5155,21863,2.1,10.9,22327,4886,17441,2,9,4691,1.9,18,0,277,278,2812
2008,27,l) Left Censored,12745,29842,1236994,1248543,1465,4.9,1212,4.1,120319,38293,82026,3.1,9.6,143417,22831,120586,1.8,11.5,-23098,-1.9,19.2,0,353,353,4373
2008,28,a) 0,3553,3611,21573,10972,3502,194,0,0,21202,21202,0,193.2,193.2,0,0,0,0,0,21202,193.2,0,0,,,
2008,28,b) 1,2932,3006,19258,20464,30,0.8,972,27.5,5059,121,4938,0.6,24.7,7470,4315,3155,21.1,36.5,-2411,-11.8,49.4,0,826,826,3926
2008,28,c) 2,2549,2657,23756,25033,83,2.9,519,18,4506,579,3927,2.3,18,7060,3774,3286,15.1,28.2,-2554,-10.2,36,0,460,460,3556
2008,28,d) 3,2152,2203,21581,21681,77,3.3,379,16.1,3887,556,3331,2.6,17.9,4087,1724,2363,8,18.9,-200,-1,35.8,0,326,326,1559
2008,28,e) 4,1904,2004,17802,17922,103,4.9,318,15,3538,619,2919,3.5,19.7,3777,1534,2243,8.6,21.1,-239,-1.4,39.4,0,273,273,1359
2008,28,f) 5,1818,1933,16874,17424,79,3.9,271,13.4,2584,507,2077,2.9,14.8,3683,1622,2061,9.3,21.1,-1099,-6.3,29.6,0,222,222,1450
2008,28,g) 6 to 10,7205,7765,81445,83509,205,2.6,760,9.5,9745,1634,8111,2,11.7,13872,4872,9000,5.8,16.6,-4127,-4.9,23.4,0,619,619,3925
2008,28,h) 11 to 15,5136,5478,62041,63414,180,3.2,496,8.8,7487,1700,5787,2.7,11.8,10233,2822,7411,4.5,16.1,-2746,-4.3,23.6,0,380,381,2094
2008,28,i) 16 to 20,3568,4108,67820,68202,124,3,283,6.8,7855,2265,5590,3.3,11.5,8618,2727,5891,4,12.6,-763,-1.1,23,0,195,195,1337
2008,28,j) 21 to 25,3620,4391,71312,71336,120,2.7,206,4.6,7150,1722,5428,2.4,10,7198,1986,5212,2.8,10.1,-48,-0.1,20,0,149,149,932
2008,28,k) 26+,3083,4558,95509,95693,163,3.6,226,4.9,13181,2282,10899,2.4,13.8,13549,4776,8773,5,14.2,-368,-0.4,27.6,0,148,148,1320
2008,28,l) Left Censored,5515,14486,442189,439960,700,4.9,516,3.6,43635,9454,34181,2.1,9.9,39176,6496,32680,1.5,8.9,4459,1,17.8,0,169,169,1653
2008,29,a) 0,8947,9004,52253,26698,8738,194.1,0,0,51110,51110,0,191.4,191.4,0,0,0,0,0,51110,191.4,0,0,,,
2008,29,b) 1,7096,7180,46264,51240,19,0.2,2469,28.9,10408,303,10105,0.6,20.3,20359,10182,10177,19.9,39.7,-9951,-19.4,40.6,0,2011,2011,9265
2008,29,c) 2,6769,7054,51704,54021,232,3,1411,18.5,9411,1425,7986,2.6,17.4,14045,6652,7393,12.3,26,-4634,-8.6,34.8,0,1110,1110,5583
2008,29,d) 3,5967,6128,49774,52058,197,3,1127,17.1,6938,736,6202,1.4,13.3,11505,5223,6282,10,22.1,-4567,-8.8,26.6,0,940,940,4540
2008,29,e) 4,5137,5243,47436,48205,168,3,933,16.6,8024,928,7096,1.9,16.6,9562,4340,5222,9,19.8,-1538,-3.2,33.2,0,764,764,3712
2008,29,f) 5,4478,4757,39443,40762,146,2.9,665,13.2,5773,756,5017,1.9,14.2,8410,3840,4570,9.4,20.6,-2637,-6.4,28.4,0,526,526,3263
2008,29,g) 6 to 10,17582,18803,199678,200911,596,3.1,2014,10.3,29317,5923,23394,2.9,14.6,31783,10855,20928,5.4,15.8,-2466,-1.2,29.2,0,1532,1536,8716
2008,29,h) 11 to 15,12719,13640,165954,167296,466,3.3,1163,8.3,23346,5329,18017,3.2,14,26029,7074,18955,4.2,15.6,-2683,-1.6,28,0,851,851,4964
2008,29,i) 16 to 20,9334,11050,160184,161321,303,2.7,741,6.6,18256,2944,15312,1.8,11.3,20530,5424,15106,3.4,12.7,-2274,-1.4,22.6,0,485,485,3330
2008,29,j) 21 to 25,8666,11387,216589,217654,339,2.9,613,5.3,19723,4422,15301,2,9.1,21852,4403,17449,2,10,-2129,-0.9,18.2,0,399,401,2602
2008,29,k) 26+,7005,11313,255691,254396,508,4.5,535,4.7,28438,8463,19975,3.3,11.2,25848,4576,21272,1.8,10.2,2590,1,20.4,0,322,322,2374
2008,29,l) Left Censored,13021,32717,1183110,1177603,1659,5.1,1311,4,131396,39566,91830,3.4,11.2,120381,21602,98779,1.8,10.2,11015,1,20.4,0,388,390,2998
2008,30,a) 0,2555,2581,10776,5478,2513,194.7,0,0,10597,10597,0,193.4,193.4,0,0,0,0,0,10597,193.4,0,0,,,
2008,30,b) 1,2135,2149,10274,10913,5,0.2,740,28.9,2654,,,,24.3,3932,2551,1381,23.4,36,-1278,-11.7,48.6,1,531,531,2131
2008,30,c) 2,2096,2160,16835,17608,74,3.2,394,16.9,2130,240,1890,1.4,12.1,3675,1469,2206,8.3,20.9,-1545,-8.8,24.2,0,259,259,1056
2008,30,d) 3,1700,1717,10600,10683,68,3.8,233,12.9,1909,189,1720,1.8,17.9,2075,746,1329,7,19.4,-166,-1.5,35.8,0,163,163,574
2008,30,e) 4,1510,1558,9516,10014,67,4.1,234,14.3,1386,153,1233,1.5,13.8,2381,1064,1317,10.6,23.8,-995,-10,27.6,0,178,178,920
2008,30,f) 5,1205,1236,7899,8276,40,3.1,165,12.7,967,,,,11.7,1720,674,1046,8.1,20.8,-753,-9.1,23.4,1,124,124,534
2008,30,g) 6 to 10,4969,5180,39667,40572,168,3.1,498,9.3,4796,885,3911,2.2,11.8,6606,2345,4261,5.8,16.3,-1810,-4.5,23.6,0,346,346,1631
2008,30,h) 11 to 15,3398,3523,31060,31024,101,2.8,280,7.7,4320,920,3400,3,13.9,4248,1351,2897,4.4,13.7,72,0.2,27.4,0,195,197,1002
2008,30,i) 16 to 20,2126,2325,24836,25362,83,3.5,181,7.6,2423,381,2042,1.5,9.6,3474,842,2632,3.3,13.7,-1051,-4.1,19.2,0,125,125,685
2008,30,j) 21 to 25,1789,2162,32256,32436,70,3.2,144,6.5,3653,697,2956,2.1,11.3,4012,1105,2907,3.4,12.4,-359,-1.1,22.6,0,89,89,786
2008,30,k) 26+,1734,2487,39919,39452,79,3.1,129,5.1,4448,587,3861,1.5,11.3,3514,695,2819,1.8,8.9,934,2.4,17.8,0,77,77,510
2008,30,l) Left Censored,2575,5380,122917,121034,237,4.4,182,3.4,13041,2547,10494,2.1,10.8,9275,1874,7401,1.5,7.7,3766,3.1,15.4,0,63,63,450
2008,31,a) 0,2714,2734,16812,8519,2649,193.8,0,0,16586,16586,0,194.7,194.7,0,0,0,0,0,16586,194.7,0,0,,,
2008,31,b) 1,2249,2298,14415,14540,6,0.2,593,22.5,3916,34,3882,0.2,26.9,4166,2374,1792,16.3,28.7,-250,-1.8,53.8,0,435,435,2053
2008,31,c) 2,2065,2165,15165,15468,75,3.2,392,16.8,2706,352,2354,2.3,17.5,3312,1563,1749,10.1,21.4,-606,-3.9,35,0,294,294,1338
2008,31,d) 3,1844,1864,12107,12432,65,3.3,265,13.5,2299,536,1763,4.3,18.5,2948,1631,1317,13.1,23.7,-649,-5.2,37,0,201,201,1342
2008,31,e) 4,1639,1662,13328,13488,41,2.3,243,13.8,1948,134,1814,1,14.4,2268,1048,1220,7.8,16.8,-320,-2.4,28.8,0,187,187,862
2008,31,f) 5,1436,1507,11730,11667,43,2.7,183,11.5,1869,201,1668,1.7,16,1743,756,987,6.5,14.9,126,1.1,29.8,0,127,127,604
2008,31,g) 6 to 10,6246,6657,73204,73461,214,3.1,581,8.5,8711,1267,7444,1.7,11.9,9225,3321,5904,4.5,12.6,-514,-0.7,23.8,0,430,430,2585
2008,31,h) 11 to 15,4405,4761,53637,53934,116,2.4,377,7.7,6313,964,5349,1.8,11.7,6907,2321,4586,4.3,12.8,-594,-1.1,23.4,0,267,267,1695
2008,31,i) 16 to 20,3325,3883,59711,59020,130,3.3,260,6.6,7130,1616,5514,2.7,12.1,5747,1424,4323,2.4,9.7,1383,2.4,19.4,0,174,174,856
2008,31,j) 21 to 25,3035,3791,71293,73992,112,2.9,174,4.5,5864,1201,4663,1.6,7.9,11261,1508,9753,2,15.2,-5397,-7.3,15.8,0,112,112,902
2008,31,k) 26+,2854,4252,85898,86340,119,2.7,267,6.2,9674,1575,8099,1.8,11.2,10557,3233,7324,3.7,12.2,-883,-1,22.4,0,128,128,594
2008,31,l) Left Censored,5655,11516,370928,371220,548,4.8,430,3.8,37728,8441,29287,2.3,10.2,38312,5144,33168,1.4,10.3,-584,-0.1,20.4,0,158,158,1125
2008,32,a) 0,5473,5523,38391,19580,5392,195.3,0,0,37623,37623,0,192.2,192.2,0,0,0,0,0,37623,192.2,0,0,,,
2008,32,b) 1,4210,4277,35990,38811,14,0.3,1607,31.3,8292,61,8231,0.2,21.4,13934,7339,6595,18.9,35.9,-5642,-14.5,42.8,0,1360,1360,6246
2008,32,c) 2,3767,3899,40139,41942,142,3.3,995,22.9,8544,572,7972,1.4,20.4,12149,6351,5798,15.1,29,-3605,-8.6,40.8,0,824,824,5437
2008,32,d) 3,3099,3237,33073,35706,110,3.1,718,20.2,4642,688,3954,1.9,13,9907,3550,6357,9.9,27.7,-5265,-14.7,26,0,607,607,3104
2008,32,e) 4,2552,2626,31616,33546,85,3,544,19,3929,514,3415,1.5,11.7,7788,2778,5010,8.3,23.2,-3859,-11.5,23.4,0,453,453,2383
2008,32,f) 5,2202,2353,29378,31299,94,3.8,386,15.4,4252,908,3344,2.9,13.6,8093,3451,4642,11,25.9,-3841,-12.3,27.2,0,318,318,2823
2008,32,g) 6 to 10,7695,8241,132457,139900,307,3.6,1001,11.7,16181,3450,12731,2.5,11.6,31067,8537,22530,6.1,22.2,-14886,-10.6,23.2,0,803,803,6849
2008,32,h) 11 to 15,4176,4670,90030,92552,191,4,433,9,12409,2336,10073,2.5,13.4,17452,4673,12779,5,18.9,-5043,-5.5,26.8,0,332,332,4006
2008,32,i) 16 to 20,2651,3386,70384,74218,165,4.8,281,8.1,9169,3638,5531,4.9,12.4,16837,4235,12602,5.7,22.7,-7668,-10.3,24.8,0,180,180,1656
2008,32,j) 21 to 25,2032,3171,76727,78914,150,4.7,194,6.1,10624,2663,7961,3.4,13.5,14997,3238,11759,4.1,19,-4373,-5.5,27,0,103,110,949
2008,32,k) 26+,1963,3374,113710,114325,258,7.7,188,5.6,13597,3846,9751,3.4,11.9,14826,2027,12799,1.8,13,-1229,-1.1,23.8,0,95,95,934
2008,32,l) Left Censored,3132,9542,461096,466049,765,8.1,490,5.2,48735,17681,31054,3.8,10.5,58641,10243,48398,2.2,12.6,-9906,-2.1,21,0,65,65,747
2008,33,a) 0,2197,2209,13137,6645,2148,194.5,0,0,12985,12985,0,195.4,195.4,0,0,0,0,0,12985,195.4,0,0,,,
2008,33,b) 1,1714,1727,10463,10817,3,0.1,533,26.3,2493,,,,23,3200,1726,1474,16,29.6,-707,-6.6,46,1,435,435,1550
2008,33,c) 2,1741,1833,13902,14388,64,3.2,356,17.9,2179,185,1994,1.3,15.1,3151,1338,1813,9.3,21.9,-972,-6.8,30.2,0,290,290,1139
2008,33,d) 3,1492,1519,11791,12174,41,2.5,250,15.4,1567,188,1379,1.5,12.9,2332,1105,1227,9.1,19.2,-765,-6.3,25.8,0,207,207,992
2008,33,e) 4,1313,1342,9049,9518,35,2.5,204,14.3,1184,116,1068,1.2,12.4,2121,969,1152,10.2,22.3,-937,-9.9,24.8,0,161,161,785
2008,33,f) 5,1131,1190,9449,9704,24,1.9,175,13.9,1168,,,,12,1678,686,992,7.1,17.3,-510,-5.3,24,1,136,136,600
2008,33,g) 6 to 10,4738,5023,48935,49607,155,3,518,9.9,6080,727,5353,1.5,12.3,7423,2635,4788,5.3,15,-1343,-2.7,24.6,0,381,381,2124
2008,33,h) 11 to 15,3777,3874,38989,40035,103,2.6,313,7.9,4166,695,3471,1.7,10.4,6258,1335,4923,3.3,15.6,-2092,-5.2,20.8,0,223,223,1090
2008,33,i) 16 to 20,2755,3092,43441,43776,59,1.9,213,6.7,4452,542,3910,1.2,10.2,5122,1723,3399,3.9,11.7,-670,-1.5,20.4,0,149,150,1348
2008,33,j) 21 to 25,2552,3065,55106,53938,98,3.1,191,6.1,8582,2675,5907,5,15.9,6246,2141,4105,4,11.6,2336,4.3,23.2,0,132,132,1095
2008,33,k) 26+,1742,2515,52958,53168,77,3,158,6.2,6882,2360,4522,4.4,12.9,7302,1516,5786,2.9,13.7,-420,-0.8,25.8,0,81,81,507
2008,33,l) Left Censored,3413,7532,274011,266640,444,5.9,361,4.8,39291,7805,31486,2.9,14.7,24549,3828,20721,1.4,9.2,14742,5.5,18.4,0,90,90,961
2008,34,a) 0,15413,15479,96229,53786,14940,193,0,0,84887,84887,0,157.8,157.8,0,0,0,0,0,84887,157.8,0,0,,,
2008,34,b) 1,12142,12215,82459,85957,35,0.2,3923,27.3,22215,1403,20812,1.6,25.8,29210,15903,13307,18.5,34,-6995,-8.2,51.6,0,3106,3106,12876
2008,34,c) 2,11369,11663,84403,87254,399,3.2,2274,18.1,15845,2369,13476,2.7,18.2,21546,9190,12356,10.5,24.7,-5701,-6.5,36.4,0,1817,1817,7775
2008,34,d) 3,10096,10259,75630,79307,286,2.6,1859,16.8,11217,1184,10033,1.5,14.1,18570,9153,9417,11.5,23.4,-7353,-9.3,28.2,0,1511,1511,7630
2008,34,e) 4,8489,8618,70665,72219,248,2.7,1460,15.8,11427,1004,10423,1.4,15.8,14534,6589,7945,9.1,20.1,-3107,-4.3,31.6,0,1225,1225,5627
2008,34,f) 5,7626,7923,74110,75909,308,3.7,1174,14.1,10362,2214,8148,2.9,13.7,13960,5200,8760,6.9,18.4,-3598,-4.7,27.4,0,965,965,4391
2008,34,g) 6 to 10,31402,32723,357405,365006,960,2.8,3708,10.9,45591,9036,36555,2.5,12.5,60793,22532,38261,6.2,16.7,-15202,-4.2,25,0,2818,2818,18821
2008,34,h) 11 to 15,22070,23020,276873,281479,699,2.9,2123,8.9,33180,6106,27074,2.2,11.8,42392,14022,28370,5,15.1,-9212,-3.3,23.6,0,1601,1606,11478
2008,34,i) 16 to 20,15998,17374,233842,235097,536,3,1315,7.4,28766,6036,22730,2.6,12.2,31276,10364,20912,4.4,13.3,-2510,-1.1,24.4,0,948,948,5614
2008,34,j) 21 to 25,13572,16202,299009,304770,497,3,1073,6.5,28707,6221,22486,2,9.4,40230,10307,29923,3.4,13.2,-11523,-3.8,18.8,0,723,727,5993
2008,34,k) 26+,11192,14719,330397,330540,518,3.5,914,6.1,38628,10825,27803,3.3,11.7,38914,7844,31070,2.4,11.8,-286,-0.1,23.4,0,558,558,3999
2008,34,l) Left Censored,19401,43091,1631999,1640450,2426,5.6,2400,5.6,183164,58888,124276,3.6,11.2,200066,46277,153789,2.8,12.2,-16902,-1,22.4,0,803,808,8354
2008,35,a) 0,2948,2989,15758,8023,2899,194,0,0,15470,15470,0,192.8,192.8,0,0,0,0,0,15470,192.8,0,0,,,
2008,35,b) 1,2345,2354,24164,25458,3,0.1,739,26.7,4068,,,,16,6655,3561,3094,14,26.1,-2587,-10.1,32,1,600,600,3068
2008,35,c) 2,2218,2297,17567,18514,90,3.7,423,17.2,3057,468,2589,2.5,16.5,4951,2057,2894,11.1,26.7,-1894,-10.2,33,0,345,345,1722
2008,35,d) 3,1852,1911,15121,15654,58,2.9,299,14.7,2527,402,2125,2.6,16.1,3592,1546,2046,9.9,22.9,-1065,-6.8,32.2,0,234,234,1415
2008,35,e) 4,1585,1661,15695,16433,57,3.3,233,13.4,2479,240,2239,1.5,15.1,3954,2127,1827,12.9,24.1,-1475,-9,30.2,0,189,189,2005
2008,35,f) 5,1350,1393,12989,13563,49,3.3,196,13.3,1906,,,,14.1,3053,1016,2037,7.5,22.5,-1147,-8.4,28.2,1,147,147,880
2008,35,g) 6 to 10,5723,6115,78328,79671,209,3.3,611,9.7,8917,1108,7809,1.4,11.2,11603,3036,8567,3.8,14.6,-2686,-3.4,22.4,0,484,484,2528
2008,35,h) 11 to 15,4186,4447,48669,50011,170,3.7,388,8.5,5716,1151,4565,2.3,11.4,8400,2339,6061,4.7,16.8,-2684,-5.4,22.8,0,267,268,1853
2008,35,i) 16 to 20,2937,3513,50125,50027,122,3.4,251,7,6896,2050,4846,4.1,13.8,6699,1541,5158,3.1,13.4,197,0.4,26.8,0,163,163,943
2008,35,j) 21 to 25,2538,3369,61452,61348,114,3.4,177,5.2,6102,1487,4615,2.4,9.9,5893,1187,4706,1.9,9.6,209,0.3,19.2,0,114,114,568
2008,35,k) 26+,2323,3364,61030,61136,96,2.8,272,7.9,7751,1019,6732,1.7,12.7,7963,2266,5697,3.7,13,-212,-0.3,25.4,0,104,104,445
2008,35,l) Left Censored,3429,8411,237549,235561,521,6.2,385,4.6,30182,11857,18325,5,12.8,26206,5295,20911,2.2,11.1,3976,1.7,22.2,0,93,93,1338
2008,36,a) 0,37095,37317,202508,102855,36213,194.1,0,0,199307,199307,0,193.8,193.8,0,0,0,0,0,199307,193.8,0,0,,,
2008,36,b) 1,28052,28131,164895,171430,34,0.1,8029,24.6,40027,586,39441,0.3,23.3,53097,29855,23242,17.4,31,-13070,-7.7,46.6,0,6214,6214,25635
2008,36,c) 2,25523,26292,185082,190152,892,3.1,5005,17.7,31856,3227,28629,1.7,16.8,41996,21405,20591,11.3,22.1,-10140,-5.3,33.6,0,3916,3916,18003
2008,36,d) 3,22227,22632,182115,179750,775,3.2,3705,15.4,40873,16343,24530,9.1,22.7,36142,18410,17732,10.2,20.1,4731,2.6,40.2,0,3042,3042,16394
2008,36,e) 4,19325,19591,153733,155744,599,2.9,2828,13.6,24183,2797,21386,1.8,15.5,28204,13071,15133,8.4,18.1,-4021,-2.6,31,0,2290,2295,11066
2008,36,f) 5,17003,17556,151715,152830,568,3.1,2356,12.8,25901,2550,23351,1.7,16.9,28130,12047,16083,7.9,18.4,-2229,-1.5,33.8,0,1907,1907,10501
2008,36,g) 6 to 10,66526,69645,733398,738029,2022,2.8,7260,10,104354,12821,91533,1.7,14.1,113615,46993,66622,6.4,15.4,-9261,-1.3,28.2,0,5567,5569,36597
2008,36,h) 11 to 15,44609,46301,531748,538190,1189,2.5,3997,8.4,63831,7616,56215,1.4,11.9,76716,29772,46944,5.5,14.3,-12885,-2.4,23.8,0,2965,2970,25465
2008,36,i) 16 to 20,34216,37207,489377,493605,1067,2.8,2621,6.9,55717,10120,45597,2.1,11.3,64172,20384,43788,4.1,13,-8455,-1.7,22.6,0,1804,1805,12615
2008,36,j) 21 to 25,29370,34169,608743,609664,913,2.6,1977,5.7,59242,11387,47855,1.9,9.7,61084,16067,45017,2.6,10,-1842,-0.3,19.4,0,1343,1367,9781
2008,36,k) 26+,22715,31964,735957,733872,973,3,1704,5.3,78707,17225,61482,2.3,10.7,74537,14128,60409,1.9,10.2,4170,0.5,20.4,0,1085,1087,8104
2008,36,l) Left Censored,42636,90993,3486116,3488463,4594,5.1,4473,4.9,363031,105800,257231,3,10.4,367725,82704,285021,2.4,10.5,-4694,-0.1,20.8,0,1658,1664,22182
2008,37,a) 0,14459,14625,81973,41470,14268,195.1,0,0,81007,81007,0,195.3,195.3,0,0,0,0,0,81007,195.3,0,0,,,
2008,37,b) 1,11883,11986,77447,81603,40,0.3,3526,25.3,18583,379,18204,0.5,22.8,26895,14411,12484,17.7,33,-8312,-10.2,45.6,0,2863,2863,12520
2008,37,c) 2,10610,11112,88236,91096,405,3.4,2117,17.6,16934,2567,14367,2.8,18.6,22653,11144,11509,12.2,24.9,-5719,-6.3,37.2,0,1694,1694,9987
2008,37,d) 3,9326,9536,78626,82485,290,2.8,1553,15.2,13879,1993,11886,2.4,16.8,21596,11428,10168,13.9,26.2,-7717,-9.4,33.6,0,1293,1293,10487
2008,37,e) 4,7736,8005,75058,76272,267,3.1,1219,14.3,12184,1298,10886,1.7,16,14612,5607,9005,7.4,19.2,-2428,-3.2,32,0,973,984,4888
2008,37,f) 5,6799,7282,72910,74446,207,2.7,921,12,10554,1893,8661,2.5,14.2,13626,5657,7969,7.6,18.3,-3072,-4.1,28.4,0,753,753,4875
2008,37,g) 6 to 10,27515,29607,329558,335479,926,3,3021,9.8,43645,9062,34583,2.7,13,55487,20219,35268,6,16.5,-11842,-3.5,26,0,2330,2335,16908
2008,37,h) 11 to 15,18442,19994,255132,257885,595,2.9,1712,8.3,30527,6330,24197,2.5,11.8,36032,10760,25272,4.2,14,-5505,-2.2,23.6,0,1293,1294,7747
2008,37,i) 16 to 20,13002,15453,264263,265867,454,2.9,1109,7,29630,6757,22873,2.5,11.1,32838,9359,23479,3.5,12.4,-3208,-1.3,22.2,0,796,797,5207
2008,37,j) 21 to 25,12518,15842,267661,268889,466,2.9,839,5.2,28839,6346,22493,2.4,10.7,31295,7519,23776,2.8,11.6,-2456,-0.9,21.4,0,566,568,3473
2008,37,k) 26+,8987,14918,364804,363277,636,4.2,815,5.4,45486,9791,35695,2.7,12.5,42431,8464,33967,2.3,11.7,3055,0.8,23.4,0,466,466,3416
2008,37,l) Left Censored,15185,45973,1627176,1626000,2784,6.1,1881,4.1,176996,55424,121572,3.4,10.9,174643,32609,142034,2,10.7,2353,0.2,21.4,0,479,484,5483
2008,38,a) 0,1152,1165,6716,3400,1142,196.1,0,0,6633,6633,0,195.1,195.1,0,0,0,0,0,6633,195.1,0,0,,,
2008,38,b) 1,962,975,8229,7792,1,0.1,228,20.6,2856,,,,36.7,1981,1284,697,16.5,25.4,875,11.3,50.8,1,153,153,1160
2008,38,c) 2,878,927,8085,8301,37,3.8,149,15.1,1528,311,1217,3.7,18.4,1961,650,1311,7.8,23.6,-433,-5.2,36.8,0,110,110,539
2008,38,d) 3,734,750,5320,5369,32,4.1,113,14.3,817,148,669,2.8,15.2,914,380,534,7.1,17,-97,-1.8,30.4,0,85,85,318
2008,38,e) 4,612,638,5236,5221,28,4.2,85,12.7,852,120,732,2.3,16.3,822,400,422,7.7,15.7,30,0.6,31.4,0,64,64,355
2008,38,f) 5,530,547,3859,3941,23,4,64,11.2,578,,,,14.7,741,430,311,10.9,18.8,-163,-4.1,29.4,1,46,46,340
2008,38,g) 6 to 10,2296,2459,23898,24622,77,3.1,203,8,3104,399,2705,1.6,12.6,4551,1918,2633,7.8,18.5,-1447,-5.9,25.2,0,141,141,1735
2008,38,h) 11 to 15,1794,1847,19447,20018,48,2.5,135,7.1,2123,171,1952,0.9,10.6,3264,688,2576,3.4,16.3,-1141,-5.7,21.2,0,93,93,566
2008,38,i) 16 to 20,1396,1540,18595,18760,44,2.8,101,6.4,1946,219,1727,1.2,10.4,2275,433,1842,2.3,12.1,-329,-1.7,20.8,0,64,64,341
2008,38,j) 21 to 25,1378,1668,20198,20300,30,1.8,86,5.1,1974,123,1851,0.6,9.7,2178,522,1656,2.6,10.7,-204,-1,19.4,0,58,58,406
2008,38,k) 26+,1371,1857,33591,33030,40,2.1,80,4.3,3556,402,3154,1.2,10.8,2433,483,1950,1.5,7.4,1123,3.4,14.8,0,48,50,290
2008,38,l) Left Censored,2601,4902,140313,139373,182,3.7,157,3.2,13061,2551,10510,1.8,9.4,11181,1493,9688,1.1,8,1880,1.4,16,0,67,67,808
2008,39,a) 0,12321,12462,89485,45341,12142,194.9,0,0,88288,88288,0,194.7,194.7,0,0,0,0,0,88288,194.7,0,0,,,
2008,39,b) 1,9754,9904,78238,84292,23,0.2,3067,26.5,17942,167,17775,0.2,21.3,30050,18853,11197,22.4,35.6,-12108,-14.3,42.6,0,2427,2427,17098
2008,39,c) 2,9512,9902,91587,96792,316,2.9,1934,18,15810,1785,14025,1.8,16.3,26220,13168,13052,13.6,27.1,-10410,-10.8,32.6,0,1542,1542,11857
2008,39,d) 3,8455,8728,86600,90443,270,2.9,1396,15,13134,1890,11244,2.1,14.5,20819,8720,12099,9.6,23,-7685,-8.5,29,0,1142,1142,7961
2008,39,e) 4,7470,7762,70497,73396,250,3,1178,14.3,10389,2022,8367,2.8,14.2,16186,7905,8281,10.8,22.1,-5797,-7.9,28.4,0,965,965,7298
2008,39,f) 5,6618,7194,71338,74050,233,3.1,961,12.7,9687,1845,7842,2.5,13.1,15111,5931,9180,8,20.4,-5424,-7.3,26.2,0,770,770,5349
2008,39,g) 6 to 10,28607,31113,354239,362442,986,3,3524,10.9,46500,9371,37129,2.6,12.8,62906,24931,37975,6.9,17.4,-16406,-4.6,25.6,0,2681,2684,18474
2008,39,h) 11 to 15,22697,24853,302416,304626,720,2.8,2140,8.4,39276,7946,31330,2.6,12.9,43695,13564,30131,4.5,14.3,-4419,-1.4,25.8,0,1549,1553,9402
2008,39,i) 16 to 20,17418,20758,311459,318732,698,3.3,1634,7.7,34222,6627,27595,2.1,10.7,48768,19542,29226,6.1,15.3,-14546,-4.6,21.4,0,1022,1023,8322
2008,39,j) 21 to 25,15581,20035,369454,372432,601,3,1117,5.5,36279,8932,27347,2.4,9.7,42234,9395,32839,2.5,11.3,-5955,-1.6,19.4,0,733,733,5359
2008,39,k) 26+,13731,20996,471411,467921,645,3,1117,5.3,52637,11016,41621,2.4,11.2,45656,9823,35833,2.1,9.8,6981,1.4,19.6,0,648,657,5164
2008,39,l) Left Censored,27046,68146,2418569,2439015,3045,4.5,3344,4.9,236415,66512,169903,2.7,9.7,277308,65715,211593,2.7,11.4,-40893,-1.7,19.4,0,921,933,10413
2008,40,a) 0,5872,5923,34881,17642,5775,195,0,0,34478,34478,0,195.4,195.4,0,0,0,0,0,34478,195.4,0,0,,,
2008,40,b) 1,4576,4620,36300,36393,11,0.2,1323,24.7,9671,,,,26.6,9857,5450,4407,15,27.1,-186,-0.5,53.2,1,1075,1075,4697
2008,40,c) 2,4114,4289,34706,35883,144,3.1,742,16.2,6302,629,5673,1.8,17.6,8656,3939,4717,11,24.1,-2354,-6.5,35.2,0,604,604,3548
2008,40,d) 3,3519,3631,38619,38797,100,2.6,577,14.9,6550,476,6074,1.2,16.9,6906,3214,3692,8.3,17.8,-356,-0.9,33.8,0,465,468,2562
2008,40,e) 4,2871,2945,26433,26890,75,2.4,426,13.7,4253,738,3515,2.7,15.8,5166,2125,3041,7.9,19.2,-913,-3.4,31.6,0,352,352,1850
2008,40,f) 5,2706,2812,28668,28719,82,2.8,337,11.5,4502,,,,15.7,4604,1791,2813,6.2,16,-102,-0.3,31.4,1,276,276,1476
2008,40,g) 6 to 10,10921,11865,128620,131536,341,2.8,1167,9.5,17275,2289,14986,1.7,13.1,23107,7707,15400,5.9,17.6,-5832,-4.5,26.2,0,928,930,6364
2008,40,h) 11 to 15,7766,8467,86159,88095,278,3.2,653,7.5,11229,2405,8824,2.7,12.7,15101,4059,11042,4.6,17.1,-3872,-4.4,25.4,0,465,465,3268
2008,40,i) 16 to 20,5563,6449,97138,96692,292,4.5,469,7.2,13024,3766,9258,3.9,13.5,12131,2503,9628,2.6,12.5,893,1,25,0,328,328,1726
2008,40,j) 21 to 25,5355,6611,108291,108556,190,2.8,340,5.1,12316,2406,9910,2.2,11.3,12845,2520,10325,2.3,11.8,-529,-0.5,22.6,0,244,244,1834
2008,40,k) 26+,4965,7465,163676,161078,302,4,367,4.9,19507,3475,16032,2.2,12.1,14311,2421,11890,1.5,8.9,5196,3.2,17.8,0,225,229,1362
2008,40,l) Left Censored,7048,17907,534999,533320,921,5.2,756,4.2,58958,17676,41282,3.3,11.1,55599,12390,43209,2.3,10.4,3359,0.7,20.8,0,221,221,1979
2008,41,a) 0,7715,7766,35184,17816,7581,195.2,0,0,34736,34736,0,195,195,0,0,0,0,0,34736,195,0,0,,,
2008,41,b) 1,6129,6175,34295,36947,19,0.3,1992,27.4,8626,124,8502,0.3,23.3,13930,8049,5881,21.8,37.7,-5304,-14.4,46.6,0,1549,1549,6940
2008,41,c) 2,5769,6064,38564,40492,213,3.3,1174,17.9,6636,992,5644,2.4,16.4,10491,4521,5970,11.2,25.9,-3855,-9.5,32.8,0,932,932,3834
2008,41,d) 3,4918,5035,33034,34270,194,3.6,822,15.4,5245,920,4325,2.7,15.3,7716,3279,4437,9.6,22.5,-2471,-7.2,30.6,0,651,651,2777
2008,41,e) 4,3989,4096,33219,34130,137,3.2,599,13.8,5222,890,4332,2.6,15.3,7044,3058,3986,9,20.6,-1822,-5.3,30.6,0,469,469,2468
2008,41,f) 5,3580,3874,30464,31018,150,3.7,484,12,4861,888,3973,2.9,15.7,5968,2390,3578,7.7,19.2,-1107,-3.5,31.4,0,392,392,2140
2008,41,g) 6 to 10,14403,15225,139994,142276,463,2.9,1586,10,18614,2405,16209,1.7,13.1,23177,7303,15874,5.1,16.3,-4563,-3.2,26.2,0,1157,1157,5711
2008,41,h) 11 to 15,10276,10957,129411,131504,361,3.2,947,8.4,14407,2138,12269,1.6,11,18592,6191,12401,4.7,14.1,-4185,-3.1,22,0,665,665,4690
2008,41,i) 16 to 20,6870,7853,106332,107960,257,3.2,565,7,12629,2748,9881,2.5,11.7,15884,4547,11337,4.2,14.7,-3255,-3,23.4,0,381,381,3505
2008,41,j) 21 to 25,5446,7205,141084,140442,245,3.3,478,6.5,16603,4199,12404,3,11.8,15319,3910,11409,2.8,10.9,1284,0.9,21.8,0,283,284,2189
2008,41,k) 26+,5226,7564,154024,152893,295,3.9,384,5,17693,4510,13183,2.9,11.6,15430,3062,12368,2,10.1,2263,1.5,20.2,0,242,243,1633
2008,41,l) Left Censored,7278,18647,597663,597428,908,4.9,724,3.9,56550,13585,42965,2.3,9.5,56080,9720,46360,1.6,9.4,470,0.1,18.8,0,217,217,1941
2008,42,a) 0,15308,15473,90275,45729,15137,195.7,0,0,89092,89092,0,194.8,194.8,0,0,0,0,0,89092,194.8,0,0,,,
2008,42,b) 1,12302,12403,85080,87429,41,0.3,3414,23.9,22127,371,21756,0.4,25.3,26824,15630,11194,17.9,30.7,-4697,-5.4,50.6,0,2639,2639,13332
2008,42,c) 2,11715,12199,103183,105593,383,2.9,2082,15.9,16548,1599,14949,1.5,15.7,21368,9882,11486,9.4,20.2,-4820,-4.5,31.4,0,1639,1639,7925
2008,42,d) 3,10783,11081,98639,100509,328,2.8,1514,13,14893,1475,13418,1.5,14.8,18632,9041,9591,9,18.5,-3739,-3.7,29.6,0,1223,1223,8091
2008,42,e) 4,9129,9493,84321,85805,315,3.2,1287,12.9,12393,1495,10898,1.7,14.4,15360,6328,9032,7.4,17.9,-2967,-3.5,28.8,0,1022,1022,5552
2008,42,f) 5,8260,8697,91688,92964,290,3.2,936,10.4,11856,1632,10224,1.8,12.8,14408,6040,8368,6.5,15.5,-2552,-2.7,25.6,0,738,738,5296
2008,42,g) 6 to 10,35538,38092,443594,449037,1077,2.7,3441,8.8,52113,8547,43566,1.9,11.6,62999,22005,40994,4.9,14,-10886,-2.4,23.2,0,2606,2610,17856
2008,42,h) 11 to 15,25284,27030,347413,347707,712,2.6,2050,7.4,44047,8241,35806,2.4,12.7,44635,13924,30711,4,12.8,-588,-0.1,25.4,0,1511,1511,11346
2008,42,i) 16 to 20,21149,23866,324074,326642,633,2.6,1652,6.8,36501,6645,29856,2,11.2,41636,12272,29364,3.8,12.7,-5135,-1.5,22.4,0,1137,1137,6863
2008,42,j) 21 to 25,18789,23602,457826,457168,777,3.2,1466,6.1,53687,17022,36665,3.7,11.7,52370,17458,34912,3.8,11.5,1317,0.2,23,0,878,881,5697
2008,42,k) 26+,15433,22792,528739,523464,769,3.4,1042,4.5,61994,16199,45795,3.1,11.8,51443,9244,42199,1.8,9.8,10551,2,19.6,0,680,684,5047
2008,42,l) Left Censored,29486,72893,2577031,2570007,4113,5.7,3067,4.2,264847,73169,191678,2.8,10.3,250800,48557,202243,1.9,9.8,14047,0.5,19.6,0,1049,1054,12888
2008,44,a) 0,1660,1668,9789,4947,1612,193.3,0,0,9684,9684,0,195.8,195.8,0,0,0,0,0,9684,195.8,0,0,,,
2008,44,b) 1,1268,1274,9969,10463,1,0.1,453,29.7,1892,,,,18.1,2880,1696,1184,16.2,27.5,-988,-9.4,36.2,1,324,324,1400
2008,44,c) 2,1239,1295,8245,8691,54,3.8,305,21.4,1488,156,1332,1.8,17.1,2379,1296,1083,14.9,27.4,-891,-10.3,34.2,0,209,209,1027
2008,44,d) 3,1126,1135,7319,7871,30,2.4,233,18.9,863,105,758,1.3,11,1966,1015,951,12.9,25,-1103,-14,22,0,191,191,877
2008,44,e) 4,1053,1074,9824,9843,40,3.5,168,14.8,1509,142,1367,1.4,15.3,1547,622,925,6.3,15.7,-38,-0.4,30.6,0,132,132,534
2008,44,f) 5,935,963,7938,8224,33,3.3,132,13,901,,,,11,1473,458,1015,5.6,17.9,-572,-6.9,22,1,97,97,372
2008,44,g) 6 to 10,3651,3837,33053,33967,135,3.4,415,10.4,4038,514,3524,1.5,11.9,5865,2209,3656,6.5,17.3,-1827,-5.4,23.8,0,300,300,1765
2008,44,h) 11 to 15,2628,2676,25914,26664,63,2.3,238,8.6,2835,687,2148,2.6,10.6,4335,1371,2964,5.1,16.3,-1500,-5.7,21.2,0,164,164,1163
2008,44,i) 16 to 20,2251,2421,36857,36873,77,3.1,210,8.5,4737,1015,3722,2.8,12.8,4768,1578,3190,4.3,12.9,-31,-0.1,25.6,0,123,125,677
2008,44,j) 21 to 25,1906,2243,33316,33777,51,2.2,146,6.4,3331,939,2392,2.8,9.9,4252,1226,3026,3.6,12.6,-921,-2.7,19.8,0,84,84,522
2008,44,k) 26+,1560,2001,39586,40384,61,3,90,4.5,4538,1121,3417,2.8,11.2,6134,869,5265,2.2,15.2,-1596,-4,22.4,0,57,57,333
2008,44,l) Left Censored,3498,5996,213784,215647,286,4.8,302,5,18841,6738,12103,3.1,8.7,22567,3554,19013,1.6,10.5,-3726,-1.8,17.4,0,94,94,760
2008,45,a) 0,6601,6632,36572,18514,6459,194.8,0,0,36116,36116,0,195.1,195.1,0,0,0,0,0,36116,195.1,0,0,,,
2008,45,b) 1,5545,5622,41521,42640,22,0.3,1718,26.2,10792,345,10447,0.8,25.3,13030,7268,5762,17,30.6,-2238,-5.3,50.6,0,1391,1391,6183
2008,45,c) 2,4941,5171,40109,42526,172,3.1,1074,19,6603,848,5755,2,15.5,11436,5451,5985,12.8,26.9,-4833,-11.4,31,0,879,879,4675
2008,45,d) 3,4399,4540,40622,41718,125,2.6,759,15.6,7073,660,6413,1.6,17,9264,3405,5859,8.2,22.2,-2191,-5.2,34,0,625,625,2846
2008,45,e) 4,3608,3723,34519,35654,96,2.4,587,14.8,4926,595,4331,1.7,13.8,7196,3108,4088,8.7,20.2,-2270,-6.4,27.6,0,478,478,2476
2008,45,f) 5,3308,3510,36663,38199,110,3,417,11.4,4797,450,4347,1.2,12.6,7868,3269,4599,8.6,20.6,-3071,-8,25.2,0,337,337,2632
2008,45,g) 6 to 10,13288,14264,167494,170782,457,3.1,1455,9.8,23053,4382,18671,2.6,13.5,29629,8422,21207,4.9,17.3,-6576,-3.8,27,0,1130,1130,6758
2008,45,h) 11 to 15,8760,9382,125584,129154,264,2.7,803,8.3,12415,2811,9604,2.2,9.6,19555,5742,13813,4.4,15.1,-7140,-5.5,19.2,0,611,612,4014
2008,45,i) 16 to 20,6213,7507,112257,112206,228,3,508,6.6,15610,3262,12348,2.9,13.9,15508,3361,12147,3,13.8,102,0.1,27.6,0,352,352,2210
2008,45,j) 21 to 25,5790,7695,132281,132230,244,3.1,405,5.2,14674,2013,12661,1.5,11.1,14571,3712,10859,2.8,11,103,0.1,22,0,278,279,2297
2008,45,k) 26+,4314,7052,147636,146599,279,3.9,311,4.4,18203,5050,13153,3.4,12.4,16129,2571,13558,1.8,11,2074,1.4,22,0,192,192,1153
2008,45,l) Left Censored,7685,22056,731111,726642,1243,5.7,908,4.1,80871,20221,60650,2.8,11.1,71932,11675,60257,1.6,9.9,8939,1.2,19.8,0,233,235,2544
2008,46,a) 0,1455,1480,8770,4445,1436,194.1,0,0,8651,8651,0,194.6,194.6,0,0,0,0,0,8651,194.6,0,0,,,
2008,46,b) 1,1256,1274,8058,8036,2,0.1,352,23.9,2114,,,,26.3,2069,1216,853,15.1,25.7,45,0.6,51.4,1,254,254,939
2008,46,c) 2,1174,1202,9131,8978,45,3.5,232,17.9,2177,208,1969,2.3,24.2,1870,809,1061,9,20.8,307,3.4,41.6,0,175,175,609
2008,46,d) 3,922,937,5420,5680,37,3.7,157,15.8,884,187,697,3.3,15.6,1404,656,748,11.5,24.7,-520,-9.1,31.2,0,123,127,592
2008,46,e) 4,874,900,6604,6424,26,2.8,103,10.9,1254,108,1146,1.7,19.5,894,346,548,5.4,13.9,360,5.6,27.8,0,84,84,304
2008,46,f) 5,775,823,6575,6740,21,2.4,96,11.2,810,,,,12,1139,411,728,6.1,16.9,-329,-4.9,24,1,81,81,377
2008,46,g) 6 to 10,3315,3469,32207,32500,117,3.3,286,8,3991,592,3399,1.8,12.3,4577,1386,3191,4.3,14.1,-586,-1.8,24.6,0,223,223,1121
2008,46,h) 11 to 15,2325,2437,25336,25541,87,3.5,191,7.7,2869,532,2337,2.1,11.2,3278,918,2360,3.6,12.8,-409,-1.6,22.4,0,129,129,682
2008,46,i) 16 to 20,1639,1811,23342,23324,71,3.8,135,7.3,3210,987,2223,4.2,13.8,3174,1359,1815,5.8,13.6,36,0.2,27.2,0,94,94,1034
2008,46,j) 21 to 25,1404,1706,23568,23599,64,3.7,112,6.5,2459,448,2011,1.9,10.4,2520,786,1734,3.3,10.7,-61,-0.3,20.8,0,66,66,374
2008,46,k) 26+,1320,1805,26715,26882,53,2.9,88,4.8,2343,373,1970,1.4,8.7,2677,773,1904,2.9,10,-334,-1.3,17.4,0,59,59,347
2008,46,l) Left Censored,2694,5152,156009,154148,226,4.4,164,3.2,15270,3351,11919,2.2,9.9,11548,2846,8702,1.8,7.5,3722,2.4,15,0,72,72,1161
2008,47,a) 0,8172,8261,53746,27108,8114,196.4,0,0,53277,53277,0,196.5,196.5,0,0,0,0,0,53277,196.5,0,0,,,
2008,47,b) 1,6411,6545,47458,51448,42,0.5,2107,27.4,10758,287,10471,0.6,20.9,18737,11585,7152,22.5,36.4,-7979,-15.5,41.8,0,1773,1773,10425
2008,47,c) 2,5779,6049,55571,56922,192,2.9,1231,18.7,10422,864,9558,1.5,18.3,13123,5867,7256,10.3,23.1,-2701,-4.8,36.6,0,1070,1070,5413
2008,47,d) 3,4936,5099,51204,51539,129,2.4,857,15.6,10038,792,9246,1.5,19.5,10708,4401,6307,8.5,20.8,-670,-1.3,39,0,735,735,3979
2008,47,e) 4,4281,4466,49955,48102,140,3,664,14.1,12617,707,11910,1.5,26.2,8910,3640,5270,7.6,18.5,3707,7.7,37,0,559,559,3076
2008,47,f) 5,3824,4073,44936,46295,138,3.2,507,11.9,6677,1146,5531,2.5,14.4,9395,2378,7017,5.1,20.3,-2718,-5.9,28.8,0,435,435,1950
2008,47,g) 6 to 10,14813,16378,202886,210755,529,3.1,1716,10.1,26718,6286,20432,3,12.7,42455,16856,25599,8,20.1,-15737,-7.4,25.4,0,1397,1402,14557
2008,47,h) 11 to 15,11252,12257,157289,164073,417,3.3,1063,8.4,20691,4590,16101,2.8,12.6,34259,9002,25257,5.5,20.9,-13568,-8.3,25.2,0,798,798,5674
2008,47,i) 16 to 20,8330,10257,185832,188865,376,3.6,689,6.6,23846,4408,19438,2.3,12.6,29911,7513,22398,4,15.8,-6065,-3.2,25.2,0,482,482,5289
2008,47,j) 21 to 25,8120,10397,192935,193065,344,3.3,559,5.3,21615,5890,15725,3.1,11.2,21874,5119,16755,2.7,11.3,-259,-0.1,22.4,0,380,386,2842
2008,47,k) 26+,6283,10999,267161,261720,726,6.7,511,4.7,43877,16665,27212,6.4,16.8,32994,5063,27931,1.9,12.6,10883,4.2,25.2,0,290,290,1742
2008,47,l) Left Censored,10893,31651,1176258,1178194,1895,6.1,1252,4,122162,36342,85820,3.1,10.4,126034,18437,107597,1.6,10.7,-3872,-0.3,20.8,0,343,344,4345
2008,48,a) 0,36282,36706,252878,128581,35994,196.1,0,0,248594,248594,0,193.3,193.3,0,0,0,0,0,248594,193.3,0,0,,,
2008,48,b) 1,28067,28462,232627,243156,117,0.4,8132,24.6,61331,1599,59732,0.7,25.2,82388,48522,33866,20,33.9,-21057,-8.7,50.4,0,6820,6820,43179
2008,48,c) 2,24452,25667,242473,248122,833,3,4679,16.9,49745,5738,44007,2.3,20,61043,28553,32490,11.5,24.6,-11298,-4.6,40,0,3865,3865,24833
2008,48,d) 3,20905,22098,259349,262674,748,3.2,3449,14.7,51003,9129,41874,3.5,19.4,57653,25407,32246,9.7,21.9,-6650,-2.5,38.8,0,2944,2944,22194
2008,48,e) 4,18224,18944,206530,210427,641,3.2,2638,13.2,35236,4552,30684,2.2,16.7,43029,18487,24542,8.8,20.4,-7793,-3.7,33.4,0,2219,2219,15634
2008,48,f) 5,16039,17325,204787,207962,547,3,2286,12.6,33050,5791,27259,2.8,15.9,39399,16844,22555,8.1,18.9,-6349,-3,31.8,0,1871,1871,14697
2008,48,g) 6 to 10,61302,66995,911139,920246,2116,3.1,6794,9.8,136714,26961,109753,2.9,14.9,154927,56657,98270,6.2,16.8,-18213,-1.9,29.8,0,5398,5408,44632
2008,48,h) 11 to 15,42367,47222,727295,728970,1621,3.3,4001,8.3,107420,22463,84957,3.1,14.7,110769,31868,78901,4.4,15.2,-3349,-0.5,29.4,0,3041,3041,23254
2008,48,i) 16 to 20,29837,36400,664762,667237,1467,4,2653,7.2,90395,21475,68920,3.2,13.5,95344,28529,66815,4.3,14.3,-4949,-0.8,27,0,1789,1789,14662
2008,48,j) 21 to 25,25403,35364,731371,718837,1336,3.7,1880,5.3,106750,40829,65921,5.7,14.9,81682,17407,64275,2.4,11.4,25068,3.5,22.8,0,1202,1222,8650
2008,48,k) 26+,22623,37068,821420,816304,1639,4.4,1902,5.1,110081,28588,81493,3.5,13.5,99848,23413,76435,2.9,12.2,10233,1.3,24.4,0,1055,1061,8028
2008,48,l) Left Censored,26962,102056,3829179,3807759,6731,6.7,5025,5,498220,148602,349618,3.9,13.1,455379,95550,359829,2.5,12,42841,1.1,24,0,994,1048,14141
2008,49,a) 0,6324,6381,31770,16113,6174,193.5,0,0,31314,31314,0,194.3,194.3,0,0,0,0,0,31314,194.3,0,0,,,
2008,49,b) 1,5033,5070,32272,34157,12,0.2,1885,30.8,8488,130,8358,0.4,24.8,12258,7878,4380,23.1,35.9,-3770,-11.1,49.6,0,1460,1460,6964
2008,49,c) 2,4303,4447,34258,36249,156,3.2,1009,20.6,6529,663,5866,1.8,18,10511,4783,5728,13.2,29,-3982,-11,36,0,756,756,4016
2008,49,d) 3,3470,3548,32240,33003,126,3.3,638,16.7,6377,420,5957,1.3,19.3,7902,3745,4157,11.3,23.9,-1525,-4.6,38.6,0,501,501,3137
2008,49,e) 4,2882,2949,26574,27223,103,3.3,475,15.1,4874,474,4400,1.7,17.9,6171,3022,3149,11.1,22.7,-1297,-4.8,35.8,0,362,362,2499
2008,49,f) 5,2582,2650,32416,33057,91,3.3,374,13.4,5063,1085,3978,3.3,15.3,6345,1958,4387,5.9,19.2,-1282,-3.9,30.6,0,276,276,1629
2008,49,g) 6 to 10,9340,9841,126487,126698,306,3,1009,9.9,19802,2691,17111,2.1,15.6,20224,7353,12871,5.8,16,-422,-0.4,31.2,0,708,708,5510
2008,49,h) 11 to 15,5578,5901,93253,94723,166,2.7,524,8.6,15094,1741,13353,1.8,15.9,18033,4553,13480,4.8,19,-2939,-3.1,31.8,0,373,373,3345
2008,49,i) 16 to 20,3251,3863,90001,91032,127,3.2,254,6.5,9326,995,8331,1.1,10.2,11388,3072,8316,3.4,12.5,-2062,-2.3,20.4,0,178,178,1786
2008,49,j) 21 to 25,2343,3285,80967,80332,117,3.5,166,5,11274,4288,6986,5.3,14,10004,2010,7994,2.5,12.5,1270,1.5,25,0,108,108,849
2008,49,k) 26+,2431,3552,86618,85999,151,4.2,181,5.1,11048,2570,8478,3,12.8,9810,2877,6933,3.3,11.4,1238,1.4,22.8,0,103,105,1672
2008,49,l) Left Censored,3755,10453,433088,431320,582,5.6,520,5,51167,10344,40823,2.4,11.9,47630,12483,35147,2.9,11,3537,0.9,22,0,94,94,1335
2008,50,a) 0,1148,1152,5370,2793,1112,193.1,0,0,5155,5155,0,184.6,184.6,0,0,0,0,0,5155,184.6,0,0,,,
2008,50,b) 1,972,982,8254,7930,3,0.3,285,24.9,2201,,,,27.8,1553,922,631,11.6,19.6,648,8.2,39.2,1,205,205,768
2008,50,c) 2,877,893,4951,5194,29,3,195,19.8,814,61,753,1.2,15.7,1300,592,708,11.4,25,-486,-9.3,31.4,0,137,137,489
2008,50,d) 3,762,770,4879,5012,25,3.1,116,14.3,763,132,631,2.6,15.2,1028,478,550,9.5,20.5,-265,-5.3,30.4,0,85,85,409
2008,50,e) 4,740,755,4722,4946,26,3.3,107,13.4,575,66,509,1.3,11.6,1023,457,566,9.2,20.7,-448,-9.1,23.2,0,81,81,372
2008,50,f) 5,661,679,4498,4589,23,3.2,84,11.8,598,,,,13,779,297,482,6.5,17,-181,-4,26,1,61,61,251
2008,50,g) 6 to 10,2838,2957,26781,27140,96,3.1,278,9.1,3037,380,2657,1.4,11.2,3754,1565,2189,5.8,13.8,-717,-2.6,22.4,0,202,202,1360
2008,50,h) 11 to 15,2146,2278,19056,19554,54,2.3,183,7.8,2013,177,1836,0.9,10.3,3009,923,2086,4.7,15.4,-996,-5.1,20.6,0,124,124,706
2008,50,i) 16 to 20,1840,1962,19029,19503,54,2.7,159,7.9,1949,547,1402,2.8,10,2896,1023,1873,5.2,14.8,-947,-4.8,20,0,100,100,817
2008,50,j) 21 to 25,1580,1844,40551,39981,70,3.8,110,5.9,3460,1028,2432,2.6,8.7,2320,564,1756,1.4,5.8,1140,2.9,11.6,0,72,72,410
2008,50,k) 26+,1202,1566,27329,26893,41,2.6,87,5.5,3202,650,2552,2.4,11.9,2330,491,1839,1.8,8.7,872,3.2,17.4,0,52,52,358
2008,50,l) Left Censored,2091,3770,107154,107396,191,5.1,197,5.2,9104,3555,5549,3.3,8.5,9589,2024,7565,1.9,8.9,-485,-0.4,17,0,48,48,458
2008,51,a) 0,12421,12531,69300,35244,12210,194.9,0,0,68112,68112,0,193.3,193.3,0,0,0,0,0,68112,193.3,0,0,,,
2008,51,b) 1,9930,9998,64092,65382,33,0.3,3090,26.4,17064,328,16736,0.5,26.1,19643,11265,8378,17.2,30,-2579,-3.9,52.2,0,2439,2439,9656
2008,51,c) 2,9339,9770,74562,76985,348,3.3,1991,18.8,13649,2013,11636,2.6,17.7,18495,8640,9855,11.2,24,-4846,-6.3,35.4,0,1605,1605,7324
2008,51,d) 3,8077,8276,64705,66859,255,2.9,1401,15.8,10080,841,9239,1.3,15.1,14388,6021,8367,9,21.5,-4308,-6.4,30.2,0,1126,1126,5236
2008,51,e) 4,6939,7098,60131,61704,224,3,1082,14.3,8709,870,7839,1.4,14.1,11855,5155,6700,8.4,19.2,-3146,-5.1,28.2,0,871,871,4436
2008,51,f) 5,5827,6119,60866,61356,203,3.2,803,12.5,9829,1549,8280,2.5,16,10808,4109,6699,6.7,17.6,-979,-1.6,32,0,641,641,3496
2008,51,g) 6 to 10,23621,25449,294921,296977,764,2.9,2621,9.9,40340,5756,34584,1.9,13.6,44451,13929,30522,4.7,15,-4111,-1.4,27.2,0,1995,1996,10938
2008,51,h) 11 to 15,16748,17920,228106,230416,550,3,1483,8.1,28408,6274,22134,2.7,12.3,33028,10430,22598,4.5,14.3,-4620,-2,24.6,0,1092,1097,7568
2008,51,i) 16 to 20,12436,14479,235393,234734,442,3,1022,6.9,31465,5190,26275,2.2,13.4,30147,7908,22239,3.4,12.8,1318,0.6,25.6,0,684,684,4475
2008,51,j) 21 to 25,10757,13892,262242,261499,452,3.2,805,5.7,33637,7367,26270,2.8,12.9,32150,8109,24041,3.1,12.3,1487,0.6,24.6,0,497,506,4037
2008,51,k) 26+,7977,12633,297101,296779,496,3.9,645,5.1,33623,9285,24338,3.1,11.3,32978,6762,26216,2.3,11.1,645,0.2,22.2,0,357,358,2781
2008,51,l) Left Censored,13321,41002,1433546,1450269,2369,5.8,2255,5.5,162566,46503,116063,3.2,11.2,196013,47376,148637,3.3,13.5,-33447,-2.3,22.4,0,412,424,4173
2008,53,a) 0,13455,13519,63498,32246,13175,194.9,0,0,62504,62504,0,193.8,193.8,0,0,0,0,0,62504,193.8,0,0,,,
2008,53,b) 1,10484,10578,60575,64018,31,0.2,3444,27.5,14758,125,14633,0.2,23.1,21644,13073,8571,20.4,33.8,-6886,-10.7,46.2,0,2707,2707,11446
2008,53,c) 2,9712,10017,68230,70609,413,3.8,1935,17.9,12826,1522,11304,2.2,18.2,17584,8328,9256,11.8,24.9,-4758,-6.7,36.4,0,1502,1502,6885
2008,53,d) 3,8055,8272,60546,61992,323,3.7,1417,16,10630,1485,9145,2.4,17.1,13522,5660,7862,9.1,21.8,-2892,-4.7,34.2,0,1101,1101,4783
2008,53,e) 4,6626,6783,53092,54512,262,3.7,981,13.7,8437,1160,7277,2.1,15.5,11277,5113,6164,9.4,20.7,-2840,-5.2,31,0,769,769,4343
2008,53,f) 5,5784,6042,51568,53147,239,3.8,809,12.8,8817,1029,7788,1.9,16.6,11975,4601,7374,8.7,22.5,-3158,-5.9,33.2,0,639,639,3996
2008,53,g) 6 to 10,23442,24972,258384,262371,962,3.7,2562,9.9,34599,5143,29456,2,13.2,42573,13842,28731,5.3,16.2,-7974,-3,26.4,0,1911,1912,11031
2008,53,h) 11 to 15,15974,17212,192531,195330,597,3.4,1519,8.6,23847,4867,18980,2.5,12.2,29445,10121,19324,5.2,15.1,-5598,-2.9,24.4,0,1039,1039,6155
2008,53,i) 16 to 20,11183,12742,186678,184754,458,3.5,911,7,27333,5070,22263,2.7,14.8,23485,6449,17036,3.5,12.7,3848,2.1,25.4,0,586,586,3915
2008,53,j) 21 to 25,8878,11589,225478,224041,413,3.5,739,6.3,23288,4122,19166,1.8,10.4,20414,5920,14494,2.6,9.1,2874,1.3,18.2,0,467,467,3557
2008,53,k) 26+,7620,11349,280355,279404,492,4.3,697,6.1,30753,8439,22314,3,11,28851,7552,21299,2.7,10.3,1902,0.7,20.6,0,386,387,2694
2008,53,l) Left Censored,10777,29462,1009496,1008552,1615,5.5,1279,4.4,103458,21473,81985,2.1,10.3,101569,20546,81023,2,10.1,1889,0.2,20.2,0,307,308,6138
2008,54,a) 0,1871,1892,11109,5642,1843,194.8,0,0,10934,10934,0,193.8,193.8,0,0,0,0,0,10934,193.8,0,0,,,
2008,54,b) 1,1522,1527,11005,11246,1,0.1,492,27.3,2792,,,,24.8,3273,2019,1254,18,29.1,-481,-4.3,49.6,1,407,407,1857
2008,54,c) 2,1552,1650,14141,14773,38,2.1,322,18,2307,284,2023,1.9,15.6,3570,1443,2127,9.8,24.2,-1263,-8.6,31.2,0,264,264,1222
2008,54,d) 3,1451,1494,11752,12127,46,2.9,208,13.2,1849,174,1675,1.4,15.2,2598,791,1807,6.5,21.4,-749,-6.2,30.4,0,171,171,685
2008,54,e) 4,1191,1264,10635,10602,24,1.8,181,13.5,1714,174,1540,1.6,16.2,1648,656,992,6.2,15.5,66,0.7,31,0,142,142,509
2008,54,f) 5,1015,1100,8558,8797,22,1.9,119,10.4,1291,,,,14.7,1768,635,1133,7.2,20.1,-477,-5.4,29.4,1,95,95,572
2008,54,g) 6 to 10,4276,4671,47489,48404,133,2.7,516,10.6,6308,941,5367,1.9,13,8139,2938,5201,6.1,16.8,-1831,-3.8,26,0,423,423,2569
2008,54,h) 11 to 15,3401,3552,34223,35483,89,2.4,323,8.8,3475,493,2982,1.4,9.8,5995,2094,3901,5.9,16.9,-2520,-7.1,19.6,0,257,257,1326
2008,54,i) 16 to 20,2701,3045,37931,38433,96,3.1,223,7.2,4478,741,3737,1.9,11.7,5482,1845,3637,4.8,14.3,-1004,-2.6,23.4,0,170,170,864
2008,54,j) 21 to 25,2568,3156,53582,53460,80,2.5,166,5.2,5372,481,4891,0.9,10,5128,984,4144,1.8,9.6,244,0.4,19.2,0,113,113,609
2008,54,k) 26+,2275,3591,60207,60095,194,5.4,184,5.1,7957,1881,6076,3.1,13.2,7732,1976,5756,3.3,12.9,225,0.3,25.8,0,113,113,772
2008,54,l) Left Censored,4512,9964,278959,277925,376,3.8,381,3.8,26673,6039,20634,2.2,9.6,24605,3564,21041,1.3,8.9,2068,0.7,17.8,0,141,141,856
2008,55,a) 0,7156,7226,42683,21645,7012,194.1,0,0,42076,42076,0,194.4,194.4,0,0,0,0,0,42076,194.4,0,0,,,
2008,55,b) 1,5984,6056,43065,45110,17,0.2,1798,25.5,9712,421,9291,0.9,21.5,13802,7355,6447,16.3,30.6,-4090,-9.1,43,0,1346,1346,6262
2008,55,c) 2,5723,6024,49322,50757,203,3.1,1130,17.4,8555,1283,7272,2.5,16.9,11424,5328,6096,10.5,22.5,-2869,-5.6,33.8,0,842,842,4542
2008,55,d) 3,5002,5090,39138,41088,164,3,861,15.8,5362,506,4856,1.2,13.1,9262,4978,4284,12.1,22.5,-3900,-9.4,26.2,0,660,660,4264
2008,55,e) 4,4296,4458,42082,43346,149,3.2,595,12.7,5459,799,4660,1.8,12.6,7986,2679,5307,6.2,18.4,-2527,-5.8,25.2,0,474,474,2250
2008,55,f) 5,3900,4098,37928,38690,117,2.7,501,11.7,5235,494,4741,1.3,13.5,6758,2761,3997,7.1,17.5,-1523,-4,27,0,365,365,2364
2008,55,g) 6 to 10,17165,18520,205332,208513,482,2.5,1785,9.3,23477,2930,20547,1.4,11.3,29838,10160,19678,4.9,14.3,-6361,-3,22.6,0,1325,1326,8245
2008,55,h) 11 to 15,13005,13843,156167,157505,406,2.9,1141,8,18782,3186,15596,2,11.9,21457,6317,15140,4,13.6,-2675,-1.7,23.8,0,802,802,4525
2008,55,i) 16 to 20,9673,11042,156930,157551,274,2.4,803,7.1,17948,4153,13795,2.6,11.4,19189,5208,13981,3.3,12.2,-1241,-0.8,22.8,0,509,511,3787
2008,55,j) 21 to 25,8365,10700,201720,201923,327,3,613,5.6,19406,4142,15264,2.1,9.6,19812,5589,14223,2.8,9.8,-406,-0.2,19.2,0,369,405,2927
2008,55,k) 26+,7125,10785,236628,236052,382,3.5,551,5.1,24533,4409,20124,1.9,10.4,23381,6288,17093,2.7,9.9,1152,0.5,19.8,0,329,338,3176
2008,55,l) Left Censored,14378,32448,1275008,1274126,1490,4.6,1246,3.9,112135,28530,83605,2.2,8.8,110370,22261,88109,1.7,8.7,1765,0.1,17.4,0,432,435,6497
2008,56,a) 0,1467,1476,6394,3255,1439,195,0,0,6278,6278,0,192.9,192.9,0,0,0,0,0,6278,192.9,0,0,,,
2008,56,b) 1,1233,1241,7112,7078,6,0.4,338,23.7,2086,26,2060,0.4,29.5,2018,912,1106,12.9,28.5,68,1,57,0,236,236,683
2008,56,c) 2,1118,1160,8104,8248,42,3.4,214,17.1,1631,174,1457,2.1,19.8,1919,799,1120,9.7,23.3,-288,-3.5,39.6,0,159,159,587
2008,56,d) 3,915,932,6401,6456,30,3.1,124,12.7,1342,514,828,8,20.8,1452,491,961,7.6,22.5,-110,-1.7,41.6,0,94,94,418
2008,56,e) 4,715,728,4449,4693,24,3.1,115,14.8,632,47,585,1,13.5,1119,436,683,9.3,23.8,-487,-10.3,27,0,93,93,378
2008,56,f) 5,663,677,4769,4920,19,2.7,80,11.3,600,38,562,0.8,12.2,902,361,541,7.3,18.3,-302,-6.1,24.4,0,59,59,258
2008,56,g) 6 to 10,2810,2910,24246,24699,117,3.9,302,10,3650,538,3112,2.2,14.8,4556,1586,2970,6.4,18.4,-906,-3.6,29.6,0,219,219,1321
2008,56,h) 11 to 15,1850,1937,17131,17176,63,3.2,166,8.3,2140,409,1731,2.4,12.5,2230,680,1550,4,13,-90,-0.5,25,0,117,117,522
2008,56,i) 16 to 20,1189,1301,17548,17277,40,3,94,7.1,2429,500,1929,2.9,14.1,1886,538,1348,3.1,10.9,543,3.2,21.8,0,67,67,350
2008,56,j) 21 to 25,1027,1257,18241,18175,40,3.1,78,6.1,2208,244,1964,1.3,12.1,2075,735,1340,4,11.4,133,0.7,22.8,0,50,51,377
2008,56,k) 26+,1139,1537,25131,24996,67,4.3,80,5.2,3741,1208,2533,4.8,15,3470,788,2682,3.2,13.9,271,1.1,27.8,0,48,48,628
2008,56,l) Left Censored,1661,3212,77501,75989,178,5.5,195,6.1,11430,3165,8265,4.2,15,8405,2226,6179,2.9,11.1,3025,3.9,22.2,0,41,41,174
2009,01,a) 0,4944,5046,31483,15865,4952,196.3,0,0,31236,31236,0,196.9,196.9,0,0,0,0,0,31236,196.9,0,0,,,
2009,01,b) 1,4346,4438,29589,32037,12,0.2,1473,28.1,7458,341,7117,1.1,23.3,12354,7025,5329,21.9,38.6,-4896,-15.3,46.6,0,1223,1223,5738
2009,01,c) 2,4190,4257,32842,35620,113,2.4,970,20.6,4801,801,4000,2.2,13.5,10357,4257,6100,12,29.1,-5556,-15.6,27,0,830,830,3832
2009,01,d) 3,3669,3864,29893,33111,106,2.5,770,18.3,3849,456,3393,1.4,11.6,10285,5101,5184,15.4,31.1,-6436,-19.5,23.2,0,641,641,4153
2009,01,e) 4,3269,3398,31641,33881,92,2.5,609,16.6,4483,1386,3097,4.1,13.2,8964,2978,5986,8.8,26.5,-4481,-13.3,26.4,0,503,503,2380
2009,01,f) 5,2890,3048,29227,31226,53,1.6,464,14.2,3258,351,2907,1.1,10.4,7256,2055,5201,6.6,23.2,-3998,-12.8,20.8,0,386,386,1608
2009,01,g) 6 to 10,11654,12509,138441,146347,303,2.3,1518,11.6,13301,2294,11007,1.6,9.1,29112,8698,20414,5.9,19.9,-15811,-10.8,18.2,0,1164,1165,6626
2009,01,h) 11 to 15,9282,10186,119908,126178,275,2.6,967,9.2,14358,2400,11958,1.9,11.4,26898,6569,20329,5.2,21.3,-12540,-9.9,22.8,0,749,749,4053
2009,01,i) 16 to 20,6385,7406,104998,108817,175,2.3,573,7.5,9173,1642,7531,1.5,8.4,16811,3648,13163,3.4,15.4,-7638,-7,16.8,0,431,437,2170
2009,01,j) 21 to 25,6137,7730,166419,171680,168,2.1,439,5.6,11605,3378,8227,2,6.8,22127,3133,18994,1.8,12.9,-10522,-6.1,13.6,0,289,289,1665
2009,01,k) 26+,5486,8904,176498,181500,287,3.2,433,4.8,15098,4411,10687,2.4,8.3,25101,4195,20906,2.3,13.8,-10003,-5.5,16.6,0,236,236,1201
2009,01,l) Left Censored,7910,22591,712759,733619,983,4.3,1209,5.3,56403,16608,39795,2.3,7.7,98122,17600,80522,2.4,13.4,-41719,-5.7,15.4,0,252,264,2690
2009,02,a) 0,1057,1078,4871,2468,1050,194.8,0,0,4806,,,,194.7,0,0,0,0,0,4806,194.7,0,1,,,
2009,02,b) 1,867,889,5033,5339,2,0.2,322,30,1458,,,,27.3,2070,1327,743,24.9,38.8,-612,-11.5,54.6,1,222,222,1121
2009,02,c) 2,773,788,4865,5035,34,3.9,191,22,774,120,654,2.4,15.4,1113,532,581,10.6,22.1,-339,-6.7,30.8,0,126,126,409
2009,02,d) 3,721,753,5996,6068,34,4.2,147,18.2,1144,138,1006,2.3,18.9,1287,461,826,7.6,21.2,-143,-2.3,37.8,0,97,97,336
2009,02,e) 4,582,598,4196,4332,22,3.4,118,18.2,611,102,509,2.4,14.1,883,394,489,9.1,20.4,-272,-6.3,28.2,0,78,78,306
2009,02,f) 5,592,610,4273,4363,29,4.5,75,11.8,694,88,606,2,15.9,873,237,636,5.4,20,-179,-4.1,31.8,0,49,49,151
2009,02,g) 6 to 10,2342,2498,28768,27881,86,3.3,272,10.5,5733,1283,4450,4.6,20.6,3959,1066,2893,3.8,14.2,1774,6.4,28.4,0,166,167,832
2009,02,h) 11 to 15,1706,1814,18419,18680,67,3.6,157,8.4,2243,209,2034,1.1,12,2765,754,2011,4,14.8,-522,-2.8,24,0,92,92,464
2009,02,i) 16 to 20,1168,1286,12288,12561,43,3.3,120,9.1,1269,173,1096,1.4,10.1,1814,369,1445,2.9,14.4,-545,-4.3,20.2,0,73,73,243
2009,02,j) 21 to 25,1113,1338,24323,24146,36,2.6,88,6.5,2803,207,2596,0.9,11.6,2448,730,1718,3,10.1,355,1.5,20.2,0,54,54,652
2009,02,k) 26+,1143,1814,41522,41620,90,5,93,5.1,7398,2509,4889,6,17.8,7594,2621,4973,6.3,18.2,-196,-0.4,35.6,0,33,33,274
2009,02,l) Left Censored,1274,3242,94460,94396,223,6.9,210,6.5,10395,2704,7691,2.9,11,10266,2145,8121,2.3,10.9,129,0.1,21.8,0,29,48,386
2009,04,a) 0,8288,8368,55579,28077,8176,195.4,0,0,55005,55005,0,195.9,195.9,0,0,0,0,0,55005,195.9,0,0,,,
2009,04,b) 1,7481,7682,57656,62287,31,0.3,3012,32.2,13851,325,13526,0.5,22.2,23113,13039,10074,20.9,37.1,-9262,-14.9,44.4,0,2430,2430,11505
2009,04,c) 2,6678,6822,49852,55923,218,2.8,2035,26.2,7654,688,6966,1.2,13.7,19796,9190,10606,16.4,35.4,-12142,-21.7,27.4,0,1694,1694,8277
2009,04,d) 3,6392,6601,53688,59127,233,3.2,1642,22.4,8041,1250,6791,2.1,13.6,18919,8252,10667,14,32,-10878,-18.4,27.2,0,1318,1318,6850
2009,04,e) 4,5140,5360,46971,52401,155,2.6,1258,21.2,5324,861,4463,1.6,10.2,16183,6561,9622,12.5,30.9,-10859,-20.7,20.4,0,1020,1020,5057
2009,04,f) 5,4493,4741,45777,49863,124,2.4,878,17.1,4898,753,4145,1.5,9.8,13069,4795,8274,9.6,26.2,-8171,-16.4,19.6,0,692,692,4292
2009,04,g) 6 to 10,16319,17404,204288,235961,507,2.7,2688,14.5,19823,4044,15779,1.7,8.4,83169,43143,40026,18.3,35.2,-63346,-26.8,16.8,0,1987,1992,12426
2009,04,h) 11 to 15,10944,12100,169002,183714,366,2.9,1427,11.3,16610,3855,12755,2.1,9,46034,10996,35038,6,25.1,-29424,-16.1,18,0,975,976,7019
2009,04,i) 16 to 20,6697,8659,135815,148555,258,2.9,809,9,11932,2612,9320,1.8,8,37412,6684,30728,4.5,25.2,-25480,-17.2,16,0,521,527,4225
2009,04,j) 21 to 25,5656,8186,176174,182849,347,4.2,611,7.3,19258,6102,13156,3.3,10.5,32608,8103,24505,4.4,17.8,-13350,-7.3,21,0,357,357,3406
2009,04,k) 26+,5214,8995,225021,233157,388,4.3,603,6.6,23421,8749,14672,3.8,10,39693,8041,31652,3.4,17,-16272,-7,20,0,276,284,2104
2009,04,l) Left Censored,5907,23057,874808,898745,1680,7.3,1762,7.6,85467,30008,55459,3.3,9.5,133340,30043,103297,3.3,14.8,-47873,-5.3,19,0,184,206,3582
2009,05,a) 0,3392,3450,19712,10066,3360,194.8,0,0,19292,19292,0,191.7,191.7,0,0,0,0,0,19292,191.7,0,0,,,
2009,05,b) 1,2904,2921,19615,20854,8,0.2,921,26.8,4853,165,4688,0.8,23.3,7330,4489,2841,21.5,35.1,-2477,-11.8,46.6,0,755,755,4116
2009,05,c) 2,2593,2632,18196,19658,67,2.3,606,20.8,2612,258,2354,1.3,13.3,5536,2609,2927,13.3,28.2,-2924,-14.9,26.6,0,505,505,2283
2009,05,d) 3,2518,2702,20451,21948,69,2.4,500,17.1,2554,490,2064,2.2,11.6,5547,2441,3106,11.1,25.3,-2993,-13.7,23.2,0,399,399,1979
2009,05,e) 4,2228,2289,17142,18751,56,2.3,366,15,1768,139,1629,0.7,9.4,4986,2123,2863,11.3,26.6,-3218,-17.2,18.8,0,303,303,1884
2009,05,f) 5,1934,2048,17516,18000,43,2,301,13.8,2607,181,2426,1,14.5,3575,1343,2232,7.5,19.9,-968,-5.4,29,0,246,246,1141
2009,05,g) 6 to 10,7820,8425,72631,76914,259,3,918,10.5,6654,1194,5460,1.6,8.7,15220,5030,10190,6.5,19.8,-8566,-11.1,17.4,0,698,701,4409
2009,05,h) 11 to 15,5684,6372,62839,66377,171,2.6,560,8.5,5538,1465,4073,2.2,8.3,12614,3398,9216,5.1,19,-7076,-10.7,16.6,0,421,421,2609
2009,05,i) 16 to 20,4038,4624,53956,55999,121,2.6,363,7.7,5273,1012,4261,1.8,9.4,9358,2176,7182,3.9,16.7,-4085,-7.3,18.8,0,269,269,1526
2009,05,j) 21 to 25,3639,4596,85806,88524,152,3.3,257,5.5,8548,4320,4228,4.9,9.7,13983,3248,10735,3.7,15.8,-5435,-6.1,19.4,0,180,184,1184
2009,05,k) 26+,3731,5530,118810,126674,161,2.9,289,5.2,11226,2751,8475,2.2,8.9,26953,6652,20301,5.3,21.3,-15727,-12.4,17.8,0,172,172,1029
2009,05,l) Left Censored,5337,13994,460774,468373,661,4.7,717,5.1,36658,10436,26222,2.2,7.8,51856,9456,42400,2,11.1,-15198,-3.3,15.6,0,174,179,1350
2009,06,a) 0,53397,53826,311118,157648,52767,196.1,0,0,306941,306941,0,194.7,194.7,0,0,0,0,0,306941,194.7,0,0,,,
2009,06,b) 1,45630,46264,299955,325731,127,0.2,15665,28.5,70807,2272,68535,0.7,21.7,122359,64129,58230,19.7,37.6,-51552,-15.9,43.4,0,12453,12460,53990
2009,06,c) 2,40757,41204,290193,312559,1392,3,10221,22.3,52340,5220,47120,1.7,16.7,97072,46718,50354,14.9,31.1,-44732,-14.4,33.4,0,8214,8214,39856
2009,06,d) 3,39551,40989,327095,354282,1426,3.2,8403,18.8,46263,5841,40422,1.6,13.1,100637,43712,56925,12.3,28.4,-54374,-15.3,26.2,0,6644,6646,36598
2009,06,e) 4,33681,35742,313144,338894,1273,3.3,6501,16.9,47333,10251,37082,3,14,98832,38435,60397,11.3,29.2,-51499,-15.2,28,0,5056,5063,26746
2009,06,f) 5,28917,29906,278244,298875,965,3,4714,14.8,34807,5220,29587,1.7,11.6,76069,26184,49885,8.8,25.5,-41262,-13.9,23.2,0,3629,3629,21702
2009,06,g) 6 to 10,110657,117189,1228770,1306196,3726,3,15013,12.2,138144,26408,111736,2,10.6,292995,90763,202232,6.9,22.4,-154851,-11.8,21.2,0,10987,11017,70485
2009,06,h) 11 to 15,70033,76630,1040714,1100825,2368,3,7602,9.6,99093,24243,74850,2.2,9,219314,52875,166439,4.8,19.9,-120221,-10.9,18,0,5399,5407,37952
2009,06,i) 16 to 20,50409,58814,902290,947174,1825,3,5226,8.6,89481,21063,68418,2.2,9.4,179248,41265,137983,4.4,18.9,-89767,-9.5,18.8,0,3467,3499,26897
2009,06,j) 21 to 25,44436,57714,1166640,1206412,1781,3,4189,7.1,103200,27797,75403,2.3,8.6,182744,39248,143496,3.3,15.1,-79544,-6.5,17.2,0,2549,2553,20679
2009,06,k) 26+,43451,66824,1510021,1569766,2105,3.1,4070,6,126188,34921,91267,2.2,8,245678,46702,198976,3,15.7,-119490,-7.7,16,0,2296,2319,17281
2009,06,l) Left Censored,42676,134994,5088471,5233953,7313,5.4,8609,6.3,458195,147600,310595,2.8,8.8,749161,160561,588600,3.1,14.3,-290966,-5.5,17.6,0,1603,1696,17105
2009,08,a) 0,9511,9555,48380,24512,9298,194.6,0,0,47736,47736,0,194.7,194.7,0,0,0,0,0,47736,194.7,0,0,,,
2009,08,b) 1,8263,8323,47627,51449,29,0.3,3105,30.9,11597,368,11229,0.7,22.5,19240,12291,6949,23.9,37.4,-7643,-14.9,45,0,2291,2306,10087
2009,08,c) 2,7309,7363,49614,51936,257,3.1,1881,22.9,10482,3975,6507,7.7,20.2,15126,7062,8064,13.6,29.1,-4644,-8.9,40.4,0,1374,1374,6094
2009,08,d) 3,6825,7015,48564,52247,272,3.6,1459,19.1,8028,1528,6500,2.9,15.4,15393,7022,8371,13.4,29.5,-7365,-14.1,30.8,0,1088,1089,5730
2009,08,e) 4,6134,6272,50807,53059,222,3.3,1145,17,7824,842,6982,1.6,14.7,12327,4693,7634,8.8,23.2,-4503,-8.5,29.4,0,830,830,3738
2009,08,f) 5,5106,5240,42043,45168,185,3.3,921,16.4,4467,603,3864,1.3,9.9,10717,4271,6446,9.5,23.7,-6250,-13.8,19.8,0,668,668,3516
2009,08,g) 6 to 10,20441,21437,187639,197918,725,3.2,2890,12.8,20712,3649,17063,1.8,10.5,41269,12934,28335,6.5,20.9,-20557,-10.4,21,0,1874,1875,8841
2009,08,h) 11 to 15,13764,15054,170339,178513,566,3.6,1587,10.2,21385,8213,13172,4.6,12,37733,8328,29405,4.7,21.1,-16348,-9.1,24,0,1003,1003,5305
2009,08,i) 16 to 20,8745,10103,143294,150455,343,3.3,879,8.5,13726,3597,10129,2.4,9.1,28047,7489,20558,5,18.6,-14321,-9.5,18.2,0,559,559,5884
2009,08,j) 21 to 25,6694,8651,148333,154387,293,3.3,593,6.7,15179,5591,9588,3.6,9.8,27287,7943,19344,5.1,17.7,-12108,-7.9,19.6,0,366,366,2962
2009,08,k) 26+,6627,10510,238100,248976,374,3.5,573,5.4,20846,5706,15140,2.3,8.4,42598,7720,34878,3.1,17.1,-21752,-8.7,16.8,0,293,293,2513
2009,08,l) Left Censored,7592,22680,793606,806420,1416,6.2,1417,6.2,77605,19041,58564,2.4,9.6,103233,27475,75758,3.4,12.8,-25628,-3.2,19.2,0,241,241,9194
2009,09,a) 0,4010,4024,25464,12842,3944,196,0,0,25245,25245,0,196.6,196.6,0,0,0,0,0,25245,196.6,0,0,,,
2009,09,b) 1,3617,3665,22093,26129,14,0.3,1188,27.5,4699,82,4617,0.3,18,12771,4859,7912,18.6,48.9,-8072,-30.9,36,0,912,912,4168
2009,09,c) 2,3087,3119,24360,26217,75,2.2,680,19.8,3901,492,3409,1.9,14.9,7614,3812,3802,14.5,29,-3713,-14.1,29.8,0,535,539,2406
2009,09,d) 3,3103,3283,26330,27391,87,2.5,542,15.4,3519,317,3202,1.2,12.8,5640,1986,3654,7.3,20.6,-2121,-7.8,25.6,0,427,427,1712
2009,09,e) 4,2783,2850,25032,26497,71,2.3,469,15.3,2984,297,2687,1.1,11.3,5913,2643,3270,10,22.3,-2929,-11,22.6,0,365,365,2291
2009,09,f) 5,2411,2470,19766,20487,65,2.5,356,13.6,2716,535,2181,2.6,13.3,4158,1578,2580,7.7,20.3,-1442,-7,26.6,0,283,283,1341
2009,09,g) 6 to 10,10066,10549,122214,130559,263,2.4,1263,11.4,11676,1930,9746,1.5,8.9,28366,7438,20928,5.7,21.7,-16690,-12.8,17.8,0,934,934,6018
2009,09,h) 11 to 15,8002,8547,92686,97339,218,2.5,768,8.7,9916,1240,8676,1.3,10.2,19222,3622,15600,3.7,19.7,-9306,-9.5,20.4,0,513,516,2530
2009,09,i) 16 to 20,6527,7148,88210,92282,168,2.3,544,7.4,8302,2498,5804,2.7,9,16445,4123,12322,4.5,17.8,-8143,-8.8,18,0,353,353,2733
2009,09,j) 21 to 25,6225,7344,119301,123367,198,2.6,530,7,8858,2526,6332,2,7.2,16990,4392,12598,3.6,13.8,-8132,-6.6,14.4,0,304,304,2760
2009,09,k) 26+,5782,8056,152983,157272,226,2.8,407,5,12723,2896,9827,1.8,8.1,21300,2963,18337,1.9,13.5,-8577,-5.4,16.2,0,223,225,1339
2009,09,l) Left Censored,9929,20580,750050,766749,928,4.5,1222,5.9,59033,14894,44139,1.9,7.7,92430,19108,73322,2.5,12.1,-33397,-4.4,15.4,0,279,292,3474
2009,10,a) 0,1238,1250,8540,4314,1222,195.5,0,0,8453,,,,195.9,0,0,0,0,0,8453,195.9,0,1,,,
2009,10,b) 1,1103,1121,7961,8454,4,0.3,330,25.3,2289,,,,27.1,3274,1842,1432,21.8,38.7,-985,-11.6,54.2,1,247,247,1590
2009,10,c) 2,886,916,6983,7788,20,2,221,21.6,734,59,675,0.8,9.4,2344,1271,1073,16.3,30.1,-1610,-20.7,18.8,0,175,175,1173
2009,10,d) 3,898,917,6777,7279,24,2.4,170,17.2,651,53,598,0.7,8.9,1654,609,1045,8.4,22.7,-1003,-13.8,17.8,0,134,134,514
2009,10,e) 4,797,804,5917,6062,25,2.8,166,18.8,1155,100,1055,1.6,19.1,1444,732,712,12.1,23.8,-289,-4.7,38.2,0,128,128,664
2009,10,f) 5,712,728,7219,7957,22,2.8,141,17.8,585,55,530,0.7,7.4,2061,997,1064,12.5,25.9,-1476,-18.5,14.8,0,98,98,442
2009,10,g) 6 to 10,2919,3038,25754,27081,89,2.8,412,12.8,2962,493,2469,1.8,10.9,5616,1866,3750,6.9,20.7,-2654,-9.8,21.8,0,284,284,1241
2009,10,h) 11 to 15,2053,2251,27681,29134,74,3.2,215,9.3,2772,547,2225,1.9,9.5,5677,1348,4329,4.6,19.5,-2905,-10,19,0,149,149,977
2009,10,i) 16 to 20,1497,1658,20471,20358,55,3.2,140,8.2,3159,1820,1339,8.9,15.5,2932,554,2378,2.7,14.4,227,1.1,28.8,0,97,97,347
2009,10,j) 21 to 25,1310,1586,21929,23425,45,2.8,97,6,1185,311,874,1.3,5.1,4177,574,3603,2.5,17.8,-2992,-12.7,10.2,0,58,58,319
2009,10,k) 26+,1255,1765,41279,41977,54,3,99,5.5,3214,769,2445,1.8,7.7,4609,626,3983,1.5,11,-1395,-3.3,15.4,0,41,41,207
2009,10,l) Left Censored,2604,5839,188650,191930,366,6.3,371,6.3,18314,8218,10096,4.3,9.5,24874,5332,19542,2.8,13,-6560,-3.5,19,0,46,48,265
2009,11,a) 0,894,894,6177,3120,880,196.9,0,0,6115,,,,196,0,0,0,0,0,6115,196,0,1,,,
2009,11,b) 1,764,770,6233,6620,1,0.1,206,23.2,1743,,,,26.3,2516,1480,1036,22.4,38,-773,-11.7,52.6,1,166,166,1365
2009,11,c) 2,739,744,6188,6250,24,3,130,16.2,1097,71,1026,1.1,17.6,1221,458,763,7.3,19.5,-124,-1.9,35.2,0,101,101,323
2009,11,d) 3,712,728,6736,6855,24,3.1,116,14.9,1304,153,1151,2.2,19,1541,592,949,8.6,22.5,-237,-3.5,38,0,94,94,524
2009,11,e) 4,857,873,8488,8728,26,2.8,110,12,1398,108,1290,1.2,16,1877,626,1251,7.2,21.5,-479,-5.5,32,0,94,94,600
2009,11,f) 5,339,345,6448,6609,9,2.5,37,10.4,603,33,570,0.5,9.1,924,195,729,3,14,-321,-4.9,18.2,0,23,23,139
2009,11,g) 6 to 10,2360,2498,38168,38777,94,3.7,228,8.9,5117,1002,4115,2.6,13.2,6334,1561,4773,4,16.3,-1217,-3.1,26.4,0,158,161,1143
2009,11,h) 11 to 15,1825,1989,33776,34346,54,2.7,141,6.9,3769,682,3087,2,11,4908,713,4195,2.1,14.3,-1139,-3.3,22,0,97,97,452
2009,11,i) 16 to 20,1338,1490,31803,31896,46,3,88,5.8,4120,1372,2748,4.3,12.9,4305,620,3685,1.9,13.5,-185,-0.6,25.8,0,56,56,276
2009,11,j) 21 to 25,1265,1465,28025,28743,43,2.9,90,6,1981,280,1701,1,6.9,3417,1095,2322,3.8,11.9,-1436,-5,13.8,0,51,51,370
2009,11,k) 26+,1522,1979,74265,74211,97,4.9,129,6.5,7866,2420,5446,3.3,10.6,7758,1515,6243,2,10.5,108,0.1,21,0,39,39,236
2009,11,l) Left Censored,2908,5919,230240,228713,538,9.2,438,7.5,25252,6454,18798,2.8,11,22198,4788,17410,2.1,9.7,3054,1.3,19.4,0,57,57,381
2009,12,a) 0,33946,34154,180025,91183,33296,195,0,0,177685,177685,0,194.9,194.9,0,0,0,0,0,177685,194.9,0,0,,,
2009,12,b) 1,27667,27965,161649,180956,65,0.2,11387,33.1,37363,1103,36260,0.6,20.6,75976,43725,32251,24.2,42,-38613,-21.4,41.2,0,9052,9052,37605
2009,12,c) 2,24573,25005,174674,193023,963,3.4,7517,26.4,24646,3106,21540,1.6,12.8,61344,31796,29548,16.5,31.8,-36698,-19,25.6,0,5998,5999,27444
2009,12,d) 3,22754,23292,158489,177673,942,3.6,6132,23.5,25552,3902,21650,2.2,14.4,63920,22523,41397,12.7,36,-38368,-21.6,28.8,0,4810,4811,18253
2009,12,e) 4,20823,21558,163769,172938,871,3.7,4873,20.6,27294,4448,22846,2.6,15.8,45632,18878,26754,10.9,26.4,-18338,-10.6,31.6,0,3777,3777,15891
2009,12,f) 5,19738,20226,137151,148413,692,3.1,4307,19.5,17566,2703,14863,1.8,11.8,40089,15802,24287,10.6,27,-22523,-15.2,23.6,0,3232,3238,12246
2009,12,g) 6 to 10,62229,65391,610783,662221,2171,3.1,9870,14.2,67577,13977,53600,2.1,10.2,170452,60551,109901,9.1,25.7,-102875,-15.5,20.4,0,7317,7329,45694
2009,12,h) 11 to 15,40367,43905,509900,531880,1447,3.2,4880,10.7,66838,20700,46138,3.9,12.6,110798,29540,81258,5.6,20.8,-43960,-8.2,25.2,0,3386,3398,19798
2009,12,i) 16 to 20,28751,33984,493392,518206,1155,3.3,3015,8.6,45917,12455,33462,2.4,8.9,95544,20583,74961,4,18.4,-49627,-9.5,17.8,0,1994,1995,12251
2009,12,j) 21 to 25,21528,27785,584275,609175,1035,3.6,2141,7.5,56281,17450,38831,2.9,9.2,106081,21893,84188,3.6,17.4,-49800,-8.2,18.4,0,1322,1322,10828
2009,12,k) 26+,18165,29546,632655,659654,1170,3.9,1967,6.6,62457,20750,41707,3.1,9.5,116454,20489,95965,3.1,17.7,-53997,-8.2,19,0,1048,1153,8324
2009,12,l) Left Censored,18579,73925,2642660,2730454,4823,6.5,5147,6.9,236391,88055,148336,3.2,8.7,411979,76742,335237,2.8,15.1,-175588,-6.4,17.4,0,709,799,9063
2009,13,a) 0,12997,13131,79258,40061,12833,195.5,0,0,78395,78395,0,195.7,195.7,0,0,0,0,0,78395,195.7,0,0,,,
2009,13,b) 1,11569,11738,76801,86456,37,0.3,4442,31.2,16600,621,15979,0.7,19.2,35910,20746,15164,24,41.5,-19310,-22.3,38.4,0,3608,3610,17528
2009,13,c) 2,10367,10534,70910,79335,319,2.7,2898,24.4,11537,1448,10089,1.8,14.5,28387,14773,13614,18.6,35.8,-16850,-21.3,29,0,2291,2294,12753
2009,13,d) 3,9308,9673,77160,85328,335,3.1,2300,21.5,11008,1887,9121,2.2,12.9,27344,13925,13419,16.3,32,-16336,-19.1,25.8,0,1836,1839,12490
2009,13,e) 4,8223,8569,77943,82441,249,2.7,1773,18.9,12982,5048,7934,6.1,15.7,21978,9043,12935,11,26.7,-8996,-11,31.4,0,1408,1408,7085
2009,13,f) 5,7215,7406,62608,69359,214,2.7,1344,16.8,7322,994,6328,1.4,10.6,20823,8511,12312,12.3,30,-13501,-19.4,21.2,0,1062,1063,7011
2009,13,g) 6 to 10,27463,29282,322212,341612,830,2.7,4094,13.2,36759,5901,30858,1.7,10.8,75558,26132,49426,7.6,22.1,-38799,-11.3,21.6,0,3061,3068,21209
2009,13,h) 11 to 15,18907,20782,253029,269333,664,3.1,2310,10.7,26731,7089,19642,2.6,9.9,59339,20384,38955,7.6,22,-32608,-12.1,19.8,0,1654,1654,13525
2009,13,i) 16 to 20,12027,14627,227038,238658,515,3.4,1259,8.4,24099,8056,16043,3.4,10.1,47338,10751,36587,4.5,19.8,-23239,-9.7,20.2,0,878,878,6272
2009,13,j) 21 to 25,10323,13288,272749,281432,445,3.3,909,6.7,30920,13977,16943,5,11,48285,8684,39601,3.1,17.2,-17365,-6.2,22,0,583,586,4428
2009,13,k) 26+,9023,14810,354672,368733,523,3.5,947,6.3,35948,10648,25300,2.9,9.7,64069,10369,53700,2.8,17.4,-28121,-7.7,19.4,0,466,526,3834
2009,13,l) Left Censored,12246,41853,1506769,1541862,2438,5.8,2665,6.3,138671,49696,88975,3.2,9,208856,39459,169397,2.6,13.5,-70185,-4.5,18,0,404,431,4585
2009,15,a) 0,1514,1526,8257,4158,1502,196.9,0,0,8199,8199,0,197.2,197.2,0,0,0,0,0,8199,197.2,0,0,,,
2009,15,b) 1,1311,1327,8483,9028,3,0.2,424,27.3,1871,18,1853,0.2,20.7,2961,1599,1362,17.7,32.8,-1090,-12.1,41.4,0,347,347,1430
2009,15,c) 2,1268,1273,9545,10320,43,3.1,302,21.4,1293,109,1184,1.1,12.5,2842,1292,1550,12.5,27.5,-1549,-15,25,0,238,238,1074
2009,15,d) 3,1174,1243,11155,11797,37,2.8,222,16.5,1709,299,1410,2.5,14.5,2993,1095,1898,9.3,25.4,-1284,-10.9,29,0,165,165,880
2009,15,e) 4,1041,1055,10054,10754,30,2.7,171,15.2,1131,367,764,3.4,10.5,2531,781,1750,7.3,23.5,-1400,-13,21,0,135,135,623
2009,15,f) 5,940,987,8833,9320,32,3.1,140,13.4,1109,133,976,1.4,11.9,2083,604,1479,6.5,22.3,-974,-10.4,23.8,0,104,104,527
2009,15,g) 6 to 10,3827,4132,40575,43519,101,2.4,434,10.1,3584,605,2979,1.4,8.2,9472,2674,6798,6.1,21.8,-5888,-13.6,16.4,0,315,315,2017
2009,15,h) 11 to 15,2743,2973,38391,38944,110,3.6,222,7.3,4010,872,3138,2.2,10.3,5115,1134,3981,2.9,13.1,-1105,-2.8,20.6,0,166,166,803
2009,15,i) 16 to 20,2164,2505,31811,33172,80,3.1,173,6.8,3047,597,2450,1.8,9.2,5769,1696,4073,5.1,17.4,-2722,-8.2,18.4,0,113,113,1299
2009,15,j) 21 to 25,1893,2379,45204,46641,58,2.4,133,5.5,3480,1218,2262,2.6,7.5,6353,1077,5276,2.3,13.6,-2873,-6.1,15,0,89,89,739
2009,15,k) 26+,2304,3275,57200,59735,68,2,165,5,3673,548,3125,0.9,6.1,8743,1264,7479,2.1,14.6,-5070,-8.5,12.2,0,103,103,687
2009,15,l) Left Censored,3018,6956,214886,220122,349,5,336,4.8,17305,6895,10410,3.1,7.9,27776,5445,22331,2.5,12.6,-10471,-4.7,15.8,0,73,77,374
2009,16,a) 0,2555,2565,14557,7434,2507,195.5,0,0,14247,14247,0,191.6,191.6,0,0,0,0,0,14247,191.6,0,0,,,
2009,16,b) 1,2365,2384,12260,13982,5,0.2,1034,34.9,2495,15,2480,0.1,17.8,5938,3135,2803,22.4,42.5,-3443,-24.7,35.6,0,761,761,2611
2009,16,c) 2,2378,2397,13896,15373,94,3.5,711,26.2,2172,398,1774,2.6,14.1,5125,2377,2748,15.5,33.3,-2953,-19.2,28.2,0,516,516,1854
2009,16,d) 3,2278,2343,14334,16019,91,3.5,623,23.7,1887,217,1670,1.4,11.8,5256,2377,2879,14.8,32.8,-3369,-21,23.6,0,455,455,1870
2009,16,e) 4,1874,1916,13902,15011,59,2.8,414,19.7,2335,202,2133,1.3,15.6,4553,1893,2660,12.6,30.3,-2218,-14.7,31.2,0,291,291,1542
2009,16,f) 5,1557,1614,12540,13629,48,2.7,304,17.4,1302,231,1071,1.7,9.6,3479,1234,2245,9.1,25.5,-2177,-15.9,19.2,0,208,208,965
2009,16,g) 6 to 10,5840,6185,58731,62490,197,3,823,12.6,5321,793,4528,1.3,8.5,12839,4104,8735,6.6,20.5,-7518,-12,17,0,532,532,3094
2009,16,h) 11 to 15,4023,4275,39384,42044,112,2.5,499,11.1,3296,533,2763,1.3,7.8,8615,2104,6511,5,20.5,-5319,-12.7,15.6,0,334,334,1570
2009,16,i) 16 to 20,2462,2761,30989,32939,59,2.1,237,8.3,2766,456,2310,1.4,8.4,6665,1401,5264,4.3,20.2,-3899,-11.8,16.8,0,135,135,954
2009,16,j) 21 to 25,1845,2324,41179,42916,68,2.9,149,6.3,3354,1073,2281,2.5,7.8,6827,1143,5684,2.7,15.9,-3473,-8.1,15.6,0,80,80,627
2009,16,k) 26+,1931,2917,61774,64444,75,2.5,171,5.8,4183,827,3356,1.3,6.5,9522,1340,8182,2.1,14.8,-5339,-8.3,13,0,87,87,398
2009,16,l) Left Censored,2788,6881,183463,188327,308,4.5,350,5.1,13767,4924,8843,2.6,7.3,23495,4136,19359,2.2,12.5,-9728,-5.2,14.6,0,64,64,526
2009,17,a) 0,16091,16204,87723,44411,15766,194.6,0,0,86625,86625,0,195.1,195.1,0,0,0,0,0,86625,195.1,0,0,,,
2009,17,b) 1,13863,14056,92371,100316,46,0.3,4589,27.6,19471,623,18848,0.6,19.4,35361,21095,14266,21,35.2,-15890,-15.8,38.8,0,3362,3362,17958
2009,17,c) 2,12149,12286,85974,94284,414,3.1,2813,20.8,14195,1538,12657,1.6,15.1,30815,14857,15958,15.8,32.7,-16620,-17.6,30.2,0,2075,2075,12898
2009,17,d) 3,11590,12043,101265,106140,446,3.4,2177,16.8,16839,1793,15046,1.7,15.9,26589,12187,14402,11.5,25.1,-9750,-9.2,31.8,0,1621,1621,10360
2009,17,e) 4,10454,10789,97620,102200,360,3.1,1827,15.8,12926,2305,10621,2.3,12.6,22085,8971,13114,8.8,21.6,-9159,-9,25.2,0,1378,1378,7235
2009,17,f) 5,9259,9490,80470,84636,260,2.6,1454,14.4,9597,1134,8463,1.3,11.3,17928,6395,11533,7.6,21.2,-8331,-9.9,22.6,0,1063,1063,4763
2009,17,g) 6 to 10,36117,38511,416890,441152,1120,2.8,4549,11.3,41406,8470,32936,1.9,9.4,89931,28168,61763,6.4,20.4,-48525,-11,18.8,0,3178,3184,20745
2009,17,h) 11 to 15,27862,29978,359687,380045,865,2.8,2870,9.2,31773,5055,26718,1.3,8.4,72489,18486,54003,4.9,19.1,-40716,-10.7,16.8,0,1907,1917,12247
2009,17,i) 16 to 20,20752,23589,334645,347218,664,2.7,1834,7.6,34101,6863,27238,2,9.8,59246,12055,47191,3.5,17.1,-25145,-7.3,19.6,0,1174,1178,7401
2009,17,j) 21 to 25,17750,21727,415932,427927,665,3,1452,6.6,34932,12941,21991,3,8.2,58922,11776,47146,2.8,13.8,-23990,-5.6,16.4,0,900,902,6480
2009,17,k) 26+,17212,25369,626854,645991,716,2.8,1378,5.4,52592,15699,36893,2.4,8.1,90866,16784,74082,2.6,14.1,-38274,-6,16.2,0,761,761,6256
2009,17,l) Left Censored,26863,65134,2404769,2483775,2835,4.3,4126,6.3,189395,61121,128274,2.5,7.6,347408,67050,280358,2.7,14,-158013,-6.4,15.2,0,888,917,9556
2009,18,a) 0,6398,6473,41034,20778,6331,195.6,0,0,40512,40512,0,195,195,0,0,0,0,0,40512,195,0,0,,,
2009,18,b) 1,6057,6159,44946,49129,22,0.3,1775,24.8,9614,349,9265,0.7,19.6,17980,8811,9169,17.9,36.6,-8366,-17,39.2,0,1402,1405,6822
2009,18,c) 2,5324,5445,42496,45809,184,3.1,1223,20.4,7210,570,6640,1.2,15.7,13835,5735,8100,12.5,30.2,-6625,-14.5,31.4,0,982,982,4921
2009,18,d) 3,5181,5474,47313,49854,184,3.1,1042,17.6,6809,690,6119,1.4,13.7,11891,5274,6617,10.6,23.9,-5082,-10.2,27.4,0,780,780,4477
2009,18,e) 4,4449,4597,39604,41920,136,2.8,732,14.9,5094,881,4213,2.1,12.2,9725,3584,6141,8.5,23.2,-4631,-11,24.4,0,559,559,2928
2009,18,f) 5,3897,4016,35503,38415,120,2.8,653,15.2,4868,945,3923,2.5,12.7,10691,5041,5650,13.1,27.8,-5823,-15.1,25.4,0,525,525,2902
2009,18,g) 6 to 10,16105,17124,177273,185147,442,2.5,2061,11.5,22773,3505,19268,1.9,12.3,38521,12620,25901,6.8,20.8,-15748,-8.5,24.6,0,1530,1534,10489
2009,18,h) 11 to 15,12581,13956,162630,169079,380,2.6,1279,8.9,17819,4644,13175,2.7,10.5,30717,7932,22785,4.7,18.2,-12898,-7.7,21,0,879,879,5151
2009,18,i) 16 to 20,9680,11357,154043,162757,293,2.5,929,8,15140,3155,11985,1.9,9.3,32567,7711,24856,4.7,20,-17427,-10.7,18.6,0,576,578,3528
2009,18,j) 21 to 25,8664,11204,198333,208037,262,2.3,650,5.7,17614,5482,12132,2.6,8.5,37021,8094,28927,3.9,17.8,-19407,-9.3,17,0,395,403,3383
2009,18,k) 26+,8216,12556,277046,289555,326,2.6,703,5.5,25576,5174,20402,1.8,8.8,50594,12102,38492,4.2,17.5,-25018,-8.7,17.6,0,310,356,2452
2009,18,l) Left Censored,13496,35043,1222311,1257292,1495,4.3,1711,4.9,95364,25823,69541,2.1,7.6,165326,23000,142326,1.8,13.1,-69962,-5.5,15.2,0,438,448,3920
2009,19,a) 0,3318,3368,20913,10511,3311,196.6,0,0,20804,20804,0,197.9,197.9,0,0,0,0,0,20804,197.9,0,0,,,
2009,19,b) 1,3084,3123,20006,22482,7,0.2,957,26.2,4682,75,4607,0.3,20.8,9634,5051,4583,22.5,42.9,-4952,-22.1,41.6,0,754,754,4600
2009,19,c) 2,2795,2821,20307,22159,99,3.3,528,17.4,3435,827,2608,3.7,15.5,7138,3412,3726,15.4,32.2,-3703,-16.7,31,0,418,418,3204
2009,19,d) 3,2826,3074,23843,24725,88,2.7,451,13.8,3537,426,3111,1.7,14.3,5300,2198,3102,8.9,21.4,-1763,-7.1,28.6,0,353,353,1685
2009,19,e) 4,2402,2462,19623,20690,86,3.3,349,13.4,2719,369,2350,1.8,13.1,4853,1714,3139,8.3,23.5,-2134,-10.4,26.2,0,264,264,1331
2009,19,f) 5,2154,2218,17647,18342,59,2.5,278,12,2318,242,2076,1.3,12.6,3708,1248,2460,6.8,20.2,-1390,-7.6,25.2,0,214,214,1105
2009,19,g) 6 to 10,8665,9332,95686,98505,264,2.7,928,9.6,11352,1327,10025,1.3,11.5,16989,4754,12235,4.8,17.2,-5637,-5.7,23,0,655,656,3842
2009,19,h) 11 to 15,6932,7507,77104,79549,225,2.9,592,7.7,8785,1089,7696,1.4,11,13674,3768,9906,4.7,17.2,-4889,-6.2,22,0,402,402,2728
2009,19,i) 16 to 20,5078,5660,66689,68012,115,2,358,6.2,6965,1001,5964,1.5,10.2,9610,2120,7490,3.1,14.1,-2645,-3.9,20.4,0,241,241,1256
2009,19,j) 21 to 25,4662,5888,114859,117262,155,2.6,332,5.6,11519,5052,6467,4.3,9.8,16324,2876,13448,2.5,13.9,-4805,-4.1,19.6,0,202,203,1112
2009,19,k) 26+,5169,8275,137627,139501,208,2.5,337,4,11823,2215,9608,1.6,8.5,15571,1941,13630,1.4,11.2,-3748,-2.7,17,0,231,231,1220
2009,19,l) Left Censored,9170,19428,657532,664136,586,3,798,4.1,52649,11133,41516,1.7,7.9,65857,8226,57631,1.2,9.9,-13208,-2,15.8,0,248,250,2427
2009,20,a) 0,3461,3484,20950,10612,3405,195.5,0,0,20676,20676,0,194.8,194.8,0,0,0,0,0,20676,194.8,0,0,,,
2009,20,b) 1,3082,3125,20036,21383,6,0.2,946,25.9,4752,71,4681,0.3,22.2,7446,4265,3181,19.9,34.8,-2694,-12.6,44.4,0,758,758,3785
2009,20,c) 2,2887,2935,20865,21710,102,3.2,592,18.6,3747,351,3396,1.6,17.3,5437,2848,2589,13.1,25,-1690,-7.7,34.6,0,469,469,2607
2009,20,d) 3,2727,2852,20973,21899,80,2.6,492,16.1,3039,424,2615,1.9,13.9,4890,1930,2960,8.8,22.3,-1851,-8.4,27.8,0,376,383,1657
2009,20,e) 4,2374,2448,21234,22629,59,2.3,389,14.9,2665,303,2362,1.3,11.8,5455,1844,3611,8.1,24.1,-2790,-12.3,23.6,0,293,293,1316
2009,20,f) 5,2151,2203,18729,20221,45,1.9,315,13.5,2310,173,2137,0.9,11.4,5293,1947,3346,9.6,26.2,-2983,-14.8,22.8,0,249,249,1662
2009,20,g) 6 to 10,8828,9236,98260,100777,233,2.4,925,9.6,11134,1069,10065,1.1,11,16167,5408,10759,5.4,16,-5033,-5,22,0,707,707,4642
2009,20,h) 11 to 15,6657,7238,87804,91825,173,2.3,618,8.3,7743,1817,5926,2,8.4,15784,3732,12052,4.1,17.2,-8041,-8.8,16.8,0,454,454,3113
2009,20,i) 16 to 20,4709,5441,76171,79146,135,2.4,392,7,7135,1286,5849,1.6,9,13085,3020,10065,3.8,16.5,-5950,-7.5,18,0,256,256,1625
2009,20,j) 21 to 25,4259,5219,80019,81356,136,2.6,299,5.6,7258,1428,5830,1.8,8.9,9931,1717,8214,2.1,12.2,-2673,-3.3,17.8,0,192,193,1105
2009,20,k) 26+,4613,6938,132395,134900,180,2.6,353,5,12839,2422,10417,1.8,9.5,17848,3256,14592,2.4,13.2,-5009,-3.7,19,0,191,191,1332
2009,20,l) Left Censored,7526,16873,530734,536973,691,4.1,759,4.5,42756,11875,30881,2.2,8,55234,7812,47422,1.5,10.3,-12478,-2.3,16,0,218,218,1785
2009,21,a) 0,4132,4152,25089,12679,4071,196.1,0,0,24820,24820,0,195.8,195.8,0,0,0,0,0,24820,195.8,0,0,,,
2009,21,b) 1,3715,3814,28506,30671,11,0.2,1080,24.5,6996,59,6937,0.2,22.8,11326,5860,5466,19.1,36.9,-4330,-14.1,45.6,0,878,878,5105
2009,21,c) 2,3377,3434,24829,27235,99,2.6,739,19.7,3681,255,3426,0.9,13.5,8493,4564,3929,16.8,31.2,-4812,-17.7,27,0,621,621,4226
2009,21,d) 3,3206,3371,27387,28848,108,3,582,16.1,3972,711,3261,2.5,13.8,6893,2629,4264,9.1,23.9,-2921,-10.1,27.6,0,470,470,2352
2009,21,e) 4,2874,2962,25380,27018,62,1.9,493,15.5,3052,499,2553,1.8,11.3,6328,2409,3919,8.9,23.4,-3276,-12.1,22.6,0,408,408,2087
2009,21,f) 5,2526,2663,23801,24680,78,2.8,404,14.3,3680,636,3044,2.6,14.9,5437,2234,3203,9.1,22,-1757,-7.1,29.8,0,321,321,1895
2009,21,g) 6 to 10,10365,11057,113356,118729,296,2.6,1174,10.2,12050,2289,9761,1.9,10.1,22796,6227,16569,5.2,19.2,-10746,-9.1,20.2,0,880,882,4959
2009,21,h) 11 to 15,8006,8827,103458,109259,210,2.3,760,8.3,10189,2476,7713,2.3,9.3,21791,6273,15518,5.7,19.9,-11602,-10.6,18.6,0,544,544,3097
2009,21,i) 16 to 20,5935,7152,94115,97921,256,3.5,507,7,9727,2278,7449,2.3,9.9,17339,2962,14377,3,17.7,-7612,-7.8,19.8,0,359,359,1881
2009,21,j) 21 to 25,5586,6910,127119,131994,188,2.7,362,5.2,9817,2341,7476,1.8,7.4,19566,3393,16173,2.6,14.8,-9749,-7.4,14.8,0,257,258,1631
2009,21,k) 26+,4970,7790,164095,168684,278,3.5,517,6.5,16403,4925,11478,2.9,9.7,25581,4043,21538,2.4,15.2,-9178,-5.5,19.4,0,231,252,1532
2009,21,l) Left Censored,8043,21181,716326,729899,1014,4.8,960,4.5,59672,19501,40171,2.7,8.2,86817,13420,73397,1.8,11.9,-27145,-3.7,16.4,0,236,236,2038
2009,22,a) 0,5374,5443,38344,19417,5337,196.1,0,0,37854,37854,0,195,195,0,0,0,0,0,37854,195,0,0,,,
2009,22,b) 1,4757,4896,38871,40048,27,0.5,1318,23.4,9788,414,9374,1,24.4,12141,6179,5962,15.4,30.3,-2353,-5.9,48.8,0,1065,1065,4991
2009,22,c) 2,4440,4482,39485,40767,127,2.6,886,18.2,7466,874,6592,2.1,18.3,10030,5028,5002,12.3,24.6,-2564,-6.3,36.6,0,730,730,4453
2009,22,d) 3,3722,4003,38607,39704,104,2.4,616,14.5,6323,565,5758,1.4,15.9,8516,3205,5311,8.1,21.4,-2193,-5.5,31.8,0,509,509,2564
2009,22,e) 4,3298,3397,35847,36231,75,2.1,477,13.3,6303,1532,4771,4.2,17.4,7070,2654,4416,7.3,19.5,-767,-2.1,34.8,0,377,377,2261
2009,22,f) 5,2981,3105,33178,34385,84,2.6,399,12.2,4389,364,4025,1.1,12.8,6803,2170,4633,6.3,19.8,-2414,-7,25.6,0,315,315,1914
2009,22,g) 6 to 10,12175,12970,158999,162570,331,2.5,1299,9.7,18761,3083,15678,1.9,11.5,25903,8203,17700,5,15.9,-7142,-4.4,23,0,1007,1007,6205
2009,22,h) 11 to 15,9328,10076,129719,131775,271,2.6,740,7.2,14831,2936,11895,2.2,11.3,18943,4745,14198,3.6,14.4,-4112,-3.1,22.6,0,562,562,3046
2009,22,i) 16 to 20,6482,7592,114564,116228,191,2.5,496,6.4,11856,1729,10127,1.5,10.2,15183,3767,11416,3.2,13.1,-3327,-2.9,20.4,0,366,366,2590
2009,22,j) 21 to 25,5919,7430,140256,142234,214,2.8,379,5,15542,4503,11039,3.2,10.9,19497,6191,13306,4.4,13.7,-3955,-2.8,21.8,0,258,258,2165
2009,22,k) 26+,6700,9677,197269,199395,253,2.6,442,4.5,22097,3448,18649,1.7,11.1,26349,5147,21202,2.6,13.2,-4252,-2.1,22.2,0,239,239,1614
2009,22,l) Left Censored,8473,21865,656012,663332,912,4.2,1033,4.7,56487,14384,42103,2.2,8.5,71128,13028,58100,2,10.7,-14641,-2.2,17,0,270,271,2911
2009,23,a) 0,1804,1819,8866,4465,1784,196.2,0,0,8803,8803,0,197.2,197.2,0,0,0,0,0,8803,197.2,0,0,,,
2009,23,b) 1,1715,1731,8501,9170,8,0.4,568,27.8,1709,91,1618,1,18.6,3046,1745,1301,19,33.2,-1337,-14.6,37.2,0,395,395,1387
2009,23,c) 2,1551,1564,9573,10081,53,3,391,22.3,1577,113,1464,1.1,15.6,2593,1218,1375,12.1,25.7,-1016,-10.1,31.2,0,277,277,991
2009,23,d) 3,1579,1665,10255,10959,62,3.5,320,17.8,1389,165,1224,1.5,12.7,2796,1151,1645,10.5,25.5,-1407,-12.8,25.4,0,232,232,999
2009,23,e) 4,1322,1338,8857,9010,42,2.9,232,16.1,1606,112,1494,1.2,17.8,1911,828,1083,9.2,21.2,-305,-3.4,35.6,0,165,165,591
2009,23,f) 5,1208,1241,9092,9407,38,2.9,195,14.8,1082,154,928,1.6,11.5,1712,634,1078,6.7,18.2,-630,-6.7,23,0,141,141,531
2009,23,g) 6 to 10,4970,5182,37796,39836,153,2.8,661,12.1,4040,671,3369,1.7,10.1,8120,3338,4782,8.4,20.4,-4080,-10.3,20.2,0,434,434,2434
2009,23,h) 11 to 15,3792,4046,37394,39163,112,2.7,370,8.8,2955,460,2495,1.2,7.5,6492,1669,4823,4.3,16.6,-3537,-9.1,15,0,247,247,1237
2009,23,i) 16 to 20,2688,3023,31263,32190,88,2.8,234,7.5,2909,984,1925,3.1,9,4763,884,3879,2.7,14.8,-1854,-5.8,18,0,140,140,575
2009,23,j) 21 to 25,2524,3126,49463,50611,92,2.9,212,6.6,4530,851,3679,1.7,9,6826,1287,5539,2.5,13.5,-2296,-4.5,18,0,120,120,477
2009,23,k) 26+,2178,3348,59631,60220,128,3.8,172,5.1,6515,2186,4329,3.6,10.8,7692,1064,6628,1.8,12.8,-1177,-2,21.6,0,99,99,586
2009,23,l) Left Censored,3267,7123,209103,214153,259,3.6,408,5.7,13179,2923,10256,1.4,6.2,23278,3857,19421,1.8,10.9,-10099,-4.7,12.4,0,128,129,1674
2009,24,a) 0,6621,6694,38998,19805,6524,194.9,0,0,38387,38387,0,193.8,193.8,0,0,0,0,0,38387,193.8,0,0,,,
2009,24,b) 1,5826,6034,40671,43237,17,0.2,1939,27.2,9521,347,9174,0.8,22,14653,7729,6924,17.9,33.9,-5132,-11.9,44,0,1510,1510,6178
2009,24,c) 2,5436,5516,39412,42390,188,3.1,1233,20.4,6398,934,5464,2.2,15.1,12354,5118,7236,12.1,29.1,-5956,-14,30.2,0,937,937,4220
2009,24,d) 3,5366,5603,43733,46114,182,3,1023,17,6543,675,5868,1.5,14.2,11304,4770,6534,10.3,24.5,-4761,-10.3,28.4,0,791,791,4145
2009,24,e) 4,4852,4997,39102,41619,124,2.3,866,16,5118,793,4325,1.9,12.3,10152,4018,6134,9.7,24.4,-5034,-12.1,24.6,0,651,651,2968
2009,24,f) 5,4346,4464,37352,39209,118,2.5,723,15.1,5306,429,4877,1.1,13.5,9019,3704,5315,9.4,23,-3713,-9.5,27,0,539,548,3129
2009,24,g) 6 to 10,17050,17945,196663,205306,479,2.5,2180,11.6,23827,3440,20387,1.7,11.6,41113,12341,28772,6,20,-17286,-8.4,23.2,0,1517,1523,9139
2009,24,h) 11 to 15,12480,13429,159531,165479,341,2.5,1209,8.7,16575,2578,13997,1.6,10,28470,7173,21297,4.3,17.2,-11895,-7.2,20,0,784,785,5052
2009,24,i) 16 to 20,9308,10585,167699,175753,257,2.4,823,7.6,12957,1840,11117,1,7.4,29065,5344,23721,3,16.5,-16108,-9.1,14.8,0,497,497,2652
2009,24,j) 21 to 25,7910,9634,183674,189108,248,2.5,624,6.3,16415,4032,12383,2.1,8.7,27283,6645,20638,3.5,14.4,-10868,-5.7,17.4,0,385,386,3273
2009,24,k) 26+,6773,9966,217850,223390,340,3.4,518,5.1,18109,5107,13002,2.3,8.1,29188,5641,23547,2.5,13.1,-11079,-5,16.2,0,279,282,2488
2009,24,l) Left Censored,9924,26671,950550,966734,1727,6.5,1633,6.1,85762,27585,58177,2.9,8.9,118130,27670,90460,2.9,12.2,-32368,-3.3,17.8,0,322,335,3385
2009,25,a) 0,7617,7657,40342,20332,7518,196.4,0,0,40020,40020,0,196.8,196.8,0,0,0,0,0,40020,196.8,0,0,,,
2009,25,b) 1,6772,6851,44066,46775,22,0.3,2094,26.1,9041,309,8732,0.7,19.3,14458,7279,7179,15.6,30.9,-5417,-11.6,38.6,0,1545,1546,5963
2009,25,c) 2,6179,6223,43091,44749,195,2.9,1308,19.2,7521,632,6889,1.4,16.8,10836,4927,5909,11,24.2,-3315,-7.4,33.6,0,987,987,3985
2009,25,d) 3,6327,6489,45068,47676,211,3,1162,16.6,6678,819,5859,1.7,14,11893,4681,7212,9.8,24.9,-5215,-10.9,28,0,890,890,3939
2009,25,e) 4,5533,5635,48732,50718,157,2.6,863,14.4,6642,525,6117,1,13.1,10613,4097,6516,8.1,20.9,-3971,-7.8,26.2,0,639,639,3207
2009,25,f) 5,4886,5043,46862,49920,143,2.7,750,14,6103,795,5308,1.6,12.2,12219,4023,8196,8.1,24.5,-6116,-12.3,24.4,0,534,534,2883
2009,25,g) 6 to 10,20203,21219,228786,238678,588,2.7,2411,10.9,25241,3643,21598,1.5,10.6,45024,15871,29153,6.6,18.9,-19783,-8.3,21.2,0,1686,1692,12800
2009,25,h) 11 to 15,15599,16503,190457,197048,438,2.6,1514,8.9,19674,3542,16132,1.8,10,32855,8899,23956,4.5,16.7,-13181,-6.7,20,0,1012,1014,6416
2009,25,i) 16 to 20,11145,12529,182345,187559,317,2.5,941,7.3,17499,3636,13863,1.9,9.3,27926,7126,20800,3.8,14.9,-10427,-5.6,18.6,0,601,601,4059
2009,25,j) 21 to 25,11182,13788,266205,272251,405,2.9,897,6.4,22273,4305,17968,1.6,8.2,34365,7078,27287,2.6,12.6,-12092,-4.4,16.4,0,488,488,3035
2009,25,k) 26+,9830,14712,407857,414412,424,2.8,771,5.2,31413,9549,21864,2.3,7.6,44522,10346,34176,2.5,10.7,-13109,-3.1,15.2,0,410,414,2707
2009,25,l) Left Censored,16603,36583,1400750,1425541,1748,4.8,2076,5.6,115808,37589,78219,2.6,8.1,165391,31839,133552,2.2,11.6,-49583,-3.5,16.2,0,530,573,6805
2009,26,a) 0,10245,10312,70354,35643,10047,194.9,0,0,69422,69422,0,194.8,194.8,0,0,0,0,0,69422,194.8,0,0,,,
2009,26,b) 1,8922,9056,69166,74112,24,0.2,3008,28.1,16694,232,16462,0.3,22.5,26586,15483,11103,20.9,35.9,-9892,-13.4,45,0,2286,2286,13539
2009,26,c) 2,7906,8022,82915,86836,282,3.2,1855,21,19867,5860,14007,6.7,22.9,27709,8783,18926,10.1,31.9,-7842,-9,45.8,0,1463,1463,7451
2009,26,d) 3,7684,7843,67771,71546,256,3,1426,16.9,11179,1023,10156,1.4,15.6,18728,7509,11219,10.5,26.2,-7549,-10.6,31.2,0,1106,1106,6561
2009,26,e) 4,6776,6946,65955,72083,210,2.8,1305,17.4,10448,2252,8196,3.1,14.5,22704,11502,11202,16,31.5,-12256,-17,29,0,1007,1008,10016
2009,26,f) 5,6040,6213,61542,66895,196,2.9,1133,16.9,8158,1200,6958,1.8,12.2,18863,8633,10230,12.9,28.2,-10705,-16,24.4,0,867,867,7813
2009,26,g) 6 to 10,24738,26330,273254,287303,793,2.9,3486,12.6,36328,6153,30175,2.1,12.6,64426,22775,41651,7.9,22.4,-28098,-9.8,25.2,0,2475,2482,18913
2009,26,h) 11 to 15,20205,21652,239217,251732,656,2.9,2332,10.3,25945,4948,20997,2,10.3,50975,13094,37881,5.2,20.2,-25030,-9.9,20.6,0,1527,1543,10316
2009,26,i) 16 to 20,15144,17375,213800,229396,444,2.5,1626,9,21214,3643,17571,1.6,9.2,52405,14163,38242,6.2,22.8,-31191,-13.6,18.4,0,1007,1013,7268
2009,26,j) 21 to 25,13613,17273,295707,305263,500,2.8,1200,6.8,29061,7720,21341,2.5,9.5,48172,10061,38111,3.3,15.8,-19111,-6.3,19,0,741,746,5307
2009,26,k) 26+,12839,18146,328591,338234,485,2.6,1098,5.9,31964,6725,25239,2,9.5,51249,7831,43418,2.3,15.2,-19285,-5.7,19,0,623,642,4134
2009,26,l) Left Censored,19179,48236,1594526,1659265,1817,3.7,3386,6.9,120970,35792,85178,2.2,7.3,250448,44798,205650,2.7,15.1,-129478,-7.8,14.6,0,697,698,6932
2009,27,a) 0,6935,7010,43686,22080,6837,195.1,0,0,43212,,,,195.7,0,0,0,0,0,43212,195.7,0,1,,,
2009,27,b) 1,5803,5866,40133,44724,9,0.1,1972,28.3,10106,,,,22.6,19288,10831,8457,24.2,43.1,-9182,-20.5,45.2,1,1423,1423,9495
2009,27,c) 2,5396,5484,44930,48008,222,3.7,1272,21.1,7213,922,6291,1.9,15,13369,6225,7144,13,27.8,-6156,-12.8,30,0,894,894,5199
2009,27,d) 3,5306,5704,42832,45119,225,3.7,1030,16.8,5778,839,4939,1.9,12.8,10352,4711,5641,10.4,22.9,-4574,-10.1,25.6,0,729,729,3860
2009,27,e) 4,4801,4969,41252,42503,182,3.4,799,15.1,5636,890,4746,2.1,13.3,8138,3685,4453,8.7,19.1,-2502,-5.8,26.6,0,561,561,3065
2009,27,f) 5,4304,4482,37239,38771,158,3.3,714,15,5025,652,4373,1.7,13,8089,3494,4595,9,20.9,-3064,-7.9,26,0,464,473,2742
2009,27,g) 6 to 10,17799,18766,191366,199663,578,2.9,2231,11.4,20844,3447,17397,1.7,10.4,37437,11200,26237,5.6,18.8,-16593,-8.4,20.8,0,1431,1432,8992
2009,27,h) 11 to 15,13366,14723,166234,173155,434,2.9,1354,8.9,15856,2472,13384,1.4,9.2,29698,8799,20899,5.1,17.2,-13842,-8,18.4,0,828,840,6985
2009,27,i) 16 to 20,9430,10819,148280,154054,291,2.6,808,7.3,12959,3203,9756,2.1,8.4,24506,5060,19446,3.3,15.9,-11547,-7.5,16.8,0,469,472,2754
2009,27,j) 21 to 25,7868,9867,198143,205755,278,2.8,620,6.2,15713,3954,11759,1.9,7.6,30937,5787,25150,2.8,15,-15224,-7.4,15.2,0,338,343,2679
2009,27,k) 26+,7496,11398,262572,271347,342,3,567,4.9,20500,5261,15239,1.9,7.6,38049,5812,32237,2.1,14,-17549,-6.4,15.2,0,314,314,2691
2009,27,l) Left Censored,12342,29090,1163489,1197491,1176,4,1461,5,102495,23604,78891,2,8.6,170500,23210,147290,1.9,14.2,-68005,-5.6,17.2,0,313,323,3714
2009,28,a) 0,2951,2972,20085,10126,2905,195.5,0,0,19919,19919,0,196.7,196.7,0,0,0,0,0,19919,196.7,0,0,,,
2009,28,b) 1,2593,2659,17247,19081,13,0.4,864,27.6,4005,64,3941,0.3,21,7672,4341,3331,22.8,40.2,-3667,-19.2,42,0,732,732,3914
2009,28,c) 2,2395,2472,16021,17539,70,2.6,582,21.3,2512,213,2299,1.2,14.3,5548,2679,2869,15.3,31.6,-3036,-17.3,28.6,0,493,493,2362
2009,28,d) 3,2143,2266,20377,21639,48,2,417,17,2534,443,2091,2,11.7,5057,2016,3041,9.3,23.4,-2523,-11.7,23.4,0,341,341,1691
2009,28,e) 4,1872,1913,18068,19694,44,2.1,326,15.9,2497,879,1618,4.5,12.7,5749,1964,3785,10,29.2,-3252,-16.5,25.4,0,266,266,1632
2009,28,f) 5,1711,1816,15867,16963,65,3.4,254,13.3,2035,426,1609,2.5,12,4226,1063,3163,6.3,24.9,-2191,-12.9,24,0,211,211,970
2009,28,g) 6 to 10,7067,7501,75629,79229,170,2.2,845,10.8,7853,1208,6645,1.5,9.9,15052,4932,10120,6.2,19,-7199,-9.1,19.8,0,621,626,3763
2009,28,h) 11 to 15,5163,5672,58202,61692,128,2.2,521,8.9,5802,1197,4605,1.9,9.4,12782,4583,8199,7.4,20.7,-6980,-11.3,18.8,0,396,396,2114
2009,28,i) 16 to 20,3591,4093,61029,63144,104,2.5,293,7,5443,1442,4001,2.3,8.6,9672,1375,8297,2.2,15.3,-4229,-6.7,17.2,0,226,226,1096
2009,28,j) 21 to 25,3527,4207,67414,69136,99,2.3,222,5.2,5892,1962,3930,2.8,8.5,9336,2128,7208,3.1,13.5,-3444,-5,17,0,156,156,1807
2009,28,k) 26+,3483,5178,103982,106736,246,4.7,269,5.2,10962,5612,5350,5.3,10.3,16470,3447,13023,3.2,15.4,-5508,-5.1,20.6,0,163,165,1126
2009,28,l) Left Censored,5365,14264,422755,431104,579,4.1,644,4.5,35178,11711,23467,2.7,8.2,51876,9637,42239,2.2,12,-16698,-3.8,16.4,0,144,155,1590
2009,29,a) 0,7616,7680,44901,22651,7506,195.5,0,0,44501,44501,0,196.5,196.5,0,0,0,0,0,44501,196.5,0,0,,,
2009,29,b) 1,6332,6401,40942,46291,18,0.2,2375,30.8,9362,162,9200,0.3,20.2,20059,11010,9049,23.8,43.3,-10697,-23.1,40.4,0,1920,1920,9893
2009,29,c) 2,5928,6030,38781,42317,215,3.3,1370,20.7,6936,603,6333,1.4,16.4,14007,7601,6406,18,33.1,-7071,-16.7,32.8,0,1098,1098,6853
2009,29,d) 3,5749,6050,45685,48672,199,3,1189,18.1,6448,930,5518,1.9,13.2,12422,5424,6998,11.1,25.5,-5974,-12.3,26.4,0,953,953,4658
2009,29,e) 4,5134,5299,41765,45701,161,2.8,981,17.2,5219,708,4511,1.5,11.4,13090,4739,8351,10.4,28.6,-7871,-17.2,22.8,0,774,774,4235
2009,29,f) 5,4505,4616,42058,44746,140,2.8,742,15.1,4879,588,4291,1.3,10.9,10254,4665,5589,10.4,22.9,-5375,-12,21.8,0,563,563,4195
2009,29,g) 6 to 10,17060,18128,174810,184926,497,2.6,2276,12,18857,2392,16465,1.3,10.2,39088,12863,26225,7,21.1,-20231,-10.9,20.4,0,1726,1729,10714
2009,29,h) 11 to 15,12689,13799,162289,170025,349,2.4,1318,9.2,17158,2782,14376,1.6,10.1,32629,8835,23794,5.2,19.2,-15471,-9.1,20.2,0,956,957,6545
2009,29,i) 16 to 20,9140,10716,138920,145764,282,2.6,843,7.7,13182,3991,9191,2.7,9,26869,7097,19772,4.9,18.4,-13687,-9.4,18,0,530,530,3780
2009,29,j) 21 to 25,8663,11173,191686,196044,317,2.8,659,5.8,18950,6345,12605,3.2,9.7,27666,5628,22038,2.9,14.1,-8716,-4.4,19.4,0,426,428,2419
2009,29,k) 26+,7939,12878,291412,296624,429,3.3,591,4.6,26648,7012,19636,2.4,9,37071,8230,28841,2.8,12.5,-10423,-3.5,18,0,335,338,2070
2009,29,l) Left Censored,12570,31878,1136372,1157291,1310,4.1,1663,5.2,94691,23943,70748,2.1,8.2,136528,28280,108248,2.4,11.8,-41837,-3.6,16.4,0,394,403,3964
2009,30,a) 0,1992,1994,7786,4000,1937,194.3,0,0,7573,7573,0,189.3,189.3,0,0,0,0,0,7573,189.3,0,0,,,
2009,30,b) 1,1806,1836,8998,9730,10,0.5,673,30.5,1738,64,1674,0.7,17.9,3201,1695,1506,17.4,32.9,-1463,-15,35.8,0,458,458,1271
2009,30,c) 2,1715,1734,8445,9215,69,3.6,441,22.7,1323,278,1045,3,14.4,2863,1294,1569,14,31.1,-1540,-16.7,28.8,0,290,290,900
2009,30,d) 3,1720,1786,15913,16284,58,2.9,405,20.5,2134,232,1902,1.4,13.1,2876,1149,1727,7.1,17.7,-742,-4.6,26.2,0,258,258,832
2009,30,e) 4,1470,1485,8650,9651,38,2.4,265,16.6,1019,117,902,1.2,10.6,3020,907,2113,9.4,31.3,-2001,-20.7,21.2,0,194,194,711
2009,30,f) 5,1309,1356,8085,8780,46,3.2,236,16.2,910,125,785,1.4,10.4,2300,852,1448,9.7,26.2,-1390,-15.8,20.8,0,140,140,562
2009,30,g) 6 to 10,4737,4899,34820,37206,119,2.3,612,11.9,3392,485,2907,1.3,9.1,8163,2264,5899,6.1,21.9,-4771,-12.8,18.2,0,383,383,1725
2009,30,h) 11 to 15,3561,3711,30049,31671,93,2.4,341,8.9,3252,401,2851,1.3,10.3,6495,1829,4666,5.8,20.5,-3243,-10.2,20.6,0,201,201,953
2009,30,i) 16 to 20,2137,2329,23070,24484,67,2.8,179,7.5,1866,286,1580,1.2,7.6,4694,1418,3276,5.8,19.2,-2828,-11.6,15.2,0,104,104,541
2009,30,j) 21 to 25,1750,2068,30503,31495,54,2.5,164,7.7,2333,354,1979,1.1,7.4,4317,798,3519,2.5,13.7,-1984,-6.3,14.8,0,97,97,621
2009,30,k) 26+,1943,2791,42092,43098,95,3.4,151,5.3,4395,902,3493,2.1,10.2,6407,654,5753,1.5,14.9,-2012,-4.7,20.4,0,89,89,377
2009,30,l) Left Censored,2530,5265,119397,120850,177,3.3,220,4.2,9162,1488,7674,1.2,7.6,12068,2272,9796,1.9,10,-2906,-2.4,15.2,0,53,53,400
2009,31,a) 0,2384,2399,12836,6471,2347,195.7,0,0,12731,12731,0,196.7,196.7,0,0,0,0,0,12731,196.7,0,0,,,
2009,31,b) 1,2079,2101,12248,14321,3,0.1,561,23.2,2926,19,2907,0.1,20.4,7072,2197,4875,15.3,49.4,-4146,-29,40.8,0,426,426,1976
2009,31,c) 2,1957,1995,12520,13382,69,3.2,350,16.4,1980,287,1693,2.1,14.8,3704,1634,2070,12.2,27.7,-1724,-12.9,29.6,0,256,256,1353
2009,31,d) 3,1867,1970,13924,14481,67,3.2,261,12.6,1823,191,1632,1.3,12.6,2937,1163,1774,8,20.3,-1114,-7.7,25.2,0,197,197,1020
2009,31,e) 4,1641,1664,11261,11692,57,3.2,252,14.3,1623,303,1320,2.6,13.9,2485,1132,1353,9.7,21.3,-862,-7.4,27.8,0,190,190,939
2009,31,f) 5,1486,1515,12204,12622,44,2.8,178,11.2,1448,274,1174,2.2,11.5,2283,816,1467,6.5,18.1,-835,-6.6,23,0,139,139,665
2009,31,g) 6 to 10,6068,6400,64881,67130,173,2.6,629,9.5,6164,1022,5142,1.5,9.2,10661,3465,7196,5.2,15.9,-4497,-6.7,18.4,0,432,435,2603
2009,31,h) 11 to 15,4554,5005,57173,59130,130,2.5,382,7.4,5817,1326,4491,2.2,9.8,9731,2895,6836,4.9,16.5,-3914,-6.7,19.6,0,252,252,2067
2009,31,i) 16 to 20,3306,3802,50306,51735,90,2.3,238,6.1,4466,901,3565,1.7,8.6,7324,1509,5815,2.9,14.2,-2858,-5.6,17.2,0,159,159,1178
2009,31,j) 21 to 25,2989,3664,73764,74930,75,2,207,5.6,5748,2342,3406,3.1,7.7,8080,1617,6463,2.2,10.8,-2332,-3.1,15.4,0,144,144,1216
2009,31,k) 26+,3223,4889,91217,93195,185,3.8,223,4.5,9783,3188,6595,3.4,10.5,13739,4143,9596,4.4,14.7,-3956,-4.2,21,0,122,126,735
2009,31,l) Left Censored,5489,11214,363912,367457,391,3.5,530,4.7,30546,6479,24067,1.8,8.3,37635,9380,28255,2.6,10.2,-7089,-1.9,16.6,0,145,145,1220
2009,32,a) 0,4441,4500,30943,15606,4421,196.5,0,0,30675,30675,0,196.6,196.6,0,0,0,0,0,30675,196.6,0,0,,,
2009,32,b) 1,3782,3836,33580,35213,13,0.3,1540,32.9,10464,199,10265,0.6,29.7,13729,6742,6987,19.1,39,-3265,-9.3,59.4,0,1263,1263,5813
2009,32,c) 2,3213,3281,29195,32893,95,2.5,1026,27.2,5094,320,4774,1,15.5,12489,6717,5772,20.4,38,-7395,-22.5,31,0,866,866,6174
2009,32,d) 3,3052,3185,29484,34177,112,3.2,804,22.7,4012,834,3178,2.4,11.7,13397,3883,9514,11.4,39.2,-9385,-27.5,23.4,0,639,639,3302
2009,32,e) 4,2591,2729,27182,29993,95,3.2,582,19.5,3496,645,2851,2.2,11.7,9117,3413,5704,11.4,30.4,-5621,-18.7,23.4,0,475,475,3017
2009,32,f) 5,2186,2266,27041,30094,84,3.4,438,17.9,2340,430,1910,1.4,7.8,8446,2259,6187,7.5,28.1,-6106,-20.3,15.6,0,353,353,1885
2009,32,g) 6 to 10,7564,8108,118432,127097,302,3.5,1185,13.8,17014,2611,14403,2.1,13.4,34344,10091,24253,7.9,27,-17330,-13.6,26.8,0,907,912,7535
2009,32,h) 11 to 15,4419,5076,83257,91554,199,3.8,607,11.5,6710,1695,5015,1.9,7.3,23304,3874,19430,4.2,25.5,-16594,-18.2,14.6,0,446,459,2969
2009,32,i) 16 to 20,2607,3281,60187,67983,128,3.8,310,9.2,4653,1240,3413,1.8,6.8,20244,3075,17169,4.5,29.8,-15591,-23,13.6,0,184,184,1429
2009,32,j) 21 to 25,2017,2956,64315,68209,142,4.7,208,6.9,5694,1824,3870,2.7,8.3,13482,2360,11122,3.5,19.8,-7788,-11.5,16.6,0,117,123,1093
2009,32,k) 26+,2170,3911,118267,122588,246,6.3,279,7.1,14115,4876,9239,4,11.5,22756,4423,18333,3.6,18.6,-8641,-7.1,23,0,107,107,1623
2009,32,l) Left Censored,3030,9349,416379,435853,680,7.3,653,7,34443,13975,20468,3.2,7.9,73390,10331,63059,2.4,16.8,-38947,-8.9,15.8,0,56,64,747
2009,33,a) 0,1729,1740,9251,4662,1707,196.2,0,0,9178,9178,0,196.9,196.9,0,0,0,0,0,9178,196.9,0,0,,,
2009,33,b) 1,1634,1647,12449,12843,4,0.2,497,25.8,2489,40,2449,0.3,19.4,3276,1696,1580,13.2,25.5,-787,-6.1,38.8,0,402,402,1522
2009,33,c) 2,1417,1431,9099,9722,34,2.2,318,20.1,1261,148,1113,1.5,13,2507,1082,1425,11.1,25.8,-1246,-12.8,26,0,247,247,951
2009,33,d) 3,1487,1570,12286,13096,47,2.8,295,17.3,1396,198,1198,1.5,10.7,3015,1356,1659,10.4,23,-1619,-12.3,21.4,0,230,230,1074
2009,33,e) 4,1284,1313,10240,10999,32,2.3,227,16,1200,156,1044,1.4,10.9,2717,1168,1549,10.6,24.7,-1517,-13.8,21.8,0,180,180,854
2009,33,f) 5,1158,1184,7858,8425,39,3.1,186,14.7,878,163,715,1.9,10.4,2011,840,1171,10,23.9,-1133,-13.5,20.8,0,148,148,691
2009,33,g) 6 to 10,4467,4660,42304,44603,138,2.8,572,11.7,4188,592,3596,1.3,9.4,8785,3018,5767,6.8,19.7,-4597,-10.3,18.8,0,411,411,2459
2009,33,h) 11 to 15,3813,4032,39418,41061,106,2.5,385,9.2,3242,370,2872,0.9,7.9,6527,1953,4574,4.8,15.9,-3285,-8,15.8,0,259,259,1455
2009,33,i) 16 to 20,2616,2879,36650,38317,76,2.6,230,7.8,2979,413,2566,1.1,7.8,6312,1074,5238,2.8,16.5,-3333,-8.7,15.6,0,144,144,777
2009,33,j) 21 to 25,2649,3136,52327,55443,107,3.3,220,6.9,3783,1017,2766,1.8,6.8,10015,2468,7547,4.5,18.1,-6232,-11.3,13.6,0,136,136,793
2009,33,k) 26+,1973,2894,57156,58378,112,3.8,165,5.6,5491,1790,3701,3.1,9.4,7934,1154,6780,2,13.6,-2443,-4.2,18.8,0,89,89,502
2009,33,l) Left Censored,3294,7313,266004,269905,363,4.9,484,6.6,22585,4912,17673,1.8,8.4,30387,5607,24780,2.1,11.3,-7802,-2.9,16.8,0,80,85,671
2009,34,a) 0,12650,12718,65982,33479,12399,195,0,0,65007,65007,0,194.2,194.2,0,0,0,0,0,65007,194.2,0,0,,,
2009,34,b) 1,10897,10971,70747,83006,12,0.1,4004,30.3,14625,93,14532,0.1,17.6,39142,15275,23867,18.4,47.2,-24517,-29.6,35.2,0,3123,3123,13084
2009,34,c) 2,9955,10043,70707,76056,330,3,2397,21.5,11121,1034,10087,1.4,14.6,21818,10169,11649,13.4,28.7,-10697,-14.1,29.2,0,1887,1887,7511
2009,34,d) 3,9603,9898,73603,78529,320,3,1984,18.4,9813,1183,8630,1.5,12.5,19665,7651,12014,9.7,25,-9852,-12.5,25,0,1523,1523,5837
2009,34,e) 4,8674,8847,68111,72003,269,2.8,1600,16.7,10063,1910,8153,2.7,14,17846,7852,9994,10.9,24.8,-7783,-10.8,28,0,1244,1244,5630
2009,34,f) 5,7419,7527,62698,66552,184,2.3,1227,15.2,8252,812,7440,1.2,12.4,15960,7693,8267,11.6,24,-7708,-11.6,24.8,0,933,933,6441
2009,34,g) 6 to 10,29649,30796,310040,328122,844,2.6,4077,12.5,31819,4567,27252,1.4,9.7,67983,24013,43970,7.3,20.7,-36164,-11,19.4,0,3057,3065,19366
2009,34,h) 11 to 15,22321,23658,266453,284425,583,2.4,2400,9.7,23715,3485,20230,1.2,8.3,59659,17616,42043,6.2,21,-35944,-12.7,16.6,0,1667,1675,14475
2009,34,i) 16 to 20,15312,16369,209798,218113,407,2.4,1449,8.6,20113,4306,15807,2,9.2,36743,8736,28007,4,16.8,-16630,-7.6,18.4,0,991,991,5795
2009,34,j) 21 to 25,13677,16204,298465,307531,452,2.7,1245,7.5,26500,6570,19930,2.1,8.6,44631,10898,33733,3.5,14.5,-18131,-5.9,17.2,0,761,763,4869
2009,34,k) 26+,12507,16617,352306,362071,473,2.8,1027,6.1,33787,9752,24035,2.7,9.3,53317,8781,44536,2.4,14.7,-19530,-5.4,18.6,0,618,621,3426
2009,34,l) Left Censored,18554,42082,1547628,1582525,2369,5.6,2643,6.3,137688,44987,92701,2.8,8.7,207482,42012,165470,2.7,13.1,-69794,-4.4,17.4,0,710,727,6948
2009,35,a) 0,2376,2388,13170,6669,2329,195.1,0,0,13002,13002,0,195,195,0,0,0,0,0,13002,195,0,0,,,
2009,35,b) 1,2046,2093,13809,14461,9,0.4,792,31.2,3567,186,3381,1.3,24.7,4870,2682,2188,18.5,33.7,-1303,-9,49.4,0,612,612,2106
2009,35,c) 2,1936,1947,23512,23826,57,2.7,441,20.5,3559,190,3369,0.8,14.9,4187,1781,2406,7.5,17.6,-628,-2.7,29.8,0,348,348,1440
2009,35,d) 3,1838,1923,15699,16565,65,3.1,407,19.3,2419,544,1875,3.3,14.6,4151,1675,2476,10.1,25.1,-1732,-10.5,29.2,0,328,328,1355
2009,35,e) 4,1633,1691,12851,13740,40,2.2,263,14.6,1750,145,1605,1.1,12.7,3528,1138,2390,8.3,25.7,-1778,-13,25.4,0,196,196,914
2009,35,f) 5,1400,1474,13620,14617,54,3.5,228,14.6,1604,243,1361,1.7,11,3597,985,2612,6.7,24.6,-1993,-13.6,22,0,177,177,736
2009,35,g) 6 to 10,5452,5791,57662,61900,157,2.6,704,11.6,5514,936,4578,1.5,8.9,13990,5304,8686,8.6,22.6,-8476,-13.7,17.8,0,515,515,3888
2009,35,h) 11 to 15,4172,4541,61138,63264,148,3.2,451,9.6,5862,1598,4264,2.5,9.3,10114,2695,7419,4.3,16,-4252,-6.7,18.6,0,326,326,1667
2009,35,i) 16 to 20,2976,3466,42349,43934,92,2.6,251,7.1,4400,875,3525,2,10,7570,1393,6177,3.2,17.2,-3170,-7.2,20,0,183,183,965
2009,35,j) 21 to 25,2476,3182,57360,58941,72,2.2,177,5.5,4801,908,3893,1.5,8.1,7962,1475,6487,2.5,13.5,-3161,-5.4,16.2,0,114,114,1048
2009,35,k) 26+,2623,3912,69648,72000,108,2.7,197,5,5281,1275,4006,1.8,7.3,9985,1576,8409,2.2,13.9,-4704,-6.6,14.6,0,123,123,631
2009,35,l) Left Censored,3344,8297,228443,231681,431,5.2,393,4.7,22396,5927,16469,2.6,9.7,28872,5956,22916,2.6,12.5,-6476,-2.8,19.4,0,75,79,854
2009,36,a) 0,33647,33761,169274,86104,32998,195.5,0,0,166340,166340,0,193.2,193.2,0,0,0,0,0,166340,193.2,0,0,,,
2009,36,b) 1,27630,27882,169159,184030,45,0.1,8442,25.9,36833,330,36503,0.2,20,66574,28677,37897,15.6,36.2,-29741,-16.2,40,0,6383,6385,24462
2009,36,c) 2,23556,23705,145668,155324,815,3.1,5171,20,23667,2905,20762,1.9,15.2,42979,20435,22544,13.2,27.7,-19312,-12.5,30.4,0,4013,4013,17391
2009,36,d) 3,22062,22830,167632,176354,722,2.9,4122,16.8,23649,3670,19979,2.1,13.4,41092,17119,23973,9.7,23.3,-17443,-9.9,26.8,0,3185,3186,14013
2009,36,e) 4,19333,19761,159241,169694,513,2.4,3299,15.6,24971,3341,21630,2,14.7,45877,14324,31553,8.4,27,-20906,-12.3,29.4,0,2556,2556,12218
2009,36,f) 5,17104,17377,138353,145600,451,2.4,2585,14,17468,1846,15622,1.3,12,31961,11731,20230,8.1,22,-14493,-10,24,0,1961,1961,9614
2009,36,g) 6 to 10,64960,67261,672768,700911,1733,2.5,8085,11.5,76209,12138,64071,1.7,10.9,132494,42820,89674,6.1,18.9,-56285,-8,21.8,0,5928,5938,34423
2009,36,h) 11 to 15,45642,48400,551405,574083,1177,2.3,4493,9,57357,9207,48150,1.6,10,102713,26722,75991,4.7,17.9,-45356,-7.9,20,0,3128,3128,18948
2009,36,i) 16 to 20,32868,35597,428434,444829,803,2.2,2781,7.6,36987,6873,30114,1.5,8.3,69777,16212,53565,3.6,15.7,-32790,-7.4,16.6,0,1874,1880,11577
2009,36,j) 21 to 25,29778,34107,591337,604398,845,2.4,2178,6.3,44942,8559,36383,1.4,7.4,71063,16775,54288,2.8,11.8,-26121,-4.4,14.8,0,1389,1389,11483
2009,36,k) 26+,25968,36660,810050,828400,957,2.6,1907,5.1,62275,13753,48522,1.7,7.5,98975,16870,82105,2,11.9,-36700,-4.4,15,0,1171,1171,7340
2009,36,l) Left Censored,40820,88817,3331789,3393134,4429,5,5406,6.1,264543,78491,186052,2.3,7.8,387233,79118,308115,2.3,11.4,-122690,-3.6,15.6,0,1565,1612,15379
2009,37,a) 0,11321,11474,67865,34381,11193,195.1,0,0,66968,66968,0,194.8,194.8,0,0,0,0,0,66968,194.8,0,0,,,
2009,37,b) 1,10367,10564,67335,74266,35,0.3,3655,29,14430,494,13936,0.7,19.4,28292,15922,12370,21.4,38.1,-13862,-18.7,38.8,0,2880,2880,14011
2009,37,c) 2,9601,9728,61907,68913,287,2.6,2415,22.3,8853,1001,7852,1.5,12.8,22864,10298,12566,14.9,33.2,-14011,-20.4,25.6,0,1941,1941,8670
2009,37,d) 3,8900,9371,75885,81648,290,2.8,1906,18.6,9954,1297,8657,1.6,12.2,21480,8649,12831,10.6,26.3,-11526,-14.1,24.4,0,1475,1483,6978
2009,37,e) 4,7952,8167,67037,73342,178,2,1491,16.8,7908,1328,6580,1.8,10.8,20517,7575,12942,10.3,28,-12609,-17.2,21.6,0,1162,1162,6054
2009,37,f) 5,6706,6996,64102,69464,203,2.7,1165,15.5,7109,984,6125,1.4,10.2,17832,6111,11721,8.8,25.7,-10723,-15.5,20.4,0,912,912,4994
2009,37,g) 6 to 10,26245,28002,288551,306776,710,2.4,3585,12.1,30216,5972,24244,1.9,9.8,66666,19112,47554,6.2,21.7,-36450,-11.9,19.6,0,2659,2669,15038
2009,37,h) 11 to 15,18724,20841,263640,274316,575,2.7,2112,9.7,26103,4328,21775,1.6,9.5,47455,10871,36584,4,17.3,-21352,-7.8,19,0,1515,1515,7351
2009,37,i) 16 to 20,12533,14870,207753,218821,399,2.6,1242,8.1,16761,3950,12811,1.8,7.7,38897,8277,30620,3.8,17.8,-22136,-10.1,15.4,0,842,842,5610
2009,37,j) 21 to 25,12396,15669,288852,298307,398,2.5,1005,6.3,24856,8163,16693,2.7,8.3,43765,6801,36964,2.3,14.7,-18909,-6.4,16.6,0,667,667,3344
2009,37,k) 26+,10082,16603,375824,384533,577,3.4,958,5.7,39038,14442,24596,3.8,10.2,56455,12460,43995,3.2,14.7,-17417,-4.5,20.4,0,510,523,4185
2009,37,l) Left Censored,14612,45431,1521206,1565171,2663,5.9,2354,5.2,114512,39160,75352,2.5,7.3,202444,37540,164904,2.4,12.9,-87932,-5.6,14.6,0,506,527,3847
2009,38,a) 0,1049,1058,5918,2995,1029,194.5,0,0,5846,,,,195.2,0,0,0,0,0,5846,195.2,0,1,,,
2009,38,b) 1,902,918,5998,6331,3,0.3,220,21.1,1355,,,,21.4,2020,1040,980,16.4,31.9,-665,-10.5,42.8,1,145,145,883
2009,38,c) 2,813,825,6009,6711,23,2.6,168,18.7,1149,84,1065,1.3,17.1,2553,1597,956,23.8,38,-1404,-20.9,34.2,0,126,126,1454
2009,38,d) 3,790,847,6310,6695,34,3.8,118,13.3,752,100,652,1.5,11.2,1521,851,670,12.7,22.7,-769,-11.5,22.4,0,82,82,723
2009,38,e) 4,671,687,5313,5299,22,3.1,80,11.1,842,69,773,1.3,15.9,814,275,539,5.2,15.4,28,0.5,30.8,0,63,63,248
2009,38,f) 5,554,580,4964,5110,16,2.6,67,11,546,28,518,0.5,10.7,837,318,519,6.2,16.4,-291,-5.7,21.4,0,52,52,245
2009,38,g) 6 to 10,2269,2376,20781,21029,53,2.2,206,8.4,2675,525,2150,2.5,12.7,3170,1003,2167,4.8,15.1,-495,-2.4,25.4,0,136,136,762
2009,38,h) 11 to 15,1758,1869,20697,20710,52,2.7,140,7.3,2927,832,2095,4,14.1,2953,744,2209,3.6,14.3,-26,-0.2,28.2,0,82,82,471
2009,38,i) 16 to 20,1412,1528,17179,17966,33,2.1,114,7.3,1506,164,1342,0.9,8.4,3079,925,2154,5.1,17.1,-1573,-8.7,16.8,0,76,77,695
2009,38,j) 21 to 25,1333,1557,19798,20395,31,1.9,101,6.3,1714,257,1457,1.3,8.4,2908,550,2358,2.7,14.3,-1194,-5.9,16.8,0,65,65,346
2009,38,k) 26+,1549,2114,36606,36583,48,2.3,86,4,3837,711,3126,1.9,10.5,3791,570,3221,1.6,10.4,46,0.1,20.8,0,57,57,359
2009,38,l) Left Censored,2524,4811,140751,141528,161,3.3,208,4.3,11920,3266,8654,2.3,8.4,13474,3472,10002,2.5,9.5,-1554,-1.1,16.8,0,73,73,852
2009,39,a) 0,10098,10214,73654,37135,10004,195.9,0,0,73038,73038,0,196.7,196.7,0,0,0,0,0,73038,196.7,0,0,,,
2009,39,b) 1,9051,9227,74352,81266,48,0.4,2948,27.2,17457,373,17084,0.5,21.5,31284,16102,15182,19.8,38.5,-13827,-17,43,0,2356,2356,14331
2009,39,c) 2,8191,8363,66148,72129,267,2.9,1760,19.3,10340,1184,9156,1.6,14.3,22302,10474,11828,14.5,30.9,-11962,-16.6,28.6,0,1390,1390,7548
2009,39,d) 3,8216,8621,82366,87408,283,3.1,1505,16.3,11922,2045,9877,2.3,13.6,22006,9598,12408,11,25.2,-10084,-11.6,27.2,0,1193,1194,7699
2009,39,e) 4,7484,7762,78610,82080,221,2.7,1158,14.1,10779,1555,9224,1.9,13.1,17719,6333,11386,7.7,21.6,-6940,-8.5,26.2,0,912,912,5167
2009,39,f) 5,6570,6870,64285,67469,191,2.6,1050,14.4,7419,649,6770,1,11,13787,5311,8476,7.9,20.4,-6368,-9.4,22,0,816,816,4353
2009,39,g) 6 to 10,27083,29116,316479,332697,741,2.4,3448,11.3,31722,4127,27595,1.2,9.5,64158,22119,42039,6.6,19.3,-32436,-9.8,19,0,2493,2517,16463
2009,39,h) 11 to 15,22239,25015,288527,301105,790,3.1,2431,9.4,29146,7161,21985,2.4,9.7,54302,14770,39532,4.9,18,-25156,-8.3,19.4,0,1635,1680,9979
2009,39,i) 16 to 20,17052,20474,282124,289778,938,4.5,1591,7.6,34772,10206,24566,3.5,12,50079,11691,38388,4,17.3,-15307,-5.3,24,0,1054,1057,6593
2009,39,j) 21 to 25,15647,19707,342250,357503,488,2.4,1210,6,24120,5355,18765,1.5,6.7,54625,10910,43715,3.1,15.3,-30505,-8.6,13.4,0,785,786,6444
2009,39,k) 26+,15222,23605,512320,531275,737,3.1,1353,5.7,45381,15394,29987,2.9,8.5,83290,16275,67015,3.1,15.7,-37909,-7.2,17,0,678,772,5563
2009,39,l) Left Censored,25935,65829,2264491,2324869,2651,4,3705,5.6,190163,60016,130147,2.6,8.2,310919,63420,247499,2.7,13.4,-120756,-5.2,16.4,0,995,1019,15940
2009,40,a) 0,5031,5075,29670,15054,4969,195.8,0,0,29233,29233,0,194.2,194.2,0,0,0,0,0,29233,194.2,0,0,,,
2009,40,b) 1,4386,4446,31829,33121,12,0.2,1326,25.6,7979,45,7934,0.1,24.1,10562,6212,4350,18.8,31.9,-2583,-7.8,48.2,0,1066,1066,5260
2009,40,c) 2,3888,3939,32899,34643,119,2.8,789,18.4,5706,644,5062,1.9,16.5,9193,4186,5007,12.1,26.5,-3487,-10,33,0,642,642,3775
2009,40,d) 3,3618,3804,31624,33070,114,2.8,586,14.5,4079,460,3619,1.4,12.3,6971,2694,4277,8.1,21.1,-2892,-8.8,24.6,0,473,473,2200
2009,40,e) 4,3182,3306,35109,36822,123,3.5,442,12.7,4736,1410,3326,3.8,12.9,8162,3039,5123,8.3,22.2,-3426,-9.3,25.8,0,359,359,2477
2009,40,f) 5,2546,2622,23235,24711,77,2.8,367,13.2,2839,333,2506,1.3,11.5,5790,2311,3479,9.4,23.4,-2951,-11.9,23,0,297,297,2070
2009,40,g) 6 to 10,10736,11495,121026,126065,320,2.7,1145,9.6,14428,3821,10607,3,11.4,24505,9704,14801,7.7,19.4,-10077,-8,22.8,0,887,889,8604
2009,40,h) 11 to 15,7926,8811,88773,92088,224,2.5,700,7.7,9427,1335,8092,1.4,10.2,16056,3589,12467,3.9,17.4,-6629,-7.2,20.4,0,513,513,2602
2009,40,i) 16 to 20,5721,6682,88851,91159,236,3.5,476,7,10494,2144,8350,2.4,11.5,15110,4202,10908,4.6,16.6,-4616,-5.1,23,0,336,336,1935
2009,40,j) 21 to 25,5126,6276,108532,109089,170,2.7,323,5.1,11716,3340,8376,3.1,10.7,12830,2277,10553,2.1,11.8,-1114,-1.1,21.4,0,222,222,1189
2009,40,k) 26+,5621,8297,171448,176032,215,2.6,467,5.5,16037,4846,11191,2.8,9.1,25204,6018,19186,3.4,14.3,-9167,-5.2,18.2,0,257,263,3095
2009,40,l) Left Censored,6870,17605,516843,523580,719,4.1,755,4.3,42395,9529,32866,1.8,8.1,55869,13935,41934,2.7,10.7,-13474,-2.6,16.2,0,184,185,1873
2009,41,a) 0,6016,6043,28083,14171,5931,196.3,0,0,27824,27824,0,196.3,196.3,0,0,0,0,0,27824,196.3,0,0,,,
2009,41,b) 1,5486,5548,28049,31303,14,0.2,1990,29.9,5903,91,5812,0.3,18.9,12411,6036,6375,19.3,39.6,-6508,-20.7,37.8,0,1546,1546,4822
2009,41,c) 2,4923,4976,27952,31561,170,3,1284,23,4108,430,3678,1.4,13,11326,4570,6756,14.5,35.9,-7218,-22.9,26,0,995,995,3897
2009,41,d) 3,4751,5108,32717,35410,191,3.4,1095,19.6,4497,511,3986,1.4,12.7,9882,4268,5614,12.1,27.9,-5385,-15.2,25.4,0,843,843,3498
2009,41,e) 4,4117,4222,28086,30494,115,2.5,864,18.7,3498,347,3151,1.1,11.5,8313,3182,5131,10.4,27.3,-4815,-15.8,23,0,645,652,2570
2009,41,f) 5,3465,3582,28462,30808,102,2.7,581,15.1,2627,321,2306,1,8.5,7319,2126,5193,6.9,23.8,-4692,-15.3,17,0,426,426,1659
2009,41,g) 6 to 10,13729,14554,119948,129893,458,3,1939,12.6,11724,2339,9385,1.8,9,31614,10274,21340,7.9,24.3,-19890,-15.3,18,0,1330,1331,7126
2009,41,h) 11 to 15,10251,11137,127539,133959,297,2.6,1141,9.8,10966,2267,8699,1.7,8.2,23805,4911,18894,3.7,17.8,-12839,-9.6,16.4,0,765,765,3468
2009,41,i) 16 to 20,6764,7752,87803,94366,246,3.1,699,8.7,7792,1938,5854,2.1,8.3,20917,3838,17079,4.1,22.2,-13125,-13.9,16.6,0,459,460,2746
2009,41,j) 21 to 25,5462,6908,121757,127355,160,2.3,472,6.7,10083,2431,7652,1.9,7.9,21279,3451,17828,2.7,16.7,-11196,-8.8,15.8,0,287,287,1722
2009,41,k) 26+,5747,8596,170845,179786,229,2.6,444,5.1,12417,3212,9205,1.8,6.9,30299,3671,26628,2,16.9,-17882,-10,13.8,0,256,258,1354
2009,41,l) Left Censored,7068,18223,560841,575606,786,4.3,899,4.9,50096,12691,37405,2.2,8.7,79626,14923,64703,2.6,13.8,-29530,-5.1,17.4,0,170,171,1526
2009,42,a) 0,13087,13202,78673,39940,12946,196.1,0,0,77467,77467,0,194,194,0,0,0,0,0,77467,194,0,0,,,
2009,42,b) 1,11671,11843,82444,85945,37,0.3,3289,24.1,20605,546,20059,0.6,24,27607,15015,12592,17.5,32.1,-7002,-8.1,48,0,2490,2509,12929
2009,42,c) 2,10470,10581,74220,79070,321,2.8,2102,18.3,11496,1492,10004,1.9,14.5,21196,9923,11273,12.5,26.8,-9700,-12.3,29,0,1615,1615,8508
2009,42,d) 3,10297,10783,94334,98423,305,2.7,1660,14.5,13114,1098,12016,1.1,13.3,21292,8413,12879,8.5,21.6,-8178,-8.3,26.6,0,1265,1265,7047
2009,42,e) 4,9632,9953,86357,92231,272,2.6,1368,13,9977,1710,8267,1.9,10.8,21724,6832,14892,7.4,23.6,-11747,-12.8,21.6,0,1067,1067,5649
2009,42,f) 5,8233,8590,76679,80364,213,2.4,1095,12.1,8655,816,7839,1,10.8,16025,6651,9374,8.3,19.9,-7370,-9.1,21.6,0,838,838,5656
2009,42,g) 6 to 10,34329,36293,402914,418239,946,2.5,3573,9.5,43119,7649,35470,1.8,10.3,73769,23343,50426,5.6,17.6,-30650,-7.3,20.6,0,2579,2591,17459
2009,42,h) 11 to 15,25925,28486,363445,374300,678,2.3,2335,8,34421,5609,28812,1.5,9.2,56130,16027,40103,4.3,15,-21709,-5.8,18.4,0,1553,1591,11927
2009,42,i) 16 to 20,20225,22839,295511,305143,622,2.7,1571,6.7,28991,7431,21560,2.4,9.5,48255,11991,36264,3.9,15.8,-19264,-6.3,19,0,1024,1024,7705
2009,42,j) 21 to 25,19212,23512,427555,442131,651,2.7,1505,6.3,34507,9622,24885,2.2,7.8,63659,16713,46946,3.8,14.4,-29152,-6.6,15.6,0,879,892,6218
2009,42,k) 26+,17260,25626,575701,588091,708,2.7,1349,5.2,52369,16329,36040,2.8,8.9,77149,13438,63711,2.3,13.1,-24780,-4.2,17.8,0,763,780,5407
2009,42,l) Left Censored,28494,71352,2468076,2509006,3213,4.5,3588,5,192002,47785,144217,1.9,7.7,273862,62534,211328,2.5,10.9,-81860,-3.2,15.4,0,927,971,9041
2009,44,a) 0,1241,1252,6650,3364,1222,195.2,0,0,6573,,,,195.4,0,0,0,0,0,6573,195.4,0,1,,,
2009,44,b) 1,1176,1184,8034,8802,1,0.1,424,29.8,1304,,,,14.8,2840,1465,1375,16.6,32.3,-1536,-17.5,29.6,1,314,314,1274
2009,44,c) 2,1038,1045,9179,9484,40,3.4,253,21.8,1386,100,1286,1.1,14.6,1995,822,1173,8.7,21,-609,-6.4,29.2,0,195,195,670
2009,44,d) 3,1062,1119,7660,7909,61,5.1,223,18.5,1180,208,972,2.6,14.9,1678,680,998,8.6,21.2,-498,-6.3,29.8,0,163,163,524
2009,44,e) 4,969,977,6877,7126,33,3.1,185,17.5,1183,71,1112,1,16.6,1680,654,1026,9.2,23.6,-497,-7,33.2,0,148,148,516
2009,44,f) 5,914,935,8256,8983,27,2.7,158,15.7,1203,128,1075,1.4,13.4,2657,1463,1194,16.3,29.6,-1454,-16.2,26.8,0,120,120,1376
2009,44,g) 6 to 10,3459,3605,30512,31479,97,2.5,508,13.3,4683,1747,2936,5.5,14.9,6617,2337,4280,7.4,21,-1934,-6.1,29.8,0,356,356,1881
2009,44,h) 11 to 15,2647,2841,27535,29042,83,2.8,259,8.8,2601,268,2333,0.9,9,5615,1165,4450,4,19.3,-3014,-10.3,18,0,162,162,929
2009,44,i) 16 to 20,2082,2205,28576,29892,64,2.8,227,9.9,3244,534,2710,1.8,10.9,5875,1297,4578,4.3,19.7,-2631,-8.8,21.8,0,124,124,813
2009,44,j) 21 to 25,1948,2234,31678,34494,50,2.2,191,8.3,2620,401,2219,1.2,7.6,8251,4266,3985,12.4,23.9,-5631,-16.3,15.2,0,109,109,3310
2009,44,k) 26+,1766,2237,42272,43332,55,2.4,113,5,4559,748,3811,1.7,10.5,6679,947,5732,2.2,15.4,-2120,-4.9,21,0,72,72,443
2009,44,l) Left Censored,3350,5735,202957,206470,245,4.2,354,6.1,14369,3442,10927,1.7,7,21394,4646,16748,2.3,10.4,-7025,-3.4,14,0,112,113,628
2009,45,a) 0,5350,5495,40517,21046,5368,195.4,0,0,38943,38943,0,185,185,0,0,0,0,0,38943,185,0,0,,,
2009,45,b) 1,4693,4734,27638,31826,13,0.2,1706,30,5795,43,5752,0.1,18.2,14171,7219,6952,22.7,44.5,-8376,-26.3,36.4,0,1376,1376,6189
2009,45,c) 2,4431,4512,32059,36643,153,3,1225,24.2,4656,430,4226,1.2,12.7,13824,6795,7029,18.5,37.7,-9168,-25,25.4,0,997,997,4856
2009,45,d) 3,4086,4230,33509,36652,125,2.7,1022,21.8,4391,448,3943,1.2,12,10676,4420,6256,12.1,29.1,-6285,-17.1,24,0,752,816,3802
2009,45,e) 4,3798,3962,36056,38318,136,3.2,680,16,4474,914,3560,2.4,11.7,8997,3051,5946,8,23.5,-4523,-11.8,23.4,0,537,537,2398
2009,45,f) 5,3151,3265,28877,31393,85,2.4,514,14.7,2719,332,2387,1.1,8.7,7751,2680,5071,8.5,24.7,-5032,-16,17.4,0,411,411,2133
2009,45,g) 6 to 10,12792,13559,150325,161052,338,2.4,1722,12,14707,2450,12257,1.5,9.1,36161,10663,25498,6.6,22.5,-21454,-13.4,18.2,0,1272,1272,8192
2009,45,h) 11 to 15,8926,9770,125922,131638,271,2.7,1002,9.9,12089,2756,9333,2.1,9.2,23520,5340,18180,4.1,17.9,-11431,-8.7,18.4,0,717,717,3500
2009,45,i) 16 to 20,6013,7178,94941,99916,189,2.6,554,7.5,7803,1909,5894,1.9,7.8,17753,4063,13690,4.1,17.8,-9950,-10,15.6,0,385,385,1882
2009,45,j) 21 to 25,5840,7767,127281,131779,208,2.6,481,6.1,11659,3250,8409,2.5,8.8,20654,2946,17708,2.2,15.7,-8995,-6.9,17.6,0,337,337,1880
2009,45,k) 26+,4815,7780,154640,160530,237,3,484,6.1,15646,6222,9424,3.9,9.7,27426,5375,22051,3.3,17.1,-11780,-7.4,19.4,0,241,244,1600
2009,45,l) Left Censored,7391,21652,682160,703684,1111,5.1,1095,5.1,51008,16330,34678,2.3,7.2,94055,18008,76047,2.6,13.4,-43047,-6.2,14.4,0,244,260,2732
2009,46,a) 0,1341,1348,7154,3618,1326,196.7,0,0,7072,,,,195.5,0,0,0,0,0,7072,195.5,0,1,,,
2009,46,b) 1,1077,1086,6927,7419,2,0.2,321,25.2,1719,,,,23.2,2703,1820,883,24.5,36.4,-984,-13.2,46.4,1,245,245,1620
2009,46,c) 2,1068,1085,6988,7489,37,3.1,222,18.8,1096,138,958,1.8,14.6,2098,1283,815,17.1,28,-1002,-13.4,29.2,0,171,171,1156
2009,46,d) 3,1039,1069,8198,8697,34,3,155,13.6,1022,122,900,1.4,11.8,2020,714,1306,8.2,23.2,-998,-11.4,23.6,0,118,118,647
2009,46,e) 4,797,813,4904,5155,19,2.2,137,15.6,693,52,641,1,13.4,1195,545,650,10.6,23.2,-502,-9.8,26.8,0,106,106,440
2009,46,f) 5,780,809,6159,6367,25,2.9,104,12.2,740,54,686,0.8,11.6,1156,306,850,4.8,18.2,-416,-6.6,23.2,0,72,72,246
2009,46,g) 6 to 10,3239,3389,29866,30786,73,2.1,321,9.1,3526,451,3075,1.5,11.5,5365,1856,3509,6,17.4,-1839,-5.9,23,0,224,224,1418
2009,46,h) 11 to 15,2414,2557,26191,27633,80,3,220,8.4,2373,456,1917,1.7,8.6,5257,1779,3478,6.4,19,-2884,-10.4,17.2,0,132,132,829
2009,46,i) 16 to 20,1619,1763,19751,20224,38,2.1,135,7.4,1814,159,1655,0.8,9,2759,628,2131,3.1,13.6,-945,-4.6,18,0,84,84,367
2009,46,j) 21 to 25,1439,1684,22908,23357,43,2.5,86,5.1,1827,290,1537,1.2,7.8,2724,446,2278,1.9,11.7,-897,-3.9,15.6,0,56,56,299
2009,46,k) 26+,1467,2067,32560,32595,57,2.7,87,4.2,3918,1932,1986,5.9,12,3987,862,3125,2.6,12.2,-69,-0.2,24,0,53,53,265
2009,46,l) Left Censored,2621,5082,154106,154672,172,3.4,206,4,12604,2977,9627,1.9,8.1,13735,1684,12051,1.1,8.9,-1131,-0.8,16.2,0,69,69,415
2009,47,a) 0,6401,6557,40224,20305,6456,196.9,0,0,39839,39839,0,196.2,196.2,0,0,0,0,0,39839,196.2,0,0,,,
2009,47,b) 1,5925,6042,38718,45662,32,0.4,2027,28.4,8195,181,8014,0.4,17.9,22082,11712,10370,25.6,48.4,-13887,-30.5,35.8,0,1721,1721,10692
2009,47,c) 2,5219,5365,38352,42565,187,3.1,1311,22,6478,1312,5166,3.1,15.2,14903,7427,7476,17.4,35,-8425,-19.8,30.4,0,1123,1123,6530
2009,47,d) 3,4826,5083,46345,50252,156,2.8,1083,19.5,5624,537,5087,1.1,11.2,13437,5995,7442,11.9,26.7,-7813,-15.5,22.4,0,901,901,4841
2009,47,e) 4,4296,4460,45036,47653,133,2.8,760,15.9,5799,1052,4747,2.2,12.2,11033,3979,7054,8.3,23.2,-5234,-11,24.4,0,620,626,3252
2009,47,f) 5,3744,3964,36101,42950,147,3.5,637,15.1,4159,651,3508,1.5,9.7,17857,3287,14570,7.7,41.6,-13698,-31.9,19.4,0,509,520,2921
2009,47,g) 6 to 10,14338,15652,182823,192428,397,2.4,1827,11.2,21181,3740,17441,1.9,11,40391,11704,28687,6.1,21,-19210,-10,22,0,1419,1421,9691
2009,47,h) 11 to 15,11272,12569,149295,159906,346,2.7,1108,8.5,14398,2898,11500,1.8,9,35620,9405,26215,5.9,22.3,-21222,-13.3,18,0,854,854,8018
2009,47,i) 16 to 20,8174,10104,161159,167669,361,3.5,751,7.3,19019,5532,13487,3.3,11.3,32038,5119,26919,3.1,19.1,-13019,-7.8,22.6,0,501,501,3393
2009,47,j) 21 to 25,8138,10296,186103,192332,299,2.9,575,5.5,18122,5584,12538,2.9,9.4,30579,5555,25024,2.9,15.9,-12457,-6.5,18.8,0,398,398,2888
2009,47,k) 26+,7088,12167,276439,289571,446,3.6,665,5.4,25109,7313,17796,2.5,8.7,51373,6024,45349,2.1,17.7,-26264,-9,17.4,0,291,298,1669
2009,47,l) Left Censored,10490,30810,1105680,1134943,1454,4.7,1750,5.6,87842,27159,60683,2.4,7.7,146368,28729,117639,2.5,12.9,-58526,-5.2,15.4,0,339,356,4166
2009,48,a) 0,31818,32182,217675,110026,31642,196.6,0,0,215298,215298,0,195.7,195.7,0,0,0,0,0,215298,195.7,0,0,,,
2009,48,b) 1,27010,27537,221857,237730,118,0.4,8251,25.7,50275,1788,48487,0.8,21.1,82021,39370,42651,16.6,34.5,-31746,-13.4,42.2,0,6808,6808,33999
2009,48,c) 2,23475,23928,202482,216001,697,2.7,5142,19.6,36879,4117,32762,1.9,17.1,63916,30048,33868,13.9,29.6,-27037,-12.5,34.2,0,4278,4279,26452
2009,48,d) 3,21315,22581,218771,230357,681,2.8,3657,15.2,32178,4189,27989,1.8,14,55350,20896,34454,9.1,24,-23172,-10,28,0,2987,2987,17527
2009,48,e) 4,18494,19614,233552,244438,528,2.5,2855,13.7,33225,6875,26350,2.8,13.6,54996,20049,34947,8.2,22.5,-21771,-8.9,27.2,0,2329,2329,16455
2009,48,f) 5,16245,16991,184138,193719,436,2.4,2279,12.7,23534,2726,20808,1.4,12.1,42695,15964,26731,8.2,22,-19161,-9.9,24.2,0,1856,1856,14255
2009,48,g) 6 to 10,60876,66282,851580,886363,1981,2.9,7228,10.5,97476,16948,80528,1.9,11,167042,50770,116272,5.7,18.8,-69566,-7.8,22,0,5500,5535,37886
2009,48,h) 11 to 15,43043,48801,712646,737228,1539,3.1,4207,8.4,92824,21432,71392,2.9,12.6,141988,36359,105629,4.9,19.3,-49164,-6.7,25.2,0,2982,2983,24787
2009,48,i) 16 to 20,30109,36406,604883,632957,1230,3.3,2720,7.3,60305,16853,43452,2.7,9.5,116452,24147,92305,3.8,18.4,-56147,-8.9,19,0,1807,1817,12325
2009,48,j) 21 to 25,24864,34034,685559,711638,1176,3.4,1999,5.8,67563,17929,49634,2.5,9.5,119720,22626,97094,3.2,16.8,-52157,-7.3,19,0,1242,1247,10723
2009,48,k) 26+,25456,42269,911862,936153,1475,3.5,2354,5.5,92310,31358,60952,3.3,9.9,140892,28214,112678,3,15.1,-48582,-5.2,19.8,0,1302,1312,8776
2009,48,l) Left Censored,25957,100931,3742028,3771850,6435,6.4,6047,6,410843,139430,271413,3.7,10.9,470486,104507,365979,2.8,12.5,-59643,-1.6,21.8,0,903,1050,9823
2009,49,a) 0,4816,4849,26093,13242,4727,195,0,0,25703,,,,194.1,0,0,0,0,0,25703,194.1,0,1,,,
2009,49,b) 1,4163,4227,26889,29078,12,0.2,1944,36.6,6607,,,,22.7,10984,6114,4870,21,37.8,-4377,-15.1,45.4,1,1462,1462,4741
2009,49,c) 2,3856,3900,26179,29127,144,3.2,1275,28.4,4593,597,3996,2,15.8,10488,5216,5272,17.9,36,-5895,-20.2,31.6,0,944,944,4317
2009,49,d) 3,3493,3624,27824,30811,145,3.6,884,22,4541,735,3806,2.4,14.7,10515,5160,5355,16.7,34.1,-5974,-19.4,29.4,0,682,682,3619
2009,49,e) 4,2910,2990,28052,30121,93,2.8,611,18.7,3693,469,3224,1.6,12.3,7830,2940,4890,9.8,26,-4137,-13.7,24.6,0,450,450,2413
2009,49,f) 5,2450,2518,23554,25119,84,3.1,477,17.5,3995,262,3733,1,15.9,7124,2441,4683,9.7,28.4,-3129,-12.5,31.8,0,361,361,2102
2009,49,g) 6 to 10,9267,9652,116546,119206,256,2.5,1298,12.7,20199,1734,18465,1.5,16.9,25519,8265,17254,6.9,21.4,-5320,-4.5,33.8,0,875,878,6807
2009,49,h) 11 to 15,5764,6292,95978,102503,244,3.7,666,10.2,8520,1735,6785,1.7,8.3,21569,4888,16681,4.8,21,-13049,-12.7,16.6,0,425,425,3715
2009,49,i) 16 to 20,3325,3794,80562,85416,99,2.5,288,7.4,6209,951,5258,1.1,7.3,15916,2100,13816,2.5,18.6,-9707,-11.3,14.6,0,185,185,1233
2009,49,j) 21 to 25,2380,3253,79686,82738,106,3.2,193,5.8,8543,1827,6716,2.2,10.3,14646,2786,11860,3.4,17.7,-6103,-7.4,20.6,0,98,98,1151
2009,49,k) 26+,2660,4061,94632,97240,147,3.6,249,6.1,8471,2844,5627,2.9,8.7,13686,2316,11370,2.4,14.1,-5215,-5.4,17.4,0,126,126,862
2009,49,l) Left Censored,3631,10483,420546,425653,781,7.5,581,5.6,40703,13831,26872,3.2,9.6,50916,13904,37012,3.3,12,-10213,-2.4,19.2,0,103,103,1321
2009,50,a) 0,933,938,7211,3625,916,195.3,0,0,7173,7173,0,197.9,197.9,0,0,0,0,0,7173,197.9,0,0,,,
2009,50,b) 1,820,825,4955,5280,0,0,282,28.5,968,0,968,0,18.3,1617,903,714,17.1,30.6,-649,-12.3,36.6,0,205,205,745
2009,50,c) 2,824,837,8042,8139,27,3,169,18.6,1298,60,1238,0.7,15.9,1491,539,952,6.6,18.3,-193,-2.4,31.8,0,124,124,432
2009,50,d) 3,770,787,4560,4749,30,3.6,129,15.4,588,69,519,1.5,12.4,966,334,632,7,20.3,-378,-7.9,24.8,0,100,100,295
2009,50,e) 4,659,669,4263,4554,25,3.5,109,15.2,500,54,446,1.2,11,1081,414,667,9.1,23.7,-581,-12.7,22,0,74,74,324
2009,50,f) 5,639,655,4126,4432,16,2.3,110,15.6,430,57,373,1.3,9.7,1042,508,534,11.5,23.5,-612,-13.8,19.4,0,78,78,429
2009,50,g) 6 to 10,2701,2772,25301,25777,77,2.7,302,10.4,2564,235,2329,0.9,9.9,3516,1026,2490,4,13.6,-952,-3.7,19.8,0,188,191,721
2009,50,h) 11 to 15,2138,2296,18307,19300,56,2.3,221,9.3,1340,193,1147,1,6.9,3326,973,2353,5,17.2,-1986,-10.3,13.8,0,143,146,746
2009,50,i) 16 to 20,1793,1930,17972,18338,57,2.9,138,7,1875,337,1538,1.8,10.2,2606,570,2036,3.1,14.2,-731,-4,20.4,0,77,77,387
2009,50,j) 21 to 25,1593,1795,37356,38394,38,2.1,139,7.5,2534,132,2402,0.3,6.6,4609,2092,2517,5.4,12,-2075,-5.4,13.2,0,78,78,366
2009,50,k) 26+,1359,1820,30899,31734,65,3.5,108,5.9,2938,989,1949,3.1,9.3,4608,726,3882,2.3,14.5,-1670,-5.2,18.6,0,61,61,398
2009,50,l) Left Censored,2029,3746,100838,103111,220,5.9,186,5,6265,1854,4411,1.8,6.1,10811,2030,8781,2,10.5,-4546,-4.4,12.2,0,47,47,423
2009,51,a) 0,10185,10284,58543,29611,10088,196.2,0,0,57865,57865,0,195.4,195.4,0,0,0,0,0,57865,195.4,0,0,,,
2009,51,b) 1,9057,9177,56759,62525,23,0.2,3030,27.9,12939,372,12567,0.6,20.7,24470,13465,11005,21.5,39.1,-11531,-18.4,41.4,0,2397,2398,11111
2009,51,c) 2,8175,8260,55322,59305,294,3.2,1945,21.3,10341,1038,9303,1.8,17.4,18307,9361,8946,15.8,30.9,-7966,-13.5,34.8,0,1536,1536,7828
2009,51,d) 3,7971,8379,66916,70510,253,2.8,1569,17.3,9165,1388,7777,2,13,16353,6939,9414,9.8,23.2,-7188,-10.2,26,0,1267,1267,5393
2009,51,e) 4,7057,7260,57210,60737,224,2.9,1210,15.6,8428,1140,7288,1.9,13.9,15481,5671,9810,9.3,25.5,-7053,-11.6,27.8,0,949,949,4687
2009,51,f) 5,6105,6271,54626,57242,175,2.6,987,14.8,7852,1140,6712,2,13.7,13084,5126,7958,9,22.9,-5232,-9.2,27.4,0,754,754,4325
2009,51,g) 6 to 10,22658,24180,256908,266403,665,2.6,2854,11.3,30743,4777,25966,1.8,11.5,49733,14923,34810,5.6,18.7,-18990,-7.2,23,0,2048,2054,11606
2009,51,h) 11 to 15,16964,18521,242552,252355,500,2.6,1653,8.6,23733,4714,19019,1.9,9.4,43339,10660,32679,4.2,17.2,-19606,-7.8,18.8,0,1162,1163,7380
2009,51,i) 16 to 20,12120,14054,210588,218537,351,2.4,1111,7.7,22285,6608,15677,3,10.2,38182,7392,30790,3.4,17.5,-15897,-7.3,20.4,0,712,712,4334
2009,51,j) 21 to 25,11008,14085,261201,266196,356,2.5,820,5.7,26870,8629,18241,3.2,10.1,36859,6507,30352,2.4,13.8,-9989,-3.7,20.2,0,490,490,2889
2009,51,k) 26+,8985,14266,316355,324495,484,3.4,753,5.2,28123,9186,18937,2.8,8.7,44402,9160,35242,2.8,13.7,-16279,-5,17.4,0,422,428,2577
2009,51,l) Left Censored,12899,41020,1377469,1400178,2881,7.1,2200,5.4,130991,50973,80018,3.6,9.4,176409,36797,139612,2.6,12.6,-45418,-3.2,18.8,0,373,387,4538
2009,53,a) 0,10192,10270,48019,24339,10014,195,0,0,47361,47361,0,194.6,194.6,0,0,0,0,0,47361,194.6,0,0,,,
2009,53,b) 1,9332,9429,52278,57575,37,0.3,3668,31.9,11837,446,11391,0.8,20.6,22430,12647,9783,22,39,-10593,-18.4,41.2,0,2823,2823,10450
2009,53,c) 2,8364,8466,50419,55166,300,3.2,2302,24.2,9485,1103,8382,2,17.2,18978,9223,9755,16.7,34.4,-9493,-17.2,34.4,0,1761,1761,7292
2009,53,d) 3,8032,8342,58380,63053,263,2.9,1857,20.2,8147,814,7333,1.3,12.9,17492,7693,9799,12.2,27.7,-9345,-14.8,25.8,0,1408,1408,6393
2009,53,e) 4,6903,7137,51658,55817,253,3.3,1317,17.1,6519,981,5538,1.8,11.7,14837,5801,9036,10.4,26.6,-8318,-14.9,23.4,0,1001,1003,4129
2009,53,f) 5,5766,5914,44526,48773,168,2.6,983,15.5,4930,802,4128,1.6,10.1,13424,5268,8156,10.8,27.5,-8494,-17.4,20.2,0,701,701,4212
2009,53,g) 6 to 10,22471,23895,223929,237635,799,3.2,3046,12.1,24297,5057,19240,2.1,10.2,51709,13486,38223,5.7,21.8,-27412,-11.6,20.4,0,2110,2110,10572
2009,53,h) 11 to 15,16123,17572,194228,204544,521,2.9,1761,9.7,18865,4033,14832,2,9.2,39497,9622,29875,4.7,19.3,-20632,-10.1,18.4,0,1173,1173,6727
2009,53,i) 16 to 20,11194,12730,159822,170136,374,2.9,1069,8.2,14731,2380,12351,1.4,8.7,35358,7284,28074,4.3,20.8,-20627,-12.1,17.4,0,686,686,4252
2009,53,j) 21 to 25,8792,11236,213033,218463,346,3,729,6.4,17325,4714,12611,2.2,7.9,28184,4294,23890,2,12.9,-10859,-5,15.8,0,460,460,2362
2009,53,k) 26+,8491,12970,304803,311201,415,3.2,807,6.1,28618,7701,20917,2.5,9.2,41415,8558,32857,2.7,13.3,-12797,-4.1,18.4,0,420,422,2384
2009,53,l) Left Censored,10412,28908,972114,988001,1591,5.5,1657,5.7,117820,24636,93184,2.5,11.9,149595,25994,123601,2.6,15.1,-31775,-3.2,23.8,0,303,318,5013
2009,54,a) 0,1544,1552,9891,4985,1529,197,0,0,9812,9812,0,196.8,196.8,0,0,0,0,0,9812,196.8,0,0,,,
2009,54,b) 1,1381,1404,9740,10320,4,0.2,434,26.3,2238,16,2222,0.2,21.7,3398,1693,1705,16.4,32.9,-1160,-11.2,43.4,0,347,347,1514
2009,54,c) 2,1293,1302,10771,10901,45,3.2,262,18.5,2206,340,1866,3.1,20.2,2466,1029,1437,9.4,22.6,-260,-2.4,40.4,0,216,216,920
2009,54,d) 3,1333,1431,13645,13850,51,3.3,265,17.2,2405,270,2135,1.9,17.4,2814,1144,1670,8.3,20.3,-409,-2.9,34.8,0,211,211,936
2009,54,e) 4,1282,1326,10390,11033,33,2.3,194,13.8,1108,121,987,1.1,10,2393,843,1550,7.6,21.7,-1285,-11.7,20,0,151,151,670
2009,54,f) 5,1076,1155,10094,10380,44,3.6,162,13.4,1554,158,1396,1.5,15,2126,975,1151,9.4,20.5,-572,-5.5,30,0,139,139,915
2009,54,g) 6 to 10,4108,4353,40378,42500,93,2.1,449,9.9,4276,480,3796,1.1,10.1,8520,2453,6067,5.8,20,-4244,-9.9,20.2,0,342,342,1790
2009,54,h) 11 to 15,3410,3784,37135,38625,97,2.5,312,8,3566,566,3000,1.5,9.2,6546,1767,4779,4.6,16.9,-2980,-7.7,18.4,0,234,234,1282
2009,54,i) 16 to 20,2615,2953,34295,34987,69,2.3,233,7.7,3653,549,3104,1.6,10.4,5036,1146,3890,3.3,14.4,-1383,-4,20.8,0,167,167,768
2009,54,j) 21 to 25,2543,3096,53996,54211,65,2.1,171,5.4,5844,1745,4099,3.2,10.8,6274,1126,5148,2.1,11.6,-430,-0.8,21.6,0,113,115,569
2009,54,k) 26+,2582,3966,67366,67593,97,2.4,180,4.5,7037,772,6265,1.1,10.4,7491,1497,5994,2.2,11.1,-454,-0.7,20.8,0,104,104,677
2009,54,l) Left Censored,4389,9992,272561,274462,524,5.3,376,3.8,23346,7424,15922,2.7,8.5,27148,3352,23796,1.2,9.9,-3802,-1.4,17,0,135,135,616
2009,55,a) 0,6017,6054,36253,18511,5917,195.5,0,0,35485,35485,0,191.7,191.7,0,0,0,0,0,35485,191.7,0,0,,,
2009,55,b) 1,5321,5410,36279,38999,27,0.4,1642,26,8085,254,7831,0.7,20.7,13524,8355,5169,21.4,34.7,-5439,-14,41.4,0,1259,1264,7347
2009,55,c) 2,5030,5095,37816,40640,171,3.1,1106,19.8,5468,558,4910,1.4,13.5,11116,5041,6075,12.4,27.4,-5648,-13.9,27,0,845,845,4226
2009,55,d) 3,4953,5267,45211,47410,164,2.9,886,15.7,5991,837,5154,1.8,12.6,10389,4263,6126,9,21.9,-4398,-9.3,25.2,0,701,701,3737
2009,55,e) 4,4422,4523,35829,37248,159,3.3,711,14.8,4810,607,4203,1.6,12.9,7648,3153,4495,8.5,20.5,-2838,-7.6,25.8,0,525,525,2571
2009,55,f) 5,3812,3974,37378,39509,97,2.3,560,13.3,4119,423,3696,1.1,10.4,8381,3046,5335,7.7,21.2,-4262,-10.8,20.8,0,417,417,2549
2009,55,g) 6 to 10,16405,17546,178549,186813,439,2.4,1848,10.1,17264,2268,14996,1.2,9.2,33791,9543,24248,5.1,18.1,-16527,-8.9,18.4,0,1287,1288,7405
2009,55,h) 11 to 15,12863,14012,159534,167616,361,2.5,1276,8.8,13548,2467,11081,1.5,8.1,29711,6833,22878,4.1,17.7,-16163,-9.6,16.2,0,839,839,5012
2009,55,i) 16 to 20,9695,10933,145016,150917,265,2.4,811,7.2,10972,1805,9167,1.2,7.3,22773,5141,17632,3.4,15.1,-11801,-7.8,14.6,0,523,527,3254
2009,55,j) 21 to 25,8432,10648,187512,193402,249,2.3,614,5.7,15017,3395,11622,1.8,7.8,26796,5137,21659,2.7,13.9,-11779,-6.1,15.6,0,384,385,2199
2009,55,k) 26+,7954,11962,255684,260494,310,2.6,635,5.2,23118,5469,17649,2.1,8.9,32737,6118,26619,2.3,12.6,-9619,-3.7,17.8,0,328,328,2941
2009,55,l) Left Censored,13931,31894,1201542,1231640,1336,4.2,1510,4.7,76971,20273,56698,1.6,6.2,137167,28111,109056,2.3,11.1,-60196,-4.9,12.4,0,411,416,5128
2009,56,a) 0,1232,1254,5907,2978,1235,197,0,0,5859,,,,196.7,0,0,0,0,0,5859,196.7,0,1,,,
2009,56,b) 1,1064,1073,5527,5832,1,0.1,358,28.1,1286,,,,22.1,1895,912,983,15.6,32.5,-609,-10.4,44.2,1,261,261,663
2009,56,c) 2,1038,1047,5892,6487,50,4.4,234,20.4,879,142,737,2.2,13.6,2068,799,1269,12.3,31.9,-1189,-18.3,27.2,0,188,188,675
2009,56,d) 3,972,1016,6808,7445,29,2.7,172,15.8,913,129,784,1.7,12.3,2187,808,1379,10.9,29.4,-1274,-17.1,24.6,0,131,131,722
2009,56,e) 4,791,810,5274,5823,20,2.3,144,16.5,648,65,583,1.1,11.1,1746,604,1142,10.4,30,-1098,-18.9,22.2,0,116,116,539
2009,56,f) 5,635,646,4035,4230,20,2.9,99,14.5,577,47,530,1.1,13.6,966,349,617,8.3,22.8,-389,-9.2,27.2,0,75,75,306
2009,56,g) 6 to 10,2775,2857,22231,22978,78,2.6,266,9,3212,347,2865,1.5,14,4706,1356,3350,5.9,20.5,-1494,-6.5,28,0,186,186,1007
2009,56,h) 11 to 15,1926,2041,17809,18362,65,3.1,169,8.1,1785,337,1448,1.8,9.7,2890,853,2037,4.6,15.7,-1105,-6,19.4,0,112,112,637
2009,56,i) 16 to 20,1226,1310,16613,16956,41,3.1,88,6.6,1849,297,1552,1.8,10.9,2535,761,1774,4.5,15,-686,-4.1,21.8,0,53,53,225
2009,56,j) 21 to 25,1017,1205,17399,17710,30,2.5,53,4.4,1351,261,1090,1.5,7.6,1973,347,1626,2,11.1,-622,-3.5,15.2,0,36,36,246
2009,56,k) 26+,1290,1770,27976,28429,53,3,90,5,2777,394,2383,1.4,9.8,3682,671,3011,2.4,13,-905,-3.2,19.6,0,57,58,297
2009,56,l) Left Censored,1601,3156,72308,73887,150,4.7,158,5,7078,1221,5857,1.7,9.6,10236,2124,8112,2.9,13.9,-3158,-4.3,19.2,0,40,40,559
2010,01,a) 0,4358,4445,29991,15078,4383,197.2,0,0,29826,29826,0,197.8,197.8,0,0,0,0,0,29826,197.8,0,0,,,
2010,01,b) 1,3670,3886,25125,28213,138,3.1,1171,26.2,5842,585,5257,2.1,20.7,12017,7372,4645,26.1,42.6,-6175,-21.9,41.4,0,941,941,6430
2010,01,c) 2,3639,3721,26590,27554,131,3.2,846,20.8,5097,455,4642,1.7,18.5,7025,3711,3314,13.5,25.5,-1928,-7,37,0,708,708,3155
2010,01,d) 3,3595,3678,29861,31321,125,3.2,699,17.6,4551,623,3928,2,14.5,7470,3177,4293,10.1,23.8,-2919,-9.3,29,0,580,580,2813
2010,01,e) 4,3200,3402,27917,28915,96,2.6,542,14.9,3978,635,3343,2.2,13.8,5974,2658,3316,9.2,20.7,-1996,-6.9,27.6,0,449,451,2375
2010,01,f) 5,2958,3075,29142,30263,91,2.8,422,13.1,4389,486,3903,1.6,14.5,6630,3063,3567,10.1,21.9,-2241,-7.4,29,0,329,338,2755
2010,01,g) 6 to 10,11395,12209,131833,134959,318,2.5,1273,10,15116,2836,12280,2.1,11.2,21368,6664,14704,4.9,15.8,-6252,-4.6,22.4,0,993,996,5524
2010,01,h) 11 to 15,9131,10116,115630,122324,273,2.6,926,8.9,12028,2751,9277,2.2,9.8,25416,10862,14554,8.9,20.8,-13388,-11,19.6,0,689,690,8494
2010,01,i) 16 to 20,6443,7420,107647,108091,207,2.7,542,7.1,13218,3195,10023,3,12.2,14105,3631,10474,3.4,13,-887,-0.8,24.4,0,391,391,2695
2010,01,j) 21 to 25,5398,7057,141143,143037,267,3.8,382,5.4,11848,3127,8721,2.2,8.3,15635,3049,12586,2.1,10.9,-3787,-2.6,16.6,0,266,266,1316
2010,01,k) 26+,6869,10442,206921,210200,312,3,474,4.5,18129,5714,12415,2.7,8.6,24686,4608,20078,2.2,11.7,-6557,-3.1,17.2,0,274,275,2801
2010,01,l) Left Censored,7654,22160,685297,695699,895,4,1001,4.5,52901,11439,41462,1.6,7.6,73704,14609,59095,2.1,10.6,-20803,-3,15.2,0,241,255,2336
2010,02,a) 0,972,988,4763,2441,953,192.9,0,0,4644,4644,0,190.2,190.2,0,0,0,0,0,4644,190.2,0,0,,,
2010,02,b) 1,771,795,4613,4711,3,0.3,249,26.6,1034,15,1019,0.3,21.9,1229,676,553,14.3,26.1,-195,-4.2,43.8,0,165,165,527
2010,02,c) 2,749,778,4634,4814,46,5.5,155,18.6,1002,166,836,3.4,20.8,1361,785,576,16.3,28.3,-359,-7.5,41.6,0,105,105,632
2010,02,d) 3,706,722,4795,4823,39,5.2,100,13.2,864,120,744,2.5,17.9,919,474,445,9.8,19.1,-55,-1.2,35.8,0,67,67,383
2010,02,e) 4,645,678,5549,5743,34,4.8,107,15,999,118,881,2.1,17.4,1387,589,798,10.3,24.2,-388,-6.8,34.8,0,79,79,481
2010,02,f) 5,540,556,4201,4216,29,5,72,12.5,726,111,615,2.6,17.2,756,270,486,6.4,17.9,-30,-0.7,34.4,0,45,45,205
2010,02,g) 6 to 10,2417,2543,27083,26679,123,4.7,232,8.9,4592,786,3806,2.9,17.2,3784,888,2896,3.3,14.2,808,3,28.4,0,140,140,538
2010,02,h) 11 to 15,1737,1896,21662,22040,92,4.8,159,8.2,2533,412,2121,1.9,11.5,3288,878,2410,4,14.9,-755,-3.4,23,0,91,91,535
2010,02,i) 16 to 20,1251,1358,12572,12526,58,4.2,96,7,1669,175,1494,1.4,13.3,1576,551,1025,4.4,12.6,93,0.7,25.2,0,53,53,375
2010,02,j) 21 to 25,1006,1172,22638,22743,35,2.9,73,6.1,2158,164,1994,0.7,9.5,2368,297,2071,1.3,10.4,-210,-0.9,19,0,36,44,195
2010,02,k) 26+,1337,2107,44463,44693,79,3.7,86,4.1,5542,1143,4399,2.6,12.4,6001,762,5239,1.7,13.4,-459,-1,24.8,0,45,45,265
2010,02,l) Left Censored,1250,3248,94124,94269,157,4.9,119,3.7,8372,1418,6954,1.5,8.9,8662,1349,7313,1.4,9.2,-290,-0.3,17.8,0,15,15,60
2010,04,a) 0,7574,7688,60996,30810,7503,195.2,0,0,60372,60372,0,195.9,195.9,0,0,0,0,0,60372,195.9,0,0,,,
2010,04,b) 1,5925,6012,47645,50704,26,0.4,2118,29.5,10965,454,10511,0.9,21.6,17083,9351,7732,18.4,33.7,-6118,-12.1,43.2,0,1694,1694,8039
2010,04,c) 2,6161,6357,46449,49423,265,3.8,1568,22.4,8084,1070,7014,2.2,16.4,14032,6959,7073,14.1,28.4,-5948,-12,32.8,0,1237,1237,5979
2010,04,d) 3,5607,5740,43333,46527,226,3.6,1271,20.2,6568,1016,5552,2.2,14.1,12956,7137,5819,15.3,27.8,-6388,-13.7,28.2,0,995,995,6019
2010,04,e) 4,5483,5698,49222,51301,235,3.8,1118,18.2,8631,1353,7278,2.6,16.8,12788,5996,6792,11.7,24.9,-4157,-8.1,33.6,0,909,909,5080
2010,04,f) 5,4474,4692,42122,44419,158,3.1,807,16.1,6158,1113,5045,2.5,13.9,10751,4564,6187,10.3,24.2,-4593,-10.3,27.8,0,600,601,3860
2010,04,g) 6 to 10,16304,17481,191514,200485,719,3.9,2375,13,24658,6677,17981,3.3,12.3,42600,13763,28837,6.9,21.2,-17942,-8.9,24.6,0,1736,1736,10519
2010,04,h) 11 to 15,10892,12087,160311,167179,528,4.2,1376,11,19313,5000,14313,3,11.6,33048,9393,23655,5.6,19.8,-13735,-8.2,23.2,0,943,952,6817
2010,04,i) 16 to 20,6850,8164,128828,132732,316,3.8,672,8,14036,4358,9678,3.3,10.6,21843,4280,17563,3.2,16.5,-7807,-5.9,21.2,0,456,456,3289
2010,04,j) 21 to 25,5488,8301,164833,170571,345,4.1,539,6.4,14405,5737,8668,3.4,8.4,25881,4431,21450,2.6,15.2,-11476,-6.8,16.8,0,306,320,2179
2010,04,k) 26+,5971,10163,244783,250805,466,4.5,706,6.9,24436,7238,17198,2.9,9.7,36480,11395,25085,4.5,14.5,-12044,-4.8,19.4,0,274,292,1798
2010,04,l) Left Censored,5741,22650,853282,861422,1479,6.5,1366,6,95112,29383,65729,3.4,11,111392,24562,86830,2.9,12.9,-16280,-1.9,22,0,138,153,1179
2010,05,a) 0,3130,3185,21761,10985,3121,196,0,0,21552,21552,0,196.2,196.2,0,0,0,0,0,21552,196.2,0,0,,,
2010,05,b) 1,2514,2603,18575,19355,11,0.4,799,26.3,4029,246,3783,1.3,20.8,5588,3505,2083,18.1,28.9,-1559,-8.1,41.6,0,627,627,2946
2010,05,c) 2,2484,2508,17593,18597,85,3.1,516,19,2941,269,2672,1.4,15.8,4948,2064,2884,11.1,26.6,-2007,-10.8,31.6,0,415,415,1718
2010,05,d) 3,2271,2314,17724,17931,81,3.3,410,16.6,2986,387,2599,2.2,16.7,3399,1575,1824,8.8,19,-413,-2.3,33.4,0,325,325,1339
2010,05,e) 4,2262,2454,19038,19587,93,3.6,334,13,2792,847,1945,4.3,14.3,3889,1697,2192,8.7,19.9,-1097,-5.6,28.6,0,271,271,1398
2010,05,f) 5,2006,2077,15756,16392,78,3.6,268,12.3,1917,219,1698,1.3,11.7,3189,1357,1832,8.3,19.5,-1272,-7.8,23.4,0,195,195,999
2010,05,g) 6 to 10,7799,8317,72651,74596,235,2.7,788,9.2,8473,1415,7058,1.9,11.4,12363,4789,7574,6.4,16.6,-3890,-5.2,22.8,0,610,610,4193
2010,05,h) 11 to 15,5752,6526,64449,65094,198,3,528,7.9,8147,2363,5784,3.6,12.5,9437,3090,6347,4.7,14.5,-1290,-2,25,0,331,331,2417
2010,05,i) 16 to 20,4218,4791,52707,53471,125,2.6,307,6.3,6159,2064,4095,3.9,11.5,7687,1824,5863,3.4,14.4,-1528,-2.9,23,0,221,221,1215
2010,05,j) 21 to 25,3185,4151,82022,82746,126,3,242,5.8,7138,2308,4830,2.8,8.6,8585,2075,6510,2.5,10.4,-1447,-1.8,17.2,0,167,167,1382
2010,05,k) 26+,4521,6434,128633,128603,192,3,306,4.7,14208,3579,10629,2.8,11,14148,2796,11352,2.2,11,60,0,22,0,183,184,1135
2010,05,l) Left Censored,5188,13882,448099,452425,611,4.4,563,4.1,36349,7807,28542,1.7,8,45001,7788,37213,1.7,9.9,-8652,-1.9,16,0,134,136,2297
2010,06,a) 0,49119,49873,282732,142549,49075,196.8,0,0,280367,280367,0,196.7,196.7,0,0,0,0,0,280367,196.7,0,0,,,
2010,06,b) 1,39163,39622,261917,282790,104,0.2,12724,27.2,56847,1305,55542,0.5,20.1,98592,57695,40897,20.4,34.9,-41745,-14.8,40.2,0,9711,9723,48417
2010,06,c) 2,38376,39103,272666,285038,1619,3.8,8489,19.9,50076,7430,42646,2.6,17.6,74819,36606,38213,12.8,26.2,-24743,-8.6,35.2,0,6618,6628,29603
2010,06,d) 3,35167,35628,256821,271966,1460,3.8,6878,17.9,40879,5795,35084,2.1,15,71169,37450,33719,13.8,26.2,-30290,-11.2,30,0,5295,5295,32471
2010,06,e) 4,34816,36289,300783,313551,1401,3.6,5883,15.2,42224,7051,35173,2.2,13.5,67760,27178,40582,8.7,21.6,-25536,-8.1,27,0,4451,4458,21826
2010,06,f) 5,29913,31915,279909,295977,1173,3.5,4752,14.1,39024,5849,33175,2,13.2,71160,34699,36461,11.7,24,-32136,-10.8,26.4,0,3538,3546,25711
2010,06,g) 6 to 10,110534,116709,1172431,1224268,4197,3.4,14196,11.6,143337,30734,112603,2.5,11.7,247010,86003,161007,7,20.2,-103673,-8.5,23.4,0,10138,10141,65028
2010,06,h) 11 to 15,71828,78907,988029,1021115,2710,3.3,7635,9.4,109279,24004,85275,2.4,10.7,175451,53684,121767,5.3,17.2,-66172,-6.5,21.4,0,5151,5181,37534
2010,06,i) 16 to 20,49027,56424,829553,853491,1915,3.3,4621,8,79064,15849,63215,1.9,9.3,126940,34642,92298,4.1,14.9,-47876,-5.6,18.6,0,3157,3165,26310
2010,06,j) 21 to 25,43291,55188,1074371,1096935,1869,3.3,3860,6.9,92037,20394,71643,1.9,8.4,137166,32436,104730,3,12.5,-45129,-4.1,16.8,0,2413,2419,16578
2010,06,k) 26+,49229,75777,1705219,1719910,2714,3.5,4389,5.7,182639,53237,129402,3.1,10.6,212020,56489,155531,3.3,12.3,-29381,-1.7,21.2,0,2290,2329,16875
2010,06,l) Left Censored,41017,131847,4868333,4955626,6649,5,7383,5.6,438840,129209,309631,2.6,8.9,613426,123344,490082,2.5,12.4,-174586,-3.5,17.8,0,1489,1526,19336
2010,08,a) 0,9087,9156,49587,25140,8972,196,0,0,48895,48895,0,194.5,194.5,0,0,0,0,0,48895,194.5,0,0,,,
2010,08,b) 1,6866,6920,40906,44271,14,0.2,2374,28.8,8718,108,8610,0.2,19.7,15448,9836,5612,22.2,34.9,-6730,-15.2,39.4,0,1715,1715,8373
2010,08,c) 2,6866,6931,42843,45264,315,4.1,1672,21.9,7257,1428,5829,3.2,16,12099,6501,5598,14.4,26.7,-4842,-10.7,32,0,1236,1241,5380
2010,08,d) 3,6277,6342,45051,47369,311,4.5,1308,19.1,6971,1569,5402,3.3,14.7,11606,5542,6064,11.7,24.5,-4635,-9.8,29.4,0,958,958,4640
2010,08,e) 4,5976,6174,44353,46433,288,4.4,1105,16.8,6430,997,5433,2.1,13.8,10589,4489,6100,9.7,22.8,-4159,-9,27.6,0,764,764,3495
2010,08,f) 5,5395,5541,47350,49098,217,3.7,931,15.8,6596,766,5830,1.6,13.4,10091,3807,6284,7.8,20.6,-3495,-7.2,26.8,0,653,653,3192
2010,08,g) 6 to 10,20174,21080,177752,184872,866,3.9,2707,12.3,22138,4687,17451,2.5,12,36378,13368,23010,7.2,19.7,-14240,-7.7,24,0,1757,1757,10386
2010,08,h) 11 to 15,13758,15065,163134,169486,594,3.8,1595,10.2,17702,3501,14201,2.1,10.4,30405,8388,22017,4.9,17.9,-12703,-7.5,20.8,0,935,935,5031
2010,08,i) 16 to 20,9126,10362,140219,142780,406,3.8,877,8.3,13941,3012,10929,2.1,9.8,19062,4840,14222,3.4,13.4,-5121,-3.6,19.6,0,531,531,3264
2010,08,j) 21 to 25,6501,8250,138340,142143,281,3.3,569,6.8,12433,3386,9047,2.4,8.7,20038,5844,14194,4.1,14.1,-7605,-5.4,17.4,0,299,305,3107
2010,08,k) 26+,7651,11870,263223,264084,426,3.5,760,6.3,33238,6809,26429,2.6,12.6,34960,8966,25994,3.4,13.2,-1722,-0.6,25.2,0,305,306,2082
2010,08,l) Left Censored,7366,22470,768028,779774,1446,6.5,1289,5.8,79839,26109,53730,3.3,10.2,103331,19528,83803,2.5,13.3,-23492,-3.1,20.4,0,187,187,1373
2010,09,a) 0,3765,3837,24384,12261,3762,196.1,0,0,24247,24247,0,197.8,197.8,0,0,0,0,0,24247,197.8,0,0,,,
2010,09,b) 1,3047,3058,20820,22664,6,0.2,853,24.1,4779,37,4742,0.2,21.1,8467,4828,3639,21.3,37.4,-3688,-16.3,42.2,0,642,643,3834
2010,09,c) 2,3107,3155,21502,21769,104,3.1,611,17.9,4060,796,3264,3.7,18.7,4593,2219,2374,10.2,21.1,-533,-2.4,37.4,0,467,468,1820
2010,09,d) 3,2700,2731,20419,21575,114,3.9,504,17.2,3025,691,2334,3.2,14,5336,2539,2797,11.8,24.7,-2311,-10.7,28,0,390,390,2114
2010,09,e) 4,2786,2969,24537,25421,121,3.9,436,14,3167,429,2738,1.7,12.5,4935,1623,3312,6.4,19.4,-1768,-6.9,25,0,315,315,1125
2010,09,f) 5,2490,2558,23338,24202,78,2.9,366,13.5,2987,523,2464,2.2,12.3,4715,2412,2303,10,19.5,-1728,-7.2,24.6,0,274,274,2149
2010,09,g) 6 to 10,9791,10261,103306,105883,341,3.2,1124,10.5,11409,1785,9624,1.7,10.8,16562,5560,11002,5.3,15.6,-5153,-4.8,21.6,0,802,802,4329
2010,09,h) 11 to 15,7949,8508,100774,103272,265,3,702,8,9174,1669,7505,1.6,8.9,14170,3760,10410,3.6,13.7,-4996,-4.8,17.8,0,478,478,3035
2010,09,i) 16 to 20,6244,6797,80912,82302,172,2.5,455,6.6,7733,1588,6145,1.9,9.4,10513,2190,8323,2.7,12.8,-2780,-3.4,18.8,0,312,312,1786
2010,09,j) 21 to 25,6090,7139,117363,118472,249,3.4,448,6.2,9977,2733,7244,2.3,8.4,12195,3076,9119,2.6,10.3,-2218,-1.9,16.8,0,275,276,1874
2010,09,k) 26+,6718,9334,167372,170349,302,3.2,480,5.1,15423,4131,11292,2.4,9.1,21377,5684,15693,3.3,12.5,-5954,-3.4,18.2,0,261,263,2813
2010,09,l) Left Censored,9613,20019,732159,740364,801,4,1030,5.1,59173,12967,46206,1.8,8,75583,13498,62085,1.8,10.2,-16410,-2.2,16,0,293,294,3403
2010,10,a) 0,1131,1137,7963,4000,1118,196.7,0,0,7926,,,,198.2,0,0,0,0,0,7926,198.2,0,1,,,
2010,10,b) 1,931,944,7327,7804,2,0.2,272,24.8,1547,,,,19.8,2501,1077,1424,13.8,32,-954,-12.2,39.6,1,224,224,938
2010,10,c) 2,952,971,6758,7374,39,3.7,191,18.3,1025,111,914,1.5,13.9,2256,1537,719,20.8,30.6,-1231,-16.7,27.8,0,153,153,1446
2010,10,d) 3,780,815,6904,6952,31,3.6,134,15.5,1125,368,757,5.3,16.2,1220,553,667,8,17.5,-95,-1.3,32.4,0,91,91,464
2010,10,e) 4,808,826,6692,6716,25,2.9,118,13.6,800,77,723,1.1,11.9,847,321,526,4.8,12.6,-47,-0.7,23.8,0,89,89,276
2010,10,f) 5,733,742,5614,5775,37,4.8,101,13.1,767,129,638,2.2,13.3,1088,341,747,5.9,18.8,-321,-5.5,26.6,0,76,76,298
2010,10,g) 6 to 10,2894,3006,28214,28689,110,3.5,362,11.6,4337,1553,2784,5.4,15.1,5286,1729,3557,6,18.4,-949,-3.3,30.2,0,281,281,1503
2010,10,h) 11 to 15,2048,2228,23640,24599,82,3.6,227,9.9,2238,302,1936,1.2,9.1,4156,1201,2955,4.9,16.9,-1918,-7.8,18.2,0,148,148,526
2010,10,i) 16 to 20,1458,1639,21068,21400,62,3.7,129,7.7,2189,535,1654,2.5,10.2,2853,788,2065,3.7,13.3,-664,-3.1,20.4,0,87,87,269
2010,10,j) 21 to 25,1302,1561,21211,21556,38,2.4,91,5.7,1802,585,1217,2.7,8.4,2491,614,1877,2.8,11.6,-689,-3.2,16.8,0,47,47,364
2010,10,k) 26+,1440,2007,43884,44471,76,3.7,119,5.9,3459,878,2581,2,7.8,4633,1179,3454,2.7,10.4,-1174,-2.6,15.6,0,52,52,317
2010,10,l) Left Censored,2528,5594,178873,183213,285,5,407,7.2,13474,3343,10131,1.8,7.4,22154,5603,16551,3.1,12.1,-8680,-4.7,14.8,0,45,45,401
2010,11,a) 0,947,963,7460,3745,949,197.1,0,0,7431,,,,198.4,0,0,0,0,0,7431,198.4,0,1,,,
2010,11,b) 1,709,709,6293,6502,1,0.1,176,21.9,1530,,,,23.5,1948,663,1285,10.2,30,-418,-6.5,47,1,131,131,531
2010,11,c) 2,663,671,6017,6085,24,3.3,118,16.4,1094,360,734,5.9,18,1229,606,623,10,20.2,-135,-2.2,36,0,92,92,416
2010,11,d) 3,673,680,6216,6221,28,3.9,93,13.1,1055,87,968,1.4,17,1065,466,599,7.5,17.1,-10,-0.1,34,0,70,70,274
2010,11,e) 4,656,672,6450,6620,23,3.3,79,11.3,999,76,923,1.1,15.1,1338,466,872,7,20.2,-339,-5.1,30.2,0,61,62,401
2010,11,f) 5,796,814,7747,8120,20,2.4,82,9.7,861,58,803,0.7,10.6,1606,675,931,8.3,19.8,-745,-9.2,21.2,0,64,64,635
2010,11,g) 6 to 10,2124,2219,32963,33537,63,2.8,195,8.5,3857,580,3277,1.7,11.5,5005,1277,3728,3.8,14.9,-1148,-3.4,23,0,143,143,1048
2010,11,h) 11 to 15,1864,2049,36627,37093,90,4.3,146,7,4402,1661,2741,4.5,11.9,5334,1122,4212,3,14.4,-932,-2.5,23.8,0,96,96,713
2010,11,i) 16 to 20,1361,1526,30783,31256,68,4.4,93,6,3012,781,2231,2.5,9.6,3957,527,3430,1.7,12.7,-945,-3.1,19.2,0,63,63,213
2010,11,j) 21 to 25,1216,1429,27301,27056,74,5.2,77,5.4,2965,681,2284,2.5,11,2475,478,1997,1.8,9.1,490,1.9,18.2,0,51,51,184
2010,11,k) 26+,1730,2291,81569,80668,151,6.6,141,6.2,9409,1264,8145,1.6,11.7,7607,1646,5961,2,9.4,1802,2.3,18.8,0,52,52,295
2010,11,l) Left Censored,2846,5898,226295,228153,457,7.8,418,7.1,21224,6783,14441,3,9.3,24940,5601,19339,2.5,10.9,-3716,-1.6,18.6,0,56,56,1150
2010,12,a) 0,34043,34458,203872,102987,33722,195.7,0,0,201771,201771,0,195.9,195.9,0,0,0,0,0,201771,195.9,0,0,,,
2010,12,b) 1,24477,24715,168927,172847,51,0.2,8562,29.1,47222,1134,46088,0.7,27.3,55062,34105,20957,19.7,31.9,-7840,-4.6,54.6,0,6799,6799,29629
2010,12,c) 2,23121,23416,148768,154270,1149,4.5,5698,22.2,33024,4382,28642,2.8,21.4,44028,24614,19414,16,28.5,-11004,-7.1,42.8,0,4535,4535,21726
2010,12,d) 3,21109,21567,148431,160765,1105,4.7,4565,19.6,20826,3955,16871,2.5,13,45494,18120,27374,11.3,28.3,-24668,-15.3,26,0,3478,3478,15351
2010,12,e) 4,20139,20677,135241,147272,1131,5.1,3834,17.5,24711,4646,20065,3.2,16.8,48772,23304,25468,15.8,33.1,-24061,-16.3,33.6,0,2894,2894,20162
2010,12,f) 5,18247,18925,156427,160537,908,4.5,3510,17.4,23588,4755,18833,3,14.7,31807,13712,18095,8.5,19.8,-8219,-5.1,29.4,0,2563,2564,10617
2010,12,g) 6 to 10,65209,68095,582650,604544,2850,4,9308,13.1,87956,21065,66891,3.5,14.5,131743,47644,84099,7.9,21.8,-43787,-7.3,29,0,6637,6643,36689
2010,12,h) 11 to 15,40736,44424,535897,553476,1794,3.9,4634,10.1,66958,27973,38985,5.1,12.1,102116,26249,75867,4.7,18.4,-35158,-6.3,24.2,0,3063,3070,17546
2010,12,i) 16 to 20,28795,32934,443824,455766,1122,3.3,2920,8.6,57774,12290,45484,2.7,12.7,81658,30212,51446,6.6,17.9,-23884,-5.2,25.4,0,1912,1920,13316
2010,12,j) 21 to 25,21452,27836,548814,546377,1113,3.9,2001,7.1,73219,12840,60379,2.4,13.4,68345,16572,51773,3,12.5,4874,0.9,25,0,1242,1252,9029
2010,12,k) 26+,21174,34068,710881,723686,1365,4,1996,5.8,74261,23716,50545,3.3,10.3,99870,28315,71555,3.9,13.8,-25609,-3.5,20.6,0,978,983,9250
2010,12,l) Left Censored,17830,71962,2607463,2619799,4172,5.8,4583,6.4,259872,76331,183541,2.9,9.9,284545,63091,221454,2.4,10.9,-24673,-1,19.8,0,628,656,7531
2010,13,a) 0,12168,12295,69956,35527,12059,196.2,0,0,68859,68859,0,193.8,193.8,0,0,0,0,0,68859,193.8,0,0,,,
2010,13,b) 1,9460,9818,69743,73986,246,2.1,3224,28.1,16860,1502,15358,2,22.8,25345,14422,10923,19.5,34.3,-8485,-11.5,45.6,0,2586,2586,12673
2010,13,c) 2,9655,9819,64361,70692,388,3.6,2312,21.5,10866,1529,9337,2.2,15.4,23528,14804,8724,20.9,33.3,-12662,-17.9,30.8,0,1809,1809,12283
2010,13,d) 3,8930,9106,63811,67169,412,4.2,1821,18.5,11275,1955,9320,2.9,16.8,17991,9752,8239,14.5,26.8,-6716,-10,33.6,0,1388,1388,7944
2010,13,e) 4,8102,8448,68361,72758,328,3.6,1545,17.1,9379,1534,7845,2.1,12.9,18173,8474,9699,11.6,25,-8794,-12.1,25.8,0,1173,1173,6039
2010,13,f) 5,7297,7766,71365,74290,419,5.1,1181,14.5,9566,2307,7259,3.1,12.9,15416,6560,8856,8.8,20.8,-5850,-7.9,25.8,0,903,903,5117
2010,13,g) 6 to 10,27304,28925,328100,328581,985,3.3,3573,11.8,53897,8551,45346,2.6,16.4,54859,17987,36872,5.5,16.7,-962,-0.3,32.8,0,2553,2553,13585
2010,13,h) 11 to 15,19032,21056,249495,257552,703,3.2,2119,9.7,28283,5988,22295,2.3,11,44398,13566,30832,5.3,17.2,-16115,-6.2,22,0,1392,1392,9717
2010,13,i) 16 to 20,12250,14480,216864,219397,433,2.9,1135,7.6,25107,5043,20064,2.3,11.4,30172,6314,23858,2.9,13.8,-5065,-2.4,22.8,0,746,748,4027
2010,13,j) 21 to 25,9611,12680,256388,263307,448,3.5,813,6.3,22759,7089,15670,2.7,8.6,36596,8520,28076,3.2,13.9,-13837,-5.3,17.2,0,508,510,5336
2010,13,k) 26+,10864,17069,385972,390273,604,3.5,1004,5.8,39976,9578,30398,2.5,10.2,48578,10338,38240,2.6,12.4,-8602,-2.2,20.4,0,457,466,3347
2010,13,l) Left Censored,11814,40589,1464461,1481251,1958,4.8,2497,6.1,128824,49967,78857,3.4,8.7,162403,37914,124489,2.6,11,-33579,-2.3,17.4,0,345,369,5935
2010,15,a) 0,1361,1375,10502,5272,1360,197.8,0,0,10460,,,,198.4,0,0,0,0,0,10460,198.4,0,1,,,
2010,15,b) 1,1128,1146,11339,9806,8,0.6,351,26.3,5446,,,,55.5,2380,1450,930,14.8,24.3,3066,31.2,48.6,1,273,273,1208
2010,15,c) 2,1102,1130,7551,8011,49,4,239,19.5,1295,239,1056,3,16.2,2215,847,1368,10.6,27.6,-920,-11.4,32.4,0,193,193,740
2010,15,d) 3,1151,1160,9280,9378,56,4.6,169,13.9,1675,497,1178,5.3,17.9,1871,867,1004,9.2,20,-196,-2.1,35.8,0,133,133,762
2010,15,e) 4,1043,1113,9617,10314,46,3.9,168,14.3,1114,168,946,1.6,10.8,2508,1181,1327,11.5,24.3,-1394,-13.5,21.6,0,126,126,782
2010,15,f) 5,926,940,9485,9756,34,3.4,147,14.8,1209,241,968,2.5,12.4,1750,610,1140,6.3,17.9,-541,-5.5,24.8,0,106,106,509
2010,15,g) 6 to 10,3818,4113,39698,40871,122,2.9,429,10.1,4718,1047,3671,2.6,11.5,7064,2602,4462,6.4,17.3,-2346,-5.8,23,0,306,306,2064
2010,15,h) 11 to 15,2753,2986,32269,32831,82,2.7,228,7.4,3919,466,3453,1.4,11.9,5043,1144,3899,3.5,15.4,-1124,-3.5,23.8,0,147,147,834
2010,15,i) 16 to 20,2115,2470,36852,37607,70,2.8,152,6,3262,641,2621,1.7,8.7,4771,909,3862,2.4,12.7,-1509,-4,17.4,0,103,104,729
2010,15,j) 21 to 25,1922,2362,39808,41397,64,2.7,144,6,2781,665,2116,1.6,6.7,5959,2158,3801,5.2,14.4,-3178,-7.7,13.4,0,99,99,1895
2010,15,k) 26+,2503,3547,61110,62639,110,3.1,194,5.4,4527,1008,3519,1.6,7.2,7585,1661,5924,2.7,12.1,-3058,-4.9,14.4,0,101,101,1068
2010,15,l) Left Censored,2942,6831,206947,211057,320,4.7,375,5.5,15493,4275,11218,2,7.3,23713,6190,17523,2.9,11.2,-8220,-3.9,14.6,0,57,57,411
2010,16,a) 0,2227,2255,11402,5740,2215,196.5,0,0,11324,,,,197.3,0,0,0,0,0,11324,197.3,0,1,,,
2010,16,b) 1,1795,1807,14838,14619,3,0.1,687,31.4,4683,,,,32,4244,2604,1640,17.8,29,439,3,58,1,516,516,2155
2010,16,c) 2,2036,2055,11328,11663,129,5.8,448,20.2,2365,366,1999,3.1,20.3,3035,1394,1641,12,26,-670,-5.7,40.6,0,338,338,1065
2010,16,d) 3,2014,2035,12883,13308,120,5.4,475,21.4,2039,423,1616,3.2,15.3,2889,1501,1388,11.3,21.7,-850,-6.4,30.6,0,335,335,1201
2010,16,e) 4,1992,2053,13792,13993,123,5.6,412,18.7,2365,342,2023,2.4,16.9,2766,1396,1370,10,19.8,-401,-2.9,33.8,0,282,282,1014
2010,16,f) 5,1687,1735,12797,13407,98,5.4,289,15.8,1648,382,1266,2.8,12.3,2867,919,1948,6.9,21.4,-1219,-9.1,24.6,0,211,211,707
2010,16,g) 6 to 10,5805,6145,58903,60304,273,4.3,776,12.1,6670,1066,5604,1.8,11.1,9471,3191,6280,5.3,15.7,-2801,-4.6,22.2,0,513,513,2316
2010,16,h) 11 to 15,4164,4457,42891,43961,154,3.4,406,8.9,4425,739,3686,1.7,10.1,6564,1879,4685,4.3,14.9,-2139,-4.8,20.2,0,238,244,1097
2010,16,i) 16 to 20,2621,2893,27677,28637,133,4.5,219,7.5,2652,506,2146,1.8,9.3,4571,1260,3311,4.4,16,-1919,-6.7,18.6,0,128,128,761
2010,16,j) 21 to 25,1801,2266,35870,36961,81,3.6,106,4.6,3543,740,2803,2,9.6,5725,676,5049,1.8,15.5,-2182,-5.9,19.2,0,64,64,457
2010,16,k) 26+,2254,3286,63368,66048,112,3.4,197,5.9,6399,2267,4132,3.4,9.7,11759,1382,10377,2.1,17.8,-5360,-8.1,19.4,0,75,80,524
2010,16,l) Left Censored,2713,6780,181741,182678,292,4.3,303,4.5,17377,4906,12471,2.7,9.5,19251,3820,15431,2.1,10.5,-1874,-1,19,0,61,61,807
2010,17,a) 0,15288,15559,95308,48019,15269,196.3,0,0,94579,94579,0,197,197,0,0,0,0,0,94579,197,0,0,,,
2010,17,b) 1,11901,12047,77655,82927,45,0.3,3775,26.7,17492,406,17086,0.5,21.1,28036,16691,11345,20.1,33.8,-10544,-12.7,42.2,0,2634,2634,13353
2010,17,c) 2,11952,12157,83648,87708,539,4.1,2403,18.3,13362,2236,11126,2.5,15.2,21482,10519,10963,12,24.5,-8120,-9.3,30.4,0,1748,1748,8715
2010,17,d) 3,10743,10895,80156,83022,466,4,1850,16,12637,1920,10717,2.3,15.2,18368,8285,10083,10,22.1,-5731,-6.9,30.4,0,1325,1326,6659
2010,17,e) 4,10383,10894,86462,93342,478,4.2,1622,14.2,11858,2105,9753,2.3,12.7,25617,10498,15119,11.2,27.4,-13759,-14.7,25.4,0,1133,1133,9379
2010,17,f) 5,9388,9697,86420,91426,319,3.1,1364,13.3,10330,1085,9245,1.2,11.3,20341,6368,13973,7,22.2,-10011,-10.9,22.6,0,931,931,4806
2010,17,g) 6 to 10,35978,38111,395776,406260,1295,3.3,4235,10.7,46274,7883,38391,1.9,11.4,67243,23074,44169,5.7,16.6,-20969,-5.2,22.8,0,2811,2826,17116
2010,17,h) 11 to 15,27528,29927,359507,368752,1025,3.3,2777,9,42925,7382,35543,2,11.6,61415,19187,42228,5.2,16.7,-18490,-5.1,23.2,0,1688,1688,13533
2010,17,i) 16 to 20,20619,23113,308979,315659,688,2.9,1689,7.2,31735,5538,26197,1.8,10.1,45094,10806,34288,3.4,14.3,-13359,-4.2,20.2,0,1029,1030,6798
2010,17,j) 21 to 25,17000,20820,389835,400800,733,3.5,1323,6.3,37769,13805,23964,3.4,9.4,59698,17832,41866,4.4,14.9,-21929,-5.5,18.8,0,785,786,6090
2010,17,k) 26+,20132,29059,683487,688729,901,3.1,1561,5.3,61825,15716,46109,2.3,9,72308,14728,57580,2.1,10.5,-10483,-1.5,18,0,757,774,6283
2010,17,l) Left Censored,25924,63567,2302602,2347424,2742,4.3,3365,5.3,169358,43853,125505,1.9,7.2,259001,53370,205631,2.3,11,-89643,-3.8,14.4,0,795,811,11441
2010,18,a) 0,5966,6088,42617,21551,5997,197,0,0,42133,42133,0,195.5,195.5,0,0,0,0,0,42133,195.5,0,0,,,
2010,18,b) 1,4844,4928,35251,37837,19,0.3,1395,24.5,8414,239,8175,0.6,22.2,13585,8657,4928,22.9,35.9,-5171,-13.7,44.4,0,1078,1078,7680
2010,18,c) 2,5166,5298,40240,42820,186,3.2,1060,18.5,7186,890,6296,2.1,16.8,12345,7255,5090,16.9,28.8,-5159,-12,33.6,0,820,820,6373
2010,18,d) 3,4701,4829,37993,40249,192,3.7,792,15.4,5509,787,4722,2,13.7,10020,5597,4423,13.9,24.9,-4511,-11.2,27.4,0,589,589,5001
2010,18,e) 4,4638,4958,43916,45544,181,3.5,677,13,5280,621,4659,1.4,11.6,8535,3484,5051,7.6,18.7,-3255,-7.1,23.2,0,493,493,2859
2010,18,f) 5,3980,4131,36863,38282,136,3.1,611,14,5366,855,4511,2.2,14,8204,3833,4371,10,21.4,-2838,-7.4,28,0,448,448,3150
2010,18,g) 6 to 10,15872,16807,163926,169148,540,3.1,1711,9.8,19047,2785,16262,1.6,11.3,29490,9171,20319,5.4,17.4,-10443,-6.1,22.6,0,1208,1208,7566
2010,18,h) 11 to 15,12437,13795,161741,165509,421,3,1185,8.4,19452,2987,16465,1.8,11.8,26988,8714,18274,5.3,16.3,-7536,-4.5,23.6,0,789,789,6375
2010,18,i) 16 to 20,9696,11033,141032,146803,340,3,839,7.4,13344,2804,10540,1.9,9.1,24885,6273,18612,4.3,17,-11541,-7.9,18.2,0,527,527,3986
2010,18,j) 21 to 25,7957,10428,191286,193379,281,2.7,619,5.8,19302,3444,15858,1.8,10,23487,5600,17887,2.9,12.1,-4185,-2.1,20,0,387,387,2401
2010,18,k) 26+,9959,14948,302004,307841,457,3,666,4.4,27010,5940,21070,1.9,8.8,38683,6018,32665,2,12.6,-11673,-3.8,17.6,0,362,362,2575
2010,18,l) Left Censored,13007,34311,1188254,1198456,1217,3.5,1449,4.2,97749,19371,78378,1.6,8.2,118152,20476,97676,1.7,9.9,-20403,-1.7,16.4,0,420,435,4233
2010,19,a) 0,3152,3180,19187,9682,3108,195.5,0,0,19011,19011,0,196.4,196.4,0,0,0,0,0,19011,196.4,0,0,,,
2010,19,b) 1,2619,2681,19294,19822,14,0.5,637,21.1,4643,202,4441,1,23.4,5698,2926,2772,14.8,28.7,-1055,-5.3,46.8,0,472,472,2470
2010,19,c) 2,2691,2737,18522,19291,99,3.4,490,16.7,3315,439,2876,2.3,17.2,4852,1948,2904,10.1,25.2,-1537,-8,34.4,0,376,376,1678
2010,19,d) 3,2479,2514,18455,19254,89,3.3,396,14.8,2702,536,2166,2.8,14,4299,1595,2704,8.3,22.3,-1597,-8.3,28,0,299,299,1328
2010,19,e) 4,2564,2812,22296,23149,84,2.9,355,12.1,2750,415,2335,1.8,11.9,4455,1651,2804,7.1,19.2,-1705,-7.3,23.8,0,255,255,1347
2010,19,f) 5,2206,2271,17651,18588,74,3.1,255,10.8,2165,396,1769,2.1,11.6,4038,1650,2388,8.9,21.7,-1873,-10.1,23.2,0,182,182,1409
2010,19,g) 6 to 10,8679,9252,90572,92462,275,2.9,835,8.8,11068,1301,9767,1.4,12,14848,4126,10722,4.5,16.1,-3780,-4.1,24,0,543,544,2969
2010,19,h) 11 to 15,6881,7549,83825,83221,231,3,561,7.3,13317,3226,10091,3.9,16,12108,3359,8749,4,14.5,1209,1.5,29,0,357,357,2044
2010,19,i) 16 to 20,5161,5677,59024,62831,163,2.8,399,6.9,6167,1130,5037,1.8,9.8,13781,7759,6022,12.3,21.9,-7614,-12.1,19.6,0,259,259,6776
2010,19,j) 21 to 25,4153,5215,101085,103241,117,2.2,263,5,6883,1524,5359,1.5,6.7,11195,2224,8971,2.2,10.8,-4312,-4.1,13.4,0,164,164,1296
2010,19,k) 26+,6233,9578,154189,156634,226,2.3,372,3.9,12406,2942,9464,1.9,7.9,17296,2775,14521,1.8,11,-4890,-3.1,15.8,0,195,195,1293
2010,19,l) Left Censored,8922,19321,642540,648504,709,3.7,661,3.4,44219,8221,35998,1.3,6.8,56146,8993,47153,1.4,8.7,-11927,-1.9,13.6,0,222,227,2250
2010,20,a) 0,3177,3199,18237,9211,3137,196.1,0,0,18053,18053,0,196,196,0,0,0,0,0,18053,196,0,0,,,
2010,20,b) 1,2625,2653,17821,19200,6,0.2,736,24,3769,21,3748,0.1,19.6,6526,3996,2530,20.8,34,-2757,-14.4,39.2,0,563,563,3521
2010,20,c) 2,2643,2691,17293,18642,90,3.1,514,17.7,2636,348,2288,1.9,14.1,5333,2769,2564,14.9,28.6,-2697,-14.5,28.2,0,409,409,2462
2010,20,d) 3,2518,2566,18864,19609,89,3.2,454,16.5,2891,517,2374,2.6,14.7,4380,2052,2328,10.5,22.3,-1489,-7.6,29.4,0,351,357,1660
2010,20,e) 4,2489,2620,20152,20777,96,3.5,326,11.9,2469,330,2139,1.6,11.9,3719,1365,2354,6.6,17.9,-1250,-6,23.8,0,258,258,1151
2010,20,f) 5,2154,2227,20693,20959,71,3,302,12.9,2842,216,2626,1,13.6,3374,1383,1991,6.6,16.1,-532,-2.5,27.2,0,222,222,1152
2010,20,g) 6 to 10,8724,9105,97728,100045,255,2.7,940,9.9,10775,2616,8159,2.6,10.8,15408,4442,10966,4.4,15.4,-4633,-4.6,21.6,0,688,688,3401
2010,20,h) 11 to 15,6679,7281,83642,85481,212,2.8,605,8.1,7801,1194,6607,1.4,9.1,11479,3376,8103,3.9,13.4,-3678,-4.3,18.2,0,377,377,2250
2010,20,i) 16 to 20,4766,5370,74413,76205,154,2.8,344,6.3,7028,1251,5777,1.6,9.2,10611,3230,7381,4.2,13.9,-3583,-4.7,18.4,0,244,245,2288
2010,20,j) 21 to 25,3876,4856,73681,75299,128,2.6,272,5.5,6502,1188,5314,1.6,8.6,9737,2624,7113,3.5,12.9,-3235,-4.3,17.2,0,173,173,1256
2010,20,k) 26+,5500,8006,143747,146614,247,3.1,335,4.2,12373,2699,9674,1.8,8.4,18107,2185,15922,1.5,12.4,-5734,-4,16.8,0,189,189,923
2010,20,l) Left Censored,7325,16683,513608,520112,665,4,679,4.1,42433,10907,31526,2.1,8.2,55440,12787,42653,2.5,10.7,-13007,-2.5,16.4,0,165,170,1567
2010,21,a) 0,3991,4065,28558,14376,4008,197.2,0,0,28365,28365,0,197.3,197.3,0,0,0,0,0,28365,197.3,0,0,,,
2010,21,b) 1,3128,3160,21365,22785,18,0.5,927,25.4,4878,251,4627,1.1,21.4,7718,4688,3030,20.6,33.9,-2840,-12.5,42.8,0,742,742,4182
2010,21,c) 2,3181,3297,24342,26346,116,3.3,646,18.2,3827,611,3216,2.3,14.5,7835,4853,2982,18.4,29.7,-4008,-15.2,29,0,516,516,4322
2010,21,d) 3,2979,3037,22532,23684,89,2.7,502,15.5,3297,255,3042,1.1,13.9,5601,2859,2742,12.1,23.6,-2304,-9.7,27.8,0,402,402,2551
2010,21,e) 4,2840,3004,25427,26382,88,2.8,450,14.1,3440,518,2922,2,13,5349,2368,2981,9,20.3,-1909,-7.3,26,0,341,341,1928
2010,21,f) 5,2573,2655,22569,24076,61,2.2,375,13.4,2615,306,2309,1.3,10.9,5628,2474,3154,10.3,23.4,-3013,-12.5,21.8,0,290,290,1964
2010,21,g) 6 to 10,10131,10723,104307,107907,321,2.9,1098,9.9,12534,2255,10279,2.1,11.6,19734,7379,12355,6.8,18.3,-7200,-6.7,23.2,0,821,821,5406
2010,21,h) 11 to 15,8022,8999,105074,107480,246,2.7,767,8.3,11168,1493,9675,1.4,10.4,15980,5121,10859,4.8,14.9,-4812,-4.5,20.8,0,504,504,3436
2010,21,i) 16 to 20,5887,6822,83040,84931,210,3,484,6.9,9581,1941,7640,2.3,11.3,13362,3084,10278,3.6,15.7,-3781,-4.4,22.6,0,311,311,2068
2010,21,j) 21 to 25,5016,6423,120628,122432,167,2.6,393,6,10926,2156,8770,1.8,8.9,14533,2651,11882,2.2,11.9,-3607,-3,17.8,0,221,221,1430
2010,21,k) 26+,6153,9379,188990,190334,420,4.5,477,5.1,18862,4357,14505,2.3,9.9,21550,4955,16595,2.6,11.3,-2688,-1.4,19.8,0,232,240,1867
2010,21,l) Left Censored,7802,20803,699165,704658,813,3.9,896,4.3,61238,20187,41051,2.9,8.7,72223,10573,61650,1.5,10.2,-10985,-1.5,17.4,0,215,216,2294
2010,22,a) 0,5052,5179,35589,17940,5083,196.3,0,0,35299,35299,0,196.8,196.8,0,0,0,0,0,35299,196.8,0,0,,,
2010,22,b) 1,4038,4128,32416,34868,12,0.3,1197,25,7470,107,7363,0.3,21.4,12374,5716,6658,16.4,35.5,-4904,-14.1,42.8,0,968,968,4788
2010,22,c) 2,4095,4236,36415,37559,136,3,795,17.4,6585,715,5870,1.9,17.5,8872,3849,5023,10.2,23.6,-2287,-6.1,35,0,639,639,3225
2010,22,d) 3,3910,3960,36632,38018,123,2.9,648,15.4,6044,1152,4892,3,15.9,8816,3725,5091,9.8,23.2,-2772,-7.3,31.8,0,516,518,3134
2010,22,e) 4,3333,3619,35089,36681,108,2.8,488,12.8,4521,739,3782,2,12.3,7704,2715,4989,7.4,21,-3183,-8.7,24.6,0,392,392,2315
2010,22,f) 5,3017,3126,34152,34933,107,3.3,364,11.2,4606,591,4015,1.7,13.2,6168,1790,4378,5.1,17.7,-1562,-4.5,26.4,0,279,279,1417
2010,22,g) 6 to 10,12173,12979,154782,160786,365,2.7,1189,8.9,17333,2856,14477,1.8,10.8,29341,10501,18840,6.5,18.2,-12008,-7.4,21.6,0,851,851,8879
2010,22,h) 11 to 15,9285,10074,122201,125779,242,2.3,735,7.1,11923,1908,10015,1.5,9.5,19078,4713,14365,3.7,15.2,-7155,-5.7,19,0,520,520,3518
2010,22,i) 16 to 20,6850,7803,113301,116608,213,2.7,437,5.5,10365,1965,8400,1.7,8.9,16979,2730,14249,2.3,14.6,-6614,-5.7,17.8,0,297,297,1907
2010,22,j) 21 to 25,5282,6802,135429,137764,190,2.8,379,5.5,12848,5204,7644,3.8,9.3,17518,3465,14053,2.5,12.7,-4670,-3.4,18.6,0,200,200,1502
2010,22,k) 26+,7866,11142,206535,212115,323,2.9,496,4.4,17554,4008,13546,1.9,8.3,28713,5042,23671,2.4,13.5,-11159,-5.2,16.6,0,293,299,2523
2010,22,l) Left Censored,8228,21687,637308,644015,935,4.3,891,4.1,51091,11951,39140,1.9,7.9,64505,10028,54477,1.6,10,-13414,-2.1,15.8,0,225,231,1634
2010,23,a) 0,1701,1745,9068,4574,1712,196.2,0,0,8989,8989,0,196.5,196.5,0,0,0,0,0,8989,196.5,0,0,,,
2010,23,b) 1,1356,1376,8387,8600,6,0.4,410,25.7,1796,89,1707,1,20.9,2222,1299,923,15.1,25.8,-426,-4.9,41.8,0,273,273,977
2010,23,c) 2,1493,1513,8037,8259,75,4.6,288,17.8,1458,333,1125,4,17.7,1902,914,988,11.1,23,-444,-5.3,35.4,0,209,209,658
2010,23,d) 3,1437,1452,9308,9469,91,6,213,14.1,1376,219,1157,2.3,14.5,1697,763,934,8.1,17.9,-321,-3.4,29,0,150,150,639
2010,23,e) 4,1440,1525,9769,10034,67,4.2,203,12.7,1364,273,1091,2.7,13.6,1894,678,1216,6.8,18.9,-530,-5.3,27.2,0,130,130,488
2010,23,f) 5,1214,1231,7850,8352,52,4,158,12.3,943,203,740,2.4,11.3,1946,586,1360,7,23.3,-1003,-12,22.6,0,116,116,492
2010,23,g) 6 to 10,4896,5131,38351,38764,209,4,524,9.9,4825,1087,3738,2.8,12.4,5650,1776,3874,4.6,14.6,-825,-2.2,24.8,0,350,350,1357
2010,23,h) 11 to 15,3919,4185,38005,38564,143,3.3,347,8.1,3691,525,3166,1.4,9.6,4809,1477,3332,3.8,12.5,-1118,-2.9,19.2,0,216,216,1139
2010,23,i) 16 to 20,2578,2868,29145,29584,101,3.5,191,6.6,2988,754,2234,2.5,10.1,3865,985,2880,3.3,13.1,-877,-3,20.2,0,121,121,716
2010,23,j) 21 to 25,2556,3162,46715,47174,106,3.3,179,5.6,4076,846,3230,1.8,8.6,4994,1020,3974,2.2,10.6,-918,-2,17.2,0,102,102,682
2010,23,k) 26+,2575,3840,64725,66337,145,3.7,206,5.3,6247,1874,4373,2.8,9.4,9470,2511,6959,3.8,14.3,-3223,-4.9,18.8,0,102,102,992
2010,23,l) Left Censored,3157,6981,201970,205010,337,4.8,379,5.4,13790,4459,9331,2.2,6.7,19870,4914,14956,2.4,9.7,-6080,-3,13.4,0,85,85,899
2010,24,a) 0,6141,6320,37021,18662,6180,195.6,0,0,36719,36719,0,196.8,196.8,0,0,0,0,0,36719,196.8,0,0,,,
2010,24,b) 1,5029,5100,36582,37295,11,0.2,1432,24.3,8771,137,8634,0.4,23.5,10196,5461,4735,14.6,27.3,-1425,-3.8,47,0,1080,1080,4314
2010,24,c) 2,5035,5252,37791,38992,219,3.9,1013,18,7564,1180,6384,3,19.4,9965,3630,6335,9.3,25.6,-2401,-6.2,38.8,0,760,760,3069
2010,24,d) 3,4788,4872,36814,38100,200,3.9,834,16.1,6105,1005,5100,2.6,16,8677,4239,4438,11.1,22.8,-2572,-6.8,32,0,612,612,3714
2010,24,e) 4,4794,5029,39425,41580,207,3.9,776,14.6,5210,778,4432,1.9,12.5,9520,4252,5268,10.2,22.9,-4310,-10.4,25,0,565,565,3673
2010,24,f) 5,4475,4614,38342,38921,188,3.9,581,12.1,6205,1252,4953,3.2,15.9,7363,2515,4848,6.5,18.9,-1158,-3,31.8,0,442,442,2145
2010,24,g) 6 to 10,17051,17797,180546,185164,662,3.6,1978,10.7,23393,3388,20005,1.8,12.6,32628,10109,22519,5.5,17.6,-9235,-5,25.2,0,1377,1381,6975
2010,24,h) 11 to 15,12641,13776,168954,174491,485,3.4,1194,8.5,16368,3605,12763,2.1,9.4,27441,7055,20386,4,15.7,-11073,-6.3,18.8,0,744,757,4995
2010,24,i) 16 to 20,9148,10347,148720,152140,314,3,758,7.2,14214,2526,11688,1.7,9.3,21053,5648,15405,3.7,13.8,-6839,-4.5,18.6,0,447,447,3937
2010,24,j) 21 to 25,7789,9327,182867,183301,315,3.3,660,6.9,19120,4797,14323,2.6,10.4,19988,4197,15791,2.3,10.9,-868,-0.5,20.8,0,369,369,2679
2010,24,k) 26+,7935,11593,244892,246789,435,3.7,618,5.3,24968,6652,18316,2.7,10.1,28762,5723,23039,2.3,11.7,-3794,-1.6,20.2,0,314,323,2176
2010,24,l) Left Censored,9656,25938,917577,934863,1344,5.1,1699,6.5,78237,21224,57013,2.3,8.4,112808,25336,87472,2.7,12.1,-34571,-3.7,16.8,0,266,267,2488
2010,25,a) 0,7561,7643,41491,20873,7515,196.7,0,0,41237,41237,0,197.6,197.6,0,0,0,0,0,41237,197.6,0,0,,,
2010,25,b) 1,5791,5837,36832,38576,22,0.3,1653,24.5,8408,679,7729,1.8,21.8,11896,6540,5356,17,30.8,-3488,-9,43.6,0,1207,1207,5562
2010,25,c) 2,5880,5963,38388,40773,239,3.7,1102,17.2,7277,1445,5832,3.5,17.8,12047,4534,7513,11.1,29.5,-4770,-11.7,35.6,0,799,800,3802
2010,25,d) 3,5414,5465,40270,41688,217,3.7,958,16.4,5893,843,5050,2,14.1,8728,3891,4837,9.3,20.9,-2835,-6.8,28.2,0,693,693,3222
2010,25,e) 4,5688,5899,42155,43357,293,4.7,848,13.7,6187,934,5253,2.2,14.3,8591,3933,4658,9.1,19.8,-2404,-5.5,28.6,0,627,628,2810
2010,25,f) 5,5054,5152,47284,47641,196,3.6,667,12.4,6910,842,6068,1.8,14.5,7624,2733,4891,5.7,16,-714,-1.5,29,0,479,480,2300
2010,25,g) 6 to 10,19885,20806,219168,224420,718,3.3,2237,10.4,24836,3929,20907,1.8,11.1,35339,11130,24209,5,15.7,-10503,-4.6,22.2,0,1472,1472,8141
2010,25,h) 11 to 15,15550,16541,196662,199091,521,3.1,1374,8.1,21777,3566,18211,1.8,10.9,26635,7737,18898,3.9,13.4,-4858,-2.5,21.8,0,902,911,5346
2010,25,i) 16 to 20,11004,12257,168998,171963,379,3,831,6.7,17543,4799,12744,2.8,10.2,23472,5497,17975,3.2,13.6,-5929,-3.4,20.4,0,559,560,4013
2010,25,j) 21 to 25,10969,13208,245238,247493,457,3.4,812,6.1,22498,6822,15676,2.8,9.1,27008,4752,22256,1.9,10.9,-4510,-1.8,18.2,0,479,479,2962
2010,25,k) 26+,11373,17116,459164,458917,667,3.9,919,5.3,46697,9562,37135,2.1,10.2,46203,9898,36305,2.2,10.1,494,0.1,20.2,0,457,476,2861
2010,25,l) Left Censored,16004,35917,1360141,1374727,1600,4.4,1763,4.9,121145,34911,86234,2.5,8.8,150316,29346,120970,2.1,10.9,-29171,-2.1,17.6,0,509,509,9143
2010,26,a) 0,9418,9508,61794,31155,9319,196,0,0,61278,61278,0,196.7,196.7,0,0,0,0,0,61278,196.7,0,0,,,
2010,26,b) 1,7655,7735,61829,65645,18,0.2,2322,25.7,14930,165,14765,0.3,22.7,22561,11294,11267,17.2,34.4,-7631,-11.7,45.4,0,1735,1735,9415
2010,26,c) 2,7615,7769,62769,65885,311,3.7,1579,18.8,10671,1558,9113,2.4,16.2,16902,8283,8619,12.6,25.7,-6231,-9.5,32.4,0,1171,1171,7299
2010,26,d) 3,6953,7056,79420,80789,269,3.6,1234,16.4,12039,1118,10921,1.4,14.9,14776,6167,8609,7.6,18.3,-2737,-3.4,29.8,0,892,892,5217
2010,26,e) 4,6859,7066,61977,65012,338,4.5,1113,15,10187,1894,8293,2.9,15.7,16257,7675,8582,11.8,25,-6070,-9.3,31.4,0,838,838,6780
2010,26,f) 5,6109,6283,60270,62753,212,3.2,859,13,9648,814,8834,1.3,15.4,14614,5448,9166,8.7,23.3,-4966,-7.9,30.8,0,643,643,4772
2010,26,g) 6 to 10,24055,25504,256683,268435,918,3.5,3093,11.6,30752,5371,25381,2,11.5,54255,19336,34919,7.2,20.2,-23503,-8.7,23,0,2134,2134,14795
2010,26,h) 11 to 15,19728,21310,237230,244407,755,3.4,2145,9.8,27285,4913,22372,2,11.2,41640,11578,30062,4.7,17,-14355,-5.8,22.4,0,1396,1396,8224
2010,26,i) 16 to 20,14920,16812,203320,208965,592,3.4,1430,8.3,23482,4950,18532,2.4,11.2,34771,9243,25528,4.4,16.6,-11289,-5.4,22.4,0,880,881,4987
2010,26,j) 21 to 25,12878,16169,255775,262134,540,3.3,1033,6.3,24305,5846,18459,2.2,9.3,37023,8592,28431,3.3,14.1,-12718,-4.8,18.6,0,613,613,5383
2010,26,k) 26+,15074,21295,382461,389056,583,2.7,1115,5.2,37346,7880,29466,2,9.6,50536,10440,40096,2.7,13,-13190,-3.4,19.2,0,613,618,5221
2010,26,l) Left Censored,18386,46708,1548755,1564087,1506,3.2,2368,5,138789,34707,104082,2.2,8.9,169453,38584,130869,2.5,10.8,-30664,-1.9,17.8,0,657,662,6334
2010,27,a) 0,6303,6465,41160,20718,6349,196.4,0,0,40884,40884,0,197.3,197.3,0,0,0,0,0,40884,197.3,0,0,,,
2010,27,b) 1,5126,5216,37256,41019,28,0.5,1601,26.2,7846,226,7620,0.6,19.1,15372,7599,7773,18.5,37.5,-7526,-18.4,38.2,0,1105,1105,6238
2010,27,c) 2,4992,5080,38018,39326,234,4.3,1008,18.4,6416,1301,5115,3.3,16.3,9031,3987,5044,10.1,23,-2615,-6.7,32.6,0,709,709,3294
2010,27,d) 3,4822,4919,41346,42995,235,4.5,804,15.5,6462,782,5680,1.8,15,9760,5300,4460,12.3,22.7,-3298,-7.7,30,0,567,567,4859
2010,27,e) 4,4804,5187,39508,41002,227,4.2,716,13.2,5230,938,4292,2.3,12.8,8218,3696,4522,9,20,-2988,-7.2,25.6,0,487,487,2949
2010,27,f) 5,4384,4556,40018,40555,183,3.8,589,12.4,6260,564,5696,1.4,15.4,7333,2910,4423,7.2,18.1,-1073,-2.7,30.8,0,390,390,2437
2010,27,g) 6 to 10,17663,18620,178915,183195,740,3.8,2003,10.4,20202,3486,16716,1.9,11,28762,10384,18378,5.7,15.7,-8560,-4.7,22,0,1242,1242,7671
2010,27,h) 11 to 15,13366,14752,169822,173095,549,3.6,1275,8.4,18010,3763,14247,2.2,10.4,24555,6847,17708,4,14.2,-6545,-3.8,20.8,0,760,760,4993
2010,27,i) 16 to 20,9706,11150,148539,150557,329,2.9,719,6.3,15778,2880,12898,1.9,10.5,19814,4768,15046,3.2,13.2,-4036,-2.7,21,0,450,450,2921
2010,27,j) 21 to 25,7600,9504,183454,186471,317,3.3,535,5.6,15831,3518,12313,1.9,8.5,21864,3847,18017,2.1,11.7,-6033,-3.2,17,0,319,319,2191
2010,27,k) 26+,8841,13204,298124,300254,363,2.7,631,4.7,25946,4647,21299,1.5,8.6,30206,6275,23931,2.1,10.1,-4260,-1.5,17.2,0,299,299,2503
2010,27,l) Left Censored,12037,28420,1137357,1143705,1095,3.8,1174,4.1,101333,32105,69228,2.8,8.9,114030,30749,83281,2.7,10,-12697,-1.1,17.8,0,240,241,2779
2010,28,a) 0,2736,2796,18638,9392,2745,196.4,0,0,18492,18492,0,196.9,196.9,0,0,0,0,0,18492,196.9,0,0,,,
2010,28,b) 1,2231,2261,15789,17689,11,0.4,644,24.6,2655,89,2566,0.5,15,6455,2519,3936,14.2,36.5,-3800,-21.5,30,0,517,517,2140
2010,28,c) 2,2195,2262,15564,16235,70,2.8,463,18.8,2823,218,2605,1.3,17.4,4165,2039,2126,12.6,25.7,-1342,-8.3,34.8,0,390,390,1824
2010,28,d) 3,2097,2177,13744,14524,79,3.4,383,16.5,2024,484,1540,3.3,13.9,3584,1641,1943,11.3,24.7,-1560,-10.8,27.8,0,311,311,1352
2010,28,e) 4,1906,2029,19874,20288,74,3.4,311,14.5,3161,712,2449,3.5,15.6,3989,1852,2137,9.1,19.7,-828,-4.1,31.2,0,257,257,1533
2010,28,f) 5,1703,1802,16356,17162,117,6.3,241,13,2245,450,1795,2.6,13.1,3857,1829,2028,10.7,22.5,-1612,-9.4,26.2,0,194,196,1620
2010,28,g) 6 to 10,6960,7385,71791,74087,215,2.8,735,9.6,8341,1277,7064,1.7,11.3,12932,3813,9119,5.1,17.5,-4591,-6.2,22.6,0,567,567,3035
2010,28,h) 11 to 15,5226,5807,58949,60336,165,2.8,464,7.8,6148,1438,4710,2.4,10.2,8922,2141,6781,3.5,14.8,-2774,-4.6,20.4,0,336,336,1634
2010,28,i) 16 to 20,3721,4221,59417,59972,135,3.1,281,6.6,6553,1018,5535,1.7,10.9,7663,1819,5844,3,12.8,-1110,-1.9,21.8,0,193,193,986
2010,28,j) 21 to 25,2977,3581,64528,65461,89,2.4,200,5.5,5221,749,4472,1.1,8,7086,2104,4982,3.2,10.8,-1865,-2.8,16,0,132,132,1032
2010,28,k) 26+,4373,6287,113491,115261,236,3.7,304,4.8,10855,2736,8119,2.4,9.4,14394,2691,11703,2.3,12.5,-3539,-3.1,18.8,0,165,169,1332
2010,28,l) Left Censored,5192,13946,406221,411833,471,3.4,570,4.1,27797,6995,20802,1.7,6.7,39021,6486,32535,1.6,9.5,-11224,-2.8,13.4,0,147,148,2060
2010,29,a) 0,7747,7835,41277,20771,7729,197.3,0,0,41013,41013,0,197.5,197.5,0,0,0,0,0,41013,197.5,0,0,,,
2010,29,b) 1,5558,5719,41356,42967,80,1.2,1875,28,8922,655,8267,1.5,20.8,12143,7142,5001,16.6,28.3,-3221,-7.5,41.6,0,1511,1511,6134
2010,29,c) 2,5294,5367,37664,39495,204,3.5,1207,20.5,6799,967,5832,2.4,17.2,10461,5260,5201,13.3,26.5,-3662,-9.3,34.4,0,957,957,4517
2010,29,d) 3,5088,5191,34585,36543,193,3.4,1027,18.3,5515,843,4672,2.3,15.1,9430,4995,4435,13.7,25.8,-3915,-10.7,30.2,0,794,799,4401
2010,29,e) 4,5103,5419,41916,43806,208,3.6,835,14.6,5779,698,5081,1.6,13.2,9558,3998,5560,9.1,21.8,-3779,-8.6,26.4,0,626,626,3165
2010,29,f) 5,4596,4749,37383,39461,166,3.3,710,14.1,4691,814,3877,2.1,11.9,8846,4040,4806,10.2,22.4,-4155,-10.5,23.8,0,540,540,3383
2010,29,g) 6 to 10,16989,17978,169360,176034,610,3.3,2107,11.2,19828,3897,15931,2.2,11.3,33175,12448,20727,7.1,18.8,-13347,-7.5,22.6,0,1534,1534,10003
2010,29,h) 11 to 15,12694,13865,158242,161989,474,3.3,1209,8.5,17524,3691,13833,2.3,10.8,25017,7018,17999,4.3,15.4,-7493,-4.6,21.6,0,825,825,4932
2010,29,i) 16 to 20,9102,10451,134860,137217,274,2.6,777,7.3,13800,3660,10140,2.7,10.1,18514,5147,13367,3.8,13.5,-4714,-3.4,20.2,0,526,526,3036
2010,29,j) 21 to 25,8042,10554,184284,187727,344,3.2,611,5.7,17197,4298,12899,2.3,9.2,24083,4454,19629,2.4,12.8,-6886,-3.6,18.4,0,368,368,2717
2010,29,k) 26+,9501,14692,309720,311142,575,3.9,682,4.6,29676,9669,20007,3.1,9.5,32520,5394,27126,1.7,10.5,-2844,-1,19,0,363,364,2382
2010,29,l) Left Censored,12164,31327,1094595,1113018,1329,4.2,1439,4.6,88695,22412,66283,2,8,125540,19146,106394,1.7,11.3,-36845,-3.3,16,0,335,353,3088
2010,30,a) 0,1770,1778,9357,4780,1733,194.9,0,0,9154,,,,191.5,0,0,0,0,0,9154,191.5,0,1,,,
2010,30,b) 1,1458,1460,7069,7337,3,0.2,471,27.3,1497,,,,20.4,2033,1250,783,17,27.7,-536,-7.3,40.8,1,316,316,966
2010,30,c) 2,1539,1573,8396,8668,74,4.3,333,19.5,1297,269,1028,3.1,15,1841,932,909,10.8,21.2,-544,-6.2,30,0,241,241,740
2010,30,d) 3,1524,1546,8522,8594,96,5.9,290,17.7,1859,736,1123,8.6,21.6,2002,789,1213,9.2,23.3,-143,-1.7,43.2,0,191,191,587
2010,30,e) 4,1551,1619,14954,15492,88,5.2,254,14.9,1457,460,997,3,9.4,2532,790,1742,5.1,16.3,-1075,-6.9,18.8,0,160,160,501
2010,30,f) 5,1323,1339,8001,8335,57,4,190,13.5,1155,201,954,2.4,13.9,1823,715,1108,8.6,21.9,-668,-8,27.8,0,118,118,570
2010,30,g) 6 to 10,4891,5051,34001,34998,216,4.1,554,10.6,4010,787,3223,2.2,11.5,6003,2218,3785,6.3,17.2,-1993,-5.7,23,0,326,326,1523
2010,30,h) 11 to 15,3624,3823,31419,32251,119,3,306,7.8,3180,464,2716,1.4,9.9,4843,1011,3832,3.1,15,-1663,-5.1,19.8,0,192,192,750
2010,30,i) 16 to 20,2251,2393,23163,23295,82,3.4,168,6.9,2344,443,1901,1.9,10.1,2607,626,1981,2.7,11.2,-263,-1.1,20.2,0,107,107,481
2010,30,j) 21 to 25,1657,1921,24196,24663,66,3.4,110,5.7,1890,321,1569,1.3,7.7,2823,517,2306,2.1,11.4,-933,-3.7,15.4,0,63,63,385
2010,30,k) 26+,2239,3201,48390,48975,91,2.8,158,4.9,4627,807,3820,1.6,9.4,5796,1136,4660,2.3,11.8,-1169,-2.4,18.8,0,85,85,545
2010,30,l) Left Censored,2455,5187,116929,118135,179,3.4,201,3.9,8949,1728,7221,1.5,7.6,11360,1367,9993,1.2,9.6,-2411,-2,15.2,0,54,54,349
2010,31,a) 0,2213,2237,10796,5438,2200,196.7,0,0,10716,10716,0,197.1,197.1,0,0,0,0,0,10716,197.1,0,0,,,
2010,31,b) 1,1902,1917,11122,11913,6,0.3,437,20.2,2145,108,2037,0.9,18,3727,2005,1722,16.8,31.3,-1582,-13.3,36,0,303,303,1683
2010,31,c) 2,1840,1867,11666,12031,66,3.3,310,15.6,1841,329,1512,2.7,15.3,2570,1297,1273,10.8,21.4,-729,-6.1,30.6,0,233,233,1118
2010,31,d) 3,1775,1812,12200,12332,69,3.6,257,13.5,2113,211,1902,1.7,17.1,2377,976,1401,7.9,19.3,-264,-2.2,34.2,0,192,192,836
2010,31,e) 4,1698,1796,13547,13949,57,3,217,11.5,1614,138,1476,1,11.6,2418,942,1476,6.8,17.3,-804,-5.7,23.2,0,142,142,739
2010,31,f) 5,1512,1539,10823,11038,43,2.7,168,10.5,1662,147,1515,1.3,15.1,2091,833,1258,7.5,18.9,-429,-3.8,30.2,0,133,133,765
2010,31,g) 6 to 10,6093,6402,55400,56509,184,2.8,591,9,6626,782,5844,1.4,11.7,8844,3152,5692,5.6,15.7,-2218,-4,23.4,0,385,390,2158
2010,31,h) 11 to 15,4623,5109,66112,67291,151,2.9,361,6.9,5562,968,4594,1.4,8.3,7919,2223,5696,3.3,11.8,-2357,-3.5,16.6,0,218,218,1651
2010,31,i) 16 to 20,3323,3736,40355,40964,115,3,244,6.4,4573,1296,3277,3.2,11.2,5790,1195,4595,2.9,14.1,-1217,-2.9,22.4,0,155,155,650
2010,31,j) 21 to 25,2835,3553,77106,78749,106,3,157,4.4,4721,869,3852,1.1,6,8006,1045,6961,1.3,10.2,-3285,-4.2,12,0,88,88,616
2010,31,k) 26+,3819,5611,99525,99628,222,4,242,4.3,10706,2887,7819,2.9,10.7,10911,1440,9471,1.4,11,-205,-0.3,21.4,0,121,121,556
2010,31,l) Left Censored,5361,11136,357395,359658,455,4.1,425,3.8,27945,8707,19238,2.4,7.8,32470,4454,28016,1.2,9,-4525,-1.2,15.6,0,122,130,905
2010,32,a) 0,4195,4247,34582,17503,4167,196.2,0,0,34159,34159,0,195.2,195.2,0,0,0,0,0,34159,195.2,0,0,,,
2010,32,b) 1,3143,3206,24758,27491,10,0.3,1206,31.3,6265,37,6228,0.1,22.8,11731,6113,5618,22.2,42.7,-5466,-19.9,45.6,0,984,984,5463
2010,32,c) 2,3061,3137,28985,31327,133,3.8,811,23.3,4998,704,4294,2.2,16,9682,4238,5444,13.5,30.9,-4684,-14.9,32,0,650,650,3671
2010,32,d) 3,2703,2780,24013,26640,107,3.5,609,20.1,3810,625,3185,2.3,14.3,9063,5148,3915,19.3,34,-5253,-19.7,28.6,0,483,483,4779
2010,32,e) 4,2608,2740,27357,28876,111,3.7,550,18.6,4512,810,3702,2.8,15.6,7550,2874,4676,10,26.1,-3038,-10.5,31.2,0,424,425,2260
2010,32,f) 5,2213,2325,22659,24633,97,3.9,444,17.7,3365,789,2576,3.2,13.7,7313,2731,4582,11.1,29.7,-3948,-16,27.4,0,363,363,2396
2010,32,g) 6 to 10,7615,8068,112866,119083,318,3.7,1225,14.4,11680,2695,8985,2.3,9.8,24114,7978,16136,6.7,20.2,-12434,-10.4,19.6,0,902,903,6425
2010,32,h) 11 to 15,4574,5299,80164,82604,216,3.9,590,10.7,10153,1991,8162,2.4,12.3,15032,4613,10419,5.6,18.2,-4879,-5.9,24.6,0,398,398,3197
2010,32,i) 16 to 20,2578,3069,57985,60986,108,3.4,281,8.9,5278,967,4311,1.6,8.7,11279,2933,8346,4.8,18.5,-6001,-9.8,17.4,0,189,189,1860
2010,32,j) 21 to 25,1993,2891,55823,57361,115,3.9,199,6.8,5652,1783,3869,3.1,9.9,8727,1911,6816,3.3,15.2,-3075,-5.3,19.8,0,117,117,1094
2010,32,k) 26+,2433,4466,125357,130452,272,6.1,276,6.2,11246,4609,6637,3.5,8.6,21435,2792,18643,2.1,16.4,-10189,-7.8,17.2,0,101,101,976
2010,32,l) Left Censored,2933,9276,402622,407029,696,7.5,579,6.3,45435,19529,25906,4.8,11.2,54249,8310,45939,2,13.3,-8814,-2.1,22.4,0,58,63,681
2010,33,a) 0,1685,1719,9775,4993,1683,195.8,0,0,9564,9564,0,191.5,191.5,0,0,0,0,0,9564,191.5,0,0,,,
2010,33,b) 1,1332,1344,7931,8198,4,0.3,353,22.9,1848,24,1824,0.3,22.5,2382,1129,1253,13.8,29.1,-534,-6.6,45,0,279,279,951
2010,33,c) 2,1404,1418,11664,12065,39,2.5,271,17.7,1668,100,1568,0.8,13.8,2470,1272,1198,10.5,20.5,-802,-6.7,27.6,0,212,212,1090
2010,33,d) 3,1260,1278,8519,8689,50,3.7,193,14.3,1328,391,937,4.5,15.3,1667,567,1100,6.5,19.2,-339,-3.9,30.6,0,145,145,473
2010,33,e) 4,1322,1404,11699,11886,47,3.2,204,13.7,1531,154,1377,1.3,12.9,1904,695,1209,5.8,16,-373,-3.1,25.8,0,155,155,528
2010,33,f) 5,1160,1190,8993,9599,38,3,154,12.3,1003,188,815,2,10.4,2214,890,1324,9.3,23.1,-1211,-12.7,20.8,0,122,122,807
2010,33,g) 6 to 10,4434,4609,38680,39799,148,3.1,527,11,4384,725,3659,1.8,11,6621,2188,4433,5.5,16.6,-2237,-5.6,22,0,379,380,1825
2010,33,h) 11 to 15,3732,3978,41397,41518,141,3.5,322,7.9,5667,1530,4137,3.7,13.6,5908,1020,4888,2.5,14.2,-241,-0.6,27.2,0,233,233,698
2010,33,i) 16 to 20,2683,2864,32464,32970,83,2.9,172,5.9,3397,498,2899,1.5,10.3,4408,1233,3175,3.7,13.4,-1011,-3.1,20.6,0,122,122,595
2010,33,j) 21 to 25,2566,3083,49710,49705,102,3.3,187,6,6064,2353,3711,4.7,12.2,6054,1092,4962,2.2,12.2,10,0,24.4,0,108,113,698
2010,33,k) 26+,2381,3410,67084,67379,129,3.8,173,5,9393,1178,8215,1.7,13.9,9983,1808,8175,2.7,14.8,-590,-0.9,27.8,0,86,86,980
2010,33,l) Left Censored,3203,7141,266776,267026,345,4.8,388,5.4,24124,5686,18438,2.1,9,24623,6082,18541,2.3,9.2,-499,-0.2,18,0,83,83,1970
2010,34,a) 0,12057,12176,67247,33986,11957,196.4,0,0,66522,66522,0,195.7,195.7,0,0,0,0,0,66522,195.7,0,0,,,
2010,34,b) 1,9385,9455,59117,61761,19,0.2,2889,26.1,13518,270,13248,0.4,21.9,18805,10936,7869,17.7,30.4,-5287,-8.5,43.8,0,2172,2184,9295
2010,34,c) 2,9241,9323,71913,72253,403,4,2021,19.9,18013,1637,16376,2.3,24.9,18692,10153,8539,14.1,25.9,-679,-1,49.8,0,1563,1563,8183
2010,34,d) 3,8695,8786,62404,66373,361,3.8,1603,17,9332,1010,8322,1.5,14.1,17270,8161,9109,12.3,26,-7938,-11.9,28.2,0,1231,1234,7081
2010,34,e) 4,8479,8763,67548,70368,332,3.6,1435,15.4,8374,1136,7238,1.6,11.9,14013,6286,7727,8.9,19.9,-5639,-8,23.8,0,1085,1085,5014
2010,34,f) 5,7703,7870,64045,65671,302,3.6,1226,14.7,9382,1894,7488,2.9,14.3,12634,5631,7003,8.6,19.2,-3252,-4.9,28.6,0,926,926,4060
2010,34,g) 6 to 10,28921,29832,289992,297875,1010,3.2,3625,11.6,33333,7776,25557,2.6,11.2,49099,17160,31939,5.8,16.5,-15766,-5.3,22.4,0,2590,2590,12798
2010,34,h) 11 to 15,22690,24271,272225,279993,788,3.2,2189,8.8,29280,5022,24258,1.8,10.5,44816,16609,28207,5.9,16,-15536,-5.5,21,0,1474,1474,13723
2010,34,i) 16 to 20,14961,15956,197641,203651,458,2.8,1264,7.7,18400,3075,15325,1.5,9,30419,6642,23777,3.3,14.9,-12019,-5.9,18,0,870,870,4784
2010,34,j) 21 to 25,13513,15626,265581,267672,538,3.4,1124,7.1,27451,6105,21346,2.3,10.3,31632,8885,22747,3.3,11.8,-4181,-1.5,20.6,0,685,694,4991
2010,34,k) 26+,14306,19193,412837,416200,656,3.4,1126,5.8,37786,12795,24991,3.1,9.1,44512,9710,34802,2.3,10.7,-6726,-1.6,18.2,0,634,635,4285
2010,34,l) Left Censored,17785,40347,1497073,1517098,1887,4.6,3014,7.4,130200,37255,92945,2.5,8.6,170251,46680,123571,3.1,11.2,-40051,-2.6,17.2,0,692,697,7578
2010,35,a) 0,2031,2056,11687,5939,2017,196.2,0,0,11496,11496,0,193.6,193.6,0,0,0,0,0,11496,193.6,0,0,,,
2010,35,b) 1,1748,1766,11927,12290,8,0.4,566,27.2,2769,144,2625,1.2,22.5,3495,1848,1647,15,28.4,-726,-5.9,45,0,448,448,1613
2010,35,c) 2,1746,1787,13017,13259,96,5,402,20.8,2502,476,2026,3.6,18.9,2985,1663,1322,12.5,22.5,-483,-3.6,37.8,0,307,307,1278
2010,35,d) 3,1662,1673,23165,23409,66,3.6,344,19,2199,211,1988,0.9,9.4,2687,1293,1394,5.5,11.5,-488,-2.1,18.8,0,252,252,1004
2010,35,e) 4,1636,1728,14539,15097,76,4.2,271,14.8,1886,314,1572,2.1,12.5,3001,1304,1697,8.6,19.9,-1115,-7.4,25,0,202,202,1007
2010,35,f) 5,1430,1490,12173,12498,54,3.4,259,16.3,2052,413,1639,3.3,16.4,2702,1116,1586,8.9,21.6,-650,-5.2,32.8,0,206,206,931
2010,35,g) 6 to 10,5432,5815,54379,55894,200,3.3,661,10.9,7204,2034,5170,3.6,12.9,10233,3867,6366,6.9,18.3,-3029,-5.4,25.8,0,472,473,2968
2010,35,h) 11 to 15,4076,4387,56488,57598,145,3.2,419,9.3,5377,766,4611,1.3,9.3,7596,1828,5768,3.2,13.2,-2219,-3.9,18.6,0,286,286,1392
2010,35,i) 16 to 20,3007,3433,41690,42471,110,3.1,283,8,4857,815,4042,1.9,11.4,6418,1760,4658,4.1,15.1,-1561,-3.7,22.8,0,167,167,1052
2010,35,j) 21 to 25,2346,3079,59102,59720,80,2.6,162,5.2,5294,1123,4171,1.9,8.9,6529,1103,5426,1.8,10.9,-1235,-2,17.8,0,100,100,547
2010,35,k) 26+,3052,4402,78684,79418,134,3,255,5.7,6878,1147,5731,1.4,8.7,8345,1820,6525,2.3,10.5,-1467,-1.8,17.4,0,131,131,706
2010,35,l) Left Censored,3290,8224,217665,223189,363,4.4,370,4.5,18399,5085,13314,2.3,8.2,29447,3921,25526,1.8,13.2,-11048,-5,16.4,0,57,57,1150
2010,36,a) 0,33956,34363,178740,90032,33809,196.8,0,0,177417,177417,0,197.1,197.1,0,0,0,0,0,177417,197.1,0,0,,,
2010,36,b) 1,25710,25854,154013,161341,59,0.2,7203,24.2,34724,1505,33219,0.9,21.5,49380,25889,23491,16,30.6,-14656,-9.1,43,0,5415,5423,22111
2010,36,c) 2,23786,24039,154799,160946,987,3.8,4899,18.9,27053,3488,23565,2.2,16.8,39347,20895,18452,13,24.4,-12294,-7.6,33.6,0,3773,3773,17530
2010,36,d) 3,20719,20874,134767,139945,839,3.8,3674,16.5,21708,2569,19139,1.8,15.5,32063,17064,14999,12.2,22.9,-10355,-7.4,31,0,2790,2790,14701
2010,36,e) 4,19675,20468,154027,159512,789,3.6,3108,14.4,20983,3673,17310,2.3,13.2,31952,14391,17561,9,20,-10969,-6.8,26.4,0,2357,2357,11609
2010,36,f) 5,17421,17836,149121,154050,645,3.4,2552,13.6,20254,2555,17699,1.7,13.1,30112,11827,18285,7.7,19.5,-9858,-6.4,26.2,0,1928,1928,9168
2010,36,g) 6 to 10,65199,67244,626767,647469,2258,3.2,7767,11.1,72984,10663,62321,1.6,11.3,114387,41923,72464,6.5,17.7,-41403,-6.4,22.6,0,5598,5603,33199
2010,36,h) 11 to 15,46538,49614,577687,588586,1496,2.9,4285,8.4,58848,9463,49385,1.6,10,80646,27182,53464,4.6,13.7,-21798,-3.7,20,0,2952,2958,17947
2010,36,i) 16 to 20,32093,34606,420568,429123,978,2.8,2517,7.1,41544,8529,33015,2,9.7,58654,16285,42369,3.8,13.7,-17110,-4,19.4,0,1706,1710,11422
2010,36,j) 21 to 25,29653,33653,568130,573467,1062,3.1,2046,6,48918,10557,38361,1.8,8.5,59592,18032,41560,3.1,10.4,-10674,-1.9,17,0,1195,1198,9195
2010,36,k) 26+,30260,42036,891511,898939,1108,2.6,2086,4.9,76452,15229,61223,1.7,8.5,91308,17038,74270,1.9,10.2,-14856,-1.7,17,0,1249,1258,10742
2010,36,l) Left Censored,39263,86631,3248313,3279958,3541,4.1,4739,5.4,286039,82567,203472,2.5,8.7,349328,80188,269140,2.4,10.7,-63289,-2,17.4,0,1418,1424,17167
2010,37,a) 0,11309,11473,75830,38148,11284,196.7,0,0,75365,75365,0,197.6,197.6,0,0,0,0,0,75365,197.6,0,0,,,
2010,37,b) 1,8537,8709,57990,62502,33,0.3,2522,25,12306,807,11499,1.3,19.7,21330,10961,10369,17.5,34.1,-9024,-14.4,39.4,0,1947,1947,9354
2010,37,c) 2,8780,8987,63245,66796,387,4,1953,20,10177,1545,8632,2.3,15.2,17278,8699,8579,13,25.9,-7101,-10.7,30.4,0,1472,1472,7212
2010,37,d) 3,8279,8421,57094,59578,321,3.5,1644,18.1,9524,1744,7780,2.9,16,14492,7297,7195,12.2,24.3,-4968,-8.3,32,0,1242,1242,6293
2010,37,e) 4,7914,8501,68659,71920,426,4.8,1316,14.7,9611,2327,7284,3.2,13.4,16132,7146,8986,9.9,22.4,-6521,-9,26.8,0,984,984,5821
2010,37,f) 5,7124,7337,61660,64076,259,3.3,1093,14.1,8552,1696,6856,2.6,13.3,13383,5217,8166,8.1,20.9,-4831,-7.6,26.6,0,830,831,4186
2010,37,g) 6 to 10,25922,27532,267766,278711,902,3.1,3081,10.8,30498,6221,24277,2.2,10.9,52388,18330,34058,6.6,18.8,-21890,-7.9,21.8,0,2222,2227,13874
2010,37,h) 11 to 15,19048,21298,265732,272538,675,3.1,2026,9.2,25896,6026,19870,2.2,9.5,39508,11576,27932,4.2,14.5,-13612,-5,19,0,1348,1353,8406
2010,37,i) 16 to 20,12444,14434,198181,202468,451,3.1,1078,7.3,20275,6846,13429,3.4,10,28848,6625,22223,3.3,14.2,-8573,-4.2,20,0,716,718,4115
2010,37,j) 21 to 25,10756,13989,267888,274066,432,3,991,6.9,24154,6818,17336,2.5,8.8,36510,7009,29501,2.6,13.3,-12356,-4.5,17.6,0,590,617,4165
2010,37,k) 26+,12881,20198,412280,416786,711,3.5,1011,5,38185,9976,28209,2.4,9.2,47197,9568,37629,2.3,11.3,-9012,-2.1,18.4,0,512,512,2992
2010,37,l) Left Censored,14071,44240,1455976,1481353,2362,5.3,2846,6.4,138294,34319,103975,2.3,9.3,189049,41706,147343,2.8,12.8,-50755,-3.5,18.6,0,459,465,4970
2010,38,a) 0,959,973,5149,2608,950,195.3,0,0,5082,5082,0,194.9,194.9,0,0,0,0,0,5082,194.9,0,0,,,
2010,38,b) 1,823,834,5531,5680,4,0.4,210,22.2,1198,27,1171,0.5,21.1,1495,589,906,10.4,26.3,-297,-5.2,42.2,0,130,130,436
2010,38,c) 2,818,834,6112,6061,33,3.8,117,13.4,1184,86,1098,1.4,19.5,1082,512,570,8.4,17.9,102,1.6,35.8,0,82,82,415
2010,38,d) 3,734,748,5522,5647,35,4.5,105,13.4,822,95,727,1.7,14.6,1072,409,663,7.2,19,-250,-4.4,29.2,0,73,73,333
2010,38,e) 4,754,799,6478,6357,33,4,74,9,1023,169,854,2.7,16.1,781,279,502,4.4,12.3,242,3.8,24.6,0,44,44,193
2010,38,f) 5,636,652,5203,5215,22,3.3,53,7.9,1059,462,597,8.9,20.3,1083,459,624,8.8,20.8,-24,-0.5,40.6,0,37,37,382
2010,38,g) 6 to 10,2306,2416,21014,21048,69,2.8,192,7.8,2897,420,2477,2,13.8,2965,863,2102,4.1,14.1,-68,-0.3,27.6,0,125,125,586
2010,38,h) 11 to 15,1756,1917,20429,20680,89,4.6,122,6.3,2384,599,1785,2.9,11.5,2886,436,2450,2.1,14,-502,-2.5,23,0,81,81,329
2010,38,i) 16 to 20,1488,1581,17750,17577,60,3.8,88,5.5,2138,369,1769,2.1,12.2,1792,290,1502,1.6,10.2,346,2,20.4,0,61,61,244
2010,38,j) 21 to 25,1243,1449,18567,18550,39,2.7,64,4.4,1996,406,1590,2.2,10.8,1962,334,1628,1.8,10.6,34,0.2,21.2,0,43,43,254
2010,38,k) 26+,1802,2410,41114,41037,71,2.9,114,4.7,4677,1212,3465,3,11.4,4523,808,3715,2,11,154,0.4,22,0,61,61,419
2010,38,l) Left Censored,2495,4791,139554,140221,179,3.7,169,3.5,10330,1792,8538,1.3,7.4,11663,2731,8932,1.9,8.3,-1333,-0.9,14.8,0,47,47,407
2010,39,a) 0,9549,9853,77238,38854,9706,197,0,0,76768,76768,0,197.6,197.6,0,0,0,0,0,76768,197.6,0,0,,,
2010,39,b) 1,7629,7768,64861,68288,38,0.4,2217,24.7,14350,577,13773,0.8,21,21204,12268,8936,18,31.1,-6854,-10.1,42,0,1635,1635,10709
2010,39,c) 2,7825,8027,67282,70035,298,3.5,1474,17.1,11643,1098,10545,1.6,16.6,17149,7696,9453,11,24.5,-5506,-7.9,33.2,0,1122,1122,6682
2010,39,d) 3,7093,7282,60780,62836,276,3.5,1320,16.9,10465,1365,9100,2.2,16.7,14577,7224,7353,11.5,23.2,-4112,-6.5,33.4,0,1032,1032,6015
2010,39,e) 4,7268,7685,75627,78574,269,3.3,1148,14.1,10195,1731,8464,2.2,13,16088,6823,9265,8.7,20.5,-5893,-7.5,26,0,863,863,5901
2010,39,f) 5,6766,7065,75278,76681,231,3.1,915,12.4,11325,2730,8595,3.6,14.8,14130,4409,9721,5.7,18.4,-2805,-3.6,29.6,0,673,673,3609
2010,39,g) 6 to 10,26398,28251,292858,304402,871,3,3084,10.5,34360,5973,28387,2,11.3,57447,21825,35622,7.2,18.9,-23087,-7.6,22.6,0,2136,2137,14494
2010,39,h) 11 to 15,21833,24535,278474,286663,812,3.2,2132,8.5,27485,6923,20562,2.4,9.6,43863,10912,32951,3.8,15.3,-16378,-5.7,19.2,0,1395,1400,8369
2010,39,i) 16 to 20,16904,20199,269587,275567,639,3.1,1450,7,28813,5920,22893,2.1,10.5,40772,13827,26945,5,14.8,-11959,-4.3,21,0,891,892,10783
2010,39,j) 21 to 25,14716,19029,336679,341190,644,3.3,1100,5.7,31995,12090,19905,3.5,9.4,41016,7945,33071,2.3,12,-9021,-2.6,18.8,0,634,634,4594
2010,39,k) 26+,17812,26892,547438,555447,732,2.7,1418,5.2,52731,12365,40366,2.2,9.5,68748,14170,54578,2.6,12.4,-16017,-2.9,19,0,713,720,6140
2010,39,l) Left Censored,24983,64054,2184685,2214784,2528,3.9,2972,4.6,168989,39217,129772,1.8,7.6,229187,38884,190303,1.8,10.3,-60198,-2.7,15.2,0,796,807,8785
2010,40,a) 0,4550,4605,30712,15512,4506,195.7,0,0,30400,30400,0,196,196,0,0,0,0,0,30400,196,0,0,,,
2010,40,b) 1,3803,3849,25390,27033,14,0.3,1112,24.9,5211,442,4769,1.6,19.3,8497,5067,3430,18.7,31.4,-3286,-12.1,38.6,0,860,860,4378
2010,40,c) 2,3711,3778,27901,29875,141,3.4,809,19.7,4641,927,3714,3.1,15.5,8588,4523,4065,15.1,28.7,-3947,-13.2,31,0,620,620,3658
2010,40,d) 3,3423,3494,28484,30709,123,3.3,563,15.1,3857,819,3038,2.7,12.6,8306,3889,4417,12.7,27,-4449,-14.4,25.2,0,432,432,3353
2010,40,e) 4,3253,3457,29008,30294,131,3.6,483,13.3,3560,677,2883,2.2,11.8,6132,2779,3353,9.2,20.2,-2572,-8.4,23.6,0,365,365,1988
2010,40,f) 5,2878,3001,28061,29954,91,2.9,390,12.4,3109,567,2542,1.9,10.4,6894,2941,3953,9.8,23,-3785,-12.6,20.8,0,297,308,2529
2010,40,g) 6 to 10,10527,11224,105176,109362,307,2.6,1086,9.3,11223,1601,9622,1.5,10.3,19594,6337,13257,5.8,17.9,-8371,-7.6,20.6,0,813,813,5111
2010,40,h) 11 to 15,8010,8902,93983,97113,268,2.9,716,7.9,9787,2031,7756,2.1,10.1,16046,4969,11077,5.1,16.5,-6259,-6.4,20.2,0,470,470,2974
2010,40,i) 16 to 20,5826,6683,87269,88434,197,2.9,463,6.8,9358,1986,7372,2.2,10.6,11687,2833,8854,3.2,13.2,-2329,-2.6,21.2,0,300,300,1684
2010,40,j) 21 to 25,4525,5579,97333,100814,168,3,310,5.5,9053,3730,5323,3.7,9,16017,3643,12374,3.6,15.9,-6964,-6.9,18,0,197,197,1866
2010,40,k) 26+,6810,9856,187174,189815,289,2.9,453,4.6,15805,4411,11394,2.3,8.3,21087,3813,17274,2,11.1,-5282,-2.8,16.6,0,265,265,1751
2010,40,l) Left Censored,6662,17340,491328,502915,639,3.7,676,3.9,36410,10547,25863,2.1,7.2,59584,9083,50501,1.8,11.8,-23174,-4.6,14.4,0,181,186,1477
2010,41,a) 0,5611,5695,27693,13952,5598,196.6,0,0,27483,27483,0,197,197,0,0,0,0,0,27483,197,0,0,,,
2010,41,b) 1,4518,4553,23818,25815,12,0.2,1328,25.1,5474,72,5402,0.3,21.2,9467,5884,3583,22.8,36.7,-3993,-15.5,42.4,0,994,994,5119
2010,41,c) 2,4668,4739,25265,26474,221,4.3,1020,19.8,4679,689,3990,2.6,17.7,7097,3622,3475,13.7,26.8,-2418,-9.1,35.4,0,759,759,3003
2010,41,d) 3,4286,4367,26478,27447,211,4.5,853,18.2,4638,651,3987,2.4,16.9,6576,3225,3351,11.7,24,-1938,-7.1,33.8,0,624,624,2647
2010,41,e) 4,4222,4633,31466,32013,251,5.2,717,14.7,5076,1294,3782,4,15.9,6169,2489,3680,7.8,19.3,-1093,-3.4,31.8,0,514,514,1950
2010,41,f) 5,3681,3787,24671,26389,154,3.8,585,14.6,3030,453,2577,1.7,11.5,6466,2447,4019,9.3,24.5,-3436,-13,23,0,423,426,1998
2010,41,g) 6 to 10,13604,14543,137181,132051,675,4.5,1621,10.8,31886,4007,27879,3,24.1,21626,6755,14871,5.1,16.4,10260,7.7,32.8,0,1117,1119,5123
2010,41,h) 11 to 15,10262,11109,120525,124798,401,3.5,1054,9.2,10950,1583,9367,1.3,8.8,19496,4816,14680,3.9,15.6,-8546,-6.8,17.6,0,667,685,3744
2010,41,i) 16 to 20,7080,8105,86734,87933,264,3.2,601,7.3,10152,1506,8646,1.7,11.5,12550,3387,9163,3.9,14.3,-2398,-2.8,23,0,400,400,2399
2010,41,j) 21 to 25,5236,6459,98600,101336,234,3.6,406,6.2,9419,3014,6405,3,9.3,14890,3175,11715,3.1,14.7,-5471,-5.4,18.6,0,243,243,1659
2010,41,k) 26+,6492,9720,200102,201377,340,3.5,553,5.6,20357,3985,16372,2,10.1,22906,4268,18638,2.1,11.4,-2549,-1.3,20.2,0,263,263,2000
2010,41,l) Left Censored,6880,17951,542586,549636,851,4.7,847,4.7,44471,14544,29927,2.6,8.1,58571,12508,46063,2.3,10.7,-14100,-2.6,16.2,0,184,192,5157
2010,42,a) 0,11937,12274,82851,41686,12084,196.9,0,0,82330,82330,0,197.5,197.5,0,0,0,0,0,82330,197.5,0,0,,,
2010,42,b) 1,10022,10152,71890,75305,29,0.2,2785,23.9,15952,455,15497,0.6,21.2,22781,12226,10555,16.2,30.3,-6829,-9.1,42.4,0,2112,2112,10248
2010,42,c) 2,10085,10249,68893,75086,376,3.4,1877,17,11467,1345,10122,1.8,15.3,23852,15755,8097,21,31.8,-12385,-16.5,30.6,0,1447,1447,14343
2010,42,d) 3,9311,9448,70458,72458,344,3.4,1477,14.7,10035,1352,8683,1.9,13.8,14035,6883,7152,9.5,19.4,-4000,-5.6,27.6,0,1127,1127,5825
2010,42,e) 4,9328,9814,92375,92469,327,3.2,1260,12.3,15398,1260,14138,1.4,16.7,15585,6550,9035,7.1,16.9,-187,-0.2,33.4,0,936,936,5662
2010,42,f) 5,8798,9153,81051,83908,296,3.1,1116,11.7,10934,1780,9154,2.1,13,16647,6247,10400,7.4,19.8,-5713,-6.8,26,0,850,850,5273
2010,42,g) 6 to 10,33958,35793,374206,387726,1089,2.9,3407,9.2,39297,8085,31212,2.1,10.1,66337,28362,37975,7.3,17.1,-27040,-7,20.2,0,2381,2381,23812
2010,42,h) 11 to 15,26445,29357,360464,362864,928,3.1,2129,7.1,40957,7731,33226,2.1,11.3,45756,12193,33563,3.4,12.6,-4799,-1.3,22.6,0,1408,1409,8855
2010,42,i) 16 to 20,19514,22014,293376,297597,674,3,1390,6.2,31022,7008,24014,2.4,10.4,39463,11569,27894,3.9,13.3,-8441,-2.9,20.8,0,919,919,8188
2010,42,j) 21 to 25,18444,22375,395089,399645,778,3.4,1287,5.7,43088,15800,27288,4,10.8,52200,9752,42448,2.4,13.1,-9112,-2.3,21.6,0,779,779,5715
2010,42,k) 26+,20577,30346,650664,655528,1026,3.4,1422,4.7,64870,18725,46145,2.9,9.9,74598,17446,57152,2.7,11.4,-9728,-1.5,19.8,0,734,744,6601
2010,42,l) Left Censored,27629,69656,2395696,2425438,2795,4,3441,4.9,190527,47948,142579,2,7.9,250011,55071,194940,2.3,10.3,-59484,-2.4,15.8,0,747,752,9373
2010,44,a) 0,1254,1268,6908,3543,1244,196.2,0,0,6730,,,,190,0,0,0,0,0,6730,190,0,1,,,
2010,44,b) 1,916,934,5777,6263,8,0.7,291,26.6,1425,,,,22.8,2396,1651,745,26.4,38.3,-971,-15.5,45.6,1,220,220,1197
2010,44,c) 2,987,995,7291,7668,45,4.1,241,22.1,1048,105,943,1.4,13.7,1801,926,875,12.1,23.5,-753,-9.8,27.4,0,189,189,783
2010,44,d) 3,917,925,7069,7106,44,4.5,168,17.1,1463,129,1334,1.8,20.6,1537,702,835,9.9,21.6,-74,-1,41.2,0,114,114,516
2010,44,e) 4,928,992,7221,7413,56,5.3,174,16.5,959,209,750,2.8,12.9,1343,589,754,7.9,18.1,-384,-5.2,25.8,0,119,119,451
2010,44,f) 5,892,900,6465,6655,32,3.4,112,12,915,243,672,3.7,13.7,1294,369,925,5.5,19.4,-379,-5.7,27.4,0,86,86,332
2010,44,g) 6 to 10,3467,3621,29706,31529,136,3.6,409,10.9,3357,424,2933,1.3,10.6,7003,2006,4997,6.4,22.2,-3646,-11.6,21.2,0,281,281,1733
2010,44,h) 11 to 15,2626,2849,27414,27982,126,4.3,263,9,3387,854,2533,3.1,12.1,4523,1113,3410,4,16.2,-1136,-4.1,24.2,0,182,182,925
2010,44,i) 16 to 20,2010,2109,23970,24840,69,3.2,161,7.4,2282,363,1919,1.5,9.2,4021,852,3169,3.4,16.2,-1739,-7,18.4,0,103,103,464
2010,44,j) 21 to 25,1953,2191,30772,31031,102,4.6,155,7,3287,1223,2064,3.9,10.6,3804,866,2938,2.8,12.3,-517,-1.7,21.2,0,105,105,688
2010,44,k) 26+,2045,2633,48901,50182,97,3.7,124,4.7,5633,2626,3007,5.2,11.2,8194,1438,6756,2.9,16.3,-2561,-5.1,22.4,0,64,64,462
2010,44,l) Left Censored,3245,5628,194119,197584,238,4.2,284,5,12015,3892,8123,2,6.1,18945,2823,16122,1.4,9.6,-6930,-3.5,12.2,0,87,87,1003
2010,45,a) 0,5040,5087,31260,15735,4995,196.4,0,0,31051,31051,0,197.3,197.3,0,0,0,0,0,31051,197.3,0,0,,,
2010,45,b) 1,4020,4177,35396,37679,18,0.4,1187,24.6,5739,217,5522,0.6,15.2,10305,5816,4489,15.4,27.3,-4566,-12.1,30.4,0,945,945,5122
2010,45,c) 2,3995,4038,24922,26289,179,4.1,911,20.8,4061,722,3339,2.7,15.4,6795,3453,3342,13.1,25.8,-2734,-10.4,30.8,0,750,750,3067
2010,45,d) 3,3805,3882,29160,30457,160,3.8,788,18.8,4419,696,3723,2.3,14.5,7013,3535,3478,11.6,23,-2594,-8.5,29,0,600,600,2759
2010,45,e) 4,3614,3756,29690,31031,147,3.7,615,15.4,4072,1042,3030,3.4,13.1,6753,2521,4232,8.1,21.8,-2681,-8.7,26.2,0,485,487,2196
2010,45,f) 5,3377,3559,32506,34057,129,3.4,516,13.7,3853,569,3284,1.7,11.3,6955,2685,4270,7.9,20.4,-3102,-9.1,22.6,0,389,389,2227
2010,45,g) 6 to 10,12527,13241,137641,142068,405,2.9,1544,11.2,16863,3940,12923,2.8,11.9,25717,9881,15836,7,18.1,-8854,-6.2,23.8,0,1132,1132,8006
2010,45,h) 11 to 15,8987,9922,124597,129342,311,3,948,9.3,11547,3321,8226,2.6,8.9,21036,5062,15974,3.9,16.3,-9489,-7.4,17.8,0,655,659,3846
2010,45,i) 16 to 20,6029,6892,88455,90232,212,3,566,8,9147,2312,6835,2.6,10.1,12701,3333,9368,3.7,14.1,-3554,-4,20.2,0,393,393,2223
2010,45,j) 21 to 25,5175,7177,119200,119837,273,3.8,436,6,14350,3762,10588,3.1,12,15623,3324,12299,2.8,13,-1273,-1,24,0,265,292,1448
2010,45,k) 26+,6065,9467,184075,185158,397,4.2,466,4.9,21217,7264,13953,3.9,11.5,23383,3805,19578,2.1,12.6,-2166,-1.1,23,0,255,261,1682
2010,45,l) Left Censored,7145,21276,650435,660828,918,4.3,1088,5.1,56567,17908,38659,2.7,8.6,77353,11739,65614,1.8,11.7,-20786,-3.1,17.2,0,211,217,2161
2010,46,a) 0,1174,1223,7886,3978,1202,196.6,0,0,7817,,,,196.5,0,0,0,0,0,7817,196.5,0,1,,,
2010,46,b) 1,1035,1044,6476,6737,5,0.4,273,22.8,1611,,,,23.9,2133,1137,996,16.9,31.7,-522,-7.8,47.8,1,186,186,961
2010,46,c) 2,942,951,5988,6392,32,3.1,160,15.7,931,131,800,2,14.6,1739,791,948,12.4,27.2,-808,-12.6,29.2,0,115,115,701
2010,46,d) 3,959,976,6371,6750,36,3.5,145,14,829,120,709,1.8,12.3,1586,816,770,12.1,23.5,-757,-11.2,24.6,0,102,102,604
2010,46,e) 4,938,963,7220,7897,29,2.9,134,13.2,916,46,870,0.6,11.6,2269,628,1641,8,28.7,-1353,-17.1,23.2,0,91,91,509
2010,46,f) 5,735,749,4643,4750,24,3.1,91,11.7,613,56,557,1.2,12.9,827,300,527,6.3,17.4,-214,-4.5,25.8,0,60,60,209
2010,46,g) 6 to 10,3263,3441,29325,30061,94,2.7,283,8,3490,681,2809,2.3,11.6,4961,1399,3562,4.7,16.5,-1471,-4.9,23.2,0,189,189,1142
2010,46,h) 11 to 15,2442,2580,25501,25634,85,3.2,187,7.1,2742,583,2159,2.3,10.7,3007,952,2055,3.7,11.7,-265,-1,21.4,0,125,125,777
2010,46,i) 16 to 20,1713,1847,20703,21184,60,3.2,116,6.2,1919,444,1475,2.1,9.1,2880,772,2108,3.6,13.6,-961,-4.5,18.2,0,80,80,468
2010,46,j) 21 to 25,1327,1521,21166,21771,53,3.5,75,4.9,2151,894,1257,4.1,9.9,3361,758,2603,3.5,15.4,-1210,-5.5,19.8,0,49,49,460
2010,46,k) 26+,1790,2501,35238,35119,105,4.2,95,3.8,4009,1013,2996,2.9,11.4,3771,1431,2340,4.1,10.7,238,0.7,21.4,0,55,55,387
2010,46,l) Left Censored,2570,5022,150507,152079,145,2.9,176,3.5,9502,1235,8267,0.8,6.2,12646,1769,10877,1.2,8.3,-3144,-2.1,12.4,0,57,57,876
2010,47,a) 0,6205,6315,42761,21577,6221,197,0,0,42369,42369,0,196.4,196.4,0,0,0,0,0,42369,196.4,0,0,,,
2010,47,b) 1,4705,4907,35805,37813,48,0.8,1535,26.8,8719,488,8231,1.3,23.1,12735,8338,4397,22.1,33.7,-4016,-10.6,46.2,0,1277,1277,7498
2010,47,c) 2,4973,5094,36185,37863,188,3.4,1163,20.9,7402,1096,6306,2.9,19.5,10758,6135,4623,16.2,28.4,-3356,-8.9,39,0,936,936,4722
2010,47,d) 3,4472,4614,34022,36125,149,3,896,18,5370,695,4675,1.9,14.9,9576,4206,5370,11.6,26.5,-4206,-11.6,29.8,0,716,716,3452
2010,47,e) 4,4199,4447,42910,44737,127,2.7,746,15.7,6088,511,5577,1.1,13.6,9741,4123,5618,9.2,21.8,-3653,-8.2,27.2,0,579,579,3213
2010,47,f) 5,3795,4072,41302,43033,229,5.4,599,14.1,6922,2082,4840,4.8,16.1,10384,4742,5642,11,24.1,-3462,-8,32.2,0,458,465,4145
2010,47,g) 6 to 10,14204,15382,173175,178215,486,3,1699,10.6,21644,4508,17136,2.5,12.1,31723,12072,19651,6.8,17.8,-10079,-5.7,24.2,0,1301,1304,10077
2010,47,h) 11 to 15,11149,12709,152061,154352,428,3.3,1089,8.4,19951,5648,14303,3.7,12.9,24533,7331,17202,4.7,15.9,-4582,-3,25.8,0,777,777,5674
2010,47,i) 16 to 20,8092,9762,143925,149885,282,2.8,689,6.9,16268,2272,13996,1.5,10.9,28187,4656,23531,3.1,18.8,-11919,-7.9,21.8,0,483,483,2746
2010,47,j) 21 to 25,7146,9360,169429,171426,276,2.9,526,5.5,16979,5264,11715,3.1,9.9,20972,3842,17130,2.2,12.2,-3993,-2.3,19.8,0,331,331,2305
2010,47,k) 26+,8994,14448,313749,317602,475,3.3,686,4.7,32454,7353,25101,2.3,10.2,40159,9339,30820,2.9,12.6,-7705,-2.4,20.4,0,323,336,4467
2010,47,l) Left Censored,10160,30115,1067290,1078741,1219,4,1352,4.5,87074,21711,65363,2,8.1,109977,21569,88408,2,10.2,-22903,-2.1,16.2,0,287,290,3306
2010,48,a) 0,30581,31253,231855,116612,30827,197.3,0,0,230487,230487,0,197.7,197.7,0,0,0,0,0,230487,197.7,0,0,,,
2010,48,b) 1,23883,24328,198119,206442,126,0.4,7096,25.1,46572,1030,45542,0.5,22.6,63217,33886,29331,16.4,30.6,-16645,-8,45.2,0,5788,5788,28952
2010,48,c) 2,22979,23566,211304,217011,817,3.2,4783,18.7,45356,5211,40145,2.4,20.9,56769,29969,26800,13.8,26.2,-11413,-5.3,41.8,0,3937,3937,26117
2010,48,d) 3,20575,21074,183335,191945,708,3.1,3505,15.6,30049,4558,25491,2.4,15.7,47268,21401,25867,11.1,24.6,-17219,-8.9,31.4,0,2905,2905,19041
2010,48,e) 4,19053,20375,203825,211540,641,3,2817,13.1,27734,4112,23622,1.9,13.1,43164,16696,26468,7.9,20.4,-15430,-7.3,26.2,0,2218,2218,14112
2010,48,f) 5,16646,17683,210844,221460,525,2.8,2418,13,29969,3924,26045,1.8,13.5,51201,20005,31196,9,23.1,-21232,-9.6,27,0,1825,1830,15926
2010,48,g) 6 to 10,61963,67123,818981,838907,2121,3.1,6675,9.6,106507,20790,85717,2.5,12.7,146358,47750,98608,5.7,17.4,-39851,-4.7,25.4,0,5030,5033,38567
2010,48,h) 11 to 15,43425,49377,725945,744190,1647,3.3,4051,8,87616,22813,64803,3.1,11.8,124107,33557,90550,4.5,16.7,-36491,-4.9,23.6,0,2827,2842,24338
2010,48,i) 16 to 20,30836,37070,572700,584859,1202,3.2,2497,6.6,63846,14782,49064,2.5,10.9,88164,23111,65053,4,15.1,-24318,-4.2,21.8,0,1706,1706,13614
2010,48,j) 21 to 25,23112,31633,639304,650055,1159,3.6,1769,5.5,73810,27043,46767,4.2,11.4,95313,22259,73054,3.4,14.7,-21503,-3.3,22.8,0,1039,1040,7771
2010,48,k) 26+,30080,49221,1035084,1040431,1820,3.7,2360,4.8,114881,33430,81451,3.2,11,125574,28008,97566,2.7,12.1,-10693,-1.1,22,0,1216,1241,12455
2010,48,l) Left Censored,25120,99671,3623562,3677737,5623,5.7,5233,5.3,349843,110966,238877,3,9.5,458194,99080,359114,2.7,12.5,-108351,-3,19,0,779,808,13562
2010,49,a) 0,4669,4711,29364,14820,4614,195.9,0,0,29088,29088,0,196.3,196.3,0,0,0,0,0,29088,196.3,0,0,,,
2010,49,b) 1,3389,3427,21565,23341,10,0.2,1295,31.3,5340,84,5256,0.4,22.9,8892,5304,3588,22.7,38.1,-3552,-15.2,45.8,0,971,971,4324
2010,49,c) 2,3459,3532,22030,24054,206,5.3,900,23.2,4088,767,3321,3.2,17,8135,4199,3936,17.5,33.8,-4047,-16.8,34,0,682,682,3549
2010,49,d) 3,3255,3303,23508,24779,195,5.4,760,21.1,3946,514,3432,2.1,15.9,6487,2967,3520,12,26.2,-2541,-10.3,31.8,0,561,561,2493
2010,49,e) 4,3049,3191,25135,26775,148,4.3,573,16.8,3330,593,2737,2.2,12.4,6610,2504,4106,9.4,24.7,-3280,-12.3,24.8,0,393,393,1949
2010,49,f) 5,2565,2652,24143,26086,119,4.2,445,15.8,3040,417,2623,1.6,11.7,6925,2659,4266,10.2,26.5,-3885,-14.8,23.4,0,329,329,2355
2010,49,g) 6 to 10,9380,9750,105522,114096,437,4.3,1276,12.5,12793,2313,10480,2,11.2,29941,8623,21318,7.6,26.2,-17148,-15,22.4,0,822,822,6817
2010,49,h) 11 to 15,5847,6436,94116,97085,256,3.8,672,10.1,8487,1665,6822,1.7,8.7,14424,4335,10089,4.5,14.9,-5937,-6.2,17.4,0,433,433,3270
2010,49,i) 16 to 20,3478,3923,73585,74776,139,3.5,301,7.5,7716,2082,5634,2.8,10.3,10097,1928,8169,2.6,13.5,-2381,-3.2,20.6,0,186,186,1170
2010,49,j) 21 to 25,2387,3180,71523,72114,105,3.3,172,5.4,7504,1858,5646,2.6,10.4,8686,1507,7179,2.1,12,-1182,-1.6,20.8,0,100,100,921
2010,49,k) 26+,3008,4555,114425,117132,197,4.3,288,6.3,11754,2905,8849,2.5,10,17167,4784,12383,4.1,14.7,-5413,-4.7,20,0,108,130,1536
2010,49,l) Left Censored,3560,10280,401644,409071,507,4.9,527,5.1,32638,9666,22972,2.4,8,47492,8559,38933,2.1,11.6,-14854,-3.6,16,0,77,77,1665
2010,50,a) 0,853,853,4148,2084,840,197,0,0,4129,4129,0,198.1,198.1,0,0,0,0,0,4129,198.1,0,0,,,
2010,50,b) 1,709,716,6615,6933,3,0.4,196,23.7,980,46,934,0.7,14.1,1616,1020,596,14.7,23.3,-636,-9.2,28.2,0,133,133,779
2010,50,c) 2,719,725,4668,4836,38,4.9,145,18.7,677,95,582,2,14,1012,447,565,9.2,20.9,-335,-6.9,28,0,94,94,318
2010,50,d) 3,732,739,7604,7819,25,3.2,120,15.2,644,62,582,0.8,8.2,1074,392,682,5,13.7,-430,-5.5,16.4,0,86,86,320
2010,50,e) 4,676,697,4216,4363,22,3,112,15.1,570,54,516,1.2,13.1,864,409,455,9.4,19.8,-294,-6.7,26.2,0,79,79,356
2010,50,f) 5,618,630,4130,4190,32,4.9,81,12.5,651,112,539,2.7,15.5,771,265,506,6.3,18.4,-120,-2.9,31,0,57,57,196
2010,50,g) 6 to 10,2721,2799,26378,26211,122,4.3,252,8.8,3228,572,2656,2.2,12.3,2893,936,1957,3.6,11,335,1.3,22,0,155,155,703
2010,50,h) 11 to 15,2125,2238,18362,18461,64,2.8,179,7.8,2032,378,1654,2,11,2229,683,1546,3.7,12.1,-197,-1.1,22,0,113,113,391
2010,50,i) 16 to 20,1705,1872,15401,15709,48,2.5,118,6.2,1541,246,1295,1.6,9.8,2157,621,1536,4,13.7,-616,-3.9,19.6,0,66,66,290
2010,50,j) 21 to 25,1588,1744,27668,27859,70,4,116,6.6,1828,498,1330,1.8,6.6,2210,413,1797,1.5,7.9,-382,-1.3,13.2,0,63,63,266
2010,50,k) 26+,1658,2188,42270,42895,62,2.8,110,5,3251,677,2574,1.6,7.6,4501,929,3572,2.2,10.5,-1250,-2.9,15.2,0,64,68,605
2010,50,l) Left Censored,1990,3728,99782,100981,156,4.2,141,3.8,6243,1840,4403,1.8,6.2,8641,1279,7362,1.3,8.6,-2398,-2.4,12.4,0,51,53,560
2010,51,a) 0,9279,9470,55513,27964,9306,196.5,0,0,55099,55099,0,197,197,0,0,0,0,0,55099,197,0,0,,,
2010,51,b) 1,7728,7846,49344,52823,21,0.2,2236,24.7,12071,136,11935,0.3,22.9,19029,9481,9548,17.9,36,-6958,-13.1,45.8,0,1731,1731,8181
2010,51,c) 2,7801,7931,53831,55334,331,3.9,1558,18.2,9604,1264,8340,2.3,17.4,12610,5754,6856,10.4,22.8,-3006,-5.4,34.8,0,1203,1203,4561
2010,51,d) 3,7227,7322,52693,53955,290,3.7,1237,15.9,8957,1130,7827,2.1,16.6,11481,5060,6421,9.4,21.3,-2524,-4.7,33.2,0,952,952,4092
2010,51,e) 4,7088,7488,63806,65072,266,3.4,1129,14.3,9673,1045,8628,1.6,14.9,12205,4878,7327,7.5,18.8,-2532,-3.9,29.8,0,839,846,4171
2010,51,f) 5,6350,6557,54913,56025,237,3.4,912,13.2,8132,1335,6797,2.4,14.5,10356,4153,6203,7.4,18.5,-2224,-4,29,0,677,677,3578
2010,51,g) 6 to 10,23022,24268,248092,252130,851,3.4,2573,10.2,32548,4536,28012,1.8,12.9,40623,13107,27516,5.2,16.1,-8075,-3.2,25.8,0,1849,1849,10177
2010,51,h) 11 to 15,17069,18902,235522,244680,570,2.9,1554,8,24673,4122,20551,1.7,10.1,42989,17044,25945,7,17.6,-18316,-7.5,20.2,0,1024,1024,12159
2010,51,i) 16 to 20,12097,13948,202809,207225,431,3,1015,7.1,23218,5772,17446,2.8,11.2,32050,7671,24379,3.7,15.5,-8832,-4.3,22.4,0,625,626,4362
2010,51,j) 21 to 25,10384,13197,243016,247576,437,3.3,848,6.3,21329,5808,15521,2.3,8.6,30448,6165,24283,2.5,12.3,-9119,-3.7,17.2,0,488,488,3496
2010,51,k) 26+,10893,16856,362550,363403,665,3.9,831,4.9,38610,11144,27466,3.1,10.6,40315,9880,30435,2.7,11.1,-1705,-0.5,21.2,0,421,435,3678
2010,51,l) Left Censored,12536,40266,1333467,1346755,2283,5.7,2373,5.9,132349,42680,89669,3.2,9.8,158925,42651,116274,3.2,11.8,-26576,-2,19.6,0,321,329,3892
2010,53,a) 0,9629,9747,48518,24459,9543,195.8,0,0,48119,48119,0,196.7,196.7,0,0,0,0,0,48119,196.7,0,0,,,
2010,53,b) 1,7518,7596,43009,45073,20,0.2,2406,26.9,9417,251,9166,0.6,20.9,13544,7813,5731,17.3,30,-4127,-9.1,41.8,0,1830,1841,6452
2010,53,c) 2,7856,7970,46728,49251,384,4.4,1852,21.3,8832,1502,7330,3,17.9,13877,6880,6997,14,28.2,-5045,-10.3,35.8,0,1422,1422,5766
2010,53,d) 3,7306,7414,46091,48263,361,4.5,1409,17.7,7442,1404,6038,2.9,15.4,11785,5593,6192,11.6,24.4,-4343,-9,30.8,0,1043,1043,4555
2010,53,e) 4,7128,7461,54274,56029,353,4.5,1171,14.8,7581,1340,6241,2.4,13.5,11090,4024,7066,7.2,19.8,-3509,-6.3,27,0,847,847,3263
2010,53,f) 5,6208,6442,48622,49756,253,3.7,944,13.9,7731,1649,6082,3.3,15.5,9999,3954,6045,7.9,20.1,-2268,-4.6,31,0,676,676,3280
2010,53,g) 6 to 10,22473,23839,210852,216943,985,4,2676,10.8,27723,5873,21850,2.7,12.8,39905,13047,26858,6,18.4,-12182,-5.6,25.6,0,1877,1878,9746
2010,53,h) 11 to 15,16356,17875,194780,200228,688,3.7,1717,9.3,20253,4580,15673,2.3,10.1,31149,8201,22948,4.1,15.6,-10896,-5.5,20.2,0,1061,1062,5972
2010,53,i) 16 to 20,11589,13076,157200,162229,448,3.3,1028,7.7,15116,3608,11508,2.2,9.3,25174,5982,19192,3.7,15.5,-10058,-6.2,18.6,0,650,655,3816
2010,53,j) 21 to 25,8216,10188,184313,187474,298,2.9,609,5.9,16500,4012,12488,2.1,8.8,22821,4344,18477,2.3,12.2,-6321,-3.4,17.6,0,384,384,2460
2010,53,k) 26+,9928,15116,348764,350675,530,3.5,870,5.7,39117,14680,24437,4.2,11.2,42939,10145,32794,2.9,12.2,-3822,-1,22.4,0,399,409,3161
2010,53,l) Left Censored,10113,28416,915748,940776,1412,5,1367,4.8,68595,21704,46891,2.3,7.3,118652,21762,96890,2.3,12.6,-50057,-5.3,14.6,0,265,272,3565
2010,54,a) 0,1370,1431,11046,5580,1412,197.3,0,0,10933,10933,0,195.9,195.9,0,0,0,0,0,10933,195.9,0,0,,,
2010,54,b) 1,1162,1170,8160,8943,3,0.2,338,24.8,1550,46,1504,0.5,17.3,3115,1781,1334,19.9,34.8,-1565,-17.5,34.6,0,264,264,1531
2010,54,c) 2,1165,1188,9592,9712,45,3.5,254,19.6,2045,131,1914,1.3,21.1,2285,1244,1041,12.8,23.5,-240,-2.4,42.2,0,206,206,1096
2010,54,d) 3,1119,1125,9163,9924,36,3,215,17.7,1559,141,1418,1.4,15.7,3081,1741,1340,17.5,31,-1522,-15.3,31.4,0,163,163,1524
2010,54,e) 4,1189,1293,12819,12959,47,3.5,187,13.7,2144,547,1597,4.2,16.5,2423,1085,1338,8.4,18.7,-279,-2.2,33,0,133,133,792
2010,54,f) 5,1163,1209,10134,10224,45,3.6,149,11.8,1498,195,1303,1.9,14.7,1677,561,1116,5.5,16.4,-179,-1.7,29.4,0,116,116,460
2010,54,g) 6 to 10,4157,4417,39162,40000,117,2.6,410,9,4806,756,4050,1.9,12,6481,1808,4673,4.5,16.2,-1675,-4.2,24,0,320,320,1496
2010,54,h) 11 to 15,3322,3749,38430,39575,85,2.2,310,8,3693,473,3220,1.2,9.3,5983,1653,4330,4.2,15.1,-2290,-5.8,18.6,0,220,220,1266
2010,54,i) 16 to 20,2559,2882,30447,30992,95,3.2,219,7.4,3749,833,2916,2.7,12.1,4838,987,3851,3.2,15.6,-1089,-3.5,24.2,0,134,134,601
2010,54,j) 21 to 25,2312,2784,50560,51756,64,2.3,122,4.3,3544,809,2735,1.6,6.8,5935,1295,4640,2.5,11.5,-2391,-4.7,13.6,0,89,89,646
2010,54,k) 26+,3113,4666,73453,74816,184,3.9,223,4.8,6812,1976,4836,2.6,9.1,9537,1756,7781,2.3,12.7,-2725,-3.6,18.2,0,120,140,897
2010,54,l) Left Censored,4253,9827,263564,267758,326,3.3,404,4.1,21764,5146,16618,1.9,8.1,30152,6020,24132,2.2,11.3,-8388,-3.2,16.2,0,120,120,2063
2010,55,a) 0,5499,5595,35761,18016,5499,196.6,0,0,35491,35491,0,197,197,0,0,0,0,0,35491,197,0,0,,,
2010,55,b) 1,4573,4622,30058,32561,14,0.3,1288,24.1,6515,98,6417,0.3,20,11520,6683,4837,20.5,35.4,-5005,-15.4,40,0,947,947,5231
2010,55,c) 2,4586,4686,33471,34908,170,3.4,880,17.4,4839,519,4320,1.5,13.9,7712,3942,3770,11.3,22.1,-2873,-8.2,27.8,0,685,687,3528
2010,55,d) 3,4435,4495,33594,35433,155,3.2,764,15.9,4827,698,4129,2,13.6,8504,4777,3727,13.5,24,-3677,-10.4,27.2,0,556,556,4139
2010,55,e) 4,4473,4811,41491,43367,189,3.8,642,12.7,4558,766,3792,1.8,10.5,8309,2924,5385,6.7,19.2,-3751,-8.7,21,0,463,463,2152
2010,55,f) 5,4024,4136,34112,35150,141,3.3,554,12.8,4325,552,3773,1.6,12.3,6400,2614,3786,7.4,18.2,-2075,-5.9,24.6,0,399,399,1834
2010,55,g) 6 to 10,16038,17010,171590,174332,530,3,1687,9.6,19253,3079,16174,1.8,11,24736,7810,16926,4.5,14.2,-5483,-3.2,22,0,1186,1186,6397
2010,55,h) 11 to 15,12813,14138,167197,168645,428,3,1097,7.6,20531,4864,15667,2.9,12.2,23427,7982,15445,4.7,13.9,-2896,-1.7,24.4,0,709,709,4492
2010,55,i) 16 to 20,9712,10858,137402,141673,314,2.8,768,6.9,12123,1987,10136,1.4,8.6,20665,6170,14495,4.4,14.6,-8542,-6,17.2,0,449,449,2358
2010,55,j) 21 to 25,8020,10150,182326,183371,307,3,508,5,15584,4010,11574,2.2,8.5,17673,2992,14681,1.6,9.6,-2089,-1.1,17,0,293,293,1784
2010,55,k) 26+,9467,13869,274060,278165,374,2.7,651,4.6,23151,5182,17969,1.9,8.3,31361,8209,23152,3,11.3,-8210,-3,16.6,0,334,334,5726
2010,55,l) Left Censored,13548,31499,1165912,1180756,1174,3.7,1182,3.8,78745,18876,59869,1.6,6.7,108433,19565,88868,1.7,9.2,-29688,-2.5,13.4,0,345,348,5024
2010,56,a) 0,1044,1048,4995,2519,1026,195.8,0,0,4952,,,,196.6,0,0,0,0,0,4952,196.6,0,1,,,
2010,56,b) 1,908,920,4671,5181,3,0.3,293,27.1,898,,,,17.3,1917,1067,850,20.6,37,-1019,-19.7,34.6,1,212,212,755
2010,56,c) 2,911,923,4776,5099,39,3.9,185,18.5,748,110,638,2.2,14.7,1393,604,789,11.8,27.3,-645,-12.6,29.4,0,142,142,465
2010,56,d) 3,888,899,5163,5505,29,3,169,17.4,955,160,795,2.9,17.3,1638,555,1083,10.1,29.8,-683,-12.5,34.6,0,126,126,443
2010,56,e) 4,852,888,5875,6311,28,3,145,15.3,693,85,608,1.3,11,1564,603,961,9.6,24.8,-871,-13.8,22,0,93,93,389
2010,56,f) 5,697,718,4747,5028,25,3.3,114,14.9,575,72,503,1.4,11.4,1136,500,636,9.9,22.6,-561,-11.2,22.8,0,89,89,442
2010,56,g) 6 to 10,2712,2777,20392,21433,90,3.1,332,11.4,2335,396,1939,1.8,10.9,4416,1203,3213,5.6,20.6,-2081,-9.7,21.8,0,206,206,848
2010,56,h) 11 to 15,1923,2050,16368,17516,73,3.5,169,8,1589,326,1263,1.9,9.1,3885,1393,2492,8,22.2,-2296,-13.1,18.2,0,110,110,709
2010,56,i) 16 to 20,1266,1351,12698,13009,29,2.1,110,7.9,1219,100,1119,0.8,9.4,1841,416,1425,3.2,14.2,-622,-4.8,18.8,0,76,76,308
2010,56,j) 21 to 25,957,1139,18758,19043,22,1.9,54,4.7,1395,206,1189,1.1,7.3,1965,169,1796,0.9,10.3,-570,-3,14.6,0,30,30,82
2010,56,k) 26+,1428,1951,28650,29345,53,2.7,100,5.1,2371,504,1867,1.7,8.1,3761,512,3249,1.7,12.8,-1390,-4.7,16.2,0,46,46,169
2010,56,l) Left Censored,1577,3131,69706,71282,130,4.1,144,4.6,5621,1252,4369,1.8,7.9,8772,1496,7276,2.1,12.3,-3151,-4.4,15.8,0,28,28,211
2011,01,a) 0,4468,4523,28147,14174,4466,197.5,0,0,27946,27946,0,197.2,197.2,0,0,0,0,0,27946,197.2,0,0,,,
2011,01,b) 1,3322,3440,26524,28257,38,1,966,24.5,6030,527,5503,1.9,21.3,9496,5312,4184,18.8,33.6,-3466,-12.3,42.6,0,783,783,4809
2011,01,c) 2,3165,3367,23896,24367,124,3.4,648,17.9,4460,565,3895,2.3,18.3,5402,2849,2553,11.7,22.2,-942,-3.9,36.6,0,527,527,2245
2011,01,d) 3,3157,3248,26528,26493,110,3.2,580,16.6,4714,936,3778,3.5,17.8,4644,2337,2307,8.8,17.5,70,0.3,35,0,477,477,2040
2011,01,e) 4,3152,3230,26154,27666,100,2.9,541,15.7,4110,374,3736,1.4,14.9,7133,4385,2748,15.8,25.8,-3023,-10.9,29.8,0,415,415,2298
2011,01,f) 5,2849,3048,26861,27448,92,2.9,435,13.5,3724,495,3229,1.8,13.6,4898,2113,2785,7.7,17.8,-1174,-4.2,27.2,0,332,332,1690
2011,01,g) 6 to 10,11303,12054,131341,132230,338,2.7,1334,10.6,17780,2210,15570,1.7,13.4,19558,6946,12612,5.3,14.8,-1778,-1.4,26.8,0,1007,1007,5395
2011,01,h) 11 to 15,8939,10022,128554,125737,352,3.4,843,8.2,21295,8816,12479,7,16.9,15661,4260,11401,3.4,12.5,5634,4.4,25,0,609,609,3315
2011,01,i) 16 to 20,6487,7414,102943,103838,198,2.6,578,7.6,10873,1796,9077,1.7,10.5,12662,2941,9721,2.8,12.2,-1789,-1.7,21,0,407,407,2064
2011,01,j) 21 to 25,5204,6629,138183,139835,209,3.1,410,6.1,10864,1754,9110,1.3,7.8,14168,2681,11487,1.9,10.1,-3304,-2.3,15.6,0,270,270,1631
2011,01,k) 26+,7552,11478,221282,223860,430,3.7,627,5.4,20584,6376,14208,2.8,9.2,25739,5671,20068,2.5,11.5,-5155,-2.3,18.4,0,318,334,2394
2011,01,l) Left Censored,7415,21779,678939,679245,851,3.9,989,4.5,59470,12225,47245,1.8,8.8,60082,13766,46316,2,8.8,-612,0,17.6,0,224,232,1135
2011,02,a) 0,939,952,4201,2128,927,194.7,0,0,4146,,,,194.8,0,0,0,0,0,4146,194.8,0,1,,,
2011,02,b) 1,691,708,4143,4435,2,0.2,254,30,998,,,,22.5,1581,768,813,17.3,35.6,-583,-13.1,45,1,165,165,508
2011,02,c) 2,687,722,4730,4683,49,6.5,125,16.5,1186,357,829,7.6,25.3,1091,356,735,7.6,23.3,95,2,46.6,0,82,82,239
2011,02,d) 3,686,708,4615,4624,41,5.5,119,16,864,149,715,3.2,18.7,881,398,483,8.6,19.1,-17,-0.4,37.4,0,79,79,239
2011,02,e) 4,645,662,4792,4805,33,4.8,94,13.6,827,103,724,2.1,17.2,853,304,549,6.3,17.8,-26,-0.6,34.4,0,57,57,167
2011,02,f) 5,600,634,5572,5557,29,4.4,69,10.5,866,62,804,1.1,15.6,836,277,559,5,15,30,0.6,30,0,46,46,219
2011,02,g) 6 to 10,2351,2461,20120,20407,104,4.1,270,10.6,3102,327,2775,1.6,15.2,3675,1441,2234,7.1,18,-573,-2.8,30.4,0,159,164,978
2011,02,h) 11 to 15,1734,1910,28703,29055,61,3.1,185,9.4,2515,349,2166,1.2,8.7,3218,1418,1800,4.9,11.1,-703,-2.4,17.4,0,115,115,1037
2011,02,i) 16 to 20,1247,1340,10817,11258,51,3.7,101,7.4,1145,187,958,1.7,10.2,2027,398,1629,3.5,18,-882,-7.8,20.4,0,51,51,168
2011,02,j) 21 to 25,1006,1217,22647,22574,105,8.8,57,4.8,3249,1220,2029,5.4,14.4,3103,494,2609,2.2,13.7,146,0.7,27.4,0,32,32,209
2011,02,k) 26+,1523,2410,47992,48608,119,5,111,4.6,5461,1530,3931,3.1,11.2,6693,1495,5198,3.1,13.8,-1232,-2.6,22.4,0,48,48,204
2011,02,l) Left Censored,1230,3241,93991,93855,121,3.7,107,3.3,7317,1611,5706,1.7,7.8,7044,1071,5973,1.1,7.5,273,0.3,15,0,22,22,134
2011,04,a) 0,7847,7932,46704,23566,7801,196.7,0,0,46277,46277,0,196.4,196.4,0,0,0,0,0,46277,196.4,0,0,,,
2011,04,b) 1,5444,5571,47125,53414,25,0.4,1954,29.5,10862,825,10037,1.5,20.3,23439,9229,14210,17.3,43.9,-12577,-23.6,40.6,0,1534,1534,7678
2011,04,c) 2,4973,5082,43328,45158,215,3.9,1133,20.4,7268,990,6278,2.2,16.1,10927,6028,4899,13.3,24.2,-3659,-8.1,32.2,0,899,899,5310
2011,04,d) 3,5243,5458,45470,46334,260,4.4,1125,19.1,9204,1089,8115,2.4,19.9,10932,5804,5128,12.5,23.6,-1728,-3.7,39.8,0,901,901,5137
2011,04,e) 4,4976,5100,39668,40690,275,5.1,905,16.7,6601,1317,5284,3.2,16.2,8645,4484,4161,11,21.2,-2044,-5,32.4,0,702,706,3902
2011,04,f) 5,4896,5098,49623,49416,221,4.1,794,14.7,9025,1034,7991,2.1,18.3,8611,4014,4597,8.1,17.4,414,0.9,34.8,0,597,597,3317
2011,04,g) 6 to 10,16452,17671,189022,191809,751,4.1,2324,12.6,24893,3904,20989,2,13,30467,12370,18097,6.4,15.9,-5574,-2.9,26,0,1676,1676,9843
2011,04,h) 11 to 15,10961,12160,167921,170571,493,3.9,1229,9.8,20581,5296,15285,3.1,12.1,25880,10520,15360,6.2,15.2,-5299,-3.1,24.2,0,867,869,8218
2011,04,i) 16 to 20,6997,8221,126409,127532,400,4.8,729,8.7,15922,5600,10322,4.4,12.5,18167,5820,12347,4.6,14.2,-2245,-1.7,25,0,487,487,3425
2011,04,j) 21 to 25,5317,7999,155955,156191,263,3.2,547,6.7,15902,2985,12917,1.9,10.2,16374,4366,12008,2.8,10.5,-472,-0.3,20.4,0,331,343,2708
2011,04,k) 26+,6716,11281,290432,281946,458,4,739,6.5,46473,9821,36652,3.5,16.5,29500,6394,23106,2.3,10.5,16973,6,21,0,320,329,2487
2011,04,l) Left Censored,5517,22467,873419,862321,1477,6.6,1330,5.9,103010,27235,75775,3.2,11.9,80814,19689,61125,2.3,9.4,22196,2.5,18.8,0,131,151,1656
2011,05,a) 0,3195,3226,19611,9898,3180,197.1,0,0,19427,19427,0,196.3,196.3,0,0,0,0,0,19427,196.3,0,0,,,
2011,05,b) 1,2357,2427,18671,20284,23,0.8,710,25.3,4317,317,4000,1.6,21.3,7543,4405,3138,21.7,37.2,-3226,-15.9,42.6,0,566,566,3601
2011,05,c) 2,2172,2261,17082,17777,92,3.8,431,17.7,2756,421,2335,2.4,15.5,4145,1994,2151,11.2,23.3,-1389,-7.8,31,0,345,345,1653
2011,05,d) 3,2140,2165,16228,16859,79,3.4,415,17.8,2628,597,2031,3.5,15.6,3890,1871,2019,11.1,23.1,-1262,-7.5,31.2,0,334,334,1372
2011,05,e) 4,2017,2065,17933,18077,88,4,339,15.5,2945,313,2632,1.7,16.3,3232,1569,1663,8.7,17.9,-287,-1.6,32.6,0,259,259,1274
2011,05,f) 5,2048,2217,18322,18732,64,2.7,300,12.8,2495,403,2092,2.2,13.3,3315,1553,1762,8.3,17.7,-820,-4.4,26.6,0,216,216,1192
2011,05,g) 6 to 10,7864,8402,73728,74565,242,2.8,851,9.8,9396,1220,8176,1.6,12.6,11070,4584,6486,6.1,14.8,-1674,-2.2,25.2,0,627,627,3455
2011,05,h) 11 to 15,5660,6426,64896,65874,193,2.9,519,7.9,6900,965,5935,1.5,10.5,8856,2807,6049,4.3,13.4,-1956,-2.9,21,0,357,357,1838
2011,05,i) 16 to 20,4285,4842,53991,54037,135,2.7,364,7.3,6001,890,5111,1.6,11.1,6093,1486,4607,2.7,11.3,-92,-0.2,22.2,0,261,262,1161
2011,05,j) 21 to 25,3060,3851,72461,72365,132,3.4,265,6.8,7659,1925,5734,2.7,10.6,7466,2518,4948,3.5,10.3,193,0.3,20.6,0,180,186,1137
2011,05,k) 26+,4940,7105,147954,146833,221,3.1,349,4.9,15334,2114,13220,1.4,10.4,13092,2784,10308,1.9,8.9,2242,1.5,17.8,0,228,236,1572
2011,05,l) Left Censored,5029,13787,448822,447253,660,4.8,596,4.3,44365,12564,31801,2.8,9.9,41226,8128,33098,1.8,9.2,3139,0.7,18.4,0,137,137,1768
2011,06,a) 0,51597,52244,287489,144611,51616,197.6,0,0,285757,285757,0,197.6,197.6,0,0,0,0,0,285757,197.6,0,0,,,
2011,06,b) 1,36617,37496,261654,274260,201,0.5,11354,26,65351,4396,60955,1.6,23.8,90563,52718,37845,19.2,33,-25212,-9.2,47.6,0,8622,8622,43751
2011,06,c) 2,33830,34413,244395,250052,1644,4.4,6789,18.3,49037,7720,41317,3.1,19.6,60350,33245,27105,13.3,24.1,-11313,-4.5,39.2,0,5277,5281,27787
2011,06,d) 3,33969,34774,260915,265836,1624,4.4,5847,15.8,47117,6516,40601,2.5,17.7,56958,28919,28039,10.9,21.4,-9841,-3.7,35.4,0,4509,4509,24430
2011,06,e) 4,31622,32141,243425,249844,1451,4.3,4943,14.6,39646,6486,33160,2.6,15.9,52484,23013,29471,9.2,21,-12838,-5.1,31.8,0,3697,3697,18959
2011,06,f) 5,31461,32966,286664,292920,1442,4.2,4707,13.6,42557,7982,34575,2.7,14.5,55069,26377,28692,9,18.8,-12512,-4.3,29,0,3448,3451,19966
2011,06,g) 6 to 10,113118,120213,1210423,1224210,4754,3.8,13507,10.8,163596,26550,137046,2.2,13.4,191170,75179,115991,6.1,15.6,-27574,-2.2,26.8,0,9617,9660,56721
2011,06,h) 11 to 15,73713,81325,1033682,1039524,3080,3.7,7236,8.7,126986,24493,102493,2.4,12.2,138670,46441,92229,4.5,13.3,-11684,-1.1,24.4,0,4978,4995,34087
2011,06,i) 16 to 20,48091,54846,772866,784802,2040,3.6,4329,7.7,76731,13676,63055,1.7,9.8,100602,28143,72459,3.6,12.8,-23871,-3,19.6,0,2943,2959,20573
2011,06,j) 21 to 25,43022,54857,1084927,1076202,1785,3.2,3846,6.9,121705,17831,103874,1.7,11.3,104256,30557,73699,2.8,9.7,17449,1.6,19.4,0,2374,2386,16845
2011,06,k) 26+,54292,82989,1916113,1906686,2958,3.5,4924,5.9,222611,48650,173961,2.6,11.7,203757,64411,139346,3.4,10.7,18854,1,21.4,0,2598,2620,22286
2011,06,l) Left Censored,39254,130194,4849188,4832019,7150,5.5,6812,5.2,509995,123333,386662,2.6,10.6,475656,121774,353882,2.5,9.8,34339,0.8,19.6,0,1496,1565,21597
2011,08,a) 0,9059,9136,48230,24320,9002,197.1,0,0,47820,47820,0,196.6,196.6,0,0,0,0,0,47820,196.6,0,0,,,
2011,08,b) 1,6575,6663,42786,45947,29,0.4,2318,29.3,10807,323,10484,0.7,23.5,17130,9794,7336,21.3,37.3,-6323,-13.8,47,0,1666,1666,7768
2011,08,c) 2,5908,5988,39342,40060,326,5.1,1273,19.7,8020,1304,6716,3.3,20,9455,4605,4850,11.5,23.6,-1435,-3.6,40,0,926,926,3870
2011,08,d) 3,6107,6194,42276,42517,356,5.4,1080,16.5,7872,1800,6072,4.2,18.5,8354,4238,4116,10,19.6,-482,-1.1,37,0,805,805,3483
2011,08,e) 4,5685,5756,44643,44658,316,5.2,909,15,7729,824,6905,1.8,17.3,7758,3761,3997,8.4,17.4,-29,-0.1,34.6,0,636,636,3001
2011,08,f) 5,5446,5644,43954,44069,295,5,800,13.6,7257,1360,5897,3.1,16.5,7487,3227,4260,7.3,17,-230,-0.5,33,0,547,547,2528
2011,08,g) 6 to 10,20334,21301,184852,188055,989,4.5,2612,11.8,24794,4611,20183,2.5,13.2,31199,12540,18659,6.7,16.6,-6405,-3.4,26.4,0,1716,1717,9645
2011,08,h) 11 to 15,13939,15164,159453,161001,655,4.2,1572,10,19669,3399,16270,2.1,12.2,22765,8256,14509,5.1,14.1,-3096,-1.9,24.4,0,927,928,5760
2011,08,i) 16 to 20,9284,10362,133550,134751,433,4.1,926,8.7,16388,4063,12325,3,12.2,18790,6541,12249,4.9,13.9,-2402,-1.7,24.4,0,577,579,5051
2011,08,j) 21 to 25,6431,8288,143775,144129,277,3.3,547,6.5,14079,2431,11648,1.7,9.8,14787,3470,11317,2.4,10.3,-708,-0.5,19.6,0,330,330,1661
2011,08,k) 26+,8483,12850,273738,277089,512,3.9,792,6.1,28844,5979,22865,2.2,10.4,35546,9281,26265,3.3,12.8,-6702,-2.4,20.8,0,397,402,2756
2011,08,l) Left Censored,7087,22414,785603,780274,1340,6,1189,5.3,85930,20664,65266,2.6,11,75271,14736,60535,1.9,9.6,10659,1.4,19.2,0,207,208,2698
2011,09,a) 0,3784,3800,23371,11739,3760,197.9,0,0,23264,23264,0,198.2,198.2,0,0,0,0,0,23264,198.2,0,0,,,
2011,09,b) 1,2859,2933,22279,23247,11,0.3,833,24.6,5192,183,5009,0.8,22.3,7128,3523,3605,15.2,30.7,-1936,-8.4,44.6,0,613,613,2800
2011,09,c) 2,2637,2649,20369,20451,102,3.6,500,17.5,3614,419,3195,2,17.7,3778,1886,1892,9.2,18.5,-164,-0.8,35.4,0,392,392,1649
2011,09,d) 3,2771,2824,21613,21743,116,3.9,442,14.8,3561,330,3231,1.5,16.4,3820,1635,2185,7.5,17.6,-259,-1.2,32.8,0,342,342,1364
2011,09,e) 4,2438,2472,20197,20327,95,3.6,346,13.3,2827,256,2571,1.3,13.9,3087,1280,1807,6.3,15.2,-260,-1.3,27.8,0,249,249,1031
2011,09,f) 5,2516,2694,23920,24376,102,3.6,375,13.3,3186,364,2822,1.5,13.1,4098,2041,2057,8.4,16.8,-912,-3.7,26.2,0,266,266,1434
2011,09,g) 6 to 10,9761,10182,98699,100373,364,3.5,1058,10,11870,1563,10307,1.6,11.8,15218,5091,10127,5.1,15.2,-3348,-3.4,23.6,0,782,782,3744
2011,09,h) 11 to 15,7800,8454,110518,110187,263,3,696,8,13058,1716,11342,1.6,11.9,12396,3468,8928,3.1,11.2,662,0.7,22.4,0,471,471,2564
2011,09,i) 16 to 20,6037,6489,74618,75981,163,2.4,539,8.1,6932,654,6278,0.9,9.1,9658,3301,6357,4.3,12.7,-2726,-3.6,18.2,0,346,354,2159
2011,09,j) 21 to 25,5891,6903,116564,116491,192,2.7,500,7.1,10606,1789,8817,1.5,9.1,10459,2840,7619,2.4,9,147,0.1,18,0,320,320,2022
2011,09,k) 26+,7459,10273,186733,185429,288,2.8,567,5.4,18761,4854,13907,2.6,10.1,16153,3331,12822,1.8,8.7,2608,1.4,17.4,0,321,321,1496
2011,09,l) Left Censored,9283,19614,723172,727195,825,4.2,1033,5.2,60463,16659,43804,2.3,8.3,68508,19953,48555,2.7,9.4,-8045,-1.1,16.6,0,260,260,3307
2011,10,a) 0,1177,1183,6691,3367,1168,197.5,0,0,6648,6648,0,197.4,197.4,0,0,0,0,0,6648,197.4,0,0,,,
2011,10,b) 1,814,821,6199,7048,3,0.3,294,30.1,1338,12,1326,0.2,19,3036,1935,1101,27.5,43.1,-1698,-24.1,38,0,212,212,1565
2011,10,c) 2,804,818,6304,6548,23,2.6,148,16.8,909,72,837,1.1,13.9,1396,759,637,11.6,21.3,-487,-7.4,27.8,0,119,119,690
2011,10,d) 3,841,858,6468,6599,29,3.2,133,14.6,819,76,743,1.2,12.4,1080,429,651,6.5,16.4,-261,-4,24.8,0,101,101,314
2011,10,e) 4,708,745,6969,6930,43,5.5,114,14.6,1311,121,1190,1.7,18.9,1232,672,560,9.7,17.8,79,1.1,35.6,0,92,92,329
2011,10,f) 5,724,743,6317,6534,22,2.8,108,13.8,655,52,603,0.8,10,1088,461,627,7.1,16.7,-433,-6.7,20,0,75,75,361
2011,10,g) 6 to 10,2851,2950,26330,26717,96,3.1,345,11.2,2933,220,2713,0.8,11,3707,1262,2445,4.7,13.9,-774,-2.9,22,0,267,267,1025
2011,10,h) 11 to 15,2070,2236,23039,23534,72,3.1,190,8.3,3051,444,2607,1.9,13,4040,1086,2954,4.6,17.2,-989,-4.2,26,0,125,125,817
2011,10,i) 16 to 20,1485,1694,22120,22519,53,3.1,105,6.1,2144,420,1724,1.9,9.5,2942,546,2396,2.4,13.1,-798,-3.6,19,0,71,71,421
2011,10,j) 21 to 25,1278,1475,20889,20611,47,3.1,98,6.5,2268,326,1942,1.6,11,1712,463,1249,2.2,8.3,556,2.7,16.6,0,52,52,144
2011,10,k) 26+,1601,2229,49965,49318,55,2.4,116,5.1,5027,983,4044,2,10.2,3733,890,2843,1.8,7.6,1294,2.6,15.2,0,61,61,461
2011,10,l) Left Censored,2434,5439,175838,177574,309,5.6,367,6.7,16307,4175,12132,2.4,9.2,19778,5627,14151,3.2,11.1,-3471,-1.9,18.4,0,47,47,220
2011,11,a) 0,987,989,6726,3382,972,196.6,0,0,6689,,,,197.8,0,0,0,0,0,6689,197.8,0,1,,,
2011,11,b) 1,744,758,8003,8162,5,0.6,191,22.2,2183,,,,26.7,2500,1507,993,18.5,30.6,-317,-3.9,53.4,1,142,142,1010
2011,11,c) 2,647,648,6144,5817,23,3.4,78,11.5,1695,242,1453,4.2,29.1,1040,521,519,9,17.9,655,11.2,35.8,0,55,55,338
2011,11,d) 3,592,600,6013,6005,23,3.6,94,14.7,1023,111,912,1.8,17,1006,445,561,7.4,16.8,17,0.2,33.6,0,69,69,368
2011,11,e) 4,628,637,6581,6398,24,3.7,60,9.1,1161,192,969,3,18.1,794,343,451,5.4,12.4,367,5.7,24.8,0,46,46,282
2011,11,f) 5,600,615,6491,6395,21,3.3,74,11.5,1096,205,891,3.2,17.1,903,376,527,5.9,14.1,193,3,28.2,0,55,55,298
2011,11,g) 6 to 10,2354,2450,32776,32331,71,2.8,205,8.1,4545,472,4073,1.5,14.1,3655,1571,2084,4.9,11.3,890,2.8,22.6,0,152,152,1311
2011,11,h) 11 to 15,1857,2054,37672,37889,61,2.9,151,7.2,4056,369,3687,1,10.7,4489,1008,3481,2.7,11.8,-433,-1.1,21.4,0,110,110,839
2011,11,i) 16 to 20,1365,1506,29836,30174,44,2.9,92,6,3078,219,2859,0.7,10.2,3754,1313,2441,4.4,12.4,-676,-2.2,20.4,0,66,66,949
2011,11,j) 21 to 25,1194,1407,26510,26528,66,4.7,71,5,3635,1132,2503,4.3,13.7,3671,772,2899,2.9,13.8,-36,-0.1,27.4,0,46,46,439
2011,11,k) 26+,1922,2575,86462,87519,116,4.5,127,4.9,5287,1007,4280,1.2,6,7401,922,6479,1.1,8.5,-2114,-2.5,12,0,48,48,246
2011,11,l) Left Censored,2816,5926,236633,231608,440,7.5,339,5.8,28459,7721,20738,3.3,12.3,18410,2656,15754,1.1,7.9,10049,4.4,15.8,0,34,34,350
2011,12,a) 0,35628,36023,196210,98807,35522,197.2,0,0,194807,194807,0,197.2,197.2,0,0,0,0,0,194807,197.2,0,0,,,
2011,12,b) 1,24613,25086,172655,185822,92,0.3,8568,28.8,40266,3838,36428,2.1,21.7,66599,35371,31228,19,35.8,-26333,-14.1,43.4,0,6647,6647,29569
2011,12,c) 2,20616,20913,136446,152447,911,4,4652,20.4,25489,3182,22307,2.1,16.7,57491,32202,25289,21.1,37.7,-32002,-21,33.4,0,3696,3696,28961
2011,12,d) 3,20103,20445,128244,136401,1061,4.8,3993,18.2,22096,4097,17999,3,16.2,38410,24453,13957,17.9,28.2,-16314,-12,32.4,0,3066,3068,17336
2011,12,e) 4,18728,19192,131701,140177,1045,5.1,3461,17,19529,3135,16394,2.2,13.9,36480,22530,13950,16.1,26,-16951,-12.1,27.8,0,2602,2602,10039
2011,12,f) 5,18003,18571,141348,138399,1007,5.1,3101,15.8,29518,3372,26146,2.4,21.3,23619,11908,11711,8.6,17.1,5899,4.2,34.2,0,2305,2305,9645
2011,12,g) 6 to 10,67295,70495,625943,637056,3335,4.5,9554,13,99434,17029,82405,2.7,15.6,121659,51316,70343,8.1,19.1,-22225,-3.5,31.2,0,6869,6874,36933
2011,12,h) 11 to 15,40899,44895,547263,564063,1930,4.2,4400,9.5,85349,14614,70735,2.6,15.1,118948,44259,74689,7.8,21.1,-33599,-6,30.2,0,3029,3030,22641
2011,12,i) 16 to 20,28984,32917,452248,454103,1422,4.2,2809,8.4,56891,10368,46523,2.3,12.5,60600,17338,43262,3.8,13.3,-3709,-0.8,25,0,1850,1868,12515
2011,12,j) 21 to 25,21711,28126,554566,538506,1142,4,2057,7.2,89966,39538,50428,7.3,16.7,57848,14587,43261,2.7,10.7,32118,6,21.4,0,1192,1206,7768
2011,12,k) 26+,23767,37592,800753,799459,1519,4,2378,6.3,93955,35203,58752,4.4,11.8,91367,27713,63654,3.5,11.4,2588,0.4,22.8,0,1253,1287,8018
2011,12,l) Left Censored,17190,70925,2646065,2615671,4507,6.4,4079,5.8,313238,77249,235989,3,12,252452,67805,184647,2.6,9.7,60786,2.3,19.4,0,609,626,6602
2011,13,a) 0,12365,12489,72910,36706,12337,197.6,0,0,72408,72408,0,197.3,197.3,0,0,0,0,0,72408,197.3,0,0,,,
2011,13,b) 1,9000,9162,60857,65074,56,0.5,2892,27,15046,553,14493,0.8,23.1,23480,14078,9402,21.6,36.1,-8434,-13,46.2,0,2245,2245,12146
2011,13,c) 2,8102,8482,78607,75400,346,3.8,1698,18.6,21062,1580,19482,2.1,27.9,14647,7528,7119,10,19.4,6415,8.5,38.8,0,1342,1342,6181
2011,13,d) 3,8468,8651,61187,62672,394,4.3,1553,16.8,10439,1417,9022,2.3,16.7,13408,7305,6103,11.7,21.4,-2969,-4.7,33.4,0,1201,1201,6506
2011,13,e) 4,7913,8117,60682,61780,388,4.5,1378,16,10039,1634,8405,2.6,16.2,12234,6524,5710,10.6,19.8,-2195,-3.6,32.4,0,1006,1006,5255
2011,13,f) 5,7214,7555,65612,66707,331,4.1,1193,14.9,10075,1496,8579,2.2,15.1,12265,5912,6353,8.9,18.4,-2190,-3.3,30.2,0,892,892,4830
2011,13,g) 6 to 10,27404,29120,308750,315654,1082,3.6,3567,11.7,42770,6297,36473,2,13.5,56577,22876,33701,7.2,17.9,-13807,-4.4,27,0,2578,2587,18035
2011,13,h) 11 to 15,19118,21290,270999,277747,835,3.8,2143,9.8,32297,7705,24592,2.8,11.6,45793,20752,25041,7.5,16.5,-13496,-4.9,23.2,0,1417,1426,8957
2011,13,i) 16 to 20,12461,14570,205477,211742,487,3.3,1255,8.4,22485,4693,17792,2.2,10.6,35015,13356,21659,6.3,16.5,-12530,-5.9,21.2,0,835,838,6643
2011,13,j) 21 to 25,9290,12216,253086,250406,403,3.2,843,6.8,29344,6485,22859,2.6,11.7,23984,8118,15866,3.2,9.6,5360,2.1,19.2,0,545,546,3434
2011,13,k) 26+,12132,18917,423236,422816,749,3.9,1065,5.6,44629,8476,36153,2,10.6,43789,11418,32371,2.7,10.4,840,0.2,20.8,0,586,595,3824
2011,13,l) Left Censored,11342,40007,1450841,1451817,2147,5.4,2118,5.3,147475,43187,104288,3,10.2,149427,36567,112860,2.5,10.3,-1952,-0.1,20.4,0,373,379,6909
2011,15,a) 0,1371,1377,9475,4781,1361,197.7,0,0,9389,9389,0,196.4,196.4,0,0,0,0,0,9389,196.4,0,0,,,
2011,15,b) 1,1029,1045,8725,9169,4,0.3,300,24.8,2191,26,2165,0.3,23.9,3079,1686,1393,18.4,33.6,-888,-9.7,47.8,0,244,244,1557
2011,15,c) 2,987,1008,10547,11013,51,4.7,190,17.6,1519,181,1338,1.6,13.8,2451,879,1572,8,22.3,-932,-8.5,27.6,0,159,159,786
2011,15,d) 3,975,992,7018,7188,36,3.4,154,14.6,1035,105,930,1.5,14.4,1375,676,699,9.4,19.1,-340,-4.7,28.8,0,128,128,579
2011,15,e) 4,1023,1032,8773,9178,26,2.4,152,13.9,929,76,853,0.8,10.1,1739,734,1005,8,18.9,-810,-8.8,20.2,0,119,119,528
2011,15,f) 5,946,1015,9165,9340,46,4.3,138,13,1138,129,1009,1.4,12.2,1488,624,864,6.7,15.9,-350,-3.7,24.4,0,116,116,568
2011,15,g) 6 to 10,3792,4068,41519,41954,121,2.9,393,9.3,4940,544,4396,1.3,11.8,5810,2305,3505,5.5,13.8,-870,-2,23.6,0,295,296,1990
2011,15,h) 11 to 15,2758,3031,34236,34353,96,3.1,223,7.2,3824,628,3196,1.8,11.1,4058,1071,2987,3.1,11.8,-234,-0.7,22.2,0,163,163,805
2011,15,i) 16 to 20,2069,2319,34952,35109,61,2.6,172,7.2,3522,202,3320,0.6,10,3836,1644,2192,4.7,10.9,-314,-0.9,20,0,117,117,947
2011,15,j) 21 to 25,1810,2300,39028,39576,55,2.3,156,6.6,2725,479,2246,1.2,6.9,3821,1056,2765,2.7,9.7,-1096,-2.8,13.8,0,104,104,637
2011,15,k) 26+,2765,3985,68842,68723,134,3.3,185,4.6,5355,1240,4115,1.8,7.8,5117,1075,4042,1.6,7.4,238,0.4,14.8,0,111,113,819
2011,15,l) Left Censored,2863,6697,208106,206285,344,5.1,327,4.9,21273,6387,14886,3.1,10.3,17631,4220,13411,2,8.5,3642,1.8,17,0,67,68,232
2011,16,a) 0,2258,2289,10736,5413,2249,196.5,0,0,10646,10646,0,196.7,196.7,0,0,0,0,0,10646,196.7,0,0,,,
2011,16,b) 1,1573,1610,9115,10078,17,0.9,581,30.1,2144,236,1908,2.3,21.3,4069,2446,1623,24.3,40.4,-1925,-19.1,42.6,0,400,400,1944
2011,16,c) 2,1522,1538,10736,11068,73,4.4,351,21,3287,386,2901,3.5,29.7,3950,2824,1126,25.5,35.7,-663,-6,59.4,0,265,265,2607
2011,16,d) 3,1754,1777,10367,10785,73,3.8,353,18.4,1984,327,1657,3,18.4,2819,1310,1509,12.1,26.1,-835,-7.7,36.8,0,254,254,1107
2011,16,e) 4,1736,1760,10912,11873,104,5.5,369,19.5,1587,281,1306,2.4,13.4,3508,1131,2377,9.5,29.5,-1921,-16.1,26.8,0,251,251,875
2011,16,f) 5,1740,1800,12935,13348,95,4.9,333,17.3,1685,250,1435,1.9,12.6,2510,950,1560,7.1,18.8,-825,-6.2,25.2,0,220,220,652
2011,16,g) 6 to 10,5843,6168,58814,60559,225,3.5,892,13.7,7012,764,6248,1.3,11.6,10502,4202,6300,6.9,17.3,-3490,-5.7,23.2,0,586,586,3164
2011,16,h) 11 to 15,4177,4497,46291,48281,166,3.6,420,9.1,4462,682,3780,1.4,9.2,8441,2189,6252,4.5,17.5,-3979,-8.3,18.4,0,252,252,1401
2011,16,i) 16 to 20,2601,2793,26819,27204,99,3.4,274,9.5,2900,319,2581,1.2,10.7,3669,993,2676,3.7,13.5,-769,-2.8,21.4,0,160,163,635
2011,16,j) 21 to 25,1794,2249,33644,34108,80,3.5,164,7.1,2910,774,2136,2.3,8.5,3838,876,2962,2.6,11.3,-928,-2.8,17,0,105,105,531
2011,16,k) 26+,2494,3570,68761,68652,126,3.5,220,6.1,6316,1645,4671,2.4,9.2,6098,1627,4471,2.4,8.9,218,0.3,17.8,0,108,111,500
2011,16,l) Left Censored,2642,6755,182360,182340,274,4.1,263,3.9,16385,4040,12345,2.2,9,16344,2289,14055,1.3,9,41,0,18,0,51,53,489
2011,17,a) 0,16229,16450,94070,47367,16200,197,0,0,93406,93406,0,197.2,197.2,0,0,0,0,0,93406,197.2,0,0,,,
2011,17,b) 1,11354,11633,93031,94696,60,0.4,3572,26.3,25716,1455,24261,1.5,27.2,29046,16353,12693,17.3,30.7,-3330,-3.5,54.4,0,2515,2515,12980
2011,17,c) 2,10445,10625,71909,74065,505,4.5,1960,17.3,13953,2368,11585,3.2,18.8,18265,8250,10015,11.1,24.7,-4312,-5.9,37.6,0,1436,1436,6766
2011,17,d) 3,10725,10951,79059,79961,536,4.6,1719,14.9,12821,2084,10737,2.6,16,14625,7113,7512,8.9,18.3,-1804,-2.3,32,0,1240,1240,5528
2011,17,e) 4,9734,9884,74985,77311,469,4.5,1443,13.9,10001,1338,8663,1.7,12.9,14653,6948,7705,9,19,-4652,-6.1,25.8,0,1032,1032,5871
2011,17,f) 5,9456,9986,80070,82064,459,4.4,1344,12.9,10378,1724,8654,2.1,12.6,14366,5562,8804,6.8,17.5,-3988,-4.9,25.2,0,959,971,4398
2011,17,g) 6 to 10,36193,38272,385947,387049,1537,3.9,4149,10.5,52170,8468,43702,2.2,13.5,54374,19124,35250,4.9,14,-2204,-0.5,27,0,2792,2797,13376
2011,17,h) 11 to 15,27169,29737,366162,376477,1106,3.6,2703,8.8,44930,7181,37749,1.9,11.9,65560,20308,45252,5.4,17.4,-20630,-5.5,23.8,0,1726,1744,16733
2011,17,i) 16 to 20,20454,22865,302651,304329,739,3.2,1817,7.8,35381,6499,28882,2.1,11.6,38737,9984,28753,3.3,12.7,-3356,-1.1,23.2,0,1102,1108,6100
2011,17,j) 21 to 25,16686,20316,391260,386097,673,3.2,1512,7.3,49568,11343,38225,2.9,12.8,39241,13829,25412,3.6,10.2,10327,2.6,20.4,0,849,939,5306
2011,17,k) 26+,22346,32281,752777,754669,952,2.9,1695,5.2,66656,12975,53681,1.7,8.8,70439,16221,54218,2.1,9.3,-3783,-0.5,17.6,0,948,954,7352
2011,17,l) Left Censored,25009,62240,2317418,2305214,2832,4.5,3025,4.9,210672,51625,159047,2.2,9.1,186264,43115,143149,1.9,8.1,24408,1,16.2,0,767,808,11093
2011,18,a) 0,6172,6282,38195,19270,6202,197.5,0,0,37851,37851,0,196.4,196.4,0,0,0,0,0,37851,196.4,0,0,,,
2011,18,b) 1,4506,4644,35855,39060,41,0.8,1336,24.9,7261,381,6880,1,18.6,13671,8225,5446,21.1,35,-6410,-16.4,37.2,0,989,989,7201
2011,18,c) 2,4212,4325,34215,34583,182,3.9,762,16.5,6841,1524,5317,4.4,19.8,7577,4071,3506,11.8,21.9,-736,-2.1,39.6,0,568,568,3390
2011,18,d) 3,4633,4762,39493,39862,207,4.1,731,14.5,7049,1149,5900,2.9,17.7,7786,4125,3661,10.3,19.5,-737,-1.8,35.4,0,559,559,3651
2011,18,e) 4,4186,4328,35939,36934,170,3.7,666,14.6,4950,793,4157,2.1,13.4,6939,2716,4223,7.4,18.8,-1989,-5.4,26.8,0,493,493,2252
2011,18,f) 5,4176,4499,42836,43484,166,3.5,632,13.4,5875,784,5091,1.8,13.5,7171,3257,3914,7.5,16.5,-1296,-3,27,0,449,458,2662
2011,18,g) 6 to 10,15674,16609,165908,167754,549,3.2,1843,10.7,20827,2521,18306,1.5,12.4,24519,9894,14625,5.9,14.6,-3692,-2.2,24.8,0,1339,1341,7759
2011,18,h) 11 to 15,12153,13545,165204,164281,455,3.3,1206,8.7,21851,3435,18416,2.1,13.3,20004,7189,12815,4.4,12.2,1847,1.1,24.4,0,853,853,4866
2011,18,i) 16 to 20,9444,10817,139740,140889,358,3.2,815,7.4,14605,3101,11504,2.2,10.4,16903,4479,12424,3.2,12,-2298,-1.6,20.8,0,535,535,3081
2011,18,j) 21 to 25,7781,9962,191639,190713,290,2.9,631,6.2,21389,4841,16548,2.5,11.2,19537,7571,11966,4,10.2,1852,1,20.4,0,398,410,3749
2011,18,k) 26+,11096,16953,344003,339579,588,3.4,823,4.8,39753,7065,32688,2.1,11.7,30905,7195,23710,2.1,9.1,8848,2.6,18.2,0,463,467,2991
2011,18,l) Left Censored,12636,33666,1187684,1181993,1434,4.3,1264,3.8,106357,23778,82579,2,9,94975,17692,77283,1.5,8,11382,1,16,0,363,370,5366
2011,19,a) 0,3238,3287,19493,9824,3238,197,0,0,19338,19338,0,196.8,196.8,0,0,0,0,0,19338,196.8,0,0,,,
2011,19,b) 1,2457,2489,15671,16964,9,0.3,636,22.4,3241,69,3172,0.4,19.1,5827,2201,3626,13,34.3,-2586,-15.2,38.2,0,446,446,1716
2011,19,c) 2,2303,2368,17784,18501,88,3.5,380,15.1,2855,382,2473,2.1,15.4,4289,2205,2084,11.9,23.2,-1434,-7.8,30.8,0,273,273,1918
2011,19,d) 3,2427,2478,17298,17786,97,3.7,350,13.4,2416,357,2059,2,13.6,3392,1340,2052,7.5,19.1,-976,-5.5,27.2,0,255,255,1111
2011,19,e) 4,2234,2284,17783,18230,98,4.1,319,13.3,2426,452,1974,2.5,13.3,3320,1589,1731,8.7,18.2,-894,-4.9,26.6,0,234,234,1280
2011,19,f) 5,2329,2581,21189,21682,87,3.2,323,12,2373,369,2004,1.7,10.9,3358,1365,1993,6.3,15.5,-985,-4.6,21.8,0,240,240,1146
2011,19,g) 6 to 10,8734,9279,91920,90720,330,3.4,932,9.7,14030,2193,11837,2.4,15.5,11630,4466,7164,4.9,12.8,2400,2.7,25.6,0,650,650,3569
2011,19,h) 11 to 15,6726,7387,88964,87935,218,2.9,618,8.1,13135,1753,11382,2,14.9,11077,3978,7099,4.5,12.6,2058,2.3,25.2,0,404,404,2758
2011,19,i) 16 to 20,5170,5650,58273,59135,126,2.2,415,7.1,5795,584,5211,1,9.8,7519,1858,5661,3.1,12.7,-1724,-2.9,19.6,0,271,271,1335
2011,19,j) 21 to 25,4056,5037,97805,97752,120,2.3,271,5.3,7231,1234,5997,1.3,7.4,7125,1721,5404,1.8,7.3,106,0.1,14.6,0,171,171,911
2011,19,k) 26+,6768,10315,170971,170397,246,2.4,454,4.4,16173,3172,13001,1.9,9.5,15025,3154,11871,1.9,8.8,1148,0.7,17.6,0,249,251,1557
2011,19,l) Left Censored,8651,19149,645425,643636,689,3.6,746,3.9,51514,10455,41059,1.6,8,47936,9280,38656,1.4,7.4,3578,0.6,14.8,0,226,233,2068
2011,20,a) 0,3207,3274,20227,10209,3219,196.6,0,0,20036,20036,0,196.3,196.3,0,0,0,0,0,20036,196.3,0,0,,,
2011,20,b) 1,2344,2370,16105,17119,6,0.2,771,27.7,3630,33,3597,0.2,21.2,5657,3390,2267,19.8,33,-2027,-11.8,42.4,0,590,590,2811
2011,20,c) 2,2290,2323,16240,17057,86,3.5,416,16.7,3029,342,2687,2,17.8,4662,2192,2470,12.9,27.3,-1633,-9.5,35.6,0,325,325,1948
2011,20,d) 3,2299,2348,16124,16669,79,3.1,416,16.5,2335,197,2138,1.2,14,3425,1518,1907,9.1,20.5,-1090,-6.5,28,0,325,325,1289
2011,20,e) 4,2249,2299,17375,18116,84,3.5,351,14.4,2262,294,1968,1.6,12.5,3743,1971,1772,10.9,20.7,-1481,-8.2,25,0,277,277,1789
2011,20,f) 5,2244,2393,19148,19532,88,3.5,296,11.8,2386,336,2050,1.7,12.2,3153,1268,1885,6.5,16.1,-767,-3.9,24.4,0,206,206,904
2011,20,g) 6 to 10,8607,8959,92251,94666,266,2.9,979,10.5,10587,1179,9408,1.2,11.2,15416,5849,9567,6.2,16.3,-4829,-5.1,22.4,0,706,706,4322
2011,20,h) 11 to 15,6672,7313,79387,80921,267,3.6,618,8.2,8141,1256,6885,1.6,10.1,11208,3723,7485,4.6,13.9,-3067,-3.8,20.2,0,411,411,3031
2011,20,i) 16 to 20,4698,5261,72132,73442,154,2.9,389,7.2,6604,828,5776,1.1,9,9224,3023,6201,4.1,12.6,-2620,-3.6,18,0,269,271,2266
2011,20,j) 21 to 25,3781,4772,76798,75286,148,3,281,5.8,9371,1802,7569,2.4,12.4,6347,1893,4454,2.5,8.4,3024,4,16.8,0,188,188,990
2011,20,k) 26+,5973,8757,155058,156239,312,3.5,435,4.9,15239,4498,10741,2.9,9.8,17600,3939,13661,2.5,11.3,-2361,-1.5,19.6,0,255,255,1657
2011,20,l) Left Censored,7038,16495,515676,517318,735,4.5,720,4.4,48065,16590,31475,3.2,9.3,51348,9653,41695,1.9,9.9,-3283,-0.6,18.6,0,214,214,1726
2011,21,a) 0,4073,4151,24700,12485,4110,198,0,0,24431,24431,0,195.7,195.7,0,0,0,0,0,24431,195.7,0,0,,,
2011,21,b) 1,2978,3063,23933,25720,10,0.3,933,26.2,5445,271,5174,1.1,21.2,9018,5361,3657,20.8,35.1,-3573,-13.9,42.4,0,738,738,4782
2011,21,c) 2,2658,2707,19907,20593,102,3.5,542,18.5,4222,676,3546,3.3,20.5,5593,2938,2655,14.3,27.2,-1371,-6.7,41,0,446,446,2561
2011,21,d) 3,2769,2888,23176,23785,105,3.4,501,16.2,3626,344,3282,1.4,15.2,4844,2094,2750,8.8,20.4,-1218,-5.2,30.4,0,412,412,1898
2011,21,e) 4,2643,2706,21556,22005,85,3,419,14.6,3385,279,3106,1.3,15.4,4283,2316,1967,10.5,19.5,-898,-4.1,30.8,0,324,324,2051
2011,21,f) 5,2545,2714,24598,24876,95,3.3,366,12.8,3573,349,3224,1.4,14.4,4128,1806,2322,7.3,16.6,-555,-2.2,28.8,0,282,282,1498
2011,21,g) 6 to 10,9888,10423,99788,101500,273,2.5,1191,10.9,12504,1527,10977,1.5,12.3,15927,6287,9640,6.2,15.7,-3423,-3.4,24.6,0,891,891,5069
2011,21,h) 11 to 15,7935,8894,104624,106709,275,3,731,8,12429,2498,9931,2.3,11.6,16598,6608,9990,6.2,15.6,-4169,-4,23.2,0,494,494,5198
2011,21,i) 16 to 20,5816,6638,83507,85382,190,2.8,518,7.6,9197,1917,7280,2.2,10.8,12946,2587,10359,3,15.2,-3749,-4.4,21.6,0,357,357,1678
2011,21,j) 21 to 25,4926,6296,117814,118229,193,3,392,6.1,12265,3313,8952,2.8,10.4,13095,4840,8255,4.1,11.1,-830,-0.7,20.8,0,253,254,2584
2011,21,k) 26+,6802,10533,207990,208815,355,3.4,464,4.4,21483,5537,15946,2.7,10.3,23132,4568,18564,2.2,11.1,-1649,-0.8,20.6,0,272,272,1589
2011,21,l) Left Censored,7511,20466,698015,694867,782,3.8,745,3.6,61721,13005,48716,1.9,8.9,55425,11287,44138,1.6,8,6296,0.9,16,0,214,225,1787
2011,22,a) 0,4908,4959,33360,16786,4891,197.3,0,0,33148,33148,0,197.5,197.5,0,0,0,0,0,33148,197.5,0,0,,,
2011,22,b) 1,3811,3943,32610,34166,17,0.4,1136,24.9,7446,179,7267,0.5,21.8,10558,4865,5693,14.2,30.9,-3112,-9.1,43.6,0,897,897,4101
2011,22,c) 2,3523,3601,30646,30998,120,3.1,632,16.4,6258,512,5746,1.7,20.2,6962,3096,3866,10,22.5,-704,-2.3,40.4,0,520,520,2539
2011,22,d) 3,3654,3820,35183,36001,151,3.7,576,14.3,6130,1002,5128,2.8,17,7766,3483,4283,9.7,21.6,-1636,-4.6,34,0,458,458,2768
2011,22,e) 4,3542,3602,35008,35714,132,3.5,476,12.6,5158,698,4460,2,14.4,6570,2597,3973,7.3,18.4,-1412,-4,28.8,0,394,394,2256
2011,22,f) 5,3029,3323,34363,34939,103,3,410,11.8,4719,798,3921,2.3,13.5,5871,2276,3595,6.5,16.8,-1152,-3.3,27,0,305,305,1777
2011,22,g) 6 to 10,12292,13081,149891,151496,429,3.2,1158,8.6,20271,2574,17697,1.7,13.4,23480,6777,16703,4.5,15.5,-3209,-2.1,26.8,0,876,876,5536
2011,22,h) 11 to 15,9240,10153,130260,132895,298,2.9,810,7.8,12651,2060,10591,1.6,9.5,17921,4660,13261,3.5,13.5,-5270,-4,19,0,594,594,3644
2011,22,i) 16 to 20,6829,7706,108143,110056,219,2.8,543,6.9,10677,1911,8766,1.7,9.7,14503,4091,10412,3.7,13.2,-3826,-3.5,19.4,0,383,389,2555
2011,22,j) 21 to 25,5190,6617,133568,134322,281,4.2,431,6.4,15570,4610,10960,3.4,11.6,17078,4684,12394,3.5,12.7,-1508,-1.1,23.2,0,231,231,1603
2011,22,k) 26+,8585,12207,232855,230946,340,2.8,568,4.6,25940,6460,19480,2.8,11.2,22121,4127,17994,1.8,9.6,3819,1.6,19.2,0,340,340,1908
2011,22,l) Left Censored,7971,21653,642950,639448,1013,4.7,882,4.1,61165,16632,44533,2.6,9.6,54161,11824,42337,1.8,8.5,7004,1.1,17,0,254,264,2232
2011,23,a) 0,1806,1826,8871,4464,1803,197.5,0,0,8814,,,,197.4,0,0,0,0,0,8814,197.4,0,1,,,
2011,23,b) 1,1244,1289,7780,8325,7,0.5,421,27.8,1745,,,,21,2834,1553,1281,18.7,34,-1089,-13,42,1,274,274,1214
2011,23,c) 2,1187,1206,7946,8140,56,4.3,217,16.8,1043,175,868,2.1,12.8,1430,711,719,8.7,17.6,-387,-4.8,25.6,0,147,147,511
2011,23,d) 3,1293,1314,7344,7636,57,4,243,17.2,1340,269,1071,3.5,17.5,1923,1137,786,14.9,25.2,-583,-7.7,35,0,177,177,990
2011,23,e) 4,1289,1303,8003,8451,80,5.8,219,15.9,1002,148,854,1.8,11.9,1897,875,1022,10.4,22.4,-895,-10.5,23.8,0,132,132,653
2011,23,f) 5,1319,1402,9913,9996,67,4.6,176,12,1433,168,1265,1.7,14.3,1598,562,1036,5.6,16,-165,-1.7,28.6,0,114,114,409
2011,23,g) 6 to 10,4822,5023,37853,38794,192,3.7,595,11.4,4322,554,3768,1.4,11.1,6204,2729,3475,7,16,-1882,-4.9,22.2,0,365,365,1581
2011,23,h) 11 to 15,3855,4123,36090,36938,134,3.1,398,9.3,3546,509,3037,1.4,9.6,5241,1764,3477,4.8,14.2,-1695,-4.6,19.2,0,259,259,1342
2011,23,i) 16 to 20,2585,2906,29946,29991,93,3.1,231,7.8,3228,494,2734,1.6,10.8,3317,1134,2183,3.8,11.1,-89,-0.3,21.6,0,144,144,725
2011,23,j) 21 to 25,2428,3012,46714,46478,97,3.2,208,6.8,3926,811,3115,1.7,8.4,3454,994,2460,2.1,7.4,472,1,14.8,0,105,106,566
2011,23,k) 26+,2951,4280,68179,68993,157,3.6,213,4.9,6573,2096,4477,3,9.5,8201,1837,6364,2.7,11.9,-1628,-2.4,19,0,104,107,997
2011,23,l) Left Censored,3057,6842,201510,201462,255,3.7,314,4.6,16213,4344,11869,2.2,8,16117,3688,12429,1.8,8,96,0,16,0,82,82,1313
2011,24,a) 0,6352,6399,40912,20635,6300,196.9,0,0,40555,40555,0,196.5,196.5,0,0,0,0,0,40555,196.5,0,0,,,
2011,24,b) 1,4609,4785,32324,33733,22,0.4,1366,24.6,7882,295,7587,0.9,23.4,10700,5631,5069,16.7,31.7,-2818,-8.3,46.8,0,1004,1004,4356
2011,24,c) 2,4394,4459,35258,35235,190,4,802,16.8,7063,582,6481,1.7,20,7017,3809,3208,10.8,19.9,46,0.1,39.8,0,615,615,3298
2011,24,d) 3,4474,4684,36694,37282,203,4.1,750,15.1,5453,774,4679,2.1,14.6,6629,3363,3266,9,17.8,-1176,-3.2,29.2,0,570,570,2771
2011,24,e) 4,4345,4432,38034,37322,190,4.1,615,13.2,7388,702,6686,1.9,19.8,5964,2897,3067,7.8,16,1424,3.8,32,0,468,468,2465
2011,24,f) 5,4358,4579,39336,39344,193,4,617,12.9,5859,644,5215,1.6,14.9,5875,2661,3214,6.8,14.9,-16,0,29.8,0,456,456,2026
2011,24,g) 6 to 10,17175,17910,180401,181946,639,3.4,1991,10.7,25568,4703,20865,2.6,14.1,28658,10535,18123,5.8,15.8,-3090,-1.7,28.2,0,1414,1416,8098
2011,24,h) 11 to 15,12496,13770,168251,169200,456,3.2,1153,8.2,18872,2632,16240,1.6,11.2,20770,6717,14053,4,12.3,-1898,-1.1,22.4,0,773,773,5129
2011,24,i) 16 to 20,9084,10188,143269,144881,313,3,769,7.4,14187,2093,12094,1.4,9.8,17410,4056,13354,2.8,12,-3223,-2.2,19.6,0,472,472,2134
2011,24,j) 21 to 25,7797,9394,190022,189535,330,3.5,558,5.9,21382,3857,17525,2,11.3,20408,3927,16481,2.1,10.8,974,0.5,21.6,0,343,343,2529
2011,24,k) 26+,8938,12974,267531,267664,455,3.5,680,5.2,26277,6339,19938,2.4,9.8,26542,6179,20363,2.3,9.9,-265,-0.1,19.6,0,394,394,2670
2011,24,l) Left Censored,9304,25746,926142,922740,1593,6.2,1345,5.2,92608,27441,65167,3,10,85803,16453,69350,1.8,9.3,6805,0.7,18.6,0,272,274,2546
2011,25,a) 0,7849,7910,42910,21584,7821,197.7,0,0,42653,42653,0,197.6,197.6,0,0,0,0,0,42653,197.6,0,0,,,
2011,25,b) 1,5798,5879,39003,40187,21,0.3,1625,24,9297,209,9088,0.5,23.1,11664,6559,5105,16.3,29,-2367,-5.9,46.2,0,1151,1151,5401
2011,25,c) 2,5095,5165,34556,34919,231,4.2,893,16.2,6257,918,5339,2.6,17.9,6983,3195,3788,9.1,20,-726,-2.1,35.8,0,669,669,2659
2011,25,d) 3,5334,5427,39064,38809,272,4.8,815,14.3,7064,1338,5726,3.4,18.2,6553,3089,3464,8,16.9,511,1.3,33.8,0,605,605,2588
2011,25,e) 4,4968,5023,39947,39792,250,4.8,678,12.9,6376,780,5596,2,16,6065,2938,3127,7.4,15.2,311,0.8,30.4,0,509,509,2456
2011,25,f) 5,5226,5437,41617,41781,215,3.8,667,11.8,5952,740,5212,1.8,14.2,6279,2455,3824,5.9,15,-327,-0.8,28.4,0,449,449,1817
2011,25,g) 6 to 10,19978,20857,219109,220006,778,3.6,2087,9.7,27054,3215,23839,1.5,12.3,28848,11613,17235,5.3,13.1,-1794,-0.8,24.6,0,1455,1455,8653
2011,25,h) 11 to 15,15537,16636,209674,208683,573,3.4,1307,7.7,23622,2881,20741,1.4,11.3,21640,5628,16012,2.7,10.4,1982,0.9,20.8,0,852,852,3713
2011,25,i) 16 to 20,11050,12085,165425,165964,357,2.9,844,6.8,17934,3687,14247,2.2,10.8,19011,6791,12220,4.1,11.5,-1077,-0.7,21.6,0,555,560,5140
2011,25,j) 21 to 25,10467,12875,241394,241733,413,3.2,803,6.1,21574,4244,17330,1.8,8.9,22252,5079,17173,2.1,9.2,-678,-0.3,17.8,0,461,462,2465
2011,25,k) 26+,12922,18986,490543,491760,621,3.2,926,4.8,44301,11951,32350,2.4,9,46734,11582,35152,2.4,9.5,-2433,-0.5,18,0,464,465,2926
2011,25,l) Left Censored,15461,35418,1357961,1357079,1565,4.4,1592,4.5,119444,23698,95746,1.7,8.8,117680,22275,95405,1.6,8.7,1764,0.1,17.4,0,454,454,4852
2011,26,a) 0,9868,10029,65695,33060,9884,197.1,0,0,65271,65271,0,197.4,197.4,0,0,0,0,0,65271,197.4,0,0,,,
2011,26,b) 1,7062,7169,58776,59802,33,0.4,2160,25.9,16662,370,16292,0.6,27.9,18714,11961,6753,20,31.3,-2052,-3.4,55.8,0,1595,1595,9859
2011,26,c) 2,6635,6724,60871,61335,280,3.9,1302,18,13128,1896,11232,3.1,21.4,14055,8263,5792,13.5,22.9,-927,-1.5,42.8,0,992,992,7215
2011,26,d) 3,6777,6967,61465,62429,314,4.3,1128,15.3,12194,1639,10555,2.6,19.5,14121,7903,6218,12.7,22.6,-1927,-3.1,39,0,854,854,6874
2011,26,e) 4,6250,6394,69526,74179,305,4.5,965,14.4,10149,1313,8836,1.8,13.7,19455,5077,14378,6.8,26.2,-9306,-12.5,27.4,0,700,702,4317
2011,26,f) 5,6230,6459,61801,61691,270,4,861,12.7,10263,1309,8954,2.1,16.6,10042,4322,5720,7,16.3,221,0.3,32.6,0,639,639,3614
2011,26,g) 6 to 10,24074,25425,264108,265080,992,3.8,2745,10.4,37206,5232,31974,2,14,39149,16006,23143,6,14.8,-1943,-0.8,28,0,1955,1964,13066
2011,26,h) 11 to 15,19168,20917,252783,251010,838,3.9,1817,8.5,34050,4638,29412,1.8,13.6,30504,11327,19177,4.5,12.2,3546,1.4,24.4,0,1154,1156,8734
2011,26,i) 16 to 20,14862,16669,196829,196133,558,3.3,1282,7.5,23894,3734,20160,1.9,12.2,22501,7055,15446,3.6,11.5,1393,0.7,23,0,809,809,4956
2011,26,j) 21 to 25,12655,15618,259432,254971,503,3.2,1106,6.9,31677,5254,26423,2.1,12.4,22754,7344,15410,2.9,8.9,8923,3.5,17.8,0,624,624,3200
2011,26,k) 26+,16805,24022,456368,444597,750,3.1,1311,5.4,67333,8322,59011,1.9,15.1,43790,10198,33592,2.3,9.8,23543,5.3,19.6,0,671,674,3614
2011,26,l) Left Censored,17705,45759,1565524,1552370,1935,4.2,1947,4.3,157596,27228,130368,1.8,10.2,131287,29392,101895,1.9,8.5,26309,1.7,17,0,573,588,6378
2011,27,a) 0,6513,6613,39748,20015,6490,196.3,0,0,39467,39467,0,197.2,197.2,0,0,0,0,0,39467,197.2,0,0,,,
2011,27,b) 1,4686,4801,34830,37275,38,0.7,1465,26.2,8761,892,7869,2.4,23.5,13651,9095,4556,24.4,36.6,-4890,-13.1,47,0,1014,1014,7603
2011,27,c) 2,4521,4610,35615,36439,230,4.7,834,17,5960,720,5240,2,16.4,7607,3350,4257,9.2,20.9,-1647,-4.5,32.8,0,609,609,2737
2011,27,d) 3,4481,4581,35936,36757,238,4.9,732,15.2,6020,1012,5008,2.8,16.4,7661,3686,3975,10,20.8,-1641,-4.4,32.8,0,537,537,2992
2011,27,e) 4,4351,4449,39454,40138,223,4.8,676,14.4,5435,640,4795,1.6,13.5,6803,3443,3360,8.6,16.9,-1368,-3.4,27,0,462,463,2593
2011,27,f) 5,4391,4780,37461,38461,226,4.5,633,12.7,5099,794,4305,2.1,13.3,7098,3460,3638,9,18.5,-1999,-5.2,26.6,0,421,421,2786
2011,27,g) 6 to 10,17694,18635,181868,182568,809,4.2,1996,10.4,23429,2943,20486,1.6,12.8,24828,10321,14507,5.7,13.6,-1399,-0.8,25.6,0,1318,1318,8458
2011,27,h) 11 to 15,13448,14861,177613,178730,617,4.1,1232,8.1,19043,3431,15612,1.9,10.7,21276,6512,14764,3.6,11.9,-2233,-1.2,21.4,0,742,742,3916
2011,27,i) 16 to 20,9701,11089,139262,140704,358,3.2,773,6.8,14178,2774,11404,2,10.1,17061,5589,11472,4,12.1,-2883,-2,20.2,0,497,499,3915
2011,27,j) 21 to 25,7530,9383,178654,177408,260,2.7,553,5.8,19619,5477,14142,3.1,11.1,17129,4911,12218,2.8,9.7,2490,1.4,19.4,0,339,339,2005
2011,27,k) 26+,9949,14535,333136,332586,372,2.5,721,4.9,29746,4546,25200,1.4,8.9,28646,6431,22215,1.9,8.6,1100,0.3,17.2,0,369,385,2871
2011,27,l) Left Censored,11693,28428,1165285,1152250,1177,4.1,1140,4,107503,23695,83808,2.1,9.3,81433,14104,67329,1.2,7.1,26070,2.2,14.2,0,296,296,2920
2011,28,a) 0,2655,2702,17124,8642,2670,197.6,0,0,16965,16965,0,196.3,196.3,0,0,0,0,0,16965,196.3,0,0,,,
2011,28,b) 1,2066,2131,16167,17154,13,0.5,610,24.8,3671,141,3530,0.8,21.4,5644,3394,2250,19.8,32.9,-1973,-11.5,42.8,0,495,495,3055
2011,28,c) 2,1930,1955,14378,15057,66,3.1,364,17.3,2273,322,1951,2.1,15.1,3630,1868,1762,12.4,24.1,-1357,-9,30.2,0,297,299,1645
2011,28,d) 3,1927,1993,14629,15263,77,3.6,339,15.9,2303,279,2024,1.8,15.1,3571,1444,2127,9.5,23.4,-1268,-8.3,30.2,0,276,276,1284
2011,28,e) 4,1895,1971,13177,13428,70,3.4,278,13.4,2023,400,1623,3,15.1,2525,1069,1456,8,18.8,-502,-3.7,30.2,0,233,233,950
2011,28,f) 5,1711,1828,18558,19002,56,2.9,251,13,2068,200,1868,1.1,10.9,2955,1465,1490,7.7,15.6,-887,-4.7,21.8,0,196,196,1259
2011,28,g) 6 to 10,6899,7377,70368,72359,242,3.2,752,9.9,8910,1214,7696,1.7,12.3,12892,5139,7753,7.1,17.8,-3982,-5.5,24.6,0,568,568,3877
2011,28,h) 11 to 15,5167,5707,55765,57376,165,2.8,475,8.1,5779,702,5077,1.2,10.1,9000,2766,6234,4.8,15.7,-3221,-5.6,20.2,0,343,343,1824
2011,28,i) 16 to 20,3742,4270,56550,56397,124,2.8,317,7.2,6709,1113,5596,2,11.9,6402,2008,4394,3.6,11.4,307,0.5,22.8,0,226,226,990
2011,28,j) 21 to 25,2893,3373,68914,68552,98,2.9,206,6,7342,1478,5864,2.2,10.7,6618,1452,5166,2.1,9.7,724,1,19.4,0,145,145,751
2011,28,k) 26+,4830,6992,123285,123790,231,3.3,293,4.2,10882,2538,8344,2.1,8.8,11892,1961,9931,1.6,9.6,-1010,-0.8,17.6,0,177,177,863
2011,28,l) Left Censored,5026,13817,410952,408772,558,4,542,3.9,33766,10769,22997,2.6,8.3,29406,6205,23201,1.5,7.2,4360,1.1,14.4,0,159,163,1200
2011,29,a) 0,7642,7791,40042,20131,7702,197.7,0,0,39822,39822,0,197.8,197.8,0,0,0,0,0,39822,197.8,0,0,,,
2011,29,b) 1,5386,5487,34429,37275,41,0.6,2247,33.7,8128,586,7542,1.6,21.8,13820,7956,5864,21.3,37.1,-5692,-15.3,43.6,0,1828,1828,6614
2011,29,c) 2,4577,4747,36569,38624,175,3.3,1125,21.5,6724,879,5845,2.3,17.4,10833,6864,3969,17.8,28,-4109,-10.6,34.8,0,941,941,6168
2011,29,d) 3,4594,4663,36512,36853,189,3.8,881,17.6,6171,729,5442,2,16.7,6853,3385,3468,9.2,18.6,-682,-1.9,33.4,0,695,695,2783
2011,29,e) 4,4488,4596,32274,33506,182,3.7,769,15.7,4685,593,4092,1.8,14,7149,3904,3245,11.7,21.3,-2464,-7.3,28,0,607,607,3298
2011,29,f) 5,4548,4860,39243,40389,195,3.8,736,14.3,5247,935,4312,2.3,13,7538,3143,4395,7.8,18.7,-2291,-5.7,26,0,568,568,2292
2011,29,g) 6 to 10,16939,17866,168756,172317,591,3.2,2146,11.5,20023,2953,17070,1.7,11.6,27144,10530,16614,6.1,15.8,-7121,-4.2,23.2,0,1612,1612,8366
2011,29,h) 11 to 15,12492,13764,150768,152428,435,3.1,1255,8.8,16337,2583,13754,1.7,10.7,19656,6086,13570,4,12.9,-3319,-2.2,21.4,0,865,866,4616
2011,29,i) 16 to 20,9138,10492,142656,144879,301,2.8,798,7.4,13984,2141,11843,1.5,9.7,18429,5276,13153,3.6,12.7,-4445,-3,19.4,0,536,536,3816
2011,29,j) 21 to 25,7634,9952,159955,158917,263,2.6,595,5.9,16764,5005,11759,3.1,10.5,14687,3690,10997,2.3,9.2,2077,1.3,18.4,0,410,410,1858
2011,29,k) 26+,10619,16319,357323,357471,527,3.2,892,5.4,33517,7217,26300,2,9.4,33812,7687,26125,2.2,9.5,-295,-0.1,18.8,0,506,508,3847
2011,29,l) Left Censored,11752,31069,1083705,1086219,1351,4.4,1213,3.9,86976,18861,68115,1.7,8,92003,15682,76321,1.4,8.5,-5027,-0.5,16,0,346,349,3459
2011,30,a) 0,1785,1797,7379,3750,1769,196.9,0,0,7259,7259,0,193.6,193.6,0,0,0,0,0,7259,193.6,0,0,,,
2011,30,b) 1,1295,1306,6622,7723,4,0.3,425,27.6,1507,13,1494,0.2,19.5,3708,2124,1584,27.5,48,-2201,-28.5,39,0,303,303,1715
2011,30,c) 2,1306,1309,6536,6820,85,6.1,232,16.8,1126,244,882,3.6,16.5,1694,815,879,12,24.8,-568,-8.3,33,0,151,151,608
2011,30,d) 3,1356,1388,7850,8116,69,4.7,246,16.6,1160,149,1011,1.8,14.3,1692,810,882,10,20.8,-532,-6.5,28.6,0,151,151,607
2011,30,e) 4,1332,1357,8031,8269,75,5.2,252,17.4,1299,309,990,3.7,15.7,1774,782,992,9.5,21.5,-475,-5.8,31.4,0,151,151,559
2011,30,f) 5,1396,1457,15355,15074,76,5,222,14.5,2158,210,1948,1.4,14.3,1595,687,908,4.6,10.6,563,3.7,21.2,0,149,149,517
2011,30,g) 6 to 10,4962,5108,32605,33861,230,4.3,598,11.3,4177,861,3316,2.5,12.3,6688,2990,3698,8.8,19.8,-2511,-7.5,24.6,0,370,372,2407
2011,30,h) 11 to 15,3584,3787,30771,31765,160,4.1,374,9.6,3086,489,2597,1.5,9.7,5073,1606,3467,5.1,16,-1987,-6.3,19.4,0,203,210,954
2011,30,i) 16 to 20,2350,2492,23180,23785,81,3.2,215,8.4,2269,391,1878,1.6,9.5,3478,872,2606,3.7,14.6,-1209,-5.1,19,0,135,135,528
2011,30,j) 21 to 25,1640,1863,23260,23553,56,2.9,125,6.6,2208,247,1961,1,9.4,2794,901,1893,3.8,11.9,-586,-2.5,18.8,0,80,80,426
2011,30,k) 26+,2428,3390,51038,51878,74,2.1,204,5.9,4094,518,3576,1,7.9,5774,1719,4055,3.3,11.1,-1680,-3.2,15.8,0,112,112,829
2011,30,l) Left Censored,2381,5183,117871,118038,204,3.9,194,3.7,9708,1864,7844,1.6,8.2,10042,3005,7037,2.5,8.5,-334,-0.3,16.4,0,67,67,2284
2011,31,a) 0,2253,2278,12364,6206,2253,197.8,0,0,12317,12317,0,198.5,198.5,0,0,0,0,0,12317,198.5,0,0,,,
2011,31,b) 1,1728,1753,10522,10620,8,0.4,433,21.7,2480,67,2413,0.6,23.4,2676,1241,1435,11.7,25.2,-196,-1.8,46.8,0,303,303,962
2011,31,c) 2,1688,1710,10933,11041,69,3.8,287,15.8,2018,312,1706,2.8,18.3,2233,1170,1063,10.6,20.2,-215,-1.9,36.6,0,212,212,999
2011,31,d) 3,1656,1686,11140,11344,62,3.5,238,13.4,1750,170,1580,1.5,15.4,2157,1046,1111,9.2,19,-407,-3.6,30.8,0,173,173,811
2011,31,e) 4,1604,1646,10668,11481,51,2.9,213,12.3,1347,189,1158,1.6,11.7,2972,1807,1165,15.7,25.9,-1625,-14.2,23.4,0,159,159,1623
2011,31,f) 5,1539,1636,12661,12913,55,3.2,207,12.1,1677,145,1532,1.1,13,2181,956,1225,7.4,16.9,-504,-3.9,26,0,160,160,799
2011,31,g) 6 to 10,6048,6319,51663,53027,234,3.6,630,9.6,6381,1489,4892,2.8,12,9108,2957,6151,5.6,17.2,-2727,-5.2,24,0,429,429,2141
2011,31,h) 11 to 15,4665,5129,63200,64187,175,3.3,414,7.9,5209,887,4322,1.4,8.1,7182,2002,5180,3.1,11.2,-1973,-3.1,16.2,0,266,266,1610
2011,31,i) 16 to 20,3295,3695,41606,42339,98,2.6,254,6.7,4387,424,3963,1,10.4,5852,1785,4067,4.2,13.8,-1465,-3.4,20.8,0,158,162,1255
2011,31,j) 21 to 25,2722,3397,66553,65306,120,3.5,213,6.2,7731,1322,6409,2,11.8,5236,1087,4149,1.7,8,2495,3.8,16,0,122,122,550
2011,31,k) 26+,4207,6133,117392,118479,170,2.7,345,5.5,9753,2124,7629,1.8,8.2,11927,2267,9660,1.9,10.1,-2174,-1.9,16.4,0,194,195,1184
2011,31,l) Left Censored,5183,11099,348565,353034,493,4.4,459,4.1,31795,7644,24151,2.2,9,40733,16836,23897,4.8,11.5,-8938,-2.5,18,0,132,133,1582
2011,32,a) 0,4253,4285,27121,13707,4234,197.6,0,0,26828,26828,0,195.7,195.7,0,0,0,0,0,26828,195.7,0,0,,,
2011,32,b) 1,2957,3014,32862,33231,13,0.4,1143,31.5,9231,51,9180,0.2,27.8,9969,5572,4397,16.8,30,-738,-2.2,55.6,0,906,906,4470
2011,32,c) 2,2638,2725,23086,23731,144,4.9,625,21.1,5512,969,4543,4.1,23.2,6802,3978,2824,16.8,28.7,-1290,-5.5,46.4,0,498,498,3503
2011,32,d) 3,2646,2732,28336,29114,155,5.3,551,18.8,4527,549,3978,1.9,15.5,6083,2907,3176,10,20.9,-1556,-5.4,31,0,441,441,2497
2011,32,e) 4,2354,2429,21369,22783,100,3.8,455,17.5,2857,387,2470,1.7,12.5,5684,3251,2433,14.3,24.9,-2827,-12.4,25,0,363,363,2911
2011,32,f) 5,2316,2435,24234,25620,119,4.6,416,16.1,2994,366,2628,1.4,11.7,5765,1953,3812,7.6,22.5,-2771,-10.8,23.4,0,302,302,1348
2011,32,g) 6 to 10,7861,8362,110017,114050,313,3.6,1106,12.6,12413,1609,10804,1.4,10.9,20479,9013,11466,7.9,18,-8066,-7.1,21.8,0,828,831,7198
2011,32,h) 11 to 15,4608,5271,71563,75592,223,4.1,575,10.5,7710,1622,6088,2.1,10.2,15768,7479,8289,9.9,20.9,-8058,-10.7,20.4,0,417,423,6970
2011,32,i) 16 to 20,2684,3206,62611,63406,160,4.9,266,8.2,6562,1332,5230,2.1,10.3,8152,1965,6187,3.1,12.9,-1590,-2.6,20.6,0,187,187,1184
2011,32,j) 21 to 25,2009,2849,55889,55690,102,3.5,193,6.7,6128,1645,4483,3,11,5730,1438,4292,2.6,10.3,398,0.7,20.6,0,112,112,680
2011,32,k) 26+,2648,4844,135935,135186,212,4.3,296,6.1,15145,4302,10843,3.2,11.2,13647,2204,11443,1.6,10.1,1498,1.1,20.2,0,124,142,896
2011,32,l) Left Censored,2855,9265,399200,400628,609,6.6,458,5,33416,7082,26334,1.8,8.3,36272,6156,30116,1.5,9.1,-2856,-0.8,16.6,0,57,57,559
2011,33,a) 0,1645,1657,8945,4520,1639,197.8,0,0,8850,8850,0,195.8,195.8,0,0,0,0,0,8850,195.8,0,0,,,
2011,33,b) 1,1295,1327,9539,9710,3,0.2,355,23.3,2396,32,2364,0.3,24.7,2738,1515,1223,15.6,28.2,-342,-3.5,49.4,0,262,262,1237
2011,33,c) 2,1136,1148,7448,7831,35,2.8,232,18.6,1259,105,1154,1.3,16.1,2024,1140,884,14.6,25.8,-765,-9.7,32.2,0,186,186,1023
2011,33,d) 3,1257,1274,10460,10988,55,4.1,188,14,1639,255,1384,2.3,14.9,2695,908,1787,8.3,24.5,-1056,-9.6,29.8,0,151,151,812
2011,33,e) 4,1124,1145,8699,8590,53,4.4,183,15.1,1537,154,1383,1.8,17.9,1319,603,716,7,15.4,218,2.5,30.8,0,143,143,505
2011,33,f) 5,1202,1283,11488,11612,44,3.3,161,12,1530,130,1400,1.1,13.2,1778,712,1066,6.1,15.3,-248,-2.1,26.4,0,118,118,507
2011,33,g) 6 to 10,4379,4558,38411,39325,149,3.1,542,11.4,4325,490,3835,1.2,11,6152,2333,3819,5.9,15.6,-1827,-4.6,22,0,396,396,1944
2011,33,h) 11 to 15,3649,3917,41725,42463,119,3,337,8.4,4233,544,3689,1.3,10,5709,2460,3249,5.8,13.4,-1476,-3.4,20,0,229,229,2146
2011,33,i) 16 to 20,2674,2850,33169,33672,63,2.1,214,7.3,2926,348,2578,1,8.7,3932,1222,2710,3.6,11.7,-1006,-3,17.4,0,153,153,895
2011,33,j) 21 to 25,2529,3054,46486,47400,102,3.3,162,5.2,3967,865,3102,1.8,8.4,5795,994,4801,2.1,12.2,-1828,-3.8,16.8,0,99,99,558
2011,33,k) 26+,2724,3787,71613,72143,107,2.8,197,5.1,6830,1387,5443,1.9,9.5,7889,2046,5843,2.8,10.9,-1059,-1.4,19,0,110,110,818
2011,33,l) Left Censored,3117,7030,256700,260527,316,4.5,312,4.4,17765,3810,13955,1.5,6.8,25419,3997,21422,1.5,9.8,-7654,-3,13.6,0,77,77,747
2011,34,a) 0,12737,12794,71540,36015,12640,197.6,0,0,71050,71050,0,197.3,197.3,0,0,0,0,0,71050,197.3,0,0,,,
2011,34,b) 1,9022,9165,64237,65525,33,0.3,2794,26.2,15885,404,15481,0.6,24.2,18460,10442,8018,15.9,28.2,-2575,-4,48.4,0,2076,2076,8603
2011,34,c) 2,8091,8165,58813,58717,365,4.1,1634,18.6,11794,1271,10523,2.2,20.1,11602,6353,5249,10.8,19.8,192,0.3,39.6,0,1295,1295,5287
2011,34,d) 3,8222,8299,74425,72839,384,4.4,1398,15.9,14428,1272,13156,1.7,19.8,11255,5237,6018,7.2,15.5,3173,4.3,31,0,1066,1066,4068
2011,34,e) 4,7788,7884,63915,63297,335,4,1232,14.8,11504,1394,10110,2.2,18.2,10268,4530,5738,7.2,16.2,1236,2,32.4,0,962,963,3781
2011,34,f) 5,7638,7883,65081,66460,348,4.2,1222,14.7,9641,1595,8046,2.4,14.5,12399,5253,7146,7.9,18.7,-2758,-4.2,29,0,888,888,3933
2011,34,g) 6 to 10,29240,30112,281182,288172,1147,3.7,3514,11.2,36801,6432,30369,2.2,12.8,50781,23109,27672,8,17.6,-13980,-4.8,25.6,0,2525,2526,17388
2011,34,h) 11 to 15,22289,23871,269801,275029,841,3.4,2197,8.9,28358,5214,23144,1.9,10.3,38816,12119,26697,4.4,14.1,-10458,-3.8,20.6,0,1516,1518,8337
2011,34,i) 16 to 20,15199,16144,200030,201186,440,2.7,1286,7.8,23206,2635,20571,1.3,11.5,25518,7408,18110,3.7,12.7,-2312,-1.2,23,0,887,888,5629
2011,34,j) 21 to 25,13058,15186,249476,249683,478,3.1,1143,7.4,25853,5816,20037,2.3,10.4,26267,7902,18365,3.2,10.5,-414,-0.1,20.8,0,715,715,4501
2011,34,k) 26+,16009,21335,473623,472630,655,3,1235,5.7,44181,8367,35814,1.8,9.3,42195,10804,31391,2.3,8.9,1986,0.4,17.8,0,688,690,3551
2011,34,l) Left Censored,17016,39610,1474176,1480412,2102,5.3,2258,5.7,136887,36015,100872,2.4,9.2,149359,33786,115573,2.3,10.1,-12472,-0.9,18.4,0,695,718,7446
2011,35,a) 0,2142,2155,12581,6338,2123,197,0,0,12486,12486,0,197,197,0,0,0,0,0,12486,197,0,0,,,
2011,35,b) 1,1512,1545,10783,11306,14,0.8,486,27,2690,250,2440,2.2,23.8,3735,2224,1511,19.7,33,-1045,-9.2,47.6,0,388,388,1841
2011,35,c) 2,1545,1566,11504,11724,71,4.3,270,16.2,1888,229,1659,2,16.1,2327,1203,1124,10.3,19.8,-439,-3.7,32.2,0,221,221,1056
2011,35,d) 3,1527,1567,12970,12976,78,4.7,290,17.3,2691,1133,1558,8.7,20.7,2703,1298,1405,10,20.8,-12,-0.1,41.4,0,228,228,1067
2011,35,e) 4,1504,1515,22139,22635,69,4.3,238,14.9,1705,293,1412,1.3,7.5,2696,892,1804,3.9,11.9,-991,-4.4,15,0,183,183,708
2011,35,f) 5,1479,1559,14214,14318,68,4.2,221,13.5,2064,216,1848,1.5,14.4,2272,1030,1242,7.2,15.9,-208,-1.5,28.8,0,172,172,776
2011,35,g) 6 to 10,5400,5769,54403,54782,219,3.7,656,11,7465,1105,6360,2,13.6,8222,2816,5406,5.1,15,-757,-1.4,27.2,0,484,485,2257
2011,35,h) 11 to 15,4032,4359,53200,55147,157,3.5,411,9.2,4476,621,3855,1.1,8.1,8370,1778,6592,3.2,15.2,-3894,-7.1,16.2,0,265,265,1255
2011,35,i) 16 to 20,3005,3373,41420,42351,114,3.3,275,8,4439,637,3802,1.5,10.5,6301,1392,4909,3.3,14.9,-1862,-4.4,21,0,172,176,757
2011,35,j) 21 to 25,2325,2946,57290,57385,84,2.8,166,5.6,4663,1072,3591,1.9,8.1,4852,1225,3627,2.1,8.5,-189,-0.4,16.2,0,115,115,884
2011,35,k) 26+,3361,4936,84779,85332,254,5.1,262,5.3,8169,1830,6339,2.1,9.6,9275,2243,7032,2.6,10.9,-1106,-1.3,19.2,0,147,147,1064
2011,35,l) Left Censored,3199,8302,219399,219745,364,4.4,347,4.2,19569,4245,15324,1.9,8.9,20261,2672,17589,1.2,9.2,-692,-0.3,17.8,0,81,81,538
2011,36,a) 0,34679,34939,174065,87688,34574,197.9,0,0,172754,172754,0,197,197,0,0,0,0,0,172754,197,0,0,,,
2011,36,b) 1,25843,26273,165264,171717,60,0.2,7539,24.9,39304,983,38321,0.6,22.9,52209,29286,22923,17.1,30.4,-12905,-7.5,45.8,0,5564,5564,23598
2011,36,c) 2,22264,22430,150915,152936,872,3.6,4353,18,30257,2679,27578,1.8,19.8,34298,20159,14139,13.2,22.4,-4041,-2.6,39.6,0,3384,3384,14901
2011,36,d) 3,20877,21145,148536,151635,893,4,3762,16.7,24237,2934,21303,1.9,16,30434,16094,14340,10.6,20.1,-6197,-4.1,32,0,2852,2852,13223
2011,36,e) 4,18459,18608,130890,132761,784,4,3016,15.3,20544,2597,17947,2,15.5,24286,12327,11959,9.3,18.3,-3742,-2.8,31,0,2228,2228,10124
2011,36,f) 5,17723,18519,149679,152245,681,3.5,2629,13.5,20202,2652,17550,1.7,13.3,25334,11588,13746,7.6,16.6,-5132,-3.3,26.6,0,1906,1913,8836
2011,36,g) 6 to 10,65925,68037,635770,643719,2356,3.3,7932,11.2,81273,12310,68963,1.9,12.6,97170,40449,56721,6.3,15.1,-15897,-2.5,25.2,0,5707,5708,28092
2011,36,h) 11 to 15,46709,50028,589358,596939,1561,3,4353,8.5,65855,8418,57437,1.4,11,81017,31005,50012,5.2,13.6,-15162,-2.6,22,0,2925,2928,24130
2011,36,i) 16 to 20,31868,33969,418795,422954,907,2.6,2549,7.3,43792,6583,37209,1.6,10.4,52109,14928,37181,3.5,12.3,-8317,-1.9,20.8,0,1681,1686,11484
2011,36,j) 21 to 25,28937,32752,549623,549860,843,2.5,2133,6.4,53332,9299,44033,1.7,9.7,53806,18811,34995,3.4,9.8,-474,-0.1,19.4,0,1322,1323,7594
2011,36,k) 26+,34182,47157,989578,991152,1217,2.5,2463,5.2,86619,15225,71394,1.5,8.7,89767,18857,70910,1.9,9.1,-3148,-0.4,17.4,0,1512,1521,10362
2011,36,l) Left Censored,37656,85196,3260775,3243554,4007,4.7,4406,5.2,320155,85115,235040,2.6,9.9,285714,67662,218052,2.1,8.8,34441,1.1,17.6,0,1398,1418,14653
2011,37,a) 0,11201,11305,67224,33875,11164,197.5,0,0,66699,66699,0,196.9,196.9,0,0,0,0,0,66699,196.9,0,0,,,
2011,37,b) 1,8436,8614,65387,69545,33,0.3,2591,25.8,14168,377,13791,0.5,20.4,22484,13020,9464,18.7,32.3,-8316,-11.9,40.8,0,2059,2059,11080
2011,37,c) 2,7266,7459,54660,56144,302,3.7,1516,18.8,10393,1238,9155,2.2,18.5,13360,7676,5684,13.7,23.8,-2967,-5.3,37,0,1213,1213,6908
2011,37,d) 3,7730,7939,60377,61585,376,4.4,1366,16.2,10813,1386,9427,2.3,17.6,13229,6367,6862,10.3,21.5,-2416,-3.9,35.2,0,1055,1066,5558
2011,37,e) 4,7340,7483,51602,54090,335,4.2,1251,15.7,7812,962,6850,1.8,14.4,12787,6091,6696,11.3,23.6,-4975,-9.2,28.8,0,949,949,5196
2011,37,f) 5,7086,7603,64389,66277,291,3.6,1125,14,8747,1130,7617,1.7,13.2,12523,5888,6635,8.9,18.9,-3776,-5.7,26.4,0,778,778,4412
2011,37,g) 6 to 10,26303,27778,270488,274421,967,3.3,3196,11.1,36296,5481,30815,2,13.2,44161,18198,25963,6.6,16.1,-7865,-2.9,26.4,0,2344,2348,13984
2011,37,h) 11 to 15,18909,21348,249307,251082,774,3.5,2001,9.1,28269,4975,23294,2,11.3,31818,10074,21744,4,12.7,-3549,-1.4,22.6,0,1364,1370,7486
2011,37,i) 16 to 20,12463,14215,214069,215514,426,2.9,1074,7.4,19799,3535,16264,1.6,9.2,22688,6082,16606,2.8,10.5,-2889,-1.3,18.4,0,757,757,4117
2011,37,j) 21 to 25,10255,13387,255500,254606,427,3.1,904,6.6,26196,5439,20757,2.1,10.3,24407,7346,17061,2.9,9.6,1789,0.7,19.2,0,562,563,3732
2011,37,k) 26+,14476,22336,467389,464269,744,3.3,1196,5.3,47270,10566,36704,2.3,10.2,41030,8602,32428,1.9,8.8,6240,1.4,17.6,0,630,648,3802
2011,37,l) Left Censored,13513,43703,1477183,1462950,2091,4.8,2031,4.6,151203,37600,113603,2.6,10.3,122737,21953,100784,1.5,8.4,28466,1.9,16.8,0,461,497,4094
2011,38,a) 0,1197,1205,6677,3414,1194,198.2,0,0,6526,6526,0,191.2,191.2,0,0,0,0,0,6526,191.2,0,0,,,
2011,38,b) 1,753,769,4903,5027,4,0.5,195,22.3,1129,14,1115,0.3,22.5,1376,676,700,13.4,27.4,-247,-4.9,45,0,139,139,542
2011,38,c) 2,739,752,5147,5263,29,3.7,105,13.2,901,78,823,1.5,17.1,1132,460,672,8.7,21.5,-231,-4.4,34.2,0,84,84,400
2011,38,d) 3,740,759,6022,6070,34,4.3,111,13.9,875,142,733,2.3,14.4,971,366,605,6,16,-96,-1.6,28.8,0,80,80,277
2011,38,e) 4,675,690,5671,5781,36,5,96,13.4,764,100,664,1.7,13.2,983,491,492,8.5,17,-219,-3.8,26.4,0,62,62,354
2011,38,f) 5,713,764,6400,6470,29,3.7,69,8.8,785,127,658,2,12.1,925,372,553,5.7,14.3,-140,-2.2,24.2,0,48,48,221
2011,38,g) 6 to 10,2344,2474,22351,22484,82,3.2,225,8.8,3474,838,2636,3.7,15.5,3740,1260,2480,5.6,16.6,-266,-1.1,31,0,165,165,1054
2011,38,h) 11 to 15,1774,1961,19740,20142,82,4.1,138,6.9,2137,380,1757,1.9,10.6,2941,843,2098,4.2,14.6,-804,-4,21.2,0,91,91,579
2011,38,i) 16 to 20,1470,1560,18351,18528,42,2.6,112,7,1927,431,1496,2.3,10.4,2280,398,1882,2.1,12.3,-353,-1.9,20.8,0,72,72,280
2011,38,j) 21 to 25,1193,1387,17877,18004,46,3.3,79,5.6,1578,286,1292,1.6,8.8,1831,287,1544,1.6,10.2,-253,-1.4,17.6,0,43,43,219
2011,38,k) 26+,1965,2607,44479,43823,79,3,135,5.1,5134,1272,3862,2.9,11.7,3822,853,2969,1.9,8.7,1312,3,17.4,0,81,81,554
2011,38,l) Left Censored,2403,4772,142191,140743,199,4.2,177,3.7,13441,2587,10854,1.8,9.6,10545,2617,7928,1.9,7.5,2896,2.1,15,0,61,63,1268
2011,39,a) 0,10002,10162,68926,34655,10029,197.4,0,0,68543,68543,0,197.8,197.8,0,0,0,0,0,68543,197.8,0,0,,,
2011,39,b) 1,7273,7608,70384,73352,52,0.6,2121,24.3,18241,938,17303,1.3,24.9,24177,14467,9710,19.7,33,-5936,-8.1,49.8,0,1644,1650,12906
2011,39,c) 2,6739,6895,62266,63302,289,3.9,1171,16,11868,1498,10370,2.4,18.7,13940,7623,6317,12,22,-2072,-3.3,37.4,0,911,911,6731
2011,39,d) 3,6978,7206,64181,65013,281,3.7,1082,14.2,11467,1838,9629,2.8,17.6,13130,5356,7774,8.2,20.2,-1663,-2.6,35.2,0,862,862,4687
2011,39,e) 4,6381,6584,59071,59786,234,3.4,939,13.6,9243,1204,8039,2,15.5,10672,4834,5838,8.1,17.9,-1429,-2.4,31,0,701,701,3752
2011,39,f) 5,6683,7094,75480,75516,282,3.8,872,11.8,10681,1565,9116,2.1,14.1,10753,4325,6428,5.7,14.2,-72,-0.1,28.2,0,631,631,3173
2011,39,g) 6 to 10,26544,28431,300256,303728,1086,3.7,2888,9.8,38501,6000,32501,2,12.7,45445,19598,25847,6.5,15,-6944,-2.3,25.4,0,2105,2112,15770
2011,39,h) 11 to 15,21130,23797,287659,287044,776,3.2,1938,7.9,34818,7369,27449,2.6,12.1,33588,9988,23600,3.5,11.7,1230,0.4,23.4,0,1305,1305,6954
2011,39,i) 16 to 20,16883,19437,261328,262577,580,2.9,1460,7.3,29599,3589,26010,1.4,11.3,32097,7759,24338,3,12.2,-2498,-0.9,22.6,0,934,937,4984
2011,39,j) 21 to 25,14273,18090,308507,309031,472,2.5,1617,8.7,30818,4221,26597,1.4,10,31866,10764,21102,3.5,10.3,-1048,-0.3,20,0,687,691,4942
2011,39,k) 26+,19782,30515,645501,640562,1073,3.5,1474,4.8,70670,14957,55713,2.3,11,60792,12037,48755,1.9,9.5,9878,1.5,19,0,823,830,4829
2011,39,l) Left Censored,24021,62463,2200156,2182815,2529,4,2847,4.5,217329,44454,172875,2,10,182647,36995,145652,1.7,8.4,34682,1.6,16.8,0,827,860,9780
2011,40,a) 0,4610,4694,26563,13407,4621,196.9,0,0,26313,26313,0,196.3,196.3,0,0,0,0,0,26313,196.3,0,0,,,
2011,40,b) 1,3394,3460,25853,28020,22,0.5,1053,26.1,6258,254,6004,0.9,22.3,10592,6881,3711,24.6,37.8,-4334,-15.5,44.6,0,837,837,6165
2011,40,c) 2,3255,3303,24873,25288,140,3.9,663,18.6,4968,640,4328,2.5,19.6,5799,3275,2524,13,22.9,-831,-3.3,39.2,0,518,518,2599
2011,40,d) 3,3289,3363,27113,27683,145,4.1,555,15.5,4306,603,3703,2.2,15.6,5445,2599,2846,9.4,19.7,-1139,-4.1,31.2,0,416,416,2013
2011,40,e) 4,3062,3140,28510,28383,120,3.6,456,13.8,5045,967,4078,3.4,17.8,4790,2151,2639,7.6,16.9,255,0.9,33.8,0,355,355,1892
2011,40,f) 5,2989,3197,29594,29173,106,3.2,360,10.8,4721,600,4121,2.1,16.2,3879,1454,2425,5,13.3,842,2.9,26.6,0,277,277,1102
2011,40,g) 6 to 10,10737,11370,109741,111135,357,3,1150,9.8,14596,2203,12393,2,13.1,17384,6448,10936,5.8,15.6,-2788,-2.5,26.2,0,848,848,4697
2011,40,h) 11 to 15,8001,9061,100302,101427,308,3.3,765,8.2,13288,2078,11210,2,13.1,15537,4466,11071,4.4,15.3,-2249,-2.2,26.2,0,509,509,3142
2011,40,i) 16 to 20,5675,6297,74487,75962,181,2.8,522,8,7670,1260,6410,1.7,10.1,10620,3175,7445,4.2,14,-2950,-3.9,20.2,0,368,374,2139
2011,40,j) 21 to 25,4365,5483,102433,101902,145,2.6,359,6.4,11764,1598,10166,1.6,11.5,10703,3207,7496,3.1,10.5,1061,1,21,0,250,250,1702
2011,40,k) 26+,7384,10764,209495,207970,277,2.5,535,4.9,20490,3534,16956,1.7,9.9,17439,3516,13923,1.7,8.4,3051,1.5,16.8,0,334,335,1846
2011,40,l) Left Censored,6473,17191,491597,488283,751,4.4,638,3.7,45555,11529,34026,2.4,9.3,38926,8211,30715,1.7,8,6629,1.3,16,0,179,186,1643
2011,41,a) 0,5824,5900,26458,13334,5830,197.6,0,0,26248,26248,0,196.9,196.9,0,0,0,0,0,26248,196.9,0,0,,,
2011,41,b) 1,4189,4295,25101,26212,33,0.7,1297,26,6238,450,5788,1.7,23.8,8459,5025,3434,19.2,32.3,-2221,-8.5,47.6,0,974,974,4225
2011,41,c) 2,3891,3935,22668,23291,162,3.8,794,18.7,4290,534,3756,2.3,18.4,5535,2772,2763,11.9,23.8,-1245,-5.4,36.8,0,601,601,2278
2011,41,d) 3,4122,4200,24631,24862,224,5,741,16.6,4587,632,3955,2.5,18.4,5048,2820,2228,11.3,20.3,-461,-1.9,36.8,0,561,561,2255
2011,41,e) 4,3849,3932,25101,25728,205,4.9,620,15,4003,599,3404,2.3,15.6,5257,2778,2479,10.8,20.4,-1254,-4.8,31.2,0,435,435,2207
2011,41,f) 5,3843,4249,31001,31177,194,4.4,544,12.3,4969,646,4323,2.1,15.9,5321,2085,3236,6.7,17.1,-352,-1.2,31.8,0,402,402,1597
2011,41,g) 6 to 10,13798,14691,119327,128839,565,3.7,1707,11.2,15114,2398,12716,1.9,11.7,34138,7653,26485,5.9,26.5,-19024,-14.8,23.4,0,1138,1139,5586
2011,41,h) 11 to 15,10091,11096,116443,117812,450,3.9,1006,8.8,13114,2746,10368,2.3,11.1,15852,5042,10810,4.3,13.5,-2738,-2.4,22.2,0,640,640,3197
2011,41,i) 16 to 20,7138,7981,82871,83858,260,3.2,590,7.2,8269,876,7393,1,9.9,10243,2895,7348,3.5,12.2,-1974,-2.3,19.8,0,393,393,1962
2011,41,j) 21 to 25,5309,6519,97178,96860,200,3,479,7.2,10979,1499,9480,1.5,11.3,10343,2628,7715,2.7,10.7,636,0.6,21.4,0,304,334,1775
2011,41,k) 26+,7136,10485,215100,216655,295,2.8,649,6.1,20324,3860,16464,1.8,9.4,23433,5502,17931,2.5,10.8,-3109,-1.4,18.8,0,341,349,2553
2011,41,l) Left Censored,6663,17767,549109,544509,778,4.4,713,4,53566,9251,44315,1.7,9.8,44367,9286,35081,1.7,8.1,9199,1.7,16.2,0,182,187,2097
2011,42,a) 0,12743,12937,78724,39602,12798,197.9,0,0,78245,78245,0,197.6,197.6,0,0,0,0,0,78245,197.6,0,0,,,
2011,42,b) 1,9258,9642,75320,78214,72,0.7,2451,22.4,19365,2386,16979,3.1,24.8,25153,13887,11266,17.8,32.2,-5788,-7.4,49.6,0,1860,1868,12148
2011,42,c) 2,8831,8984,70126,70441,343,3.6,1483,15.5,12673,1666,11007,2.4,18,13303,7003,6300,9.9,18.9,-630,-0.9,36,0,1150,1150,5961
2011,42,d) 3,9011,9196,68416,68426,355,3.7,1387,14.3,12382,1789,10593,2.6,18.1,12402,5898,6504,8.6,18.1,-20,0,36.2,0,1057,1057,5085
2011,42,e) 4,8468,8623,70787,70237,340,3.8,1112,12.3,12117,1628,10489,2.3,17.3,11016,5263,5753,7.5,15.7,1101,1.6,31.4,0,825,825,4394
2011,42,f) 5,8598,9089,86174,89690,316,3.3,1018,10.8,10948,1325,9623,1.5,12.2,17980,10073,7907,11.2,20,-7032,-7.8,24.4,0,739,741,9146
2011,42,g) 6 to 10,34314,36116,377585,379837,1124,3,3377,9.1,44005,5649,38356,1.5,11.6,48508,17734,30774,4.7,12.8,-4503,-1.2,23.2,0,2405,2407,13886
2011,42,h) 11 to 15,26350,29508,369524,368876,881,2.9,2178,7.2,43842,6823,37019,1.8,11.9,42545,13091,29454,3.5,11.5,1297,0.4,23,0,1382,1390,7595
2011,42,i) 16 to 20,19245,21543,293602,295753,573,2.6,1403,6.4,30159,5987,24172,2,10.2,34460,9067,25393,3.1,11.7,-4301,-1.5,20.4,0,917,917,6100
2011,42,j) 21 to 25,18030,21336,339149,337762,616,2.8,1229,5.7,36328,6031,30297,1.8,10.8,33554,8623,24931,2.6,9.9,2774,0.9,19.8,0,814,814,4967
2011,42,k) 26+,23035,34443,769970,765522,1400,4,1706,4.9,87460,31210,56250,4.1,11.4,78564,19905,58659,2.6,10.3,8896,1.1,20.6,0,905,908,5737
2011,42,l) Left Censored,26569,68778,2423325,2403823,3037,4.4,2954,4.3,232721,54826,177895,2.3,9.7,193717,42436,151281,1.8,8.1,39004,1.6,16.2,0,901,908,9499
2011,44,a) 0,1260,1270,7285,3668,1253,197.3,0,0,7235,7235,0,197.2,197.2,0,0,0,0,0,7235,197.2,0,0,,,
2011,44,b) 1,910,927,6099,6266,8,0.7,310,28.3,1419,114,1305,1.8,22.6,1753,984,769,15.7,28,-334,-5.4,45.2,0,217,217,721
2011,44,c) 2,769,788,4990,5311,30,3.5,170,19.8,741,55,686,1,14,1383,839,544,15.8,26,-642,-12,28,0,135,135,719
2011,44,d) 3,870,879,6934,7137,44,4.7,167,17.8,951,208,743,2.9,13.3,1357,791,566,11.1,19,-406,-5.7,26.6,0,127,127,672
2011,44,e) 4,856,867,7314,7156,55,6.1,106,11.9,1337,365,972,5.1,18.7,1021,364,657,5.1,14.3,316,4.4,28.6,0,79,79,298
2011,44,f) 5,851,918,6642,6784,52,5.5,122,12.8,749,93,656,1.4,11,1032,499,533,7.4,15.2,-283,-4.2,22,0,85,85,421
2011,44,g) 6 to 10,3481,3615,30949,31040,149,4,406,10.8,3816,560,3256,1.8,12.3,3998,1565,2433,5,12.9,-182,-0.6,24.6,0,281,281,1124
2011,44,h) 11 to 15,2590,2838,26662,26844,100,3.4,261,8.9,2866,393,2473,1.5,10.7,3229,1033,2196,3.8,12,-363,-1.3,21.4,0,157,160,735
2011,44,i) 16 to 20,2012,2117,25355,25908,62,2.9,155,7.2,2223,222,2001,0.9,8.6,3329,1073,2256,4.1,12.8,-1106,-4.2,17.2,0,100,100,322
2011,44,j) 21 to 25,1907,2137,30775,30963,77,3.6,133,6.1,2531,598,1933,1.9,8.2,2906,708,2198,2.3,9.4,-375,-1.2,16.4,0,82,82,269
2011,44,k) 26+,2306,2923,52002,52404,97,3.3,146,4.9,3937,598,3339,1.1,7.5,4741,1013,3728,1.9,9,-804,-1.5,15,0,78,78,395
2011,44,l) Left Censored,3146,5535,199561,195987,250,4.5,290,5.2,21445,4349,17096,2.2,10.9,14297,3986,10311,2,7.3,7148,3.6,14.6,0,87,87,937
2011,45,a) 0,4951,5042,30506,15336,4991,198,0,0,30341,30341,0,197.8,197.8,0,0,0,0,0,30341,197.8,0,0,,,
2011,45,b) 1,3752,3823,25926,28298,38,0.9,1195,26.8,6549,485,6064,1.7,23.1,11292,7524,3768,26.6,39.9,-4743,-16.8,46.2,0,935,935,6480
2011,45,c) 2,3436,3599,34020,34875,141,3.6,735,18.9,4890,746,4144,2.1,14,6600,3413,3187,9.8,18.9,-1710,-4.9,28,0,572,572,2525
2011,45,d) 3,3434,3483,23796,24351,113,3,658,17.5,4068,422,3646,1.7,16.7,5178,2841,2337,11.7,21.3,-1110,-4.6,33.4,0,519,519,2427
2011,45,e) 4,3345,3430,27329,28061,146,4,572,15.7,4715,539,4176,1.9,16.8,6179,3249,2930,11.6,22,-1464,-5.2,33.6,0,414,414,2750
2011,45,f) 5,3195,3330,27930,28658,114,3.2,519,14.7,3866,331,3535,1.2,13.5,5322,2807,2515,9.8,18.6,-1456,-5.1,27,0,383,385,2415
2011,45,g) 6 to 10,12473,13203,135105,138019,470,3.4,1609,11.7,16149,2523,13626,1.8,11.7,21976,9366,12610,6.8,15.9,-5827,-4.2,23.4,0,1192,1195,6986
2011,45,h) 11 to 15,9061,10032,125329,125766,331,3.2,908,8.8,15718,2376,13342,1.9,12.5,16592,6625,9967,5.3,13.2,-874,-0.7,25,0,664,668,5531
2011,45,i) 16 to 20,6049,6813,93086,94252,192,2.7,601,8.5,9511,1699,7812,1.8,10.1,11843,3103,8740,3.3,12.6,-2332,-2.5,20.2,0,407,408,1689
2011,45,j) 21 to 25,4856,6560,112253,111588,217,3.2,430,6.4,13603,3094,10509,2.8,12.2,12273,3161,9112,2.8,11,1330,1.2,22,0,281,281,1804
2011,45,k) 26+,6836,10787,209983,210304,335,3.1,528,4.8,22104,4410,17694,2.1,10.5,22745,5214,17531,2.5,10.8,-641,-0.3,21,0,291,291,2204
2011,45,l) Left Censored,6891,20968,656531,652062,875,4.2,912,4.3,67621,17042,50579,2.6,10.4,58684,9009,49675,1.4,9,8937,1.4,18,0,211,218,1434
2011,46,a) 0,1136,1148,6371,3210,1129,196.7,0,0,6323,6323,0,197,197,0,0,0,0,0,6323,197,0,0,,,
2011,46,b) 1,904,949,6502,7170,7,0.6,256,23.6,1290,42,1248,0.6,18,2625,1636,989,22.8,36.6,-1335,-18.6,36,0,175,183,1487
2011,46,c) 2,910,917,5962,6223,32,3.3,163,16.6,895,69,826,1.1,14.4,1417,727,690,11.7,22.8,-522,-8.4,28.8,0,112,112,522
2011,46,d) 3,864,874,5656,5773,44,4.8,123,13.5,1029,264,765,4.6,17.8,1262,620,642,10.7,21.9,-233,-4.1,35.6,0,97,97,532
2011,46,e) 4,874,895,5942,6155,40,4.3,120,12.8,901,297,604,4.8,14.6,1326,652,674,10.6,21.5,-425,-6.9,29.2,0,82,82,350
2011,46,f) 5,850,868,6823,6973,34,3.7,119,13,866,113,753,1.6,12.4,1165,474,691,6.8,16.7,-299,-4.3,24.8,0,83,83,328
2011,46,g) 6 to 10,3185,3339,26599,27229,127,3.7,348,10.1,3419,875,2544,3.2,12.6,4679,1566,3113,5.8,17.2,-1260,-4.6,25.2,0,239,239,1188
2011,46,h) 11 to 15,2461,2621,25458,25828,86,3.2,214,8,3121,775,2346,3,12.1,3861,1191,2670,4.6,14.9,-740,-2.8,24.2,0,133,133,657
2011,46,i) 16 to 20,1736,1877,21301,21683,67,3.5,118,6.2,2795,923,1872,4.3,12.9,3559,1082,2477,5,16.4,-764,-3.5,25.8,0,71,71,407
2011,46,j) 21 to 25,1258,1450,21204,21127,44,3,112,7.5,2327,420,1907,2,11,2173,696,1477,3.3,10.3,154,0.7,20.6,0,72,72,436
2011,46,k) 26+,1984,2711,36164,36838,77,2.8,135,4.9,3231,832,2399,2.3,8.8,4578,1086,3492,2.9,12.4,-1347,-3.6,17.6,0,76,76,740
2011,46,l) Left Censored,2511,5050,150172,150944,163,3.2,146,2.9,10845,2134,8711,1.4,7.2,12389,3717,8672,2.5,8.2,-1544,-1,14.4,0,53,54,2880
2011,47,a) 0,6315,6366,41183,20743,6299,197.9,0,0,40880,40880,0,197.1,197.1,0,0,0,0,0,40880,197.1,0,0,,,
2011,47,b) 1,4624,4786,37765,40085,65,1.2,1467,26.4,9502,1065,8437,2.7,23.7,14142,7623,6519,19,35.3,-4640,-11.6,47.4,0,1223,1224,6726
2011,47,c) 2,4017,4227,36745,36231,180,3.9,876,19.2,8735,928,7807,2.6,24.1,7706,4261,3445,11.8,21.3,1029,2.8,42.6,0,733,742,3639
2011,47,d) 3,4324,4448,35255,35456,170,3.6,776,16.3,6294,740,5554,2.1,17.8,6696,3250,3446,9.2,18.9,-402,-1.1,35.6,0,653,653,2713
2011,47,e) 4,3953,4102,31773,32433,161,3.7,661,15.2,5224,857,4367,2.6,16.1,6543,3031,3512,9.3,20.2,-1319,-4.1,32.2,0,511,511,2420
2011,47,f) 5,3784,4028,42278,42699,151,3.6,550,13,7299,621,6678,1.5,17.1,8141,3409,4732,8,19.1,-842,-2,34.2,0,440,447,3012
2011,47,g) 6 to 10,14315,15597,171589,175539,553,3.4,1729,10.7,22579,3548,19031,2,12.9,30478,14019,16459,8,17.4,-7899,-4.5,25.8,0,1299,1301,11536
2011,47,h) 11 to 15,10845,12507,159421,160966,457,3.6,1111,8.6,20080,3856,16224,2.4,12.5,23170,9411,13759,5.8,14.4,-3090,-1.9,25,0,821,823,7066
2011,47,i) 16 to 20,8035,9585,141005,139840,297,3,742,7.6,18232,2179,16053,1.6,13,15903,3660,12243,2.6,11.4,2329,1.6,22.8,0,537,537,2573
2011,47,j) 21 to 25,6811,8939,171138,172467,256,2.8,582,6.4,16848,3075,13773,1.8,9.8,19506,7847,11659,4.5,11.3,-2658,-1.5,19.6,0,357,360,1777
2011,47,k) 26+,9880,15577,338414,336805,457,2.9,797,5.1,35712,7385,28327,2.2,10.6,32493,6211,26282,1.8,9.6,3219,1,19.2,0,469,484,3185
2011,47,l) Left Censored,9750,29485,1075787,1068487,1209,4.1,1426,4.8,100420,16665,83755,1.6,9.4,85819,20410,65409,1.9,8,14601,1.4,16,0,327,354,1982
2011,48,a) 0,32209,32749,218765,110385,32392,197.8,0,0,216761,216761,0,196.4,196.4,0,0,0,0,0,216761,196.4,0,0,,,
2011,48,b) 1,23024,23722,214636,221410,127,0.5,6969,25.4,55532,2232,53300,1,25.1,69080,40271,28809,18.2,31.2,-13548,-6.1,50.2,0,5547,5595,34010
2011,48,c) 2,20548,21159,183764,188619,862,3.8,4031,17.7,37129,4466,32663,2.4,19.7,46838,24639,22199,13.1,24.8,-9709,-5.1,39.4,0,3335,3335,22107
2011,48,d) 3,20204,20865,204880,206193,784,3.5,3406,15.3,37948,4832,33116,2.3,18.4,40573,19555,21018,9.5,19.7,-2625,-1.3,36.8,0,2780,2786,16988
2011,48,e) 4,18314,18859,173505,177437,641,3.2,2843,14.2,29791,4632,25159,2.6,16.8,37655,17985,19670,10.1,21.2,-7864,-4.4,33.6,0,2281,2281,14872
2011,48,f) 5,17288,18627,196795,199152,655,3.4,2371,12.2,29924,4723,25201,2.4,15,34637,15997,18640,8,17.4,-4713,-2.4,30,0,1871,1887,13369
2011,48,g) 6 to 10,63031,68545,864899,871670,2246,3.2,7016,9.9,130657,22764,107893,2.6,15,144198,54435,89763,6.2,16.5,-13541,-1.5,30,0,5382,5398,40992
2011,48,h) 11 to 15,43247,49637,735965,739230,1778,3.5,4294,8.4,92052,15427,76625,2.1,12.5,98583,33038,65545,4.5,13.3,-6531,-0.8,25,0,3015,3045,23668
2011,48,i) 16 to 20,30788,36409,559700,573137,1227,3.3,2748,7.4,57059,10070,46989,1.8,10,83933,20716,63217,3.6,14.6,-26874,-4.6,20,0,1883,1888,14025
2011,48,j) 21 to 25,22699,31294,637656,638028,1112,3.5,1986,6.3,70870,13826,57044,2.2,11.1,71614,15548,56066,2.4,11.2,-744,-0.1,22.2,0,1254,1278,7507
2011,48,k) 26+,32958,53804,1145061,1144346,1836,3.4,2953,5.4,124798,31822,92976,2.8,10.9,123367,27200,96167,2.4,10.8,1431,0.1,21.6,0,1579,1587,10188
2011,48,l) Left Censored,24217,99389,3697367,3656387,5725,5.8,4727,4.8,431638,123661,307977,3.4,11.8,349679,67046,282633,1.8,9.6,81959,2.2,19.2,0,810,825,8623
2011,49,a) 0,4571,4629,27364,13754,4554,196.8,0,0,27220,27220,0,197.9,197.9,0,0,0,0,0,27220,197.9,0,0,,,
2011,49,b) 1,3397,3458,24463,26722,30,0.7,1165,28.5,5687,415,5272,1.6,21.3,10204,6205,3999,23.2,38.2,-4517,-16.9,42.6,0,887,888,5392
2011,49,c) 2,2867,2915,20559,20992,139,4.4,637,20.1,4920,730,4190,3.5,23.4,5785,3332,2453,15.9,27.6,-865,-4.2,46.8,0,483,483,2730
2011,49,d) 3,3013,3092,20664,21233,183,5.5,611,18.5,3931,635,3296,3,18.5,5068,2936,2132,13.8,23.9,-1137,-5.4,37,0,440,440,2359
2011,49,e) 4,2941,2992,23654,23665,183,5.8,502,15.9,4281,422,3859,1.8,18.1,4303,1894,2409,8,18.2,-22,-0.1,36.2,0,356,362,1561
2011,49,f) 5,2785,2921,26763,25929,164,5.4,447,14.6,6303,3151,3152,12.2,24.3,4634,1967,2667,7.6,17.9,1669,6.4,35.8,0,297,300,1405
2011,49,g) 6 to 10,9659,10111,108330,110536,463,4.4,1174,11.2,15103,2729,12374,2.5,13.7,19517,6428,13089,5.8,17.7,-4414,-4,27.4,0,776,779,4792
2011,49,h) 11 to 15,6009,6552,97112,99174,258,3.8,625,9.3,11222,2561,8661,2.6,11.3,15346,4708,10638,4.7,15.5,-4124,-4.2,22.6,0,384,390,3069
2011,49,i) 16 to 20,3598,4068,70670,71516,175,4.2,351,8.4,7495,2055,5440,2.9,10.5,9187,3304,5883,4.6,12.8,-1692,-2.3,21,0,210,210,2676
2011,49,j) 21 to 25,2392,3141,69718,69565,123,3.9,192,6,7624,1271,6353,1.8,11,7318,1832,5486,2.6,10.5,306,0.5,21,0,114,114,918
2011,49,k) 26+,3300,4982,123068,124023,176,3.5,273,5.4,10729,2616,8113,2.1,8.7,12639,2198,10441,1.8,10.2,-1910,-1.5,17.4,0,148,148,1175
2011,49,l) Left Censored,3438,10206,404617,403014,497,4.9,468,4.6,35235,6783,28452,1.7,8.7,32028,5408,26620,1.3,7.9,3207,0.8,15.8,0,84,84,437
2011,50,a) 0,897,897,4585,2304,883,196.9,0,0,4563,4563,0,198,198,0,0,0,0,0,4563,198,0,0,,,
2011,50,b) 1,639,641,3559,3802,4,0.5,194,26,818,171,647,4.5,21.5,1304,572,732,15,34.3,-486,-12.8,43,0,132,132,406
2011,50,c) 2,601,608,6400,6517,27,4.1,133,20.1,609,79,530,1.2,9.3,843,314,529,4.8,12.9,-234,-3.6,18.6,0,102,102,257
2011,50,d) 3,635,640,3978,4074,32,4.7,107,15.7,500,58,442,1.4,12.3,691,275,416,6.8,17,-191,-4.7,24.6,0,78,78,232
2011,50,e) 4,676,684,4405,4580,28,3.9,89,12.5,546,50,496,1.1,11.9,895,452,443,9.9,19.5,-349,-7.6,23.8,0,61,61,388
2011,50,f) 5,620,641,4104,4159,28,4.2,84,12.6,536,44,492,1.1,12.9,646,318,328,7.6,15.5,-110,-2.6,25.8,0,59,59,228
2011,50,g) 6 to 10,2617,2679,19067,19584,109,3.9,304,10.9,2295,221,2074,1.1,11.7,3328,1268,2060,6.5,17,-1033,-5.3,23.4,0,198,202,938
2011,50,h) 11 to 15,2191,2317,24842,24859,74,3.1,189,8,2414,280,2134,1.1,9.7,2447,777,1670,3.1,9.8,-33,-0.1,19.4,0,128,128,624
2011,50,i) 16 to 20,1610,1775,16437,16497,60,3.3,142,7.8,1900,249,1651,1.5,11.5,2020,654,1366,4,12.2,-120,-0.7,23,0,76,76,363
2011,50,j) 21 to 25,1591,1719,25823,26288,60,3.4,131,7.5,1803,275,1528,1,6.9,2733,1062,1671,4,10.4,-930,-3.5,13.8,0,80,80,357
2011,50,k) 26+,1831,2412,45167,45634,60,2.4,155,6.3,3491,370,3121,0.8,7.6,4424,1120,3304,2.5,9.7,-933,-2.1,15.2,0,85,85,503
2011,50,l) Left Censored,1927,3618,103715,102988,103,2.8,146,4,7872,1299,6573,1.3,7.6,6417,1077,5340,1,6.2,1455,1.4,12.4,0,45,45,370
2011,51,a) 0,9675,9749,54567,27461,9640,197.8,0,0,54212,54212,0,197.4,197.4,0,0,0,0,0,54212,197.4,0,0,,,
2011,51,b) 1,6916,7119,50108,52871,38,0.5,2154,26,12789,580,12209,1.1,24.2,18314,10724,7590,20.3,34.6,-5525,-10.4,48.4,0,1664,1664,8266
2011,51,c) 2,6690,6832,49476,49243,310,4.2,1282,17.5,10673,1187,9486,2.4,21.7,10206,5311,4895,10.8,20.7,467,1,41.4,0,1005,1005,4419
2011,51,d) 3,6840,6960,50094,51730,293,3.9,1251,16.8,8248,1630,6618,3.2,15.9,11520,6208,5312,12,22.3,-3272,-6.4,31.8,0,983,983,5224
2011,51,e) 4,6539,6640,53037,52919,280,4,937,13.4,9303,1082,8221,2,17.6,9066,3731,5335,7.1,17.1,237,0.5,34.2,0,722,722,2915
2011,51,f) 5,6381,6770,59834,60952,281,4,965,13.6,7842,1054,6788,1.7,12.9,10077,4293,5784,7,16.5,-2235,-3.6,25.8,0,741,741,3532
2011,51,g) 6 to 10,23449,24663,249100,251598,891,3.5,2757,10.8,32721,4603,28118,1.8,13,37716,14333,23383,5.7,15,-4995,-2,26,0,1983,1984,11833
2011,51,h) 11 to 15,16839,18880,238171,240715,690,3.6,1576,8.1,29573,6036,23537,2.5,12.3,34661,10047,24614,4.2,14.4,-5088,-2.1,24.6,0,1048,1048,6909
2011,51,i) 16 to 20,12108,13627,187308,188937,429,3.1,1006,7.2,19637,3824,15813,2,10.4,22895,5876,17019,3.1,12.1,-3258,-1.7,20.8,0,697,697,3952
2011,51,j) 21 to 25,10014,12712,240724,239851,515,4,801,6.2,28891,7576,21315,3.2,12,27144,5636,21508,2.3,11.3,1747,0.7,22.6,0,500,502,3470
2011,51,k) 26+,12365,19254,412274,411793,660,3.4,951,4.9,40030,9521,30509,2.3,9.7,39067,9244,29823,2.2,9.5,963,0.2,19,0,499,510,3945
2011,51,l) Left Censored,12079,40008,1340589,1334779,2441,6.1,2095,5.3,148543,43304,105239,3.2,11.1,136922,29817,107105,2.2,10.3,11621,0.8,20.6,0,386,396,4866
2011,53,a) 0,10043,10125,46947,23680,9949,196.5,0,0,46535,46535,0,196.5,196.5,0,0,0,0,0,46535,196.5,0,0,,,
2011,53,b) 1,6922,7051,42740,45112,28,0.3,2454,29.2,10884,202,10682,0.4,24.1,15628,7573,8055,16.8,34.6,-4744,-10.5,48.2,0,1821,1821,6224
2011,53,c) 2,6394,6484,40551,41181,280,4,1367,19.4,8009,849,7160,2.1,19.4,9269,4653,4616,11.3,22.5,-1260,-3.1,38.8,0,1012,1012,3603
2011,53,d) 3,6823,6955,43653,45078,308,4.1,1307,17.5,7672,875,6797,1.9,17,10521,4843,5678,10.7,23.3,-2849,-6.3,34,0,983,983,3876
2011,53,e) 4,6464,6574,43525,44681,300,4.3,1125,16.1,6815,765,6050,1.7,15.3,9126,4160,4966,9.3,20.4,-2311,-5.1,30.6,0,822,822,3348
2011,53,f) 5,6372,6715,52406,53191,251,3.5,1007,14.2,7095,732,6363,1.4,13.3,8664,3577,5087,6.7,16.3,-1569,-3,26.6,0,712,713,2707
2011,53,g) 6 to 10,22590,23939,207631,213954,822,3.3,2936,11.7,26371,4612,21759,2.2,12.3,39017,14371,24646,6.7,18.2,-12646,-5.9,24.6,0,2050,2050,10782
2011,53,h) 11 to 15,16063,17678,188959,191996,645,3.5,1768,9.7,22206,3321,18885,1.7,11.6,28280,9570,18710,5,14.7,-6074,-3.1,23.2,0,1171,1171,7124
2011,53,i) 16 to 20,11254,12644,150048,152486,463,3.6,1118,8.6,18895,8060,10835,5.3,12.4,23770,5785,17985,3.8,15.6,-4875,-3.2,24.8,0,721,725,3845
2011,53,j) 21 to 25,8378,10248,180231,179724,336,3.2,742,7.1,18147,2067,16080,1.2,10.1,17132,4231,12901,2.4,9.5,1015,0.6,19,0,448,452,2610
2011,53,k) 26+,10947,16466,375462,377883,516,3.1,978,5.9,32926,8161,24765,2.2,8.7,37767,7213,30554,1.9,10,-4841,-1.3,17.4,0,522,528,3055
2011,53,l) Left Censored,9743,28067,905394,914243,1437,5.1,1462,5.2,104450,21714,82736,2.4,11.4,122147,47119,75028,5.2,13.4,-17697,-2,22.8,0,305,309,5270
2011,54,a) 0,1483,1529,9198,4654,1505,196.9,0,0,9088,9088,0,195.3,195.3,0,0,0,0,0,9088,195.3,0,0,,,
2011,54,b) 1,1048,1117,10863,10964,13,1,300,23.6,2304,62,2242,0.6,21,2506,1048,1458,9.6,22.9,-202,-1.9,42,0,232,232,806
2011,54,c) 2,1006,1015,7981,8071,34,3.1,191,17.5,1410,105,1305,1.3,17.5,1590,758,832,9.4,19.7,-180,-2.2,35,0,165,165,684
2011,54,d) 3,1013,1035,8300,8972,37,3.3,191,17.2,1046,80,966,0.9,11.7,2390,1175,1215,13.1,26.6,-1344,-14.9,23.4,0,159,159,1091
2011,54,e) 4,978,988,8846,8944,38,3.6,165,15.6,1740,406,1334,4.5,19.5,1936,875,1061,9.8,21.6,-196,-2.1,39,0,127,127,756
2011,54,f) 5,1064,1164,11738,12234,43,3.5,151,12.4,1501,134,1367,1.1,12.3,2493,1192,1301,9.7,20.4,-992,-8.1,24.6,0,111,111,1052
2011,54,g) 6 to 10,4191,4464,40393,40972,133,2.9,485,10.4,5523,630,4893,1.5,13.5,6681,2447,4234,6,16.3,-1158,-2.8,27,0,374,374,1929
2011,54,h) 11 to 15,3258,3676,38422,38909,110,2.9,301,8,4235,559,3676,1.4,10.9,5209,1750,3459,4.5,13.4,-974,-2.5,21.8,0,215,215,1461
2011,54,i) 16 to 20,2488,2802,30067,30212,79,2.7,242,8.4,3674,868,2806,2.9,12.2,3964,1050,2914,3.5,13.1,-290,-0.9,24.4,0,168,168,845
2011,54,j) 21 to 25,2205,2570,41247,41196,57,2.2,182,6.9,3684,417,3267,1,8.9,3581,1178,2403,2.9,8.7,103,0.2,17.4,0,128,128,823
2011,54,k) 26+,3416,5245,91770,90607,180,3.4,233,4.4,10246,2202,8044,2.4,11.3,7920,1909,6011,2.1,8.7,2326,2.6,17.4,0,145,145,1000
2011,54,l) Left Censored,4093,9662,259477,259807,392,4.1,383,4,21274,3852,17422,1.5,8.2,21934,3337,18597,1.3,8.4,-660,-0.2,16.4,0,137,138,844
2011,55,a) 0,5562,5712,32588,16379,5641,197.5,0,0,32419,32419,0,197.9,197.9,0,0,0,0,0,32419,197.9,0,0,,,
2011,55,b) 1,4136,4252,31448,33343,28,0.6,1262,25.6,8005,1415,6590,4.2,24,11794,6829,4965,20.5,35.4,-3789,-11.4,48,0,929,929,5767
2011,55,c) 2,3987,4043,28406,29399,151,3.5,744,17.2,5046,470,4576,1.6,17.2,7031,3710,3321,12.6,23.9,-1985,-6.7,34.4,0,572,572,3252
2011,55,d) 3,4047,4155,30737,32065,151,3.4,667,15.1,4290,591,3699,1.8,13.4,6945,3511,3434,10.9,21.7,-2655,-8.3,26.8,0,490,490,2981
2011,55,e) 4,3993,4054,32786,33316,163,3.8,588,13.8,4929,908,4021,2.7,14.8,5989,2730,3259,8.2,18,-1060,-3.2,29.6,0,429,429,2190
2011,55,f) 5,4101,4441,42326,41796,166,3.6,510,11,6590,1008,5582,2.4,15.8,5529,2409,3120,5.8,13.2,1061,2.6,26.4,0,362,364,1995
2011,55,g) 6 to 10,15740,16578,165605,166647,513,3,1745,10.1,20440,2581,17859,1.5,12.3,22523,8237,14286,4.9,13.5,-2083,-1.2,24.6,0,1202,1202,6037
2011,55,h) 11 to 15,12774,14116,173337,175393,422,2.9,1169,8.1,17992,2793,15199,1.6,10.3,22103,5890,16213,3.4,12.6,-4111,-2.3,20.6,0,769,771,4395
2011,55,i) 16 to 20,9662,10735,133466,134018,330,3,800,7.3,14370,3213,11157,2.4,10.7,15474,4763,10711,3.6,11.5,-1104,-0.8,21.4,0,493,495,3443
2011,55,j) 21 to 25,7860,9793,171735,172199,264,2.7,572,5.7,14852,2101,12751,1.2,8.6,15780,4054,11726,2.4,9.2,-928,-0.6,17.2,0,339,339,1908
2011,55,k) 26+,10538,15473,312880,311689,386,2.5,761,4.9,30759,4727,26032,1.5,9.9,28377,6409,21968,2.1,9.1,2382,0.8,18.2,0,394,417,3578
2011,55,l) Left Censored,13068,30934,1178812,1170056,1009,3.3,1201,3.9,97177,20069,77108,1.7,8.3,79664,13919,65745,1.2,6.8,17513,1.5,13.6,0,345,353,3336
2011,56,a) 0,1151,1154,4849,2450,1136,196.9,0,0,4798,,,,195.8,0,0,0,0,0,4798,195.8,0,1,,,
2011,56,b) 1,806,813,4469,4719,5,0.5,222,23.9,986,,,,20.9,1485,586,899,12.4,31.5,-499,-10.6,41.8,1,156,156,461
2011,56,c) 2,771,784,3766,4211,31,3.6,166,19.5,630,57,573,1.4,15,1519,855,664,20.3,36.1,-889,-21.1,30,0,126,126,743
2011,56,d) 3,811,825,4621,4718,35,4,139,15.9,713,99,614,2.1,15.1,907,434,473,9.2,19.2,-194,-4.1,30.2,0,104,104,353
2011,56,e) 4,806,815,5195,5173,34,4,121,14.1,1084,60,1024,1.2,21,1040,441,599,8.5,20.1,44,0.9,40.2,0,88,88,379
2011,56,f) 5,781,813,5670,5707,40,4.7,103,12.2,1027,177,850,3.1,18,1100,384,716,6.7,19.3,-73,-1.3,36,0,69,69,308
2011,56,g) 6 to 10,2718,2822,19903,20425,127,4.4,290,10,3123,606,2517,3,15.3,4166,1779,2387,8.7,20.4,-1043,-5.1,30.6,0,190,190,1065
2011,56,h) 11 to 15,2011,2123,17441,17945,77,3.5,188,8.6,2111,298,1813,1.7,11.8,3118,1165,1953,6.5,17.4,-1007,-5.6,23.6,0,104,104,501
2011,56,i) 16 to 20,1305,1399,13307,13398,48,3.4,103,7.2,1673,339,1334,2.5,12.5,1854,354,1500,2.6,13.8,-181,-1.3,25,0,69,69,240
2011,56,j) 21 to 25,934,1097,17277,17265,41,3.7,60,5.4,1513,329,1184,1.9,8.8,1489,265,1224,1.5,8.6,24,0.2,17.2,0,39,39,163
2011,56,k) 26+,1576,2073,32873,32320,62,3,108,5.1,3790,868,2922,2.7,11.7,2683,533,2150,1.6,8.3,1107,3.4,16.6,0,58,58,176
2011,56,l) Left Censored,1548,3182,71476,70633,163,5.1,131,4.1,7647,1540,6107,2.2,10.8,5960,878,5082,1.2,8.4,1687,2.4,16.8,0,26,26,221
2012,01,a) 0,4488,4562,27960,14057,4510,197.7,0,0,27807,27807,0,197.8,197.8,0,0,0,0,0,27807,197.8,0,0,,,
2012,01,b) 1,3421,3472,26162,26847,16,0.4,988,24.8,6538,124,6414,0.5,24.4,7907,4880,3027,18.2,29.5,-1369,-5.1,48.8,0,783,783,3962
2012,01,c) 2,2910,3026,25695,25935,117,3.6,520,16.1,5145,717,4428,2.8,19.8,5625,3153,2472,12.2,21.7,-480,-1.9,39.6,0,423,423,2348
2012,01,d) 3,2843,3070,23744,23734,144,4.5,436,13.6,4611,781,3830,3.3,19.4,4591,2230,2361,9.4,19.3,20,0.1,38.6,0,355,355,1722
2012,01,e) 4,2883,3053,25799,26166,142,4.4,439,13.7,4558,869,3689,3.3,17.4,5292,2068,3224,7.9,20.2,-734,-2.8,34.8,0,347,349,1660
2012,01,f) 5,2909,2970,25902,25895,112,3.6,369,12,4207,549,3658,2.1,16.2,4192,1937,2255,7.5,16.2,15,0,32.4,0,280,280,1353
2012,01,g) 6 to 10,11451,12189,125564,127136,425,3.4,1283,10.2,17262,2732,14530,2.1,13.6,20406,8459,11947,6.7,16.1,-3144,-2.5,27.2,0,917,923,5782
2012,01,h) 11 to 15,8665,9608,140605,139689,322,3.3,869,8.8,20160,3499,16661,2.5,14.4,18327,7363,10964,5.3,13.1,1833,1.3,26.2,0,562,573,4354
2012,01,i) 16 to 20,6598,7292,91725,92872,221,3,554,7.4,10140,1721,8419,1.9,10.9,12434,4456,7978,4.8,13.4,-2294,-2.5,21.8,0,382,383,3239
2012,01,j) 21 to 25,5174,6657,131000,131520,252,3.7,424,6.3,14025,1720,12305,1.3,10.7,15065,2937,12128,2.2,11.5,-1040,-0.8,21.4,0,235,248,1669
2012,01,k) 26+,8382,12654,247242,246049,525,4.1,677,5.3,26292,6053,20239,2.5,10.7,23906,5462,18444,2.2,9.7,2386,1,19.4,0,306,321,2475
2012,01,l) Left Censored,7316,21857,677064,681020,1110,5.1,1034,4.7,61621,14531,47090,2.1,9,69533,14963,54570,2.2,10.2,-7912,-1.2,18,0,191,197,2005
2012,02,a) 0,974,989,5866,2993,964,194.9,0,0,5746,5746,0,192,192,0,0,0,0,0,5746,192,0,0,,,
2012,02,b) 1,686,697,3942,3995,4,0.5,235,28.6,1061,16,1045,0.4,26.6,1166,574,592,14.4,29.2,-105,-2.6,53.2,0,154,154,382
2012,02,c) 2,608,628,4100,4073,44,6.6,134,20.1,941,201,740,4.9,23.1,887,401,486,9.8,21.8,54,1.3,43.6,0,82,82,276
2012,02,d) 3,613,645,4303,4331,32,4.7,104,15.3,841,81,760,1.9,19.4,896,407,489,9.4,20.7,-55,-1.3,38.8,0,63,63,167
2012,02,e) 4,630,652,4866,4722,30,4.4,88,12.9,986,143,843,3,20.9,698,303,395,6.4,14.8,288,6.1,29.6,0,55,55,204
2012,02,f) 5,593,604,4662,4680,38,6,90,14.3,744,122,622,2.6,15.9,780,322,458,6.9,16.7,-36,-0.8,31.8,0,44,44,181
2012,02,g) 6 to 10,2457,2570,22875,22912,126,4.8,269,10.2,3898,685,3213,3,17,3971,1376,2595,6,17.3,-73,-0.3,34,0,141,141,626
2012,02,h) 11 to 15,1774,1945,26863,27706,115,5.9,165,8.4,5153,1367,3786,4.9,18.6,6838,680,6158,2.5,24.7,-1685,-6.1,37.2,0,89,89,339
2012,02,i) 16 to 20,1245,1300,10026,10299,43,3.2,105,7.9,1216,230,986,2.2,11.8,1761,601,1160,5.8,17.1,-545,-5.3,23.6,0,54,54,337
2012,02,j) 21 to 25,993,1167,19721,19711,49,4.2,78,6.6,2191,415,1776,2.1,11.1,2170,994,1176,5,11,21,0.1,22,0,35,35,863
2012,02,k) 26+,1713,2679,53525,53766,104,3.8,164,6.1,6390,895,5495,1.7,11.9,6872,1297,5575,2.4,12.8,-482,-0.9,23.8,0,51,54,236
2012,02,l) Left Censored,1225,3253,95531,94935,193,5.9,186,5.7,10571,2745,7826,2.9,11.1,9379,1285,8094,1.4,9.9,1192,1.2,19.8,0,14,18,81
2012,04,a) 0,7751,7800,49276,24875,7687,197.1,0,0,48802,48802,0,196.2,196.2,0,0,0,0,0,48802,196.2,0,0,,,
2012,04,b) 1,5910,5998,44189,45167,28,0.4,1811,26,11591,600,10991,1.3,25.7,13547,7952,5595,17.6,30,-1956,-4.3,51.4,0,1368,1370,6350
2012,04,c) 2,4651,4793,46839,46841,214,4.1,1015,19.6,9300,901,8399,1.9,19.9,9304,5301,4003,11.3,19.9,-4,0,39.8,0,799,799,4219
2012,04,d) 3,4431,4571,43570,43611,255,5.3,804,16.7,8498,2132,6366,4.9,19.5,8580,4033,4547,9.2,19.7,-82,-0.2,39,0,614,614,3203
2012,04,e) 4,4801,5164,46879,46735,274,5.1,754,14,9028,1812,7216,3.9,19.3,8739,4241,4498,9.1,18.7,289,0.6,37.4,0,550,553,3097
2012,04,f) 5,4472,4575,37174,38004,211,4.4,707,14.7,5791,717,5074,1.9,15.2,7450,3631,3819,9.6,19.6,-1659,-4.4,30.4,0,517,522,2561
2012,04,g) 6 to 10,17286,18295,200692,201714,858,4.5,2165,11.4,30263,6832,23431,3.4,15,32307,13498,18809,6.7,16,-2044,-1,30,0,1434,1450,9049
2012,04,h) 11 to 15,11141,12315,172051,171963,530,4.2,1218,9.6,21186,4817,16369,2.8,12.3,21009,7791,13218,4.5,12.2,177,0.1,24.4,0,760,763,4473
2012,04,i) 16 to 20,7252,8311,125993,126141,302,3.5,769,9,16284,4250,12034,3.4,12.9,16580,6086,10494,4.8,13.1,-296,-0.2,25.8,0,445,455,2770
2012,04,j) 21 to 25,5248,7612,155077,152920,312,4,530,6.9,20159,5506,14653,3.6,13.2,15845,4495,11350,2.9,10.4,4314,2.8,20.8,0,263,269,1886
2012,04,k) 26+,7525,12573,314635,315028,644,5.1,888,7,39147,8950,30197,2.8,12.4,39933,11047,28886,3.5,12.7,-786,-0.3,24.8,0,339,363,3724
2012,04,l) Left Censored,5442,22674,868882,872300,1524,6.8,1347,6,109503,25517,83986,2.9,12.6,116339,29139,87200,3.3,13.3,-6836,-0.7,25.2,0,147,171,1337
2012,05,a) 0,3106,3130,16467,8281,3098,198,0,0,16373,16373,0,197.7,197.7,0,0,0,0,0,16373,197.7,0,0,,,
2012,05,b) 1,2503,2545,18020,19074,17,0.6,642,22.3,4203,181,4022,0.9,22,6310,3157,3153,16.6,33.1,-2107,-11.1,44,0,510,510,2622
2012,05,c) 2,2097,2176,18417,18701,85,3.7,379,16.5,3160,429,2731,2.3,16.9,3727,1765,1962,9.4,19.9,-567,-3,33.8,0,311,311,1436
2012,05,d) 3,1956,2045,17081,16976,82,3.8,306,14.2,3309,552,2757,3.3,19.5,3098,1592,1506,9.4,18.2,211,1.3,36.4,0,234,234,1087
2012,05,e) 4,2009,2118,16995,16848,101,4.6,240,11,3112,819,2293,4.9,18.5,2817,1446,1371,8.6,16.7,295,1.8,33.4,0,181,181,1229
2012,05,f) 5,1862,1892,17752,17717,68,3.5,238,12.1,3112,417,2695,2.4,17.6,3042,1313,1729,7.4,17.2,70,0.4,34.4,0,183,184,891
2012,05,g) 6 to 10,8056,8629,76139,77489,316,3.6,910,10.2,9932,1354,8578,1.7,12.8,12631,5241,7390,6.8,16.3,-2699,-3.5,25.6,0,637,644,3628
2012,05,h) 11 to 15,5683,6338,64733,63697,202,3.1,539,8.3,11719,1486,10233,2.3,18.4,9647,3476,6171,5.5,15.1,2072,3.3,30.2,0,349,351,1966
2012,05,i) 16 to 20,4380,4845,54940,55077,169,3.4,365,7.4,6525,1276,5249,2.3,11.8,6799,2003,4796,3.6,12.3,-274,-0.5,23.6,0,222,222,1324
2012,05,j) 21 to 25,3098,3891,63390,67236,113,2.9,274,6.9,6051,965,5086,1.4,9,13742,2244,11498,3.3,20.4,-7691,-11.4,18,0,151,158,890
2012,05,k) 26+,5316,7567,154251,157122,246,3.2,489,6.4,14230,2437,11793,1.6,9.1,19972,5440,14532,3.5,12.7,-5742,-3.6,18.2,0,231,242,2414
2012,05,l) Left Censored,4930,13800,449697,449281,620,4.5,616,4.5,39854,8996,30858,2,8.9,39021,10039,28982,2.2,8.7,833,0.2,17.4,0,119,129,1252
2012,06,a) 0,53308,53719,292241,147400,53027,197.4,0,0,289682,289682,0,196.5,196.5,0,0,0,0,0,289682,196.5,0,0,,,
2012,06,b) 1,39601,40377,283817,285722,262,0.6,11267,24.4,73892,3495,70397,1.2,25.9,77701,44916,32785,15.7,27.2,-3809,-1.3,51.8,0,8298,8299,34570
2012,06,c) 2,32123,33129,253155,256101,1516,4.3,6115,17.3,55499,7551,47948,2.9,21.7,61390,36448,24942,14.2,24,-5891,-2.3,43.4,0,4599,4603,24678
2012,06,d) 3,30493,31286,246510,245374,1479,4.5,4982,15.1,50344,8297,42047,3.4,20.5,48072,24830,23242,10.1,19.6,2272,0.9,39.2,0,3707,3709,18930
2012,06,e) 4,31288,32639,269641,266887,1746,5.1,4589,13.5,56431,10142,46289,3.8,21.1,50923,27573,23350,10.3,19.1,5508,2,38.2,0,3344,3346,20994
2012,06,f) 5,29098,29473,232354,235243,1398,4.6,3972,12.9,40536,6730,33806,2.9,17.2,46314,21339,24975,9.1,19.7,-5778,-2.5,34.4,0,2819,2831,15886
2012,06,g) 6 to 10,118027,124440,1258392,1263516,5407,4.2,13874,10.8,189635,30110,159525,2.4,15,199883,84426,115457,6.7,15.8,-10248,-0.8,30,0,9106,9180,55985
2012,06,h) 11 to 15,76143,83419,1042925,1052621,3606,4.2,7697,9,133639,25331,108308,2.4,12.7,153031,56465,96566,5.4,14.5,-19392,-1.8,25.4,0,4674,4713,35201
2012,06,i) 16 to 20,49102,54987,784274,787199,2088,3.7,4558,8.1,96021,19675,76346,2.5,12.2,101870,34701,67169,4.4,12.9,-5849,-0.7,24.4,0,2744,2791,20087
2012,06,j) 21 to 25,42196,52686,1037251,1036515,2239,4.2,3978,7.4,120837,21110,99727,2,11.7,119365,32431,86934,3.1,11.5,1472,0.2,23,0,2184,2206,14667
2012,06,k) 26+,60509,91679,2130142,2124747,3721,4,6227,6.7,239301,46810,192491,2.2,11.3,228512,57264,171248,2.7,10.8,10789,0.5,21.6,0,2775,2890,19545
2012,06,l) Left Censored,38632,130263,4884345,4861076,7835,6,7608,5.8,556212,125038,431174,2.6,11.4,509676,126933,382743,2.6,10.5,46536,0.9,21,0,1296,1402,17007
2012,08,a) 0,9102,9145,45559,22895,9023,197.3,0,0,45328,45328,0,198,198,0,0,0,0,0,45328,198,0,0,,,
2012,08,b) 1,6849,6933,45071,45776,27,0.3,2069,25.8,11481,653,10828,1.4,25.1,12890,7748,5142,16.9,28.2,-1409,-3.1,50.2,0,1486,1486,6306
2012,08,c) 2,5750,5866,41405,41456,331,5.3,1154,18.4,8187,1464,6723,3.5,19.7,8289,4609,3680,11.1,20,-102,-0.3,39.4,0,833,833,3559
2012,08,d) 3,5371,5458,40199,39779,306,5.3,853,14.9,7599,1628,5971,4.1,19.1,6758,3323,3435,8.4,17,841,2.1,34,0,617,617,2363
2012,08,e) 4,5604,5740,43720,43653,293,4.9,845,14.1,8528,1483,7045,3.4,19.5,8394,4789,3605,11,19.2,134,0.3,38.4,0,582,582,3145
2012,08,f) 5,5203,5270,39836,39664,285,5.2,752,13.7,6917,1167,5750,2.9,17.4,6572,2976,3596,7.5,16.6,345,0.8,33.2,0,482,483,2208
2012,08,g) 6 to 10,20900,21774,195571,194904,1088,4.8,2523,11.2,30255,5217,25038,2.7,15.5,28920,13345,15575,6.8,14.8,1335,0.7,29.6,0,1544,1559,8653
2012,08,h) 11 to 15,14392,15562,170758,168933,771,4.9,1463,9.2,24291,4861,19430,2.9,14.4,20640,7760,12880,4.6,12.2,3651,2.2,24.4,0,847,853,4139
2012,08,i) 16 to 20,9551,10459,138519,138086,396,3.7,921,8.6,17040,2649,14391,1.9,12.3,16173,6716,9457,4.9,11.7,867,0.6,23.4,0,504,521,2940
2012,08,j) 21 to 25,6544,8208,143544,142615,335,4,628,7.5,18586,4076,14510,2.9,13,16727,5177,11550,3.6,11.7,1859,1.3,23.4,0,297,299,1591
2012,08,k) 26+,9392,14241,302442,302790,702,4.9,930,6.5,33566,9307,24259,3.1,11.1,34261,10279,23982,3.4,11.3,-695,-0.2,22.2,0,400,419,3634
2012,08,l) Left Censored,7072,22454,790843,786815,1411,6.3,1383,6.2,87363,21838,65525,2.8,11.1,79307,16240,63067,2.1,10.1,8056,1,20.2,0,164,180,2050
2012,09,a) 0,4021,4031,23300,11878,3985,197.7,0,0,22845,22845,0,192.3,192.3,0,0,0,0,0,22845,192.3,0,0,,,
2012,09,b) 1,2956,2979,20664,21362,13,0.4,759,22.5,5085,358,4727,1.7,23.8,6481,3452,3029,16.2,30.3,-1396,-6.5,47.6,0,573,573,3003
2012,09,c) 2,2531,2620,22218,22131,125,4.5,444,16,4285,621,3664,2.8,19.4,4110,2343,1767,10.6,18.6,175,0.8,37.2,0,334,334,1778
2012,09,d) 3,2406,2430,20185,20207,111,4.4,346,13.6,3482,350,3132,1.7,17.2,3525,2000,1525,9.9,17.4,-43,-0.2,34.4,0,264,264,1369
2012,09,e) 4,2538,2627,22351,22155,135,4.9,383,13.9,4270,888,3382,4,19.3,3877,1857,2020,8.4,17.5,393,1.8,35,0,285,285,1433
2012,09,f) 5,2274,2293,19407,19630,114,4.8,274,11.6,2510,444,2066,2.3,12.8,2955,1218,1737,6.2,15.1,-445,-2.3,25.6,0,195,195,954
2012,09,g) 6 to 10,10011,10508,106784,106601,420,3.9,1010,9.4,14492,1860,12632,1.7,13.6,14126,5388,8738,5.1,13.3,366,0.3,26.6,0,693,693,3518
2012,09,h) 11 to 15,7774,8403,113538,113883,323,3.8,685,8,15724,2742,12982,2.4,13.8,16413,4795,11618,4.2,14.4,-689,-0.6,27.6,0,434,435,2345
2012,09,i) 16 to 20,6140,6509,70617,70615,214,3.2,442,6.7,7640,1260,6380,1.8,10.8,7635,2605,5030,3.7,10.8,5,0,21.6,0,293,295,1779
2012,09,j) 21 to 25,5685,6560,120098,114801,230,3.5,412,6.2,20197,1940,18257,1.7,17.6,9602,2911,6691,2.5,8.4,10595,9.2,16.8,0,242,256,1964
2012,09,k) 26+,8298,11362,210649,210490,419,3.6,694,6,22630,4472,18158,2.1,10.8,22312,5970,16342,2.8,10.6,318,0.2,21.2,0,313,324,1863
2012,09,l) Left Censored,9056,19464,729779,725790,986,5.1,1092,5.6,74119,15076,59043,2.1,10.2,66140,16169,49971,2.2,9.1,7979,1.1,18.2,0,273,275,2770
2012,10,a) 0,1245,1251,6973,3641,1232,197,0,0,6665,6665,0,183.1,183.1,0,0,0,0,0,6665,183.1,0,0,,,
2012,10,b) 1,863,866,5230,5877,5,0.5,290,28.5,1164,107,1057,1.8,19.8,2457,1745,712,29.7,41.8,-1293,-22,39.6,0,218,218,1428
2012,10,c) 2,693,699,5136,5573,32,4.3,137,18.2,931,139,792,2.5,16.7,1804,1431,373,25.7,32.4,-873,-15.7,33.4,0,110,110,478
2012,10,d) 3,716,733,6127,6103,18,2.3,96,12.4,1029,86,943,1.4,16.9,981,449,532,7.4,16.1,48,0.8,32.2,0,73,73,354
2012,10,e) 4,769,797,6716,6683,37,4.4,113,13.6,1221,326,895,4.9,18.3,1154,669,485,10,17.3,67,1,34.6,0,86,86,488
2012,10,f) 5,649,682,6755,6846,32,4.5,76,10.8,783,185,598,2.7,11.4,965,349,616,5.1,14.1,-182,-2.7,22.8,0,57,57,273
2012,10,g) 6 to 10,2804,2884,26249,26682,103,3.4,340,11.3,3169,485,2684,1.8,11.9,4035,1617,2418,6.1,15.1,-866,-3.2,23.8,0,235,235,957
2012,10,h) 11 to 15,2047,2203,22920,22877,98,4.3,215,9.5,2898,374,2524,1.6,12.7,2811,1070,1741,4.7,12.3,87,0.4,24.6,0,152,153,650
2012,10,i) 16 to 20,1483,1690,22057,22056,47,2.7,128,7.4,2251,432,1819,2,10.2,2249,806,1443,3.7,10.2,2,0,20.4,0,75,75,404
2012,10,j) 21 to 25,1253,1401,19308,19865,44,3.1,98,6.9,2097,227,1870,1.1,10.6,3211,894,2317,4.5,16.2,-1114,-5.6,21.2,0,43,43,140
2012,10,k) 26+,1834,2529,51115,51951,146,5.7,181,7.1,4909,1591,3318,3.1,9.4,6581,2447,4134,4.7,12.7,-1672,-3.3,18.8,0,57,59,547
2012,10,l) Left Censored,2401,5568,184395,181578,387,7,357,6.4,24729,7693,17036,4.2,13.6,19095,7910,11185,4.4,10.5,5634,3.1,21,0,45,49,540
2012,11,a) 0,940,941,6052,3052,930,197.7,0,0,6001,6001,0,196.6,196.6,0,0,0,0,0,6001,196.6,0,0,,,
2012,11,b) 1,792,793,7297,6932,6,0.7,180,20.3,2349,83,2266,1.2,33.9,1618,1018,600,14.7,23.3,731,10.6,46.6,0,137,137,914
2012,11,c) 2,661,676,8527,8102,30,4.2,116,16.2,1959,333,1626,4.1,24.2,1108,585,523,7.2,13.7,851,10.5,27.4,0,80,80,451
2012,11,d) 3,607,613,7140,6653,26,4.1,73,11.5,2083,573,1510,8.6,31.3,1108,396,712,6,16.7,975,14.6,33.4,0,54,54,310
2012,11,e) 4,590,631,8211,7451,39,6.1,59,9.3,2401,1396,1005,18.7,32.2,881,346,535,4.6,11.8,1520,20.4,23.6,0,40,40,200
2012,11,f) 5,569,572,6287,6438,16,2.7,75,12.5,981,152,829,2.4,15.2,1282,785,497,12.2,19.9,-301,-4.7,30.4,0,53,53,476
2012,11,g) 6 to 10,2397,2480,36607,34998,96,3.8,215,8.5,6963,1545,5418,4.4,19.9,3744,1339,2405,3.8,10.7,3219,9.2,21.4,0,142,142,734
2012,11,h) 11 to 15,1855,2023,37523,37549,73,3.5,185,8.9,5008,659,4349,1.8,13.3,5060,2584,2476,6.9,13.5,-52,-0.2,26.6,0,106,106,1711
2012,11,i) 16 to 20,1364,1495,26112,26310,56,3.7,96,6.3,2808,493,2315,1.9,10.7,3203,628,2575,2.4,12.2,-395,-1.5,21.4,0,59,59,314
2012,11,j) 21 to 25,1194,1460,28221,28380,86,5.8,116,7.9,3859,808,3051,2.8,13.6,4176,1281,2895,4.5,14.7,-317,-1.1,27.2,0,43,43,381
2012,11,k) 26+,2111,2781,89520,90180,113,4,177,6.3,7312,1605,5707,1.8,8.1,8631,1746,6885,1.9,9.6,-1319,-1.5,16.2,0,65,65,752
2012,11,l) Left Censored,2768,5679,232856,233032,320,5.6,398,7,24487,4678,19809,2,10.5,24838,3995,20843,1.7,10.7,-351,-0.2,21,0,44,56,278
2012,12,a) 0,36591,36885,194390,98742,36331,197,0,0,191297,191297,0,193.7,193.7,0,0,0,0,0,191297,193.7,0,0,,,
2012,12,b) 1,26830,27305,181870,184228,162,0.5,8175,25.8,51917,3779,48138,2.1,28.2,56632,34704,21928,18.8,30.7,-4715,-2.5,56.4,0,6156,6162,27282
2012,12,c) 2,21504,22019,160342,165485,1085,4.6,4254,18.1,32829,5969,26860,3.6,19.8,43114,26372,16742,15.9,26.1,-10285,-6.3,39.6,0,3268,3274,20913
2012,12,d) 3,18560,18945,129468,132507,840,4.2,3045,15.3,24653,4064,20589,3.1,18.6,30730,14959,15771,11.3,23.2,-6077,-4.6,37.2,0,2271,2273,10779
2012,12,e) 4,18399,18947,129410,129536,965,4.9,2785,14.1,26824,6500,20324,5,20.7,27075,14536,12539,11.2,20.9,-251,-0.2,41.4,0,2044,2049,11430
2012,12,f) 5,17210,17550,133819,132451,886,4.8,2514,13.7,27984,2917,25067,2.2,21.1,25247,14330,10917,10.8,19.1,2737,2,38.2,0,1777,1780,9304
2012,12,g) 6 to 10,70699,73603,648312,648461,3786,5,8754,11.6,122561,17298,105263,2.7,18.9,122858,69970,52888,10.8,18.9,-297,0,37.8,0,5913,5978,56335
2012,12,h) 11 to 15,42058,45528,510270,519333,2092,4.5,4369,9.4,68418,15679,52739,3,13.2,86544,43039,43505,8.3,16.7,-18126,-3.5,26.4,0,2738,2794,33800
2012,12,i) 16 to 20,29507,33349,575730,541506,1353,4,2630,7.8,121542,10875,110667,2,22.4,53093,19937,33156,3.7,9.8,68449,12.6,19.6,0,1662,1704,11677
2012,12,j) 21 to 25,22181,27948,508834,513472,1186,4.2,2046,7.2,51595,12453,39142,2.4,10,60872,14883,45989,2.9,11.9,-9277,-1.9,20,0,1076,1099,7268
2012,12,k) 26+,26821,42055,912266,916231,2112,5,2915,6.9,104632,25295,79337,2.8,11.4,112562,34590,77972,3.8,12.3,-7930,-0.9,22.8,0,1257,1343,17212
2012,12,l) Left Censored,16976,71843,2658455,2649554,4911,6.9,3884,5.4,292616,84938,207678,3.2,11,274815,83731,191084,3.2,10.4,17801,0.6,20.8,0,534,564,5495
2012,13,a) 0,12498,12599,72713,36701,12440,197.5,0,0,72025,72025,0,196.2,196.2,0,0,0,0,0,72025,196.2,0,0,,,
2012,13,b) 1,9379,9514,67263,69731,53,0.5,2835,25.8,17804,1101,16703,1.6,25.5,22740,14590,8150,20.9,32.6,-4936,-7.1,51,0,2138,2138,11693
2012,13,c) 2,7875,8042,59798,59950,369,4.3,1498,17.4,13136,1616,11520,2.7,21.9,13439,6744,6695,11.2,22.4,-303,-0.5,43.8,0,1148,1148,5213
2012,13,d) 3,7274,7713,79899,79937,341,4.2,1172,14.5,12346,1927,10419,2.4,15.4,12421,5820,6601,7.3,15.5,-75,-0.1,30.8,0,899,899,4797
2012,13,e) 4,7823,8162,63435,63206,444,5.2,1140,13.4,12002,1973,10029,3.1,19,11544,5620,5924,8.9,18.3,458,0.7,36.6,0,862,862,4511
2012,13,f) 5,7271,7427,59313,60055,370,4.8,1059,13.7,10260,1893,8367,3.2,17.1,11744,6631,5113,11,19.6,-1484,-2.5,34.2,0,754,756,4924
2012,13,g) 6 to 10,27927,29472,305497,310002,1369,4.5,3627,11.9,43712,7749,35963,2.5,14.1,52721,22422,30299,7.2,17,-9009,-2.9,28.2,0,2349,2367,14689
2012,13,h) 11 to 15,19329,21382,280327,282774,961,4.4,2027,9.3,35196,8017,27179,2.8,12.4,40090,13350,26740,4.7,14.2,-4894,-1.8,24.8,0,1255,1260,7809
2012,13,i) 16 to 20,12952,14943,198302,198562,641,4.2,1229,8.1,23067,4950,18117,2.5,11.6,23587,7317,16270,3.7,11.9,-520,-0.3,23.2,0,722,732,3865
2012,13,j) 21 to 25,9171,11966,239989,241980,455,3.7,935,7.7,27622,5043,22579,2.1,11.4,31603,12049,19554,5,13.1,-3981,-1.7,22.8,0,485,486,3109
2012,13,k) 26+,13528,20851,477793,475098,1110,5.3,1536,7.3,57298,16683,40615,3.5,12.1,51908,15208,36700,3.2,10.9,5390,1.2,21.8,0,577,617,4290
2012,13,l) Left Censored,11060,39997,1459375,1452631,2579,6.5,2465,6.2,169002,48541,120461,3.3,11.6,155514,44430,111084,3.1,10.7,13488,0.9,21.4,0,357,386,3140
2012,15,a) 0,1367,1382,7922,3992,1359,196.7,0,0,7860,7860,0,196.9,196.9,0,0,0,0,0,7860,196.9,0,0,,,
2012,15,b) 1,1055,1065,9102,9253,4,0.3,298,24.3,2183,17,2166,0.2,23.6,2485,1482,1003,16,26.9,-302,-3.3,47.2,0,231,231,968
2012,15,c) 2,908,929,8411,8525,32,3.2,147,14.9,1439,90,1349,1.1,16.9,1667,925,742,10.9,19.6,-228,-2.7,33.8,0,113,113,785
2012,15,d) 3,867,879,10845,10892,29,3.1,135,14.4,1987,132,1855,1.2,18.2,2080,1454,626,13.3,19.1,-93,-0.9,36.4,0,99,99,517
2012,15,e) 4,906,952,7294,7284,45,4.6,119,12,1346,204,1142,2.8,18.5,1325,534,791,7.3,18.2,21,0.3,36.4,0,92,92,355
2012,15,f) 5,933,938,8948,8847,38,3.9,127,13,1312,369,943,4.2,14.8,1110,626,484,7.1,12.5,202,2.3,25,0,102,103,512
2012,15,g) 6 to 10,3812,4071,42807,43262,132,3.2,379,9.1,5316,1064,4252,2.5,12.3,6226,2566,3660,5.9,14.4,-910,-2.1,24.6,0,248,248,1137
2012,15,h) 11 to 15,2748,2996,33941,34151,76,2.5,248,8.1,3715,433,3282,1.3,10.9,4134,1383,2751,4,12.1,-419,-1.2,21.8,0,165,165,882
2012,15,i) 16 to 20,2081,2283,34316,34137,55,2.4,163,7,3357,165,3192,0.5,9.8,2999,929,2070,2.7,8.8,358,1,17.6,0,94,94,452
2012,15,j) 21 to 25,1835,2250,38256,38175,91,4,161,7.1,3749,1027,2722,2.7,9.8,3586,888,2698,2.3,9.4,163,0.4,18.8,0,88,88,480
2012,15,k) 26+,3056,4360,78733,78155,154,3.5,289,6.5,7637,1175,6462,1.5,9.8,6481,1682,4799,2.2,8.3,1156,1.5,16.6,0,102,104,617
2012,15,l) Left Censored,2819,6649,211568,209285,336,5,379,5.7,21466,7101,14365,3.4,10.3,16899,4485,12414,2.1,8.1,4567,2.2,16.2,0,58,64,368
2012,16,a) 0,2343,2351,10804,5479,2302,195.8,0,0,10650,10650,0,194.4,194.4,0,0,0,0,0,10650,194.4,0,0,,,
2012,16,b) 1,1711,1754,10417,10465,20,1,508,25.1,2675,225,2450,2.2,25.6,2770,1554,1216,14.8,26.5,-95,-0.9,51.2,0,377,377,1151
2012,16,c) 2,1419,1454,9301,9253,92,6,260,17,1958,277,1681,3,21.2,1862,1056,806,11.4,20.1,96,1.1,40.2,0,187,187,827
2012,16,d) 3,1389,1422,10178,10349,76,5.1,213,14.3,1682,325,1357,3.1,16.3,2023,937,1086,9.1,19.5,-341,-3.2,32.6,0,152,152,721
2012,16,e) 4,1629,1687,11384,11065,114,6.5,248,14.2,2620,1025,1595,9.3,23.7,1981,892,1089,8.1,17.9,639,5.8,35.8,0,175,175,641
2012,16,f) 5,1589,1608,10274,10544,93,5.5,256,15.2,1687,236,1451,2.2,16,2227,920,1307,8.7,21.1,-540,-5.1,32,0,169,170,612
2012,16,g) 6 to 10,6149,6443,64103,63667,323,4.8,803,12,10796,2798,7998,4.4,17,9924,5539,4385,8.7,15.6,872,1.4,31.2,0,509,514,2915
2012,16,h) 11 to 15,4242,4546,45163,45460,228,4.9,439,9.5,5662,1117,4545,2.5,12.5,6255,2371,3884,5.2,13.8,-593,-1.3,25,0,247,253,1201
2012,16,i) 16 to 20,2810,2994,29703,29531,136,4.5,248,8.2,3818,899,2919,3,12.9,3473,1166,2307,3.9,11.8,345,1.1,23.6,0,146,148,649
2012,16,j) 21 to 25,1848,2197,29924,30067,95,4.3,160,7.2,3988,523,3465,1.7,13.3,4273,1986,2287,6.6,14.2,-285,-0.9,26.6,0,89,89,540
2012,16,k) 26+,2755,3982,77284,76779,176,4.4,259,6.5,10419,2353,8066,3.1,13.6,9408,2725,6683,3.5,12.3,1011,1.3,24.6,0,122,131,553
2012,16,l) Left Censored,2612,6734,185102,184922,328,4.9,350,5.2,18599,5896,12703,3.2,10.1,18239,6195,12044,3.4,9.9,360,0.2,19.8,0,55,57,611
2012,17,a) 0,16209,16301,84321,42524,16051,196.9,0,0,83594,83594,0,196.6,196.6,0,0,0,0,0,83594,196.6,0,0,,,
2012,17,b) 1,12350,12592,84400,88717,53,0.4,3624,25,20346,898,19448,1,22.9,28979,14122,14857,15.9,32.7,-8633,-9.8,45.8,0,2471,2471,10943
2012,17,c) 2,10079,10378,94942,97817,503,4.6,1847,16.8,17774,2685,15089,2.7,18.2,23523,11007,12516,11.3,24,-5749,-5.8,36.4,0,1313,1318,6005
2012,17,d) 3,9473,9690,73210,72577,476,4.7,1472,14.5,14488,1793,12695,2.5,20,13221,7281,5940,10,18.2,1267,1.8,36.4,0,1049,1049,5228
2012,17,e) 4,9931,10313,81766,81154,502,4.7,1300,12.1,14607,2411,12196,3,18,13382,6541,6841,8.1,16.5,1225,1.5,33,0,874,874,4826
2012,17,f) 5,8988,9176,74294,74715,446,4.7,1209,12.7,11499,1693,9806,2.3,15.4,12340,6253,6087,8.4,16.5,-841,-1.1,30.8,0,837,839,4440
2012,17,g) 6 to 10,37248,39302,390081,391266,1587,3.9,4062,10,54864,9369,45495,2.4,14,57234,21968,35266,5.6,14.6,-2370,-0.6,28,0,2619,2626,14825
2012,17,h) 11 to 15,27107,29723,365210,365771,1219,4,2481,8.2,48843,10398,38445,2.8,13.4,49965,15823,34142,4.3,13.7,-1122,-0.3,26.8,0,1459,1482,10112
2012,17,i) 16 to 20,20658,22615,287457,285920,861,3.7,1728,7.5,35867,6266,29601,2.2,12.5,32792,9728,23064,3.4,11.5,3075,1,23,0,1019,1022,5477
2012,17,j) 21 to 25,16651,20015,377343,380716,676,3.3,1429,7,43033,9958,33075,2.6,11.3,49778,23145,26633,6.1,13.1,-6745,-1.8,22.6,0,743,749,5132
2012,17,k) 26+,24613,35322,838283,833649,1373,3.8,2200,6.2,94932,21378,73554,2.6,11.4,85664,23309,62355,2.8,10.3,9268,1.1,20.6,0,1023,1051,8391
2012,17,l) Left Censored,24394,61329,2327692,2322506,3167,5.1,3841,6.2,242521,57489,185032,2.5,10.4,232151,63155,168996,2.7,10,10370,0.4,20,0,719,772,10689
2012,18,a) 0,6249,6279,42811,21580,6188,197.1,0,0,42462,42462,0,196.8,196.8,0,0,0,0,0,42462,196.8,0,0,,,
2012,18,b) 1,4826,4977,51655,51710,45,0.8,1271,22.6,9662,961,8701,1.9,18.7,9772,5617,4155,10.9,18.9,-110,-0.2,37.4,0,941,942,4364
2012,18,c) 2,3987,4153,33987,34470,194,4.4,731,16.6,6938,1206,5732,3.5,20.1,7904,4752,3152,13.8,22.9,-966,-2.8,40.2,0,582,582,3923
2012,18,d) 3,3837,3969,34072,33946,188,4.5,599,14.4,6973,1057,5916,3.1,20.5,6721,3628,3093,10.7,19.8,252,0.7,39.6,0,442,442,2638
2012,18,e) 4,4263,4471,39394,39484,189,4.1,595,12.8,6688,1007,5681,2.6,16.9,6868,4069,2799,10.3,17.4,-180,-0.5,33.8,0,452,453,3444
2012,18,f) 5,3873,3953,35117,35318,165,4,483,11.8,5486,559,4927,1.6,15.5,5887,3224,2663,9.1,16.7,-401,-1.2,31,0,341,350,2457
2012,18,g) 6 to 10,16224,17116,174175,174109,724,4.1,1722,9.8,26086,4841,21245,2.8,15,25953,10763,15190,6.2,14.9,133,0.1,29.8,0,1138,1159,6781
2012,18,h) 11 to 15,12062,13563,166891,164586,600,4.4,1085,7.9,25482,4848,20634,2.9,15.5,20872,8443,12429,5.1,12.7,4610,2.8,25.4,0,665,694,5075
2012,18,i) 16 to 20,9481,10717,145384,144085,378,3.5,785,7.2,17295,2888,14407,2,12,14696,3954,10742,2.7,10.2,2599,1.8,20.4,0,525,528,2717
2012,18,j) 21 to 25,7785,9743,180074,178178,322,3.3,615,6.2,20607,2742,17865,1.5,11.6,16814,3589,13225,2,9.4,3793,2.2,18.8,0,357,360,2202
2012,18,k) 26+,12286,18861,394973,391955,895,4.7,1159,6.1,48180,14657,33523,3.7,12.3,42146,9349,32797,2.4,10.8,6034,1.5,21.6,0,509,534,3872
2012,18,l) Left Censored,12481,33441,1212885,1200924,1705,5.1,1793,5.4,131211,26128,105083,2.2,10.9,107288,25063,82225,2.1,8.9,23923,2,17.8,0,317,328,3909
2012,19,a) 0,3258,3272,17907,8991,3237,197.9,0,0,17832,17832,0,198.3,198.3,0,0,0,0,0,17832,198.3,0,0,,,
2012,19,b) 1,2592,2643,18626,18969,25,0.8,616,20.8,4848,815,4033,4.3,25.6,5533,3492,2041,18.4,29.2,-685,-3.6,51.2,0,443,443,2423
2012,19,c) 2,2201,2232,14863,15026,103,4.4,368,15.6,2613,385,2228,2.6,17.4,2939,1527,1412,10.2,19.6,-326,-2.2,34.8,0,277,277,1176
2012,19,d) 3,2089,2169,18321,18097,91,4,318,14,3640,347,3293,1.9,20.1,3192,1673,1519,9.2,17.6,448,2.5,35.2,0,235,236,1402
2012,19,e) 4,2275,2370,18527,18030,95,3.9,250,10.2,3661,584,3077,3.2,20.3,2666,1037,1629,5.8,14.8,995,5.5,29.6,0,191,191,767
2012,19,f) 5,2093,2143,16817,17231,83,3.8,238,10.8,2166,251,1915,1.5,12.6,2994,1207,1787,7,17.4,-828,-4.8,25.2,0,173,173,1003
2012,19,g) 6 to 10,9077,9722,97189,97360,398,4,869,8.7,12519,2274,10245,2.3,12.9,12860,4708,8152,4.8,13.2,-341,-0.3,25.8,0,571,572,3249
2012,19,h) 11 to 15,6756,7376,76807,80127,272,3.6,558,7.4,9700,1432,8268,1.8,12.1,16339,9977,6362,12.5,20.4,-6639,-8.3,24.2,0,334,336,2210
2012,19,i) 16 to 20,5249,5707,61337,61209,233,4,399,6.9,7776,1883,5893,3.1,12.7,7520,2917,4603,4.8,12.3,256,0.4,24.6,0,248,248,1066
2012,19,j) 21 to 25,4182,4899,79194,79031,176,3.6,298,6,8335,1921,6414,2.4,10.5,8008,2070,5938,2.6,10.1,327,0.4,20.2,0,166,169,943
2012,19,k) 26+,7379,11312,204253,202811,445,3.9,553,4.9,21491,4180,17311,2.1,10.6,18606,5147,13459,2.5,9.2,2885,1.4,18.4,0,263,269,2527
2012,19,l) Left Censored,8466,19175,662588,655275,916,4.8,929,4.8,64134,11568,52566,1.8,9.8,49507,11211,38296,1.7,7.6,14627,2.2,15.2,0,215,222,2336
2012,20,a) 0,3353,3371,22191,11174,3326,197.3,0,0,22035,22035,0,197.2,197.2,0,0,0,0,0,22035,197.2,0,0,,,
2012,20,b) 1,2464,2534,17401,18320,19,0.7,696,24,4261,252,4009,1.4,23.3,6098,4277,1821,23.3,33.3,-1837,-10,46.6,0,530,530,3693
2012,20,c) 2,2084,2121,16368,16224,100,4.5,363,16.2,3224,483,2741,3,19.9,2936,1437,1499,8.9,18.1,288,1.8,36.2,0,286,286,1158
2012,20,d) 3,2089,2145,17012,16617,101,4.5,310,13.8,3853,421,3432,2.5,23.2,3062,1553,1509,9.3,18.4,791,4.8,36.8,0,240,241,1302
2012,20,e) 4,2138,2227,17020,16686,108,4.7,287,12.4,3770,978,2792,5.9,22.6,3102,1576,1526,9.4,18.6,668,4,37.2,0,212,212,1120
2012,20,f) 5,2076,2085,16660,17064,81,3.7,290,13.3,2544,373,2171,2.2,14.9,3351,1770,1581,10.4,19.6,-807,-4.7,29.8,0,190,193,938
2012,20,g) 6 to 10,8778,9185,93389,93210,345,3.7,951,10.1,13677,2108,11569,2.3,14.7,13319,5276,8043,5.7,14.3,358,0.4,28.6,0,608,612,3622
2012,20,h) 11 to 15,6665,7270,78642,78762,269,3.6,589,7.9,10287,1937,8350,2.5,13.1,10527,3641,6886,4.6,13.4,-240,-0.3,26.2,0,385,391,2189
2012,20,i) 16 to 20,4811,5286,64052,64517,161,3,436,8.1,6814,1262,5552,2,10.6,7744,2698,5046,4.2,12,-930,-1.4,21.2,0,238,239,1227
2012,20,j) 21 to 25,3740,4618,79929,79510,154,3.3,279,6,8459,2295,6164,2.9,10.6,7621,1812,5809,2.3,9.6,838,1,19.2,0,162,164,769
2012,20,k) 26+,6600,9647,175014,174681,428,4.4,560,5.8,20196,4920,15276,2.8,11.6,19529,5289,14240,3,11.2,667,0.4,22.4,0,251,257,1636
2012,20,l) Left Censored,6943,16449,525607,522464,813,4.9,849,5.2,52400,14799,37601,2.8,10,46114,10733,35381,2.1,8.8,6286,1.2,17.6,0,162,192,2431
2012,21,a) 0,4092,4124,26710,13427,4076,197.7,0,0,26567,26567,0,197.9,197.9,0,0,0,0,0,26567,197.9,0,0,,,
2012,21,b) 1,3189,3287,21631,23083,25,0.7,829,22.3,5568,531,5037,2.3,24.1,8471,4659,3812,20.2,36.7,-2903,-12.6,48.2,0,656,656,3821
2012,21,c) 2,2627,2694,23438,23847,137,4.8,517,18,4622,832,3790,3.5,19.4,5439,2930,2509,12.3,22.8,-817,-3.4,38.8,0,396,396,1993
2012,21,d) 3,2382,2431,20055,19940,98,3.8,365,14.2,3773,586,3187,2.9,18.9,3542,1924,1618,9.6,17.8,231,1.1,35.6,0,294,294,1653
2012,21,e) 4,2551,2738,23378,23483,99,3.5,346,12.1,3987,523,3464,2.2,17,4196,1962,2234,8.4,17.9,-209,-0.9,34,0,259,259,1263
2012,21,f) 5,2414,2459,21657,21700,101,3.9,342,13.3,3622,905,2717,4.2,16.7,3708,1553,2155,7.2,17.1,-86,-0.4,33.4,0,258,260,1197
2012,21,g) 6 to 10,9998,10505,100113,102724,402,3.7,1127,10.4,13507,2518,10989,2.5,13.1,18729,7969,10760,7.8,18.2,-5222,-5.1,26.2,0,749,756,3904
2012,21,h) 11 to 15,7927,8808,103244,102628,350,3.9,749,8.3,14254,3600,10654,3.5,13.9,13021,3914,9107,3.8,12.7,1233,1.2,25.4,0,466,473,2478
2012,21,i) 16 to 20,5962,6700,86439,86361,203,3,499,7.3,10336,2073,8263,2.4,12,10179,3175,7004,3.7,11.8,157,0.2,23.6,0,292,294,1460
2012,21,j) 21 to 25,4795,6035,110038,106548,212,3.5,359,5.9,17391,5332,12059,5,16.3,10410,2421,7989,2.3,9.8,6981,6.5,19.6,0,208,212,1265
2012,21,k) 26+,7561,11731,236418,237031,497,4.2,677,5.7,26408,7034,19374,3,11.1,27633,8604,19029,3.6,11.7,-1225,-0.6,22.2,0,323,331,2470
2012,21,l) Left Censored,7440,20535,712147,704709,1050,5.1,1008,4.9,77490,15302,62188,2.2,11,62614,12731,49883,1.8,8.9,14876,2.1,17.8,0,188,196,2216
2012,22,a) 0,5216,5247,32555,16559,5183,197.6,0,0,31993,31993,0,193.2,193.2,0,0,0,0,0,31993,193.2,0,0,,,
2012,22,b) 1,3795,3845,30597,31723,13,0.3,1037,23.6,7580,300,7280,0.9,23.9,9832,5429,4403,17.1,31,-2252,-7.1,47.8,0,807,807,4394
2012,22,c) 2,3401,3539,33662,33075,148,4,549,14.7,7594,1430,6164,4.3,23,6420,2583,3837,7.8,19.4,1174,3.6,38.8,0,444,444,1988
2012,22,d) 3,3143,3251,31251,31303,120,3.5,487,14.2,6625,676,5949,2.2,21.2,6728,3124,3604,10,21.5,-103,-0.3,42.4,0,367,367,2690
2012,22,e) 4,3389,3580,35463,35415,134,3.6,424,11.4,6484,785,5699,2.2,18.3,6387,2812,3575,7.9,18,97,0.3,36,0,311,311,1882
2012,22,f) 5,3236,3293,35347,35164,108,3.1,428,12.4,5764,605,5159,1.7,16.4,5397,2123,3274,6,15.3,367,1.1,30.6,0,324,324,1635
2012,22,g) 6 to 10,12345,13288,151433,153243,464,3.4,1318,9.6,20950,2922,18028,1.9,13.7,24569,9952,14617,6.5,16,-3619,-2.3,27.4,0,898,902,7270
2012,22,h) 11 to 15,9339,10191,134436,136673,325,3.1,758,7.3,15410,1794,13616,1.3,11.3,19883,5201,14682,3.8,14.5,-4473,-3.2,22.6,0,488,505,3170
2012,22,i) 16 to 20,6959,7647,103658,104243,188,2.4,500,6.4,11384,1820,9564,1.7,10.9,12555,4424,8131,4.2,12,-1171,-1.1,21.8,0,292,293,2427
2012,22,j) 21 to 25,5116,6501,126565,127801,241,3.6,478,7.2,14553,2687,11866,2.1,11.4,17024,5123,11901,4,13.3,-2471,-1.9,22.8,0,230,230,1625
2012,22,k) 26+,9450,13352,258912,257355,467,3.5,719,5.3,29801,6269,23532,2.4,11.6,26686,5465,21221,2.1,10.4,3115,1.2,20.8,0,320,334,1896
2012,22,l) Left Censored,7861,21939,654981,650802,1235,5.7,1074,4.9,72139,18289,53850,2.8,11.1,63781,12418,51363,1.9,9.8,8358,1.3,19.6,0,226,236,2845
2012,23,a) 0,1790,1797,9172,4670,1767,196.7,0,0,9005,9005,0,192.8,192.8,0,0,0,0,0,9005,192.8,0,0,,,
2012,23,b) 1,1360,1387,8503,8638,7,0.4,419,26.1,2115,53,2062,0.6,24.5,2385,1177,1208,13.6,27.6,-270,-3.1,49,0,278,278,914
2012,23,c) 2,1115,1159,7484,7505,60,4.9,191,15.6,1243,194,1049,2.6,16.6,1284,593,691,7.9,17.1,-41,-0.5,33.2,0,135,135,444
2012,23,d) 3,1094,1122,7921,8089,57,4.9,163,13.9,1385,155,1230,1.9,17.1,1721,999,722,12.4,21.3,-336,-4.2,34.2,0,118,118,460
2012,23,e) 4,1203,1252,7768,7756,76,5.8,186,14.3,1519,297,1222,3.8,19.6,1495,807,688,10.4,19.3,24,0.3,38.6,0,123,123,491
2012,23,f) 5,1201,1208,7926,7931,70,5.6,156,12.5,1288,159,1129,2,16.2,1298,656,642,8.3,16.4,-10,-0.2,32.4,0,94,94,415
2012,23,g) 6 to 10,4939,5168,39714,39774,264,5,578,10.9,5583,761,4822,1.9,14,5702,2413,3289,6.1,14.3,-119,-0.3,28,0,376,379,1685
2012,23,h) 11 to 15,3854,4103,36910,36883,182,4.3,404,9.6,4985,1021,3964,2.8,13.5,4930,1961,2969,5.3,13.4,55,0.1,26.8,0,255,256,1381
2012,23,i) 16 to 20,2688,2918,28346,29012,115,3.8,261,8.7,2771,459,2312,1.6,9.6,4103,1444,2659,5,14.1,-1332,-4.5,19.2,0,138,139,687
2012,23,j) 21 to 25,2323,2901,43523,43729,136,4.7,178,6.1,5010,1286,3724,2.9,11.5,5421,1489,3932,3.4,12.4,-411,-0.9,23,0,106,106,1009
2012,23,k) 26+,3331,4795,76959,77382,182,3.8,297,6.1,8239,2022,6217,2.6,10.6,9084,2535,6549,3.3,11.7,-845,-1.1,21.2,0,111,115,1129
2012,23,l) Left Censored,2978,6846,205099,202870,404,5.9,363,5.3,20241,4541,15700,2.2,10,15783,3709,12074,1.8,7.8,4458,2.2,15.6,0,84,87,836
2012,24,a) 0,6694,6722,38248,19414,6623,197.1,0,0,37668,37668,0,194,194,0,0,0,0,0,37668,194,0,0,,,
2012,24,b) 1,4963,5041,39809,39887,41,0.7,1273,22.3,10074,1021,9053,2.6,25.3,10230,5474,4756,13.7,25.6,-156,-0.3,50.6,0,932,932,4443
2012,24,c) 2,4177,4355,32959,32566,200,4.4,670,14.7,7079,879,6200,2.7,21.7,6293,3031,3262,9.3,19.3,786,2.4,38.6,0,505,505,2348
2012,24,d) 3,4046,4142,34868,34717,201,4.7,578,13.4,6311,1170,5141,3.4,18.2,6009,2995,3014,8.6,17.3,302,0.9,34.6,0,423,423,2345
2012,24,e) 4,4220,4487,39637,38636,229,5,527,11.4,7889,1916,5973,5,20.4,5887,2450,3437,6.3,15.2,2002,5.2,30.4,0,386,386,1829
2012,24,f) 5,4038,4118,38436,37974,163,3.8,485,11.4,6676,933,5743,2.5,17.6,5752,2498,3254,6.6,15.1,924,2.5,30.2,0,363,363,1973
2012,24,g) 6 to 10,17554,18286,180309,181197,730,3.9,1898,10.1,24408,3323,21085,1.8,13.5,26184,10629,15555,5.9,14.5,-1776,-1,27,0,1262,1274,6949
2012,24,h) 11 to 15,12714,13960,172958,172854,563,4,1089,7.7,22481,5516,16965,3.2,13,22272,6740,15532,3.9,12.9,209,0.1,25.8,0,669,670,3639
2012,24,i) 16 to 20,9235,10019,133343,134976,363,3.6,708,7,12742,1680,11062,1.2,9.4,16008,4831,11177,3.6,11.9,-3266,-2.5,18.8,0,419,425,3154
2012,24,j) 21 to 25,7725,9311,179908,179833,354,3.8,592,6.3,21730,4841,16889,2.7,12.1,21579,8365,13214,4.7,12,151,0.1,24,0,294,308,2130
2012,24,k) 26+,10193,14613,315959,313829,561,3.8,869,5.9,37997,7869,30128,2.5,12.1,33737,8123,25614,2.6,10.8,4260,1.3,21.6,0,344,353,1997
2012,24,l) Left Censored,9143,25642,940713,934530,1451,5.7,1501,5.9,109114,28828,80286,3.1,11.7,96747,25627,71120,2.7,10.4,12367,1.3,20.8,0,243,260,2704
2012,25,a) 0,8277,8337,43892,22033,8252,198,0,0,43718,43718,0,198.4,198.4,0,0,0,0,0,43718,198.4,0,0,,,
2012,25,b) 1,6136,6210,44012,42978,34,0.5,1590,22.6,12079,677,11402,1.6,28.1,10011,5814,4197,13.5,23.3,2068,4.8,46.6,0,1161,1162,4674
2012,25,c) 2,5187,5258,39604,39348,238,4.3,872,15.7,7757,899,6858,2.3,19.7,7244,3815,3429,9.7,18.4,513,1.3,36.8,0,659,659,3003
2012,25,d) 3,4695,4798,37162,36768,227,4.5,643,12.9,7097,678,6419,1.8,19.3,6309,3425,2884,9.3,17.2,788,2.1,34.4,0,459,459,2283
2012,25,e) 4,5021,5237,42160,40468,275,5.1,610,11.3,9151,1657,7494,4.1,22.6,5767,2888,2879,7.1,14.3,3384,8.3,28.6,0,427,427,1953
2012,25,f) 5,4652,4688,39612,39483,222,4.6,559,11.6,6769,1138,5631,2.9,17.1,6511,3516,2995,8.9,16.5,258,0.6,33,0,399,399,2768
2012,25,g) 6 to 10,20508,21315,220998,218633,924,4.2,2109,9.6,35239,5311,29928,2.4,16.1,30509,14403,16106,6.6,14,4730,2.1,28,0,1363,1366,10374
2012,25,h) 11 to 15,15660,16728,210441,210464,699,4.1,1312,7.7,25812,3086,22726,1.5,12.3,25857,9806,16051,4.7,12.3,-45,0,24.6,0,802,816,4883
2012,25,i) 16 to 20,11559,12524,161253,162716,453,3.6,867,6.8,18378,3230,15148,2,11.3,21304,6742,14562,4.1,13.1,-2926,-1.8,22.6,0,510,512,3564
2012,25,j) 21 to 25,9980,12070,220685,220017,466,3.8,795,6.5,22590,3474,19116,1.6,10.3,21254,5940,15314,2.7,9.7,1336,0.6,19.4,0,429,443,3164
2012,25,k) 26+,14595,21172,557544,553294,761,3.6,1200,5.6,52590,9818,42772,1.8,9.5,44089,10294,33795,1.9,8,8501,1.5,16,0,537,566,3334
2012,25,l) Left Censored,15180,35018,1375455,1365145,1749,5,1962,5.6,138331,28779,109552,2.1,10.1,117711,27609,90102,2,8.6,20620,1.5,17.2,0,430,456,5369
2012,26,a) 0,10187,10370,67895,34124,10239,197.5,0,0,67542,67542,0,197.9,197.9,0,0,0,0,0,67542,197.9,0,0,,,
2012,26,b) 1,7735,7973,64121,67192,76,0.8,2058,22.8,17079,576,16503,0.9,25.4,23220,14802,8418,22,34.6,-6141,-9.2,50.8,0,1430,1430,6935
2012,26,c) 2,6245,6357,56036,56315,287,4.3,1120,16.6,11648,1050,10598,1.9,20.7,12206,5499,6707,9.8,21.7,-558,-1,41.4,0,855,858,4219
2012,26,d) 3,6042,6149,58808,58852,283,4.4,891,13.8,10850,1187,9663,2,18.4,10938,5360,5578,9.1,18.6,-88,-0.2,36.8,0,688,689,3999
2012,26,e) 4,6249,6585,65440,62696,328,4.8,861,12.6,16109,5375,10734,8.6,25.7,10620,5875,4745,9.4,16.9,5489,8.8,33.8,0,620,620,4533
2012,26,f) 5,5823,5943,57284,60441,275,4.5,717,11.7,7460,1020,6440,1.7,12.3,13774,5000,8774,8.3,22.8,-6314,-10.5,24.6,0,513,514,3786
2012,26,g) 6 to 10,24709,25794,268103,269683,1121,4.2,2619,9.9,40599,5372,35227,2,15.1,43758,20332,23426,7.5,16.2,-3159,-1.1,30.2,0,1772,1791,14523
2012,26,h) 11 to 15,18946,20776,241840,241286,925,4.4,1725,8.2,32897,6336,26561,2.6,13.6,31788,12162,19626,5,13.2,1109,0.4,26.4,0,1009,1010,6782
2012,26,i) 16 to 20,15248,16678,206254,205867,642,3.8,1209,7.2,25764,5445,20319,2.6,12.5,24989,10054,14935,4.9,12.1,775,0.4,24.2,0,712,732,4375
2012,26,j) 21 to 25,12641,15526,263300,257047,573,3.6,1025,6.5,38180,5913,32267,2.3,14.9,25674,10085,15589,3.9,10,12506,4.9,20,0,537,542,5814
2012,26,k) 26+,18692,26491,509189,510119,1088,4.1,1555,5.8,67457,15858,51599,3.1,13.2,69317,31712,37605,6.2,13.6,-1860,-0.4,26.4,0,705,738,20451
2012,26,l) Left Censored,17390,45252,1605190,1590788,2071,4.6,2642,5.8,173772,31086,142686,2,10.9,144970,38651,106319,2.4,9.1,28802,1.8,18.2,0,508,553,6068
2012,27,a) 0,6437,6465,33462,16857,6359,196.7,0,0,33211,33211,0,197,197,0,0,0,0,0,33211,197,0,0,,,
2012,27,b) 1,5003,5129,36844,38125,35,0.6,1415,24.1,8644,540,8104,1.4,22.7,11205,5341,5864,14,29.4,-2561,-6.7,45.4,0,927,927,4076
2012,27,c) 2,4148,4279,35759,35235,212,4.7,744,16.4,6538,933,5605,2.6,18.6,5489,3023,2466,8.6,15.6,1049,3,31.2,0,493,495,2149
2012,27,d) 3,4180,4257,41452,38695,237,5.4,593,13.4,11884,1162,10722,3,30.7,6370,3224,3146,8.3,16.5,5514,14.2,33,0,410,410,2449
2012,27,e) 4,4228,4403,37105,36621,251,5.5,527,11.6,7164,1200,5964,3.3,19.6,6195,3010,3185,8.2,16.9,969,2.7,33.8,0,364,364,1903
2012,27,f) 5,4064,4148,35693,37432,217,5.1,514,12,6135,652,5483,1.7,16.4,9612,6622,2990,17.7,25.7,-3477,-9.3,32.8,0,350,350,6191
2012,27,g) 6 to 10,17904,18938,182473,182428,914,4.7,1920,9.9,26193,4328,21865,2.4,14.4,26103,11669,14434,6.4,14.3,90,0.1,28.6,0,1149,1169,8342
2012,27,h) 11 to 15,13737,15047,175514,175717,623,4.1,1156,7.6,20711,3916,16795,2.2,11.8,21117,7614,13503,4.3,12,-406,-0.2,23.6,0,630,635,3937
2012,27,i) 16 to 20,9929,11230,140928,141210,412,3.6,753,6.6,15573,2919,12654,2.1,11,16136,5703,10433,4,11.4,-563,-0.4,22,0,453,454,3352
2012,27,j) 21 to 25,7606,9336,165600,162644,369,3.9,610,6.5,20720,4739,15981,2.9,12.7,14807,4112,10695,2.5,9.1,5913,3.6,18.2,0,332,334,1941
2012,27,k) 26+,11080,16214,386557,382149,690,4.2,916,5.6,43600,7890,35710,2.1,11.4,34785,8490,26295,2.2,9.1,8815,2.3,18.2,0,398,426,3470
2012,27,l) Left Censored,11496,28131,1192900,1181745,1244,4.4,1501,5.3,120987,18933,102054,1.6,10.2,98677,20702,77975,1.8,8.4,22310,1.8,16.8,0,285,301,3618
2012,28,a) 0,2621,2634,15265,7742,2592,196.8,0,0,15046,15046,0,194.3,194.3,0,0,0,0,0,15046,194.3,0,0,,,
2012,28,b) 1,2002,2064,15769,16316,16,0.7,623,26.1,4465,172,4293,1.1,27.4,5558,3478,2080,21.3,34.1,-1093,-6.7,54.8,0,518,519,2918
2012,28,c) 2,1769,1844,14980,15452,75,3.8,377,19,3075,278,2797,1.8,19.9,4018,2081,1937,13.5,26,-943,-6.1,39.8,0,300,300,1754
2012,28,d) 3,1723,1762,13194,13456,69,3.7,282,15.1,2288,393,1895,2.9,17,2812,1365,1447,10.1,20.9,-524,-3.9,34,0,224,224,1136
2012,28,e) 4,1771,1936,15930,15450,98,4.9,261,13,3768,754,3014,4.9,24.4,2808,1369,1439,8.9,18.2,960,6.2,36.4,0,200,200,1113
2012,28,f) 5,1741,1817,12255,12607,74,3.9,225,11.9,1988,268,1720,2.1,15.8,2692,1067,1625,8.5,21.4,-704,-5.6,31.6,0,165,165,689
2012,28,g) 6 to 10,6920,7366,71395,72314,239,3.1,781,10.3,9824,2220,7604,3.1,13.6,11661,4277,7384,5.9,16.1,-1837,-2.5,27.2,0,544,544,2580
2012,28,h) 11 to 15,5192,5709,59601,59852,192,3.3,512,8.8,6838,1249,5589,2.1,11.4,7340,2361,4979,3.9,12.3,-502,-0.9,22.8,0,329,330,1593
2012,28,i) 16 to 20,3836,4269,55791,56609,120,2.8,257,5.9,5277,1108,4169,2,9.3,6913,1744,5169,3.1,12.2,-1636,-2.9,18.6,0,181,181,1170
2012,28,j) 21 to 25,2927,3487,75348,73104,116,3.3,226,6.4,11079,1186,9893,1.6,15.2,6590,1502,5088,2.1,9,4489,6.2,18,0,124,127,704
2012,28,k) 26+,5216,7492,133291,132890,255,3.4,427,5.6,14296,3347,10949,2.5,10.8,13493,2991,10502,2.3,10.2,803,0.6,20.4,0,209,214,1261
2012,28,l) Left Censored,4936,13860,405389,407711,636,4.6,576,4.2,32563,6501,26062,1.6,8,37206,6182,31024,1.5,9.1,-4643,-1.1,16,0,130,136,960
2012,29,a) 0,7680,7708,41385,20882,7613,197.5,0,0,41007,41007,0,196.4,196.4,0,0,0,0,0,41007,196.4,0,0,,,
2012,29,b) 1,5452,5637,34530,37199,53,0.8,2080,31,8703,718,7985,1.9,23.4,14040,8607,5433,23.1,37.7,-5337,-14.3,46.8,0,1730,1730,7271
2012,29,c) 2,4395,4533,32647,33495,239,4.8,1213,24.2,6537,1024,5513,3.1,19.5,8232,4862,3370,14.5,24.6,-1695,-5.1,39,0,984,984,3224
2012,29,d) 3,4055,4245,35723,36402,204,4.5,748,16.6,5703,749,4954,2.1,15.7,7060,3942,3118,10.8,19.4,-1357,-3.7,31.4,0,596,596,3364
2012,29,e) 4,4217,4508,39490,38155,286,6.1,653,14,8481,3401,5080,8.9,22.2,5810,3048,2762,8,15.2,2671,7,30.4,0,494,494,2300
2012,29,f) 5,4100,4201,31553,31685,193,4.4,581,13.2,5403,1028,4375,3.2,17.1,5666,2494,3172,7.9,17.9,-263,-0.8,34.2,0,451,452,1845
2012,29,g) 6 to 10,17540,18523,177218,177501,782,4.1,2064,10.8,25859,4125,21734,2.3,14.6,26425,10735,15690,6,14.9,-566,-0.3,29.2,0,1431,1437,6935
2012,29,h) 11 to 15,12461,13776,152877,153229,573,4.1,1159,8.2,19192,3486,15706,2.3,12.5,19895,6283,13612,4.1,13,-703,-0.5,25,0,735,758,3908
2012,29,i) 16 to 20,9276,10332,137064,136950,391,3.7,767,7.3,15751,3009,12742,2.2,11.5,15522,5012,10510,3.7,11.3,229,0.2,22.6,0,485,485,2736
2012,29,j) 21 to 25,7518,9458,160234,158585,335,3.5,737,7.6,19639,4121,15518,2.6,12.4,16340,4732,11608,3,10.3,3299,2.1,20.6,0,340,346,1569
2012,29,k) 26+,11788,17932,386402,387387,706,3.9,1006,5.6,37595,7062,30533,1.8,9.7,39564,7436,32128,1.9,10.2,-1969,-0.5,19.4,0,485,516,3091
2012,29,l) Left Censored,11516,30967,1091712,1086713,1566,5.1,1612,5.2,110055,28354,81701,2.6,10.1,100057,23186,76871,2.1,9.2,9998,0.9,18.4,0,329,349,4313
2012,30,a) 0,1918,1927,8066,4053,1905,197.7,0,0,8026,8026,0,198,198,0,0,0,0,0,8026,198,0,0,,,
2012,30,b) 1,1353,1373,7430,7444,6,0.4,400,25.2,1782,91,1691,1.2,23.9,1810,1057,753,14.2,24.3,-28,-0.4,47.8,0,274,274,813
2012,30,c) 2,1170,1186,6601,6643,64,5.1,210,16.8,1398,276,1122,4.2,21,1481,891,590,13.4,22.3,-83,-1.3,42,0,148,148,782
2012,30,d) 3,1183,1209,6611,6614,69,5.4,194,15.3,1275,272,1003,4.1,19.3,1281,626,655,9.5,19.4,-6,-0.1,38.6,0,140,140,517
2012,30,e) 4,1256,1320,7942,7937,96,7,190,13.9,1485,345,1140,4.3,18.7,1474,687,787,8.7,18.6,11,0.1,37.2,0,110,110,313
2012,30,f) 5,1247,1259,7800,7884,86,6.6,185,14.2,1087,225,862,2.9,13.8,1255,553,702,7,15.9,-168,-2.1,27.6,0,110,112,346
2012,30,g) 6 to 10,5322,5475,42191,42416,288,5.1,575,10.3,5603,899,4704,2.1,13.2,6053,2251,3802,5.3,14.3,-450,-1.1,26.4,0,337,342,1535
2012,30,h) 11 to 15,3635,3810,30089,30034,205,5.3,338,8.8,4313,975,3338,3.2,14.4,4202,1637,2565,5.5,14,111,0.4,28,0,196,197,763
2012,30,i) 16 to 20,2525,2640,23620,23978,99,3.7,200,7.5,2628,445,2183,1.9,11,3344,1180,2164,4.9,13.9,-716,-2.9,22,0,122,126,662
2012,30,j) 21 to 25,1673,1865,21629,21321,75,4,127,6.7,2852,582,2270,2.7,13.4,2236,734,1502,3.4,10.5,616,2.9,21,0,58,62,286
2012,30,k) 26+,2670,3672,58032,57449,136,3.7,205,5.5,6786,1459,5327,2.5,11.8,5620,1366,4254,2.4,9.8,1166,2,19.6,0,101,101,590
2012,30,l) Left Censored,2359,5273,119101,118972,294,5.6,220,4.2,11313,2942,8371,2.5,9.5,11054,1892,9162,1.6,9.3,259,0.2,18.6,0,49,49,330
2012,31,a) 0,2379,2384,16057,8074,2345,196.7,0,0,15967,15967,0,197.8,197.8,0,0,0,0,0,15967,197.8,0,0,,,
2012,31,b) 1,1806,1831,11171,11622,5,0.2,414,20.2,2761,99,2662,0.9,23.8,3662,2246,1416,19.3,31.5,-901,-7.7,47.6,0,301,301,1424
2012,31,c) 2,1577,1619,11038,10797,78,4.6,240,14.2,2252,249,2003,2.3,20.9,1769,921,848,8.5,16.4,483,4.5,32.8,0,184,184,743
2012,31,d) 3,1556,1579,10548,10689,67,4.1,191,11.6,1865,237,1628,2.2,17.4,2146,1214,932,11.4,20.1,-281,-2.7,34.8,0,148,148,947
2012,31,e) 4,1532,1590,12612,12039,72,4.4,207,12.5,2931,749,2182,6.2,24.3,1784,923,861,7.7,14.8,1147,9.5,29.6,0,151,151,677
2012,31,f) 5,1497,1531,10126,10236,55,3.5,164,10.4,1410,127,1283,1.2,13.8,1630,750,880,7.3,15.9,-220,-2.1,27.6,0,118,118,581
2012,31,g) 6 to 10,6247,6526,53689,53615,227,3.4,557,8.4,8179,1724,6455,3.2,15.3,8031,2833,5198,5.3,15,148,0.3,30,0,369,378,1711
2012,31,h) 11 to 15,4735,5158,58017,58462,196,3.7,390,7.4,5875,972,4903,1.7,10,6765,2459,4306,4.2,11.6,-890,-1.6,20,0,222,224,1272
2012,31,i) 16 to 20,3380,3682,47301,46514,115,3.1,249,6.7,5967,653,5314,1.4,12.8,4393,1373,3020,3,9.4,1574,3.4,18.8,0,152,155,815
2012,31,j) 21 to 25,2732,3382,63391,64182,113,3.3,220,6.4,6446,815,5631,1.3,10,8028,1707,6321,2.7,12.5,-1582,-2.5,20,0,116,116,786
2012,31,k) 26+,4637,6676,131365,129449,237,3.5,351,5.2,14761,2940,11821,2.3,11.4,10929,2683,8246,2.1,8.4,3832,3,16.8,0,168,173,1173
2012,31,l) Left Censored,5090,11109,353996,351977,549,4.9,610,5.5,34323,8616,25707,2.4,9.8,30284,5259,25025,1.5,8.6,4039,1.2,17.2,0,128,140,1415
2012,32,a) 0,4218,4240,28063,14144,4182,197.3,0,0,27839,27839,0,196.8,196.8,0,0,0,0,0,27839,196.8,0,0,,,
2012,32,b) 1,3156,3198,25555,26211,17,0.5,1033,27.6,6162,192,5970,0.7,23.5,7474,4549,2925,17.4,28.5,-1312,-5,47,0,803,803,3571
2012,32,c) 2,2529,2603,30540,30684,133,4.7,571,20.3,5269,726,4543,2.4,17.2,5557,3081,2476,10,18.1,-288,-0.9,34.4,0,470,470,2676
2012,32,d) 3,2335,2441,20737,21822,138,5.3,434,16.8,3815,552,3263,2.5,17.5,5985,3565,2420,16.3,27.4,-2170,-9.9,35,0,344,347,2917
2012,32,e) 4,2393,2502,24294,26251,139,5.3,426,16.2,4235,552,3683,2.1,16.1,8149,4880,3269,18.6,31,-3914,-14.9,32.2,0,324,324,3773
2012,32,f) 5,2112,2156,19277,19726,108,4.7,359,15.8,3062,494,2568,2.5,15.5,3959,1958,2001,9.9,20.1,-897,-4.6,31,0,261,263,1384
2012,32,g) 6 to 10,8191,8644,100153,101433,377,4.2,1162,12.9,15040,2296,12744,2.3,14.8,17599,7741,9858,7.6,17.4,-2559,-2.6,29.6,0,780,805,5218
2012,32,h) 11 to 15,4759,5338,93100,91293,257,4.7,590,10.7,15186,7058,8128,7.7,16.6,11571,3310,8261,3.6,12.7,3615,3.9,25.4,0,355,361,2157
2012,32,i) 16 to 20,2768,3295,59094,61101,143,4.3,272,8.1,6523,1818,4705,3,10.7,10537,5416,5121,8.9,17.2,-4014,-6.5,21.4,0,155,160,1285
2012,32,j) 21 to 25,2024,2719,59276,58271,107,3.9,198,7.2,8500,1160,7340,2,14.6,6489,2786,3703,4.8,11.1,2011,3.5,22.2,0,93,93,1273
2012,32,k) 26+,2971,5323,150041,148260,253,4.7,358,6.7,17687,3275,14412,2.2,11.9,14124,3112,11012,2.1,9.5,3563,2.4,19,0,118,119,1042
2012,32,l) Left Censored,2836,9375,411695,406606,632,6.8,547,5.9,45257,13145,32112,3.2,11.1,35079,7215,27864,1.8,8.6,10178,2.5,17.2,0,64,72,1114
2012,33,a) 0,1720,1727,11611,7194,1707,197.7,0,0,8835,,,,122.8,0,0,0,0,0,8835,122.8,0,1,,,
2012,33,b) 1,1298,1307,7232,8002,3,0.2,327,22.1,1665,,,,20.8,3204,2413,791,30.2,40,-1539,-19.2,41.6,1,249,249,2135
2012,33,c) 2,1149,1187,9352,9606,48,3.8,209,16.6,1974,225,1749,2.3,20.5,2481,783,1698,8.2,25.8,-507,-5.3,41,0,165,165,653
2012,33,d) 3,1035,1066,7185,7247,46,4.1,144,12.9,1315,239,1076,3.3,18.1,1439,619,820,8.5,19.9,-124,-1.8,36.2,0,114,114,491
2012,33,e) 4,1166,1200,11651,11212,47,3.8,149,12,2557,414,2143,3.7,22.8,1679,767,912,6.8,15,878,7.8,30,0,112,112,586
2012,33,f) 5,1047,1062,8292,8391,57,5.2,140,12.7,1326,195,1131,2.3,15.8,1524,842,682,10,18.2,-198,-2.4,31.6,0,104,106,496
2012,33,g) 6 to 10,4549,4739,41357,41546,203,4.2,488,10,5947,1085,4862,2.6,14.3,6324,2632,3692,6.3,15.2,-377,-0.9,28.6,0,333,334,1830
2012,33,h) 11 to 15,3607,3863,40512,40655,170,4.3,319,8.1,4899,1269,3630,3.1,12.1,5184,1511,3673,3.7,12.8,-285,-0.7,24.2,0,193,194,884
2012,33,i) 16 to 20,2790,2938,32894,33563,81,2.7,193,6.5,3038,364,2674,1.1,9.1,4375,1956,2419,5.8,13,-1337,-3.9,18.2,0,129,130,647
2012,33,j) 21 to 25,2373,2783,42311,42372,109,3.9,184,6.5,4244,973,3271,2.3,10,4365,1280,3085,3,10.3,-121,-0.3,20,0,115,118,927
2012,33,k) 26+,3158,4339,79789,79913,182,4.1,303,6.9,8297,1838,6459,2.3,10.4,8545,2667,5878,3.3,10.7,-248,-0.3,20.8,0,135,157,1444
2012,33,l) Left Censored,3058,7121,249793,254189,460,6.5,385,5.4,21138,4861,16277,1.9,8.3,29930,13259,16671,5.2,11.8,-8792,-3.5,16.6,0,69,70,885
2012,34,a) 0,13390,13414,66471,33380,13256,197.6,0,0,66182,66182,0,198.3,198.3,0,0,0,0,0,66182,198.3,0,0,,,
2012,34,b) 1,9760,9844,81088,76550,24,0.2,2741,24.2,26586,211,26375,0.3,34.7,17509,9971,7538,13,22.9,9077,11.8,45.8,0,2059,2059,8157
2012,34,c) 2,7946,8093,65683,64504,396,4.6,1489,17.3,15168,1972,13196,3.1,23.5,12810,6837,5973,10.6,19.9,2358,3.6,39.8,0,1110,1110,5026
2012,34,d) 3,7313,7407,59325,59036,360,4.6,1157,14.9,10482,1722,8760,2.9,17.8,9904,4387,5517,7.4,16.8,578,1,33.6,0,901,901,3406
2012,34,e) 4,7617,7756,71859,73677,418,5.2,1080,13.4,12930,1936,10994,2.6,17.5,16565,4944,11621,6.7,22.5,-3635,-5,35,0,823,823,3835
2012,34,f) 5,7209,7284,65515,64578,323,4.3,917,12.1,11826,898,10928,1.4,18.3,9951,4753,5198,7.4,15.4,1875,2.9,30.8,0,680,680,3893
2012,34,g) 6 to 10,29619,30535,289801,290321,1394,4.4,3520,11.2,40405,6993,33412,2.4,13.9,41444,18312,23132,6.3,14.3,-1039,-0.4,27.8,0,2417,2423,11874
2012,34,h) 11 to 15,22333,23812,273456,275002,949,3.9,2003,8.2,33207,5572,27635,2,12.1,36299,13224,23075,4.8,13.2,-3092,-1.1,24.2,0,1332,1344,6845
2012,34,i) 16 to 20,15766,16668,205945,206881,501,2.9,1277,7.5,23112,3114,19998,1.5,11.2,24983,8380,16603,4.1,12.1,-1871,-0.9,22.4,0,835,853,6209
2012,34,j) 21 to 25,12753,14563,228709,232177,520,3.5,1100,7.4,23252,3893,19359,1.7,10,30187,8227,21960,3.5,13,-6935,-3,20,0,618,630,3905
2012,34,k) 26+,17969,23865,516500,517223,992,4.1,1540,6.4,51502,11106,40396,2.1,10,52948,14886,38062,2.9,10.2,-1446,-0.2,20,0,750,770,5049
2012,34,l) Left Censored,16540,39127,1474742,1475990,2107,5.4,2352,6,156642,30460,126182,2.1,10.6,159138,41088,118050,2.8,10.8,-2496,-0.2,21.2,0,549,560,5043
2012,35,a) 0,2275,2300,13854,6966,2267,197.1,0,0,13776,13776,0,197.8,197.8,0,0,0,0,0,13776,197.8,0,0,,,
2012,35,b) 1,1616,1640,12078,12391,11,0.6,505,26.6,2879,100,2779,0.8,23.2,3505,1973,1532,15.9,28.3,-626,-5.1,46.4,0,388,388,1588
2012,35,c) 2,1306,1333,10394,10461,52,3.6,267,18.6,2253,398,1855,3.8,21.5,2387,1388,999,13.3,22.8,-134,-1.3,43,0,194,200,1045
2012,35,d) 3,1380,1400,10713,11047,46,3.1,218,14.7,1704,285,1419,2.6,15.4,2372,1368,1004,12.4,21.5,-668,-6.1,30.8,0,162,164,936
2012,35,e) 4,1444,1513,13731,13468,77,4.9,183,11.7,2748,757,1991,5.6,20.4,2221,928,1293,6.9,16.5,527,3.9,33,0,139,139,690
2012,35,f) 5,1382,1392,21436,21657,65,4.5,175,12.1,1483,335,1148,1.5,6.8,1924,679,1245,3.1,8.9,-441,-2.1,13.6,0,121,121,456
2012,35,g) 6 to 10,5507,5829,55377,55852,276,4.6,660,11,7959,1482,6477,2.7,14.3,8909,3505,5404,6.3,16,-950,-1.7,28.6,0,456,464,2093
2012,35,h) 11 to 15,4113,4445,53331,54929,151,3.3,392,8.6,5129,881,4248,1.6,9.3,8324,1672,6652,3,15.2,-3195,-5.9,18.6,0,257,257,1039
2012,35,i) 16 to 20,2985,3293,37481,37790,128,3.8,227,6.8,4175,929,3246,2.5,11,4792,1106,3686,2.9,12.7,-617,-1.7,22,0,146,147,695
2012,35,j) 21 to 25,2315,2862,55055,55735,89,3,216,7.4,5913,702,5211,1.3,10.6,7272,2065,5207,3.7,13,-1359,-2.4,21.2,0,106,106,978
2012,35,k) 26+,3712,5403,93035,93799,212,3.9,329,6,9455,2242,7213,2.4,10.1,10982,2808,8174,3,11.7,-1527,-1.6,20.2,0,161,163,953
2012,35,l) Left Censored,3148,8366,217518,218678,447,5.3,464,5.5,23491,5921,17570,2.7,10.7,25810,7584,18226,3.5,11.8,-2319,-1.1,21.4,0,72,113,625
2012,36,a) 0,34684,34779,166034,83570,34398,197.8,0,0,164928,164928,0,197.4,197.4,0,0,0,0,0,164928,197.4,0,0,,,
2012,36,b) 1,26912,27203,173208,172682,70,0.2,7268,23.4,45995,1262,44733,0.7,26.6,44942,25953,18989,15,26,1053,0.6,52,0,5419,5419,20247
2012,36,c) 2,22824,23302,164530,164741,1130,4.6,4197,16.9,32936,4364,28572,2.6,20,33358,18449,14909,11.2,20.2,-422,-0.2,40,0,3178,3180,14967
2012,36,d) 3,19992,20214,151161,150643,879,4.1,3210,15,26094,4047,22047,2.7,17.3,25057,13686,11371,9.1,16.6,1037,0.7,33.2,0,2396,2396,10724
2012,36,e) 4,19085,19582,152581,150615,957,4.7,2773,13.5,30245,4653,25592,3.1,20.1,26312,12735,13577,8.5,17.5,3933,2.6,35,0,2018,2025,9594
2012,36,f) 5,16965,17081,128881,129115,806,4.5,2301,12.9,19896,3626,16270,2.8,15.4,20363,10072,10291,7.8,15.8,-467,-0.4,30.8,0,1704,1704,7912
2012,36,g) 6 to 10,68058,70516,664499,667228,2927,4,7654,10.5,90750,13427,77323,2,13.6,96207,39796,56411,6,14.4,-5457,-0.8,27.2,0,5292,5308,27440
2012,36,h) 11 to 15,47170,50325,600698,597400,1863,3.6,4318,8.4,77369,10143,67226,1.7,13,70773,26064,44709,4.4,11.8,6596,1.2,23.6,0,2797,2814,15958
2012,36,i) 16 to 20,32551,34496,430589,431571,1135,3.2,2521,7.2,47980,7028,40952,1.6,11.1,49944,17313,32631,4,11.6,-1964,-0.5,22.2,0,1669,1683,10359
2012,36,j) 21 to 25,28330,32033,548954,545793,1113,3.4,2103,6.5,55458,9258,46200,1.7,10.2,49136,13167,35969,2.4,9,6322,1.2,18,0,1306,1333,7721
2012,36,k) 26+,38379,52247,1093237,1093619,1658,3.1,3104,5.9,112348,20495,91853,1.9,10.3,113112,25703,87409,2.4,10.3,-764,0,20.6,0,1591,1631,10344
2012,36,l) Left Censored,36715,84218,3263075,3254537,4111,4.9,4422,5.2,310334,68358,241976,2.1,9.5,293259,67704,225555,2.1,9,17075,0.5,18,0,1234,1303,13431
2012,37,a) 0,11285,11342,61689,31098,11173,197,0,0,61183,61183,0,196.7,196.7,0,0,0,0,0,61183,196.7,0,0,,,
2012,37,b) 1,8657,8779,61497,64323,50,0.5,2387,23.8,14802,548,14254,0.9,23,20454,12563,7891,19.5,31.8,-5652,-8.8,46,0,1794,1794,10636
2012,37,c) 2,7438,7628,67208,66547,287,3.5,1328,16.3,14432,1809,12623,2.7,21.7,13109,6710,6399,10.1,19.7,1323,2,39.4,0,1054,1055,5587
2012,37,d) 3,6614,6846,55534,54174,343,4.8,1015,14.2,12077,3114,8963,5.7,22.3,9357,4811,4546,8.9,17.3,2720,5,34.6,0,761,761,3469
2012,37,e) 4,7142,7560,61911,61541,392,5,1059,13.5,12323,2293,10030,3.7,20,11583,5560,6023,9,18.8,740,1.2,37.6,0,782,783,3322
2012,37,f) 5,6787,6908,49354,50162,327,4.6,934,13,7870,1594,6276,3.2,15.7,9486,4599,4887,9.2,18.9,-1616,-3.2,31.4,0,697,697,3270
2012,37,g) 6 to 10,27036,28598,281993,283605,1183,4,3137,10.6,41908,8938,32970,3.2,14.8,45131,18412,26719,6.5,15.9,-3223,-1.1,29.6,0,2099,2112,11435
2012,37,h) 11 to 15,19192,21334,307858,300646,819,3.8,1899,8.7,51278,6963,44315,2.3,17.1,36853,12098,24755,4,12.3,14425,4.8,24.6,0,1139,1145,6897
2012,37,i) 16 to 20,12830,14595,181464,181533,499,3.4,1064,7.2,19878,3846,16032,2.1,11,20015,7049,12966,3.9,11,-137,0,22,0,702,707,3956
2012,37,j) 21 to 25,10179,12945,240232,240606,483,3.7,917,7,26453,6082,20371,2.5,11,27200,8355,18845,3.5,11.3,-747,-0.3,22,0,474,488,4761
2012,37,k) 26+,15999,24591,516984,518162,1027,4.1,1431,5.8,53044,12183,40861,2.4,10.2,55399,14130,41269,2.7,10.7,-2355,-0.5,20.4,0,642,663,5178
2012,37,l) Left Censored,13267,43933,1486956,1473965,2723,6.2,2403,5.5,161520,33465,128055,2.3,11,135537,30011,105526,2,9.2,25983,1.8,18.4,0,390,411,5134
2012,38,a) 0,1571,1585,9680,4871,1555,196.2,0,0,9619,9619,0,197.5,197.5,0,0,0,0,0,9619,197.5,0,0,,,
2012,38,b) 1,935,956,6124,6345,13,1.2,250,23.2,1878,98,1780,1.5,29.6,2319,1714,605,27,36.5,-441,-6.9,59.2,0,180,180,1456
2012,38,c) 2,683,707,5882,5289,39,5.3,106,14.3,2070,722,1348,13.7,39.1,883,492,391,9.3,16.7,1187,22.4,33.4,0,78,78,401
2012,38,d) 3,701,716,5932,5614,37,5,83,11.3,1419,229,1190,4.1,25.3,783,352,431,6.3,13.9,636,11.4,27.8,0,65,65,217
2012,38,e) 4,686,705,6106,5995,37,5.1,87,11.9,1258,348,910,5.8,21,1036,468,568,7.8,17.3,222,3.7,34.6,0,71,72,314
2012,38,f) 5,638,649,5971,5822,35,5.3,80,12,1428,432,996,7.4,24.5,1129,719,410,12.3,19.4,299,5.1,38.8,0,60,60,650
2012,38,g) 6 to 10,2583,2734,25275,24688,126,4.6,213,7.7,4329,967,3362,3.9,17.5,3155,1154,2001,4.7,12.8,1174,4.7,25.6,0,145,147,827
2012,38,h) 11 to 15,1788,1966,21593,20987,61,3.1,140,7,3560,321,3239,1.5,17,2348,1004,1344,4.8,11.2,1212,5.8,22.4,0,85,85,455
2012,38,i) 16 to 20,1428,1498,17840,17365,45,3,105,6.9,2607,583,2024,3.4,15,1658,509,1149,2.9,9.5,949,5.5,19,0,71,72,370
2012,38,j) 21 to 25,1210,1348,19127,18716,50,3.7,76,5.6,2607,400,2207,2.1,13.9,1784,525,1259,2.8,9.5,823,4.4,19,0,44,44,326
2012,38,k) 26+,2183,2960,50263,49135,132,4.4,170,5.7,7508,1778,5730,3.6,15.3,5252,1928,3324,3.9,10.7,2256,4.6,21.4,0,88,91,1137
2012,38,l) Left Censored,2381,4859,150418,147117,256,5.3,203,4.2,18258,3477,14781,2.4,12.4,11656,2021,9635,1.4,7.9,6602,4.5,15.8,0,57,60,393
2012,39,a) 0,10396,10494,70858,35820,10381,197.8,0,0,70076,70076,0,195.6,195.6,0,0,0,0,0,70076,195.6,0,0,,,
2012,39,b) 1,7744,7908,63502,65237,40,0.4,2129,23.6,16021,922,15099,1.4,24.6,19490,11205,8285,17.2,29.9,-3469,-5.3,49.2,0,1610,1614,8883
2012,39,c) 2,6469,6831,73047,70926,292,4.1,1093,15.2,15025,2733,12292,3.9,21.2,10783,5985,4798,8.4,15.2,4242,6,30.4,0,875,875,4924
2012,39,d) 3,6137,6352,59998,60823,301,4.5,911,13.7,12035,1760,10275,2.9,19.8,13684,8342,5342,13.7,22.5,-1649,-2.7,39.6,0,690,690,6608
2012,39,e) 4,6504,6849,69131,66990,315,4.4,838,11.8,14430,2286,12144,3.4,21.5,10149,5187,4962,7.7,15.2,4281,6.3,30.4,0,618,618,3966
2012,39,f) 5,5929,6064,57301,57754,251,4,717,11.4,9957,1151,8806,2,17.2,10863,5500,5363,9.5,18.8,-906,-1.6,34.4,0,535,539,4562
2012,39,g) 6 to 10,26899,28680,323449,322220,1118,3.8,2846,9.7,51841,10968,40873,3.4,16.1,49383,22334,27049,6.9,15.3,2458,0.8,30.6,0,1908,1920,14158
2012,39,h) 11 to 15,20898,23431,288818,286348,918,3.8,1901,8,39916,7551,32365,2.6,13.9,34976,12884,22092,4.5,12.2,4940,1.7,24.4,0,1180,1192,8256
2012,39,i) 16 to 20,17018,19389,264580,260829,675,3.4,1297,6.6,34994,5412,29582,2.1,13.4,27492,9602,17890,3.7,10.5,7502,2.9,21,0,833,835,5607
2012,39,j) 21 to 25,14083,17640,305407,301583,664,3.7,1189,6.7,42467,9318,33149,3.1,14.1,34819,10061,24758,3.3,11.5,7648,2.6,23,0,645,663,5613
2012,39,k) 26+,21960,33425,709252,707385,1396,4.1,2051,6.1,77874,18151,59723,2.6,11,74139,21679,52460,3.1,10.5,3735,0.5,21,0,830,868,6175
2012,39,l) Left Censored,23453,62078,2225793,2211730,3120,5,3457,5.6,237495,41151,196344,1.9,10.7,209369,50497,158872,2.3,9.5,28126,1.2,19,0,761,794,9865
2012,40,a) 0,4915,4944,27571,13858,4881,197.5,0,0,27426,27426,0,197.9,197.9,0,0,0,0,0,27426,197.9,0,0,,,
2012,40,b) 1,3608,3693,27024,26592,22,0.5,929,22.2,8563,335,8228,1.3,32.2,7699,4753,2946,17.9,29,864,3.2,58,0,680,680,3949
2012,40,c) 2,2985,3072,27794,26990,131,4,541,16.6,6542,1118,5424,4.1,24.2,4933,2614,2319,9.7,18.3,1609,5.9,36.6,0,416,416,2111
2012,40,d) 3,3015,3128,25955,25607,155,4.8,407,12.6,5228,866,4362,3.4,20.4,4533,2126,2407,8.3,17.7,695,2.7,35.4,0,305,305,1759
2012,40,e) 4,3059,3167,27589,27231,152,4.6,409,12.5,5129,871,4258,3.2,18.8,4413,2236,2177,8.2,16.2,716,2.6,32.4,0,302,302,1516
2012,40,f) 5,2827,2910,27797,27763,142,4.7,369,12.3,4991,1199,3792,4.3,18,4923,1926,2997,6.9,17.7,68,0.3,35.4,0,281,281,1530
2012,40,g) 6 to 10,11190,11843,118713,118834,425,3.5,1174,9.6,17745,2823,14922,2.4,14.9,17987,7113,10874,6,15.1,-242,-0.2,29.8,0,814,817,4461
2012,40,h) 11 to 15,8016,9073,101037,101862,312,3.4,697,7.5,13135,2323,10812,2.3,12.9,14784,4774,10010,4.7,14.5,-1649,-1.6,25.8,0,453,454,2862
2012,40,i) 16 to 20,5858,6360,68252,68301,184,2.8,469,7.2,8310,1484,6826,2.2,12.2,8408,2523,5885,3.7,12.3,-98,-0.1,24.4,0,306,308,1559
2012,40,j) 21 to 25,4306,5396,104374,103464,199,3.7,330,6.1,12476,3085,9391,3,12.1,10655,3810,6845,3.7,10.3,1821,1.8,20.6,0,186,193,1260
2012,40,k) 26+,8080,11661,228717,228963,464,3.9,690,5.9,24439,5577,18862,2.4,10.7,24930,6479,18451,2.8,10.9,-491,-0.2,21.4,0,317,330,2568
2012,40,l) Left Censored,6403,17348,500620,496699,904,5.2,853,4.9,56009,16290,39719,3.3,11.3,48166,10173,37993,2,9.7,7843,1.6,19.4,0,186,198,1471
2012,41,a) 0,5909,5931,28600,14403,5863,197.7,0,0,28394,28394,0,197.1,197.1,0,0,0,0,0,28394,197.1,0,0,,,
2012,41,b) 1,4491,4579,24521,25138,21,0.4,1254,23.9,5792,259,5533,1,23,7026,4202,2824,16.7,27.9,-1234,-4.9,46,0,907,907,3289
2012,41,c) 2,3709,3823,25763,25514,206,5.1,698,17.2,5701,847,4854,3.3,22.3,5203,2876,2327,11.3,20.4,498,1.9,40.8,0,502,502,2056
2012,41,d) 3,3541,3609,23055,22808,196,5.2,539,14.3,4959,788,4171,3.5,21.7,4465,2453,2012,10.8,19.6,494,2.1,39.2,0,404,404,1832
2012,41,e) 4,3847,4011,26051,25552,229,5.5,525,12.7,5517,1243,4274,4.9,21.6,4518,2391,2127,9.4,17.7,999,3.9,35.4,0,371,371,1791
2012,41,f) 5,3554,3627,24508,24698,200,5.3,505,13.4,4116,769,3347,3.1,16.7,4495,2126,2369,8.6,18.2,-379,-1.5,33.4,0,336,337,1542
2012,41,g) 6 to 10,14400,15264,123831,125080,758,4.8,1823,11.6,18553,3167,15386,2.5,14.8,21051,9069,11982,7.3,16.8,-2498,-2,29.6,0,1010,1018,4647
2012,41,h) 11 to 15,10171,11072,108237,109059,514,4.5,1086,9.6,13784,3282,10502,3,12.6,15428,5845,9583,5.4,14.1,-1644,-1.5,25.2,0,602,609,3620
2012,41,i) 16 to 20,7322,8024,86149,86775,342,4.2,712,8.7,11315,2806,8509,3.2,13,12567,4633,7934,5.3,14.5,-1252,-1.5,26,0,403,406,3006
2012,41,j) 21 to 25,5320,6438,93651,93174,243,3.7,492,7.5,11484,1945,9539,2.1,12.3,10529,3288,7241,3.5,11.3,955,1,22.6,0,254,262,1373
2012,41,k) 26+,7884,11517,237287,237015,459,3.9,768,6.6,26247,5807,20440,2.5,11.1,25703,5541,20162,2.3,10.8,544,0.3,21.6,0,345,351,2184
2012,41,l) Left Censored,6628,17930,563312,559696,1004,5.6,891,5,56452,12842,43610,2.3,10.1,49220,10361,38859,1.9,8.8,7232,1.3,17.6,0,150,159,1191
2012,42,a) 0,12990,13052,77314,38864,12924,198,0,0,76900,76900,0,197.9,197.9,0,0,0,0,0,76900,197.9,0,0,,,
2012,42,b) 1,10097,10282,75838,76340,51,0.4,2479,21.4,18817,748,18069,1,24.6,19821,11739,8082,15.4,26,-1004,-1.4,49.2,0,1852,1852,8809
2012,42,c) 2,8263,8681,74927,74456,336,3.7,1356,14.8,14938,2300,12638,3.1,20.1,13995,7758,6237,10.4,18.8,943,1.3,37.6,0,1055,1056,5929
2012,42,d) 3,8177,8366,68177,69006,372,4.3,1062,12.2,12055,1749,10306,2.5,17.5,13712,8056,5656,11.7,19.9,-1657,-2.4,35,0,822,822,6907
2012,42,e) 4,8476,8840,72640,71017,435,4.8,1019,11.2,14191,2231,11960,3.1,20,10945,5112,5833,7.2,15.4,3246,4.6,30.8,0,753,753,3721
2012,42,f) 5,7868,8020,69250,69414,288,3.5,907,10.9,10351,1373,8978,2,14.9,10679,4333,6346,6.2,15.4,-328,-0.5,29.8,0,675,676,3348
2012,42,g) 6 to 10,34833,36635,381175,382384,1301,3.5,3455,9.2,49631,8678,40953,2.3,13,52048,20138,31910,5.3,13.6,-2417,-0.6,26,0,2340,2363,12854
2012,42,h) 11 to 15,26575,29379,359608,361341,1043,3.5,2261,7.6,47461,10996,36465,3,13.1,50927,21215,29712,5.9,14.1,-3466,-1,26.2,0,1410,1431,12900
2012,42,i) 16 to 20,19452,21494,300158,298812,697,3.2,1322,6.1,33324,5910,27414,2,11.2,30631,8174,22457,2.7,10.3,2693,0.9,20.6,0,870,876,4811
2012,42,j) 21 to 25,17745,20919,331674,329516,684,3.2,1353,6.4,41289,9037,32252,2.7,12.5,36973,11106,25867,3.4,11.2,4316,1.3,22.4,0,815,824,5571
2012,42,k) 26+,25744,37996,865044,856761,1600,4.2,2287,6,104269,26439,77830,3.1,12.2,87702,23707,63995,2.8,10.2,16567,2,20.4,0,1013,1040,7398
2012,42,l) Left Censored,26049,68087,2443913,2431964,3072,4.5,3618,5.3,246637,55360,191277,2.3,10.1,222739,48501,174238,2,9.2,23898,0.9,18.4,0,701,740,7169
2012,44,a) 0,1324,1325,6738,3385,1315,198.5,0,0,6707,6707,0,198.1,198.1,0,0,0,0,0,6707,198.1,0,0,,,
2012,44,b) 1,962,976,6834,7012,4,0.4,272,24.3,1964,128,1836,1.8,28,2319,1173,1146,16.7,33.1,-355,-5.1,56,0,202,202,941
2012,44,c) 2,826,850,6359,6279,57,6.4,146,16.3,1449,289,1160,4.6,23.1,1289,709,580,11.3,20.5,160,2.6,41,0,109,109,525
2012,44,d) 3,697,708,5001,4993,34,4.5,119,15.9,1086,279,807,5.6,21.8,1069,554,515,11.1,21.4,17,0.4,42.8,0,77,77,305
2012,44,e) 4,807,826,7008,7002,46,5.3,113,13.1,1073,153,920,2.2,15.3,1061,595,466,8.5,15.2,12,0.1,30.4,0,77,77,497
2012,44,f) 5,792,800,7667,7525,40,4.8,105,12.6,1627,407,1220,5.4,21.6,1343,646,697,8.6,17.8,284,3.8,35.6,0,76,76,522
2012,44,g) 6 to 10,3566,3737,32793,32605,193,5,395,10.3,4920,865,4055,2.7,15.1,4543,1705,2838,5.2,13.9,377,1.2,27.8,0,261,261,1118
2012,44,h) 11 to 15,2605,2866,26346,26556,132,4.5,254,8.7,3107,427,2680,1.6,11.7,3527,1574,1953,5.9,13.3,-420,-1.6,23.4,0,154,154,974
2012,44,i) 16 to 20,1980,2074,23695,23656,84,4,173,8.2,2679,752,1927,3.2,11.3,2601,1064,1537,4.5,11,78,0.3,22,0,100,100,420
2012,44,j) 21 to 25,1823,2024,30397,30466,71,3.4,147,7.1,3645,393,3252,1.3,12,3783,1403,2380,4.6,12.4,-138,-0.4,24,0,66,71,425
2012,44,k) 26+,2602,3242,57156,57229,113,3.4,192,5.9,5858,1067,4791,1.9,10.2,6004,1251,4753,2.2,10.5,-146,-0.3,20.4,0,95,97,528
2012,44,l) Left Censored,3084,5484,197449,198816,274,5,323,5.9,16630,4959,11671,2.5,8.4,19363,3276,16087,1.6,9.7,-2733,-1.3,16.8,0,82,87,506
2012,45,a) 0,5031,5070,28589,14433,4987,196.7,0,0,28312,28312,0,196.2,196.2,0,0,0,0,0,28312,196.2,0,0,,,
2012,45,b) 1,3830,3915,29384,29733,17,0.4,1035,23.2,7629,256,7373,0.9,25.7,8327,4330,3997,14.6,28,-698,-2.3,51.4,0,798,798,3580
2012,45,c) 2,3305,3387,25202,25198,146,4.1,604,16.8,5183,556,4627,2.2,20.6,5174,2494,2680,9.9,20.5,9,0.1,41,0,482,483,2108
2012,45,d) 3,3102,3255,31293,31815,144,4.2,468,13.7,4785,843,3942,2.6,15,5829,2494,3335,7.8,18.3,-1044,-3.3,30,0,361,361,1643
2012,45,e) 4,3188,3336,24920,24648,151,4.4,429,12.4,4684,698,3986,2.8,19,4139,1855,2284,7.5,16.8,545,2.2,33.6,0,306,308,1418
2012,45,f) 5,3088,3169,27475,27399,161,4.9,431,13.1,4478,714,3764,2.6,16.3,4325,1932,2393,7.1,15.8,153,0.5,31.6,0,325,329,1603
2012,45,g) 6 to 10,12669,13294,131889,133044,517,3.8,1464,10.7,16981,2945,14036,2.2,12.8,19290,7735,11555,5.8,14.5,-2309,-1.7,25.6,0,937,942,5227
2012,45,h) 11 to 15,9228,10165,139467,138413,363,3.5,875,8.4,18615,5498,13117,4,13.4,16506,5688,10818,4.1,11.9,2109,1.5,23.8,0,564,578,3649
2012,45,i) 16 to 20,6163,6849,94808,93410,237,3.4,532,7.6,13052,2119,10933,2.3,14,10255,3184,7071,3.4,11,2797,3,22,0,318,322,1567
2012,45,j) 21 to 25,4832,6287,109955,110090,216,3.4,443,6.9,12296,2030,10266,1.8,11.2,12565,4532,8033,4.1,11.4,-269,-0.2,22.4,0,251,259,1726
2012,45,k) 26+,7568,11800,226941,226997,465,3.9,665,5.6,25159,4859,20300,2.1,11.1,25271,5364,19907,2.4,11.1,-112,0,22.2,0,320,334,1725
2012,45,l) Left Censored,6777,21158,661404,660267,1025,4.9,992,4.7,69434,15427,54007,2.3,10.5,67160,15024,52136,2.3,10.2,2274,0.3,20.4,0,153,155,2295
2012,46,a) 0,1272,1273,7019,3525,1256,197.3,0,0,6989,,,,198.3,0,0,0,0,0,6989,198.3,0,1,,,
2012,46,b) 1,882,896,7141,6736,3,0.3,238,23.3,2208,,,,32.8,1397,886,511,13.2,20.7,811,12.1,41.4,1,171,171,734
2012,46,c) 2,783,824,5831,5944,28,3.2,157,17.8,818,53,765,0.9,13.8,1043,557,486,9.4,17.5,-225,-3.7,27.6,0,110,110,374
2012,46,d) 3,832,843,6340,6129,37,4.2,115,13.1,1242,267,975,4.4,20.3,819,358,461,5.8,13.4,423,6.9,26.8,0,87,87,264
2012,46,e) 4,826,854,5851,5740,40,4.6,91,10.4,1075,172,903,3,18.7,853,324,529,5.6,14.9,222,3.8,29.8,0,65,65,232
2012,46,f) 5,833,856,6031,5921,40,4.6,86,9.8,1093,387,706,6.5,18.5,872,335,537,5.7,14.7,221,3.8,29.4,0,61,61,239
2012,46,g) 6 to 10,3308,3435,27665,27850,142,4,325,9.3,3832,590,3242,2.1,13.8,4202,1755,2447,6.3,15.1,-370,-1.3,27.6,0,225,225,1320
2012,46,h) 11 to 15,2495,2659,26335,26223,116,4.3,212,7.9,3197,732,2465,2.8,12.2,2973,986,1987,3.8,11.3,224,0.9,22.6,0,127,128,591
2012,46,i) 16 to 20,1815,1921,21006,21004,72,3.7,126,6.5,2484,676,1808,3.2,11.8,2479,608,1871,2.9,11.8,5,0,23.6,0,81,81,307
2012,46,j) 21 to 25,1293,1471,22810,22667,49,3.3,102,6.8,2653,381,2272,1.7,11.7,2367,899,1468,4,10.4,286,1.3,20.8,0,57,57,268
2012,46,k) 26+,2174,3030,40490,39950,170,5.6,162,5.4,5321,1130,4191,2.8,13.3,4241,1183,3058,3,10.6,1080,2.7,21.2,0,83,86,466
2012,46,l) Left Censored,2481,5057,154061,152594,211,4.2,231,4.6,14399,4235,10164,2.8,9.4,11464,2409,9055,1.6,7.5,2935,1.9,15,0,58,63,595
2012,47,a) 0,6403,6451,42826,21663,6365,197.3,0,0,42326,42326,0,195.4,195.4,0,0,0,0,0,42326,195.4,0,0,,,
2012,47,b) 1,4834,4900,39122,39259,37,0.7,1406,25,11699,776,10923,2,29.8,11973,6714,5259,17.1,30.5,-274,-0.7,59.6,0,1133,1133,4929
2012,47,c) 2,4048,4233,43226,40454,168,3.7,773,17.1,13689,1438,12251,3.6,33.8,8144,4696,3448,11.6,20.1,5545,13.7,40.2,0,612,612,3547
2012,47,d) 3,3595,3802,36226,36467,144,3.6,564,14.1,6575,833,5742,2.3,18,7056,3420,3636,9.4,19.3,-481,-1.3,36,0,446,446,2308
2012,47,e) 4,3912,4264,37452,37045,174,3.9,621,13.9,8072,1381,6691,3.7,21.8,7258,4407,2851,11.9,19.6,814,2.2,39.2,0,470,470,3707
2012,47,f) 5,3596,3734,31138,31418,158,4,528,13.5,5485,891,4594,2.8,17.5,6045,3056,2989,9.7,19.2,-560,-1.7,35,0,391,391,2444
2012,47,g) 6 to 10,14665,15846,174433,175808,605,3.7,1760,10.7,25917,4663,21254,2.7,14.7,28667,13079,15588,7.4,16.3,-2750,-1.6,29.4,0,1200,1207,8792
2012,47,h) 11 to 15,10557,12045,161419,161475,442,3.6,1077,8.7,21321,4384,16937,2.7,13.2,21434,8027,13407,5,13.3,-113,-0.1,26.4,0,663,671,4802
2012,47,i) 16 to 20,8150,9493,125608,126181,375,3.9,744,7.7,15041,4344,10697,3.4,11.9,16186,5376,10810,4.3,12.8,-1145,-0.9,23.8,0,488,496,3048
2012,47,j) 21 to 25,6643,8787,179744,179143,343,3.9,590,6.6,18252,4203,14049,2.3,10.2,17049,5171,11878,2.9,9.5,1203,0.7,19,0,348,352,1898
2012,47,k) 26+,10999,17101,375256,373380,668,3.9,1011,5.9,41079,8483,32596,2.3,11,37326,8286,29040,2.2,10,3753,1,20,0,454,467,2767
2012,47,l) Left Censored,9555,29593,1092067,1085703,1570,5.3,1478,5,108190,23216,84974,2.1,10,95461,22925,72536,2.1,8.8,12729,1.2,17.6,0,279,287,1555
2012,48,a) 0,33811,34143,218127,110004,33777,197.9,0,0,216247,216247,0,196.6,196.6,0,0,0,0,0,216247,196.6,0,0,,,
2012,48,b) 1,24980,25643,214777,214043,218,0.7,6772,23.2,62996,4572,58424,2.1,29.4,61527,37113,24414,17.3,28.7,1469,0.7,57.4,0,5376,5388,30040
2012,48,c) 2,20167,20922,217454,215315,863,3.9,3725,16.7,48088,6415,41673,3,22.3,43809,21010,22799,9.8,20.3,4279,2,40.6,0,2922,2922,16552
2012,48,d) 3,18484,19219,193843,189106,796,3.9,2836,14,44118,4192,39926,2.2,23.3,34644,17810,16834,9.4,18.3,9474,5,36.6,0,2224,2226,14406
2012,48,e) 4,18579,19494,196554,193767,811,4,2506,12.4,40442,6453,33989,3.3,20.9,34868,16775,18093,8.7,18,5574,2.9,36,0,1919,1923,12626
2012,48,f) 5,16853,17298,173482,172548,617,3.4,2139,11.9,31662,4968,26694,2.9,18.3,29794,13992,15802,8.1,17.3,1868,1,34.6,0,1575,1585,9922
2012,48,g) 6 to 10,65530,70963,902454,896788,2581,3.5,7407,10.1,144280,25158,119122,2.8,16.1,132948,53677,79271,6,14.8,11332,1.3,29.6,0,5008,5057,35780
2012,48,h) 11 to 15,43781,49660,782109,782851,1809,3.6,4165,8.2,103140,16188,86952,2.1,13.2,104624,38498,66126,4.9,13.4,-1484,-0.2,26.4,0,2697,2734,18772
2012,48,i) 16 to 20,31299,36343,554340,554577,1246,3.4,2806,7.6,71869,12710,59159,2.3,13,72342,26562,45780,4.8,13,-473,0,26,0,1787,1808,12674
2012,48,j) 21 to 25,23110,30671,632772,629057,1271,4.1,2132,6.9,81520,16036,65484,2.5,13,74089,23535,50554,3.7,11.8,7431,1.2,23.6,0,1098,1139,8069
2012,48,k) 26+,36420,60384,1295345,1279579,3087,5.1,3549,5.9,171393,45108,126285,3.5,13.4,139860,33742,106118,2.6,10.9,31533,2.5,21.8,0,1460,1573,10687
2012,48,l) Left Censored,24012,100805,3836475,3794490,6769,6.8,5478,5.5,459384,135400,323984,3.6,12.1,375414,87764,287650,2.3,9.9,83970,2.2,19.8,0,711,782,9775
2012,49,a) 0,4811,4860,30604,15399,4786,197,0,0,30411,30411,0,197.5,197.5,0,0,0,0,0,30411,197.5,0,0,,,
2012,49,b) 1,3390,3466,25385,25824,20,0.5,1107,27.3,6605,235,6370,0.9,25.6,7482,4950,2532,19.2,29,-877,-3.4,51.2,0,848,849,3812
2012,49,c) 2,2927,3014,23319,23892,144,4.4,610,18.8,4566,513,4053,2.1,19.1,5712,3398,2314,14.2,23.9,-1146,-4.8,38.2,0,452,452,2754
2012,49,d) 3,2575,2637,20541,20476,131,4.7,427,15.4,4614,488,4126,2.4,22.5,4484,2213,2271,10.8,21.9,130,0.6,43.8,0,311,311,1842
2012,49,e) 4,2802,2918,21426,20930,181,6,414,13.7,4780,696,4084,3.3,22.8,3788,1751,2037,8.4,18.1,992,4.7,36.2,0,292,292,1277
2012,49,f) 5,2659,2687,22084,22736,138,4.9,424,15,3361,436,2925,1.9,14.8,4664,2525,2139,11.1,20.5,-1303,-5.7,29.6,0,279,282,1463
2012,49,g) 6 to 10,10220,10633,116519,116958,575,5.3,1253,11.5,17998,3731,14267,3.2,15.4,18876,8831,10045,7.6,16.1,-878,-0.7,30.8,0,764,780,5930
2012,49,h) 11 to 15,6300,6848,94226,95578,324,4.6,594,8.5,11546,2311,9235,2.4,12.1,14249,6620,7629,6.9,14.9,-2703,-2.8,24.2,0,337,341,5118
2012,49,i) 16 to 20,3873,4303,67618,67754,209,4.8,349,8,8307,1046,7261,1.5,12.3,8578,2599,5979,3.8,12.7,-271,-0.4,24.6,0,206,213,1683
2012,49,j) 21 to 25,2526,3149,82106,79604,131,4.1,192,6,12688,2530,10158,3.2,15.9,7683,1253,6430,1.6,9.7,5005,6.2,19.4,0,81,82,360
2012,49,k) 26+,3627,5569,145230,141087,277,4.9,368,6.6,22639,7031,15608,5,16,14353,3240,11113,2.3,10.2,8286,5.8,20.4,0,149,157,1349
2012,49,l) Left Censored,3384,10275,409680,407100,580,5.7,502,4.9,41482,8766,32716,2.2,10.2,36321,6208,30113,1.5,8.9,5161,1.3,17.8,0,77,88,958
2012,50,a) 0,981,991,4141,2089,979,197.6,0,0,4104,4104,0,196.5,196.5,0,0,0,0,0,4104,196.5,0,0,,,
2012,50,b) 1,715,718,4196,4458,5,0.6,176,21.8,968,97,871,2.2,21.7,1491,776,715,17.4,33.4,-523,-11.7,43.4,0,128,128,619
2012,50,c) 2,573,578,3502,3539,30,4.9,98,16.1,582,89,493,2.5,16.4,656,358,298,10.1,18.5,-74,-2.1,32.8,0,70,70,279
2012,50,d) 3,569,578,11738,9103,30,5,67,11.3,6019,83,5936,0.9,66.1,748,374,374,4.1,8.2,5271,57.9,16.4,0,47,47,238
2012,50,e) 4,585,606,3963,4044,31,4.9,93,14.7,786,87,699,2.2,19.4,947,630,317,15.6,23.4,-161,-4,38.8,0,64,66,547
2012,50,f) 5,622,632,7256,7280,31,4.7,76,11.6,718,138,580,1.9,9.9,765,293,472,4,10.5,-47,-0.6,19.8,0,55,57,189
2012,50,g) 6 to 10,2609,2673,19021,19343,120,4.4,283,10.3,2444,434,2010,2.2,12.6,3087,1284,1803,6.6,16,-643,-3.4,25.2,0,174,174,857
2012,50,h) 11 to 15,2173,2289,24865,24785,84,3.6,209,8.9,2706,273,2433,1.1,10.9,2545,1014,1531,4.1,10.3,161,0.6,20.6,0,125,125,517
2012,50,i) 16 to 20,1641,1755,15507,15873,60,3.4,118,6.6,1580,171,1409,1.1,10,2311,751,1560,4.7,14.6,-731,-4.6,20,0,74,74,444
2012,50,j) 21 to 25,1523,1629,17621,20835,71,4.3,128,7.7,1842,464,1378,2.2,8.8,8270,833,7437,4,39.7,-6428,-30.9,17.6,0,70,70,489
2012,50,k) 26+,2076,2696,50604,49883,128,4.7,179,6.6,5917,1234,4683,2.5,11.9,4474,1344,3130,2.7,9,1443,2.9,18,0,92,93,522
2012,50,l) Left Censored,1872,3642,102931,102227,179,4.9,182,5,9654,2418,7236,2.4,9.4,8246,1889,6357,1.8,8.1,1408,1.3,16.2,0,53,58,509
2012,51,a) 0,9854,9913,54236,27279,9787,197.5,0,0,53915,53915,0,197.6,197.6,0,0,0,0,0,53915,197.6,0,0,,,
2012,51,b) 1,7513,7626,51827,52164,49,0.6,2016,23.2,14649,633,14016,1.2,28.1,15323,8149,7174,15.6,29.4,-674,-1.3,56.2,0,1516,1516,6548
2012,51,c) 2,6157,6396,53961,52447,282,4.2,1057,15.6,12406,2395,10011,4.6,23.7,9378,4480,4898,8.5,17.9,3028,5.8,35.8,0,784,787,3571
2012,51,d) 3,6088,6235,48030,48253,283,4.3,920,14.1,9091,1770,7321,3.7,18.8,9537,4944,4593,10.2,19.8,-446,-1,37.6,0,683,683,3411
2012,51,e) 4,6310,6557,58176,56844,283,4.1,864,12.6,11403,1565,9838,2.8,20.1,8739,3760,4979,6.6,15.4,2664,4.7,30.8,0,649,649,2717
2012,51,f) 5,6024,6097,49438,50635,266,4.2,789,12.4,8457,1132,7325,2.2,16.7,10851,6939,3912,13.7,21.4,-2394,-4.7,33.4,0,585,585,3161
2012,51,g) 6 to 10,24347,25528,262066,261714,1007,3.8,2714,10.3,40028,5100,34928,1.9,15.3,39323,15764,23559,6,15,705,0.3,30,0,1825,1838,9048
2012,51,h) 11 to 15,16810,18771,235553,238013,721,3.8,1596,8.3,29592,5330,24262,2.2,12.4,34511,12579,21932,5.3,14.5,-4919,-2.1,24.8,0,971,985,5731
2012,51,i) 16 to 20,12324,13698,176899,179464,445,3.2,1014,7.3,18242,3249,14993,1.8,10.2,23371,7299,16072,4.1,13,-5129,-2.8,20.4,0,624,629,3625
2012,51,j) 21 to 25,9864,12355,227959,231430,464,3.7,904,7.2,25618,6438,19180,2.8,11.1,32560,8709,23851,3.8,14.1,-6942,-3,22.2,0,482,511,3498
2012,51,k) 26+,13987,21423,457643,458760,882,4.1,1301,6,48876,10836,38040,2.4,10.7,51110,11599,39511,2.5,11.1,-2234,-0.4,21.4,0,524,535,3436
2012,51,l) Left Censored,11903,39839,1367533,1352712,2375,6,2384,6,183223,41290,141933,3.1,13.5,153582,38371,115211,2.8,11.4,29641,2.1,22.8,0,308,353,4062
2012,53,a) 0,9962,10003,46156,24016,9828,196.5,0,0,44280,44280,0,184.4,184.4,0,0,0,0,0,44280,184.4,0,0,,,
2012,53,b) 1,7517,7628,47755,47063,51,0.6,2373,26.7,13848,576,13272,1.2,29.4,12463,7402,5061,15.7,26.5,1385,2.9,53,0,1721,1721,5674
2012,53,c) 2,6120,6299,40892,41010,347,5.2,1141,17.1,9169,1959,7210,4.8,22.4,9404,5044,4360,12.3,22.9,-235,-0.5,44.8,0,844,844,4068
2012,53,d) 3,5777,5878,41385,41329,309,5,942,15.2,8086,1182,6904,2.9,19.6,7973,4021,3952,9.7,19.3,113,0.3,38.6,0,701,701,2968
2012,53,e) 4,6279,6531,45915,45025,358,5.3,966,14.2,9699,1769,7930,3.9,21.5,7919,4043,3876,9,17.6,1780,3.9,35.2,0,688,688,2928
2012,53,f) 5,5916,5967,41284,42198,285,4.6,865,13.9,6047,743,5304,1.8,14.3,7874,4156,3718,9.8,18.7,-1827,-4.4,28.6,0,588,594,2937
2012,53,g) 6 to 10,23636,24902,210570,213090,1117,4.3,2882,11.2,30100,4699,25401,2.2,14.1,35139,15136,20003,7.1,16.5,-5039,-2.4,28.2,0,1779,1790,9033
2012,53,h) 11 to 15,16164,17700,191855,194054,775,4.3,1683,9.3,24291,5010,19281,2.6,12.5,28688,10340,18348,5.3,14.8,-4397,-2.3,25,0,957,967,5332
2012,53,i) 16 to 20,11502,12736,157768,155684,486,3.7,1086,8.3,23168,7811,15357,5,14.9,18999,5937,13062,3.8,12.2,4169,2.7,24.4,0,605,608,2758
2012,53,j) 21 to 25,8415,10300,179774,179271,393,3.7,798,7.6,20311,3081,17230,1.7,11.3,19305,5403,13902,3,10.8,1006,0.5,21.6,0,439,443,2339
2012,53,k) 26+,12119,18034,406003,406278,770,4.2,1261,6.9,39972,8688,31284,2.1,9.8,40521,9202,31319,2.3,10,-549,-0.2,19.6,0,527,558,3893
2012,53,l) Left Censored,9574,27957,907805,906172,1733,6.2,1609,5.8,97269,22474,74795,2.5,10.7,94004,17861,76143,2,10.4,3265,0.3,20.8,0,275,296,2977
2012,54,a) 0,1516,1523,10855,5462,1496,196.5,0,0,10787,10787,0,197.5,197.5,0,0,0,0,0,10787,197.5,0,0,,,
2012,54,b) 1,1148,1201,9286,9200,9,0.7,302,22.1,2348,103,2245,1.1,25.5,2175,1281,894,13.9,23.6,173,1.9,47.2,0,236,236,918
2012,54,c) 2,916,981,10784,10701,32,3.1,164,15.7,2064,127,1937,1.2,19.3,1897,818,1079,7.6,17.7,167,1.6,35.4,0,120,120,544
2012,54,d) 3,899,939,8431,8235,58,5.9,151,15.4,1961,424,1537,5.1,23.8,1568,808,760,9.8,19,393,4.8,38,0,118,118,638
2012,54,e) 4,944,991,7923,8117,44,4.3,129,12.6,1260,183,1077,2.3,15.5,1648,638,1010,7.9,20.3,-388,-4.8,31,0,106,106,502
2012,54,f) 5,902,911,8449,8562,42,4.4,120,12.7,1317,216,1101,2.5,15.4,1543,573,970,6.7,18,-226,-2.6,30.8,0,94,94,499
2012,54,g) 6 to 10,4313,4655,44456,44431,154,3.2,434,9.1,6212,768,5444,1.7,14,6161,2172,3989,4.9,13.9,51,0.1,27.8,0,305,305,1324
2012,54,h) 11 to 15,3187,3499,37794,37798,119,3.3,268,7.5,5244,773,4471,2,13.9,5251,1598,3653,4.2,13.9,-7,0,27.8,0,190,198,1021
2012,54,i) 16 to 20,2529,2807,31556,31806,108,3.8,214,7.5,4069,621,3448,2,12.8,4569,2121,2448,6.7,14.4,-500,-1.6,25.6,0,144,144,1522
2012,54,j) 21 to 25,2160,2531,40524,39691,83,3.2,156,6.1,5459,1290,4169,3.3,13.8,3793,936,2857,2.4,9.6,1666,4.2,19.2,0,90,92,519
2012,54,k) 26+,3747,5661,99627,99276,199,3.5,335,5.8,11423,1862,9561,1.9,11.5,10721,2732,7989,2.8,10.8,702,0.7,21.6,0,151,156,887
2012,54,l) Left Censored,3985,9597,262686,261706,416,4.3,501,5.2,25740,5548,20192,2.1,9.8,23780,6761,17019,2.6,9.1,1960,0.7,18.2,0,120,133,819
2012,55,a) 0,5623,5654,29851,15018,5585,197.6,0,0,29667,29667,0,197.5,197.5,0,0,0,0,0,29667,197.5,0,0,,,
2012,55,b) 1,4270,4417,30527,31194,38,0.8,1210,24,7651,388,7263,1.2,24.5,8984,5903,3081,18.9,28.8,-1333,-4.3,49,0,899,899,4755
2012,55,c) 2,3624,3751,33014,32211,151,3.8,658,16.5,7706,1683,6023,5.2,23.9,6100,3447,2653,10.7,18.9,1606,5,37.8,0,500,500,2350
2012,55,d) 3,3640,3729,28413,28614,168,4.3,541,13.9,4995,584,4411,2,17.5,5397,2669,2728,9.3,18.9,-402,-1.4,35,0,401,403,1902
2012,55,e) 4,3785,3982,31820,31548,199,4.8,499,12.1,6021,775,5246,2.5,19.1,5476,2947,2529,9.3,17.4,545,1.7,34.8,0,373,373,2321
2012,55,f) 5,3708,3757,31228,31651,166,4.3,459,11.8,4392,475,3917,1.5,13.9,5238,2416,2822,7.6,16.5,-846,-2.6,27.8,0,332,332,1939
2012,55,g) 6 to 10,16016,16847,170133,171730,720,4.2,1741,10.1,22881,4556,18325,2.7,13.3,26075,11456,14619,6.7,15.2,-3194,-1.9,26.6,0,1139,1153,6713
2012,55,h) 11 to 15,12803,14193,176001,176304,517,3.6,1124,7.8,20456,3792,16664,2.2,11.6,21062,6811,14251,3.9,11.9,-606,-0.3,23.2,0,662,670,3841
2012,55,i) 16 to 20,9837,10572,127382,128034,377,3.5,712,6.6,13621,2385,11236,1.9,10.6,14924,5166,9758,4,11.7,-1303,-1.1,21.2,0,431,432,2626
2012,55,j) 21 to 25,7891,9828,165525,165287,355,3.6,609,6.1,17348,2739,14609,1.7,10.5,16872,4258,12614,2.6,10.2,476,0.3,20.4,0,350,355,1856
2012,55,k) 26+,11725,17138,354270,353320,707,4.1,963,5.6,36984,8509,28475,2.4,10.5,35084,8709,26375,2.5,9.9,1900,0.6,19.8,0,428,437,2862
2012,55,l) Left Censored,12778,30755,1191946,1184845,1425,4.6,1571,5.1,106601,21882,84719,1.8,9,92399,18376,74023,1.6,7.8,14202,1.2,15.6,0,352,381,3910
2012,56,a) 0,1200,1202,4850,2453,1185,197.2,0,0,4795,4795,0,195.5,195.5,0,0,0,0,0,4795,195.5,0,0,,,
2012,56,b) 1,855,863,4832,4886,6,0.6,272,27,1304,108,1196,2.2,26.7,1412,897,515,18.4,28.9,-108,-2.2,53.4,0,198,198,687
2012,56,c) 2,720,727,4310,4280,32,4.2,116,15.1,1044,143,901,3.3,24.4,984,539,445,12.6,23,60,1.4,46,0,91,91,433
2012,56,d) 3,693,723,4464,4245,36,4.7,115,15.1,1159,70,1089,1.6,27.3,720,314,406,7.4,17,439,10.3,34,0,90,90,251
2012,56,e) 4,769,805,6141,5806,54,6.5,105,12.7,1882,532,1350,9.2,32.4,1211,787,424,13.6,20.9,671,11.5,41.8,0,74,74,376
2012,56,f) 5,743,749,5066,5175,32,4.1,106,13.5,850,159,691,3.1,16.4,1068,497,571,9.6,20.6,-218,-4.2,32.8,0,72,77,353
2012,56,g) 6 to 10,2838,2930,21530,21527,132,4.4,321,10.6,4098,1277,2821,5.9,19,4092,1690,2402,7.9,19,6,0,38,0,191,192,1023
2012,56,h) 11 to 15,2075,2162,17891,18127,78,3.6,165,7.5,2356,256,2100,1.4,13,2828,935,1893,5.2,15.6,-472,-2.6,26,0,99,100,482
2012,56,i) 16 to 20,1388,1474,12513,12653,57,3.8,108,7.2,1615,226,1389,1.8,12.8,1894,474,1420,3.7,15,-279,-2.2,25.6,0,60,61,265
2012,56,j) 21 to 25,924,1049,17541,17778,38,3.5,91,8.5,1977,286,1691,1.6,11.1,2451,775,1676,4.4,13.8,-474,-2.7,22.2,0,44,46,357
2012,56,k) 26+,1726,2254,34644,34779,94,4.1,133,5.8,4548,1426,3122,4.1,13.1,4818,2200,2618,6.3,13.9,-270,-0.8,26.2,0,65,80,574
2012,56,l) Left Censored,1540,3247,72950,71703,179,5.5,155,4.8,8897,1991,6906,2.8,12.4,6402,1732,4670,2.4,8.9,2495,3.5,17.8,0,32,34,128
2013,01,a) 0,4362,4417,30275,15198,4363,197.6,0,0,30154,,,,198.4,0,0,0,0,0,30154,198.4,0,1,,,
2013,01,b) 1,3460,3537,24389,26196,6,0.1,1034,25.5,5960,,,,22.8,9574,6193,3381,23.6,36.5,-3614,-13.7,45.6,1,812,812,5258
2013,01,c) 2,2981,3037,24908,25563,97,3,562,17.3,4427,406,4021,1.6,17.3,5736,2802,2934,11,22.4,-1309,-5.1,34.6,0,456,456,2423
2013,01,d) 3,2597,2719,26017,25771,83,2.9,423,14.7,4776,377,4399,1.5,18.5,4284,1892,2392,7.3,16.6,492,1.9,33.2,0,340,340,1549
2013,01,e) 4,2602,2826,24263,24103,79,2.7,366,12.4,4311,355,3956,1.5,17.9,3990,2027,1963,8.4,16.6,321,1.3,33.2,0,276,277,1664
2013,01,f) 5,2693,2865,26246,26224,96,3.3,302,10.2,3809,335,3474,1.3,14.5,3764,1208,2556,4.6,14.4,45,0.1,28.8,0,235,238,1035
2013,01,g) 6 to 10,11565,12260,128689,128626,372,2.9,1262,10,18010,2577,15433,2,14,17884,7408,10476,5.8,13.9,126,0.1,27.8,0,963,964,6134
2013,01,h) 11 to 15,8611,9553,133866,136852,266,2.7,723,7.4,15294,2274,13020,1.7,11.2,21265,9610,11655,7,15.5,-5971,-4.3,22.4,0,525,525,3033
2013,01,i) 16 to 20,6761,7383,87899,89296,208,2.8,524,7,8303,1316,6987,1.5,9.3,11097,3726,7371,4.2,12.4,-2794,-3.1,18.6,0,389,389,2419
2013,01,j) 21 to 25,5125,6427,104884,106541,207,3.2,421,6.5,10803,1524,9279,1.4,10.1,14116,5986,8130,5.6,13.2,-3313,-3.1,20.2,0,272,272,5003
2013,01,k) 26+,9059,13720,294191,293139,382,2.8,621,4.5,27176,4767,22409,1.6,9.3,25072,4557,20515,1.6,8.6,2104,0.7,17.2,0,332,336,1811
2013,01,l) Left Censored,7089,21483,685731,680949,913,4.2,976,4.5,65986,14093,51893,2.1,9.7,56421,11850,44571,1.7,8.3,9565,1.4,16.6,0,206,215,2367
2013,02,a) 0,995,995,4747,2386,980,197,0,0,4722,,,,197.9,0,0,0,0,0,4722,197.9,0,1,,,
2013,02,b) 1,732,748,5580,5707,1,0.1,241,27.8,948,,,,16.6,1202,718,484,12.6,21.1,-254,-4.5,33.2,1,128,128,444
2013,02,c) 2,629,644,3905,3920,39,5.8,99,14.8,778,93,685,2.4,19.8,807,255,552,6.5,20.6,-29,-0.8,39.6,0,59,59,168
2013,02,d) 3,567,587,4386,4242,47,7.7,91,15,1053,82,971,1.9,24.8,764,260,504,6.1,18,289,6.8,36,0,60,60,184
2013,02,e) 4,556,588,4373,4339,29,4.7,91,14.8,789,139,650,3.2,18.2,720,281,439,6.5,16.6,69,1.6,33.2,0,65,65,210
2013,02,f) 5,581,604,4819,4853,35,5.6,90,14.3,778,99,679,2,16,845,387,458,8,17.4,-67,-1.4,32,0,62,62,243
2013,02,g) 6 to 10,2464,2562,21655,21730,132,5,257,9.8,3228,527,2701,2.4,14.9,3378,1143,2235,5.3,15.5,-150,-0.6,29.8,0,153,153,881
2013,02,h) 11 to 15,1859,2028,28710,28739,73,3.5,187,9,3021,323,2698,1.1,10.5,3079,1281,1798,4.5,10.7,-58,-0.2,21,0,102,102,674
2013,02,i) 16 to 20,1265,1330,10871,11142,53,3.9,126,9.2,1165,157,1008,1.4,10.5,1707,649,1058,5.8,15.3,-542,-4.8,21,0,77,77,484
2013,02,j) 21 to 25,956,1070,13450,13486,38,3.5,75,6.9,1534,70,1464,0.5,11.4,1605,602,1003,4.5,11.9,-71,-0.5,22.8,0,40,40,476
2013,02,k) 26+,1828,2818,61098,60733,71,2.5,161,5.6,5954,801,5153,1.3,9.8,5223,942,4281,1.6,8.6,731,1.2,17.2,0,73,74,309
2013,02,l) Left Censored,1213,3309,100198,98707,193,5.9,135,4.1,10778,2432,8346,2.5,10.9,7795,1140,6655,1.2,7.9,2983,3,15.8,0,17,17,328
2013,04,a) 0,7600,7631,45539,22916,7541,197.6,0,0,45247,45247,0,197.4,197.4,0,0,0,0,0,45247,197.4,0,0,,,
2013,04,b) 1,5940,5998,46392,47823,10,0.1,1804,26.2,12160,190,11970,0.4,25.4,15021,9150,5871,19.1,31.4,-2861,-6,50.8,0,1327,1327,7712
2013,04,c) 2,5186,5303,42449,43209,264,4.7,1025,18.1,9063,1654,7409,3.8,21,10582,5954,4628,13.8,24.5,-1519,-3.5,42,0,750,750,4656
2013,04,d) 3,4172,4312,44427,45061,171,3.8,700,15.4,6453,971,5482,2.2,14.3,7721,4213,3508,9.3,17.1,-1268,-2.8,28.6,0,530,531,3377
2013,04,e) 4,4026,4251,41869,41543,268,6.1,629,14.3,7442,1761,5681,4.2,17.9,6790,3151,3639,7.6,16.3,652,1.6,32.6,0,487,487,2735
2013,04,f) 5,4466,4857,46786,46838,244,4.9,596,11.9,6712,1156,5556,2.5,14.3,6816,3319,3497,7.1,14.6,-104,-0.3,28.6,0,420,420,2696
2013,04,g) 6 to 10,17833,18794,205801,205905,777,4,2187,11.3,29500,4429,25071,2.2,14.3,29708,13583,16125,6.6,14.4,-208,-0.1,28.6,0,1474,1477,9668
2013,04,h) 11 to 15,11486,12615,175765,174903,447,3.5,1069,8.3,21325,3034,18291,1.7,12.2,19602,7051,12551,4,11.2,1723,1,22.4,0,720,733,4930
2013,04,i) 16 to 20,7564,8527,133089,132475,300,3.4,691,7.9,16920,3745,13175,2.8,12.8,15692,5067,10625,3.8,11.8,1228,1,23.6,0,480,480,4188
2013,04,j) 21 to 25,5137,7382,140202,138415,276,3.7,456,6.1,18008,4564,13444,3.3,13,14433,4005,10428,2.9,10.4,3575,2.6,20.8,0,234,235,2419
2013,04,k) 26+,8228,13822,355624,356236,460,3.3,693,5,35351,7404,27947,2.1,9.9,36575,6437,30138,1.8,10.3,-1224,-0.4,19.8,0,371,379,3207
2013,04,l) Left Censored,5278,22473,866161,865264,1403,6.3,1104,4.9,91176,22199,68977,2.6,10.5,89381,19580,69801,2.3,10.3,1795,0.2,20.6,0,125,144,1449
2013,05,a) 0,3130,3154,16757,8407,3131,198.5,0,0,16700,16700,0,198.6,198.6,0,0,0,0,0,16700,198.6,0,0,,,
2013,05,b) 1,2396,2423,14906,15661,5,0.2,711,25.6,3622,78,3544,0.5,23.1,5131,3131,2000,20,32.8,-1509,-9.7,46.2,0,550,551,2643
2013,05,c) 2,2206,2249,17075,17567,75,3.1,398,16.6,2898,414,2484,2.4,16.5,3881,1963,1918,11.2,22.1,-983,-5.6,33,0,316,316,1430
2013,05,d) 3,1870,1954,16958,17643,57,2.8,290,14,2165,264,1901,1.5,12.3,3534,1714,1820,9.7,20,-1369,-7.7,24.6,0,240,240,1578
2013,05,e) 4,1769,1863,16596,16952,59,3,262,13.4,2452,494,1958,2.9,14.5,3164,1153,2011,6.8,18.7,-712,-4.2,29,0,204,204,952
2013,05,f) 5,1858,1946,16111,16393,55,2.7,228,11.3,2203,279,1924,1.7,13.4,2766,1202,1564,7.3,16.9,-563,-3.5,26.8,0,178,178,995
2013,05,g) 6 to 10,7966,8488,75868,76569,292,3.3,849,9.7,9784,1143,8641,1.5,12.8,11185,4280,6905,5.6,14.6,-1401,-1.8,25.6,0,604,605,3400
2013,05,h) 11 to 15,5750,6467,70653,69840,163,2.5,492,7.4,10091,1886,8205,2.7,14.4,8464,2697,5767,3.9,12.1,1627,2.3,24.2,0,368,368,1966
2013,05,i) 16 to 20,4426,4872,53061,53278,139,2.8,349,7,5345,656,4689,1.2,10,5779,1925,3854,3.6,10.8,-434,-0.8,20,0,270,270,1610
2013,05,j) 21 to 25,3091,3652,57147,56302,137,3.7,227,6.2,6983,2486,4497,4.4,12.4,5292,1097,4195,1.9,9.4,1691,3,18.8,0,153,159,775
2013,05,k) 26+,5739,8424,174211,174301,289,3.4,417,4.9,16205,3227,12978,1.9,9.3,16384,3977,12407,2.3,9.4,-179,-0.1,18.6,0,262,264,1791
2013,05,l) Left Censored,4811,13591,444642,446904,514,3.8,629,4.6,37715,8525,29190,1.9,8.4,42240,13004,29236,2.9,9.5,-4525,-1.1,16.8,0,133,169,1527
2013,06,a) 0,53415,53747,299898,150962,53187,197.9,0,0,297873,297873,0,197.3,197.3,0,0,0,0,0,297873,197.3,0,0,1,1,0
2013,06,b) 1,40917,41350,281240,289002,51,0.1,12409,26.1,77266,804,76462,0.3,26.7,92789,55234,37555,19.1,32.1,-15523,-5.4,53.4,0,8780,8781,43357
2013,06,c) 2,34721,35520,282301,281625,1475,3.9,6746,17.8,59757,8175,51582,2.9,21.2,58405,32871,25534,11.7,20.7,1352,0.5,41.4,0,4952,4958,26183
2013,06,d) 3,28872,29900,251376,251676,1306,4.1,4775,15.2,48788,6443,42345,2.6,19.4,49387,26601,22786,10.6,19.6,-599,-0.2,38.8,0,3464,3464,21944
2013,06,e) 4,27761,28597,248479,247271,1142,3.8,4080,13.6,42209,5055,37154,2,17.1,39793,19237,20556,7.8,16.1,2416,1,32.2,0,2960,2961,14999
2013,06,f) 5,28845,30219,264086,266464,1289,4.1,3966,12.6,42490,4856,37634,1.8,15.9,47246,22447,24799,8.4,17.7,-4756,-1.8,31.8,0,2747,2753,17744
2013,06,g) 6 to 10,119912,125565,1256082,1249434,5156,4,13520,10.5,190523,28713,161810,2.3,15.2,177226,74813,102413,6,14.2,13297,1,28.4,0,9114,9167,55840
2013,06,h) 11 to 15,79440,86811,1102181,1102630,3190,3.6,7404,8.4,140265,26148,114117,2.4,12.7,141162,46821,94341,4.2,12.8,-897,-0.1,25.4,0,4845,4872,33494
2013,06,i) 16 to 20,50775,55758,800339,803058,1981,3.5,4441,7.8,91473,17915,73558,2.2,11.4,96911,29911,67000,3.7,12.1,-5438,-0.7,22.8,0,2955,2963,20954
2013,06,j) 21 to 25,40603,50421,887615,880917,2026,4,3826,7.5,123166,38963,84203,4.4,14,109769,35230,74539,4,12.5,13397,1.5,25,0,2090,2102,15182
2013,06,k) 26+,65814,99633,2498310,2461593,3423,3.4,5964,5.9,310068,66830,243238,2.7,12.6,236635,65359,171276,2.7,9.6,73433,3,19.2,0,3236,3290,23231
2013,06,l) Left Censored,37322,128603,5035346,4959399,7010,5.5,6838,5.3,573249,157092,416157,3.2,11.6,421356,104245,317111,2.1,8.5,151893,3.1,17,0,1367,1476,22296
2013,08,a) 0,9417,9471,43957,22163,9362,197.7,0,0,43589,43589,0,196.7,196.7,0,0,0,0,0,43589,196.7,0,0,,,
2013,08,b) 1,6957,7000,43527,44692,9,0.1,2141,26.5,11254,288,10966,0.6,25.2,13584,8128,5456,18.2,30.4,-2330,-5.2,50.4,0,1482,1482,6385
2013,08,c) 2,6050,6138,43686,44282,281,4.3,1137,17.4,8758,947,7811,2.1,19.8,9949,6046,3903,13.7,22.5,-1191,-2.7,39.6,0,844,847,4850
2013,08,d) 3,5095,5214,40616,40987,247,4.5,939,17,7263,700,6563,1.7,17.7,8006,4191,3815,10.2,19.5,-743,-1.8,35.4,0,654,654,3012
2013,08,e) 4,4939,5053,39660,39924,262,5,718,13.7,6482,1228,5254,3.1,16.2,7009,3528,3481,8.8,17.6,-527,-1.4,32.4,0,508,508,2879
2013,08,f) 5,5230,5370,41379,42063,260,4.7,683,12.3,5854,742,5112,1.8,13.9,7222,2987,4235,7.1,17.2,-1368,-3.3,27.8,0,457,457,2215
2013,08,g) 6 to 10,21460,22260,194901,194836,1133,5,2417,10.6,28198,3912,24286,2,14.5,28067,11323,16744,5.8,14.4,131,0.1,28.8,0,1488,1489,8705
2013,08,h) 11 to 15,14766,15835,168182,169771,655,4.1,1434,8.9,20931,2830,18101,1.7,12.3,24109,9587,14522,5.6,14.2,-3178,-1.9,24.6,0,883,889,7386
2013,08,i) 16 to 20,9949,10858,173499,157039,450,4.1,892,8.1,48423,4041,44382,2.6,30.8,15503,4967,10536,3.2,9.9,32920,20.9,19.8,0,557,558,3108
2013,08,j) 21 to 25,6663,8281,136577,136061,306,3.6,566,6.7,14549,3422,11127,2.5,10.7,13516,4494,9022,3.3,9.9,1033,0.8,19.8,0,324,324,1737
2013,08,k) 26+,10145,15388,352681,346654,467,3,869,5.6,45028,9818,35210,2.8,13,32973,10932,22041,3.2,9.5,12055,3.5,19,0,476,484,4004
2013,08,l) Left Censored,6908,22173,812203,802485,1380,6.3,1118,5.1,93294,24990,68304,3.1,11.6,73858,16852,57006,2.1,9.2,19436,2.4,18.4,0,168,174,2925
2013,09,a) 0,4067,4079,27028,13579,4032,197.7,0,0,26899,,,,198.1,0,0,0,0,0,26899,198.1,0,1,,,
2013,09,b) 1,3156,3169,21223,22217,4,0.1,866,24.1,4991,,,,22.5,6979,4406,2573,19.8,31.4,-1988,-8.9,45,1,603,603,3794
2013,09,c) 2,2633,2658,20020,20436,97,3.4,456,16.2,3169,307,2862,1.5,15.5,4001,1626,2375,8,19.6,-832,-4.1,31,0,344,344,1369
2013,09,d) 3,2321,2412,21608,21815,88,3.5,319,12.7,3051,460,2591,2.1,14,3465,1372,2093,6.3,15.9,-414,-1.9,28,0,219,219,1032
2013,09,e) 4,2216,2250,19692,19989,84,3.6,292,12.5,3031,731,2300,3.7,15.2,3625,1464,2161,7.3,18.1,-594,-2.9,30.4,0,209,209,1152
2013,09,f) 5,2340,2426,21218,21709,96,3.8,303,12,2859,449,2410,2.1,13.2,3840,1554,2286,7.2,17.7,-981,-4.5,26.4,0,199,199,1265
2013,09,g) 6 to 10,9779,10205,103837,104849,331,3.1,1091,10.4,12587,1299,11288,1.2,12,14611,6474,8137,6.2,13.9,-2024,-1.9,24,0,741,741,4035
2013,09,h) 11 to 15,7811,8442,113139,115033,233,2.7,674,7.8,10359,1340,9019,1.2,9,14147,4659,9488,4.1,12.3,-3788,-3.3,18,0,417,417,2801
2013,09,i) 16 to 20,6127,6477,71057,72207,192,2.9,486,7.4,7320,1044,6276,1.4,10.1,9620,3642,5978,5,13.3,-2300,-3.2,20.2,0,306,306,3092
2013,09,j) 21 to 25,5366,6065,88431,89075,146,2.4,400,6.5,6699,768,5931,0.9,7.5,7987,1728,6259,1.9,9,-1288,-1.5,15,0,229,229,1056
2013,09,k) 26+,9035,12339,257390,257061,382,3.1,726,5.8,22591,4201,18390,1.6,8.8,21933,6731,15202,2.6,8.5,658,0.3,17,0,392,395,2464
2013,09,l) Left Censored,8747,19240,731988,728532,880,4.6,956,5,62696,11610,51086,1.6,8.6,55784,11683,44101,1.6,7.7,6912,0.9,15.4,0,269,293,3909
2013,10,a) 0,1220,1222,7413,3723,1206,197.4,0,0,7381,,,,198.3,0,0,0,0,0,7381,198.3,0,1,,,
2013,10,b) 1,944,950,6263,6619,1,0.1,303,27.5,1392,,,,21,2104,1333,771,20.1,31.8,-712,-10.8,42,1,222,222,1143
2013,10,c) 2,777,779,5102,5203,33,4,132,16,871,153,718,2.9,16.7,1073,533,540,10.2,20.6,-202,-3.9,33.4,0,94,94,425
2013,10,d) 3,622,628,4957,5012,23,3.5,100,15.1,686,149,537,3,13.7,795,348,447,6.9,15.9,-109,-2.2,27.4,0,72,72,231
2013,10,e) 4,646,663,6398,6260,33,4.7,104,14.9,1276,548,728,8.8,20.4,999,446,553,7.1,16,277,4.4,32,0,78,78,383
2013,10,f) 5,726,751,7211,6953,21,2.7,67,8.7,1266,58,1208,0.8,18.2,749,266,483,3.8,10.8,517,7.4,21.6,0,48,48,182
2013,10,g) 6 to 10,2825,2916,29913,29331,102,3.4,282,9.4,4646,1769,2877,6,15.8,3482,1281,2201,4.4,11.9,1164,3.9,23.8,0,207,207,1065
2013,10,h) 11 to 15,2052,2222,22036,22101,66,2.9,183,8,2472,425,2047,1.9,11.2,2601,1017,1584,4.6,11.8,-129,-0.6,22.4,0,119,119,588
2013,10,i) 16 to 20,1561,1698,23871,23610,63,3.7,111,6.5,2683,1062,1621,4.5,11.4,2160,413,1747,1.7,9.1,523,2.3,18.2,0,70,71,310
2013,10,j) 21 to 25,1192,1372,17847,17660,57,4.1,90,6.5,2135,254,1881,1.4,12.1,1760,439,1321,2.5,10,375,2.1,20,0,55,55,323
2013,10,k) 26+,2016,2798,56653,55846,96,3.4,140,5,6341,1901,4440,3.4,11.4,4727,959,3768,1.7,8.5,1614,2.9,17,0,74,76,431
2013,10,l) Left Censored,2318,5472,197542,191041,307,5.6,303,5.5,30104,10113,19991,5.3,15.8,17102,4779,12323,2.5,9,13002,6.8,18,0,49,53,718
2013,11,a) 0,1032,1032,7220,3619,1024,198.4,0,0,7202,,,,199,0,0,0,0,0,7202,199,0,1,,,
2013,11,b) 1,765,767,6232,6139,2,0.2,173,20.3,1547,,,,25.2,1361,647,714,10.5,22.2,186,3,44.4,1,131,131,490
2013,11,c) 2,720,724,7411,7354,27,3.6,106,14,1333,227,1106,3.1,18.1,1219,438,781,6,16.6,114,1.5,33.2,0,80,80,345
2013,11,d) 3,614,626,8490,8397,27,4.2,75,11.6,1567,418,1149,5,18.7,1381,425,956,5.1,16.4,186,2.3,32.8,0,57,57,371
2013,11,e) 4,548,556,6070,6446,13,2.2,70,12,1015,44,971,0.7,15.7,1766,1203,563,18.7,27.4,-751,-11.7,31.4,0,53,54,1162
2013,11,f) 5,554,595,7509,7761,16,2.6,59,9.6,1024,67,957,0.9,13.2,1527,728,799,9.4,19.7,-503,-6.5,26.4,0,39,39,314
2013,11,g) 6 to 10,2396,2459,38033,37817,75,3,220,8.7,5035,512,4523,1.4,13.3,4602,1697,2905,4.5,12.2,433,1.1,24.4,0,158,158,1134
2013,11,h) 11 to 15,1888,2045,38347,38453,46,2.2,149,7.1,4295,286,4009,0.7,11.2,4507,1000,3507,2.6,11.7,-212,-0.5,22.4,0,99,100,592
2013,11,i) 16 to 20,1346,1438,24424,24400,34,2.3,91,6.2,2564,414,2150,1.7,10.5,2515,817,1698,3.3,10.3,49,0.2,20.6,0,64,65,733
2013,11,j) 21 to 25,1189,1465,28938,28900,71,4.8,98,6.6,3630,950,2680,3.3,12.6,3553,1129,2424,3.9,12.3,77,0.3,24.6,0,42,42,178
2013,11,k) 26+,2261,2949,93484,93468,96,3.2,168,5.6,8619,1424,7195,1.5,9.2,8586,1701,6885,1.8,9.2,33,0,18.4,0,74,75,639
2013,11,l) Left Censored,2747,5861,234609,233470,586,10.2,363,6.3,22426,8224,14202,3.5,9.6,20147,7407,12740,3.2,8.6,2279,1,17.2,0,52,52,2695
2013,12,a) 0,36105,36180,180403,91118,35646,197,0,0,178570,178570,0,196,196,0,0,0,0,0,178570,196,0,0,,,
2013,12,b) 1,27756,28043,175795,183097,34,0.1,8813,27.2,45727,637,45090,0.3,25,60330,37675,22655,20.6,32.9,-14603,-7.9,50,0,6442,6442,30858
2013,12,c) 2,23436,23958,187570,185176,1029,4,4715,18.4,51094,4294,46800,2.3,27.6,46306,23515,22791,12.7,25,4788,2.6,50,0,3485,3485,18263
2013,12,d) 3,19223,19736,149066,155603,817,3.9,3354,16.1,25376,3569,21807,2.3,16.3,38450,15564,22886,10,24.7,-13074,-8.4,32.6,0,2472,2475,12087
2013,12,e) 4,16953,17327,127218,128251,737,4.1,2509,13.8,21286,3802,17484,3,16.6,23352,11096,12256,8.7,18.2,-2066,-1.6,33.2,0,1821,1824,8679
2013,12,f) 5,17006,17546,127170,128069,803,4.4,2432,13.3,21646,2986,18660,2.3,16.9,23444,11590,11854,9,18.3,-1798,-1.4,33.8,0,1728,1730,9593
2013,12,g) 6 to 10,72364,74917,654493,668115,3337,4.3,8885,11.5,89298,21706,67592,3.2,13.4,116541,41433,75108,6.2,17.4,-27243,-4,26.8,0,5929,5939,29159
2013,12,h) 11 to 15,43730,47563,524587,526692,1920,4,4314,8.9,65772,10786,54986,2,12.5,69982,27197,42785,5.2,13.3,-4210,-0.8,25,0,2862,2863,17006
2013,12,i) 16 to 20,30084,33280,429955,437835,1274,3.8,2617,7.7,58146,17376,40770,4,13.3,73906,42394,31512,9.7,16.9,-15760,-3.6,26.6,0,1663,1679,16155
2013,12,j) 21 to 25,22457,28187,583104,580893,1073,3.8,1930,6.8,76845,15002,61843,2.6,13.2,72423,16219,56204,2.8,12.5,4422,0.7,25,0,1169,1175,10317
2013,12,k) 26+,29600,46235,1042178,1039220,1807,3.9,2684,5.8,112535,28497,84038,2.7,10.8,106618,30600,76018,2.9,10.3,5917,0.5,20.6,0,1379,1416,11554
2013,12,l) Left Censored,16460,71409,2728161,2696449,4274,6,3493,4.9,281071,73227,207844,2.7,10.4,217648,45187,172461,1.7,8.1,63423,2.3,16.2,0,532,541,5108
2013,13,a) 0,12303,12333,66340,33401,12207,198,0,0,65879,65879,0,197.2,197.2,0,0,0,0,0,65879,197.2,0,0,,,
2013,13,b) 1,9628,9749,66305,69643,23,0.2,2867,25.7,16030,493,15537,0.7,23,22706,10971,11735,15.8,32.6,-6676,-9.6,46,0,2069,2069,8754
2013,13,c) 2,8200,8335,61237,64178,338,3.8,1613,18.1,10677,1254,9423,2,16.6,16559,10157,6402,15.8,25.8,-5882,-9.2,33.2,0,1186,1187,8733
2013,13,d) 3,7188,7350,61459,61312,288,3.7,1076,14,10252,1983,8269,3.2,16.7,9957,4616,5341,7.5,16.2,295,0.5,32.4,0,802,802,3778
2013,13,e) 4,6626,7151,73532,76848,291,3.9,964,12.9,11652,2398,9254,3.1,15.2,18284,5109,13175,6.6,23.8,-6632,-8.6,30.4,0,743,743,4173
2013,13,f) 5,7182,7537,62026,62828,310,4,1000,12.8,8720,1031,7689,1.6,13.9,10323,4833,5490,7.7,16.4,-1603,-2.5,27.8,0,728,730,3736
2013,13,g) 6 to 10,28587,29908,295000,299311,1232,4,3359,10.9,38842,4962,33880,1.7,13,47464,22125,25339,7.4,15.9,-8622,-2.9,26,0,2356,2358,18462
2013,13,h) 11 to 15,19831,21911,289342,290833,780,3.5,1830,8.2,38172,6450,31722,2.2,13.1,41153,18464,22689,6.3,14.2,-2981,-1.1,26.2,0,1197,1202,11961
2013,13,i) 16 to 20,13438,15113,201840,202619,606,3.9,1166,7.6,22524,4878,17646,2.4,11.1,24082,8285,15797,4.1,11.9,-1558,-0.8,22.2,0,757,759,4019
2013,13,j) 21 to 25,9176,11782,208087,207981,441,3.7,787,6.6,21843,3185,18658,1.5,10.5,21631,6631,15000,3.2,10.4,212,0.1,20.8,0,456,465,2638
2013,13,k) 26+,14662,22743,540831,539736,783,3.4,1142,5,58577,11510,47067,2.1,10.9,56386,20027,36359,3.7,10.4,2191,0.5,20.8,0,627,632,5536
2013,13,l) Left Censored,10735,39651,1496426,1475108,2088,5.3,1989,5,163398,33777,129621,2.3,11.1,120764,28073,92691,1.9,8.2,42634,2.9,16.4,0,325,330,3825
2013,15,a) 0,1367,1375,8193,4110,1363,198.3,0,0,8167,8167,0,198.7,198.7,0,0,0,0,0,8167,198.7,0,0,,,
2013,15,b) 1,1090,1097,7421,7664,0,0,283,22.9,2070,0,2070,0,27,2556,1812,744,23.6,33.4,-486,-6.4,54,0,202,202,1574
2013,15,c) 2,945,956,9833,9564,31,3.1,155,15.3,1874,88,1786,0.9,19.6,1336,563,773,5.9,14,538,5.6,28,0,107,107,470
2013,15,d) 3,829,855,8515,8658,28,3.1,115,12.9,1246,128,1118,1.5,14.4,1532,606,926,7,17.7,-286,-3.3,28.8,0,92,92,538
2013,15,e) 4,824,836,9309,10129,34,4,92,10.7,1566,71,1495,0.7,15.5,3205,2206,999,21.8,31.6,-1639,-16.1,31,0,70,70,2063
2013,15,f) 5,849,903,7139,7222,46,5,100,10.8,980,167,813,2.3,13.6,1146,536,610,7.4,15.9,-166,-2.3,27.2,0,81,81,411
2013,15,g) 6 to 10,3840,4071,44901,44633,144,3.4,402,9.6,5880,1424,4456,3.2,13.2,5344,1800,3544,4,12,536,1.2,24,0,278,280,1313
2013,15,h) 11 to 15,2839,3117,35565,35764,91,2.9,235,7.4,3953,386,3567,1.1,11.1,4350,1490,2860,4.2,12.2,-397,-1.1,22.2,0,158,158,1190
2013,15,i) 16 to 20,2102,2247,33666,33267,77,3.4,154,6.8,3338,351,2987,1.1,10,2539,804,1735,2.4,7.6,799,2.4,15.2,0,94,94,407
2013,15,j) 21 to 25,1784,2247,32388,32113,82,3.6,150,6.6,3313,479,2834,1.5,10.3,2762,1006,1756,3.1,8.6,551,1.7,17.2,0,92,94,660
2013,15,k) 26+,3267,4583,92971,92332,127,2.7,226,4.9,8521,2224,6297,2.4,9.2,7242,2957,4285,3.2,7.8,1279,1.4,15.6,0,111,111,687
2013,15,l) Left Censored,2742,6556,209822,209613,295,4.5,308,4.7,16989,4162,12827,2,8.1,16570,3890,12680,1.9,7.9,419,0.2,15.8,0,65,68,420
2013,16,a) 0,2352,2355,10726,5422,2324,197.4,0,0,10608,,,,195.6,0,0,0,0,0,10608,195.6,0,1,,,
2013,16,b) 1,1768,1774,9674,10228,2,0.1,580,28.1,2464,,,,24.1,3572,2421,1151,23.7,34.9,-1108,-10.8,48.2,1,409,409,2068
2013,16,c) 2,1503,1548,11050,10806,74,4.5,303,18.4,2587,888,1699,8.2,23.9,2099,1053,1046,9.7,19.4,488,4.5,38.8,0,227,227,817
2013,16,d) 3,1273,1305,9120,9231,68,4.9,227,16.5,1683,337,1346,3.7,18.2,1905,1139,766,12.3,20.6,-222,-2.4,36.4,0,163,163,1001
2013,16,e) 4,1289,1328,10391,10336,53,3.9,165,12,1613,284,1329,2.7,15.6,1502,619,883,6,14.5,111,1.1,29,0,119,119,492
2013,16,f) 5,1540,1600,11306,11385,84,5.1,197,12,1796,383,1413,3.4,15.8,1953,840,1113,7.4,17.2,-157,-1.4,31.6,0,127,127,642
2013,16,g) 6 to 10,6491,6760,54373,53895,386,5.6,746,10.8,8592,1414,7178,2.6,15.9,7635,3056,4579,5.7,14.2,957,1.7,28.4,0,493,493,2428
2013,16,h) 11 to 15,4214,4505,57990,57539,177,3.8,393,8.5,6730,780,5950,1.4,11.7,5828,2163,3665,3.8,10.1,902,1.6,20.2,0,250,250,1588
2013,16,i) 16 to 20,2952,3170,33246,33184,120,3.7,275,8.5,4013,1003,3010,3,12.1,3889,1694,2195,5.1,11.7,124,0.4,23.4,0,185,185,1321
2013,16,j) 21 to 25,1900,2183,26534,26432,85,3.8,162,7.3,3109,586,2523,2.2,11.8,2904,1053,1851,4,11,205,0.8,22,0,104,104,598
2013,16,k) 26+,2968,4320,87042,85857,114,2.6,212,4.9,8990,1242,7748,1.4,10.5,6619,1341,5278,1.6,7.7,2371,2.8,15.4,0,116,116,534
2013,16,l) Left Censored,2548,6640,193099,189090,297,4.5,304,4.6,21456,5918,15538,3.1,11.3,13437,2479,10958,1.3,7.1,8019,4.2,14.2,0,58,62,681
2013,17,a) 0,15772,15831,80788,40667,15632,197.5,0,0,80242,,,,197.3,0,0,0,0,0,80242,197.3,0,1,,,
2013,17,b) 1,12342,12424,78986,82131,12,0.1,3886,27.1,17434,,,,21.2,23723,14039,9684,17.1,28.9,-6289,-7.7,42.4,1,2593,2597,10943
2013,17,c) 2,10972,11292,82716,83810,526,4.4,2014,16.8,15428,1792,13636,2.1,18.4,17616,9630,7986,11.5,21,-2188,-2.6,36.8,0,1419,1419,8135
2013,17,d) 3,9065,9366,93967,93309,409,4.1,1513,15.3,18258,3011,15247,3.2,19.6,16941,9831,7110,10.5,18.2,1317,1.4,36.4,0,1035,1035,8201
2013,17,e) 4,8740,8973,74352,73807,384,4.1,1187,12.7,12185,1321,10864,1.8,16.5,11094,5114,5980,6.9,15,1091,1.5,30,0,783,783,3835
2013,17,f) 5,9244,9634,79144,79501,420,4.2,1167,11.7,11294,1861,9433,2.3,14.2,12008,5390,6618,6.8,15.1,-714,-0.9,28.4,0,782,782,4293
2013,17,g) 6 to 10,37505,39409,379237,385006,1438,3.5,4198,10.3,45014,6069,38945,1.6,11.7,56552,22954,33598,6,14.7,-11538,-3,23.4,0,2692,2697,16921
2013,17,h) 11 to 15,26957,29369,370175,372365,949,3.2,2469,8.2,55436,16342,39094,4.4,14.9,59815,26254,33561,7.1,16.1,-4379,-1.2,29.8,0,1500,1508,13943
2013,17,i) 16 to 20,20963,22726,291363,292949,725,3.1,1799,7.8,31659,7678,23981,2.6,10.8,34831,11179,23652,3.8,11.9,-3172,-1.1,21.6,0,1107,1115,7670
2013,17,j) 21 to 25,16243,19556,352306,350379,777,3.9,1421,7.2,39758,6693,33065,1.9,11.3,35904,11648,24256,3.3,10.2,3854,1.1,20.4,0,813,817,5793
2013,17,k) 26+,26587,38270,927462,921797,1190,3.1,2075,5.4,92471,19132,73339,2.1,10,81140,22508,58632,2.4,8.8,11331,1.2,17.6,0,1173,1189,8852
2013,17,l) Left Censored,23634,60389,2368276,2345267,2813,4.7,2991,4.9,247775,67980,179795,2.9,10.6,201756,45117,156639,1.9,8.6,46019,2,17.2,0,754,821,11692
2013,18,a) 0,6197,6244,39424,19875,6187,198.2,0,0,39099,39099,0,196.7,196.7,0,0,0,0,0,39099,196.7,0,0,,,
2013,18,b) 1,4850,4884,38880,40826,7,0.1,1403,25.1,8019,199,7820,0.5,19.6,11910,7546,4364,18.5,29.2,-3891,-9.6,39.2,0,1062,1062,6471
2013,18,c) 2,4278,4447,36740,37010,156,3.3,738,15.7,6332,647,5685,1.7,17.1,6872,3201,3671,8.6,18.6,-540,-1.5,34.2,0,558,560,2683
2013,18,d) 3,3566,3752,33643,34244,113,2.9,568,14.4,5201,932,4269,2.7,15.2,6403,3596,2807,10.5,18.7,-1202,-3.5,30.4,0,431,431,3136
2013,18,e) 4,3508,3641,33814,33939,122,3.2,474,12.5,5286,502,4784,1.5,15.6,5536,2604,2932,7.7,16.3,-250,-0.7,31.2,0,350,350,2236
2013,18,f) 5,3922,4138,37662,38349,136,3.2,478,11.1,5124,565,4559,1.5,13.4,6497,2920,3577,7.6,16.9,-1373,-3.5,26.8,0,362,362,2573
2013,18,g) 6 to 10,16050,16856,170290,170820,545,3.1,1787,10.3,23922,3521,20401,2.1,14,24981,10126,14855,5.9,14.6,-1059,-0.6,28,0,1224,1224,8178
2013,18,h) 11 to 15,12168,13550,175106,175587,387,2.8,1181,8.5,20827,3154,17673,1.8,11.9,21788,7249,14539,4.1,12.4,-961,-0.5,23.8,0,718,735,5466
2013,18,i) 16 to 20,9483,10520,141724,141140,273,2.5,790,7.4,16948,3209,13739,2.3,12,15779,4666,11113,3.3,11.2,1169,0.8,22.4,0,550,552,3292
2013,18,j) 21 to 25,7567,9341,157098,157607,236,2.5,581,6.1,15833,2517,13316,1.6,10,16851,5110,11741,3.2,10.7,-1018,-0.7,20,0,349,353,3670
2013,18,k) 26+,13224,20272,446897,444653,605,3,1010,4.9,45139,8144,36995,1.8,10.2,40652,12142,28510,2.7,9.1,4487,1.1,18.2,0,563,564,4386
2013,18,l) Left Censored,12141,32999,1234239,1224815,1157,3.5,1343,4.1,115595,23745,91850,1.9,9.4,96746,16232,80514,1.3,7.9,18849,1.5,15.8,0,347,350,3792
2013,19,a) 0,3082,3104,16392,8258,3060,197.2,0,0,16268,16268,0,197,197,0,0,0,0,0,16268,197,0,0,,,
2013,19,b) 1,2559,2576,15800,16885,6,0.2,701,24,3219,47,3172,0.3,19.1,5389,3420,1969,20.3,31.9,-2170,-12.8,38.2,0,466,466,2843
2013,19,c) 2,2294,2349,18009,17996,84,3.4,404,16.2,3154,608,2546,3.4,17.5,3128,1488,1640,8.3,17.4,26,0.1,34.8,0,294,294,1191
2013,19,d) 3,2021,2046,14734,14786,64,3,260,12.2,2338,190,2148,1.3,15.8,2442,1104,1338,7.5,16.5,-104,-0.7,31.6,0,189,189,925
2013,19,e) 4,1887,1983,18582,18566,63,3,281,13.5,2713,287,2426,1.5,14.6,2681,1159,1522,6.2,14.4,32,0.2,28.8,0,201,201,898
2013,19,f) 5,2109,2204,18657,18583,67,2.9,242,10.6,2571,324,2247,1.7,13.8,2423,1021,1402,5.5,13,148,0.8,26,0,173,173,853
2013,19,g) 6 to 10,9071,9647,86151,87115,282,2.8,907,9.1,10035,1333,8702,1.5,11.5,11962,4312,7650,4.9,13.7,-1927,-2.2,23,0,577,579,3207
2013,19,h) 11 to 15,6684,7320,74576,75536,200,2.7,586,7.8,7416,1106,6310,1.5,9.8,9335,3186,6149,4.2,12.4,-1919,-2.6,19.6,0,376,377,2442
2013,19,i) 16 to 20,5380,5860,62366,63439,171,2.9,409,6.9,5733,1217,4516,1.9,9,7879,2036,5843,3.2,12.4,-2146,-3.4,18,0,251,251,1298
2013,19,j) 21 to 25,4123,4708,73951,73476,121,2.5,283,5.9,6747,1137,5610,1.5,9.2,5796,1530,4266,2.1,7.9,951,1.3,15.8,0,191,191,1238
2013,19,k) 26+,7816,12119,235506,233652,420,3.5,558,4.6,22595,6176,16419,2.6,9.7,18888,4364,14524,1.9,8.1,3707,1.6,16.2,0,319,325,2525
2013,19,l) Left Censored,8265,18987,664606,663117,680,3.6,641,3.4,53659,12339,41320,1.9,8.1,50680,12801,37879,1.9,7.6,2979,0.5,15.2,0,212,224,2825
2013,20,a) 0,3252,3258,21038,10603,3213,197.2,0,0,20870,,,,196.8,0,0,0,0,0,20870,196.8,0,1,,,
2013,20,b) 1,2590,2614,17760,19854,7,0.2,765,25.6,3597,,,,18.1,7785,3550,4235,17.9,39.2,-4188,-21.1,36.2,1,559,559,3060
2013,20,c) 2,2183,2251,17067,17223,84,3.5,401,16.8,3499,970,2529,5.6,20.3,3810,2260,1550,13.1,22.1,-311,-1.8,40.6,0,291,291,1784
2013,20,d) 3,1837,1871,15673,16053,56,2.8,323,16.2,2258,189,2069,1.2,14.1,3018,1469,1549,9.2,18.8,-760,-4.7,28.2,0,252,252,1268
2013,20,e) 4,1878,1937,16424,16669,61,3,292,14.3,2553,249,2304,1.5,15.3,3042,1255,1787,7.5,18.2,-489,-2.9,30.6,0,220,220,1025
2013,20,f) 5,2000,2103,17393,17296,86,4,241,11.1,2596,359,2237,2.1,15,2402,1194,1208,6.9,13.9,194,1.1,27.8,0,175,175,958
2013,20,g) 6 to 10,8746,9103,89478,90898,317,3.4,936,10,11025,2018,9007,2.2,12.1,13865,6105,7760,6.7,15.3,-2840,-3.2,24.2,0,657,661,4550
2013,20,h) 11 to 15,6634,7239,79901,81296,184,2.5,605,8.2,8562,1099,7463,1.4,10.5,11351,3925,7426,4.8,14,-2789,-3.5,21,0,394,395,2850
2013,20,i) 16 to 20,4923,5344,64261,64692,142,2.6,386,7.1,7021,1196,5825,1.8,10.9,7882,2025,5857,3.1,12.2,-861,-1.3,21.8,0,257,261,1343
2013,20,j) 21 to 25,3709,4552,73086,74297,117,2.5,285,6.2,6208,794,5414,1.1,8.4,8629,3358,5271,4.5,11.6,-2421,-3.2,16.8,0,164,164,1278
2013,20,k) 26+,7053,10269,193376,192807,286,2.8,471,4.6,20676,4438,16238,2.3,10.7,19538,3802,15736,2,10.1,1138,0.6,20.2,0,278,287,2255
2013,20,l) Left Censored,6781,16225,534538,527858,617,3.8,566,3.5,49950,9345,40605,1.8,9.5,36590,7064,29526,1.3,6.9,13360,2.6,13.8,0,169,169,1762
2013,21,a) 0,4377,4408,24180,12141,4377,198.6,0,0,24079,24079,0,198.3,198.3,0,0,0,0,0,24079,198.3,0,0,,,
2013,21,b) 1,3175,3211,22133,24267,9,0.2,919,25.1,5613,68,5545,0.3,23.1,9881,6988,2893,28.8,40.7,-4268,-17.6,46.2,0,713,713,6216
2013,21,c) 2,2822,2921,20713,21297,95,3.1,502,16.2,3563,391,3172,1.8,16.7,4730,2565,2165,12,22.2,-1167,-5.5,33.4,0,390,390,2102
2013,21,d) 3,2346,2448,22870,22758,117,4.6,383,14.9,4009,1202,2807,5.3,17.6,3785,1786,1999,7.8,16.6,224,1,33.2,0,293,293,1464
2013,21,e) 4,2175,2223,19522,19702,68,2.9,289,12.4,3232,203,3029,1,16.4,3591,1252,2339,6.4,18.2,-359,-1.8,32.8,0,240,240,1146
2013,21,f) 5,2335,2522,22543,22947,82,3.1,306,11.7,3143,599,2544,2.6,13.7,3950,1691,2259,7.4,17.2,-807,-3.5,27.4,0,240,241,1427
2013,21,g) 6 to 10,10055,10541,98441,100719,356,3.3,1079,9.9,11830,1772,10058,1.8,11.7,16386,6735,9651,6.7,16.3,-4556,-4.6,23.4,0,780,781,5212
2013,21,h) 11 to 15,7914,8745,107148,107173,243,2.7,642,7.2,15704,4018,11686,3.7,14.7,15753,4684,11069,4.4,14.7,-49,0,29.4,0,443,448,3416
2013,21,i) 16 to 20,5979,6571,84034,83561,192,2.9,446,6.7,11026,2389,8637,2.9,13.2,10079,2634,7445,3.2,12.1,947,1.1,24.2,0,314,314,2085
2013,21,j) 21 to 25,4692,5888,95833,95982,182,3,388,6.5,8805,1551,7254,1.6,9.2,9103,2644,6459,2.8,9.5,-298,-0.3,18.4,0,242,243,1376
2013,21,k) 26+,8159,12554,269635,267488,401,3.2,638,5,29378,6534,22844,2.4,11,25083,4840,20243,1.8,9.4,4295,1.6,18.8,0,332,333,2259
2013,21,l) Left Censored,7210,20480,708887,709192,893,4.4,828,4.1,69877,18737,51140,2.6,9.9,70486,22177,48309,3.1,9.9,-609,0,19.8,0,213,220,2481
2013,22,a) 0,4860,4888,33110,16698,4832,197.7,0,0,32825,32825,0,196.6,196.6,0,0,0,0,0,32825,196.6,0,0,,,
2013,22,b) 1,4054,4089,31801,32347,5,0.1,1160,24.9,8099,13,8086,0,25,9190,5516,3674,17.1,28.4,-1091,-3.4,50,0,891,891,4768
2013,22,c) 2,3337,3380,29212,29971,95,2.6,603,16.7,5200,282,4918,0.9,17.4,6718,2947,3771,9.8,22.4,-1518,-5,34.8,0,461,461,2295
2013,22,d) 3,3058,3199,30384,31495,92,2.7,474,14.1,4552,726,3826,2.3,14.5,6774,3582,3192,11.4,21.5,-2222,-7,29,0,362,362,3014
2013,22,e) 4,2925,3037,29501,30116,118,3.8,372,11.8,4431,473,3958,1.6,14.7,5661,2578,3083,8.6,18.8,-1230,-4.1,29.4,0,281,281,2034
2013,22,f) 5,3164,3359,35448,35589,103,3,350,10.1,4740,458,4282,1.3,13.3,5022,2083,2939,5.9,14.1,-282,-0.8,26.6,0,269,269,1693
2013,22,g) 6 to 10,12706,13543,154559,155390,396,2.9,1175,8.5,19807,1757,18050,1.1,12.7,21468,7793,13675,5,13.8,-1661,-1.1,25.4,0,844,844,5962
2013,22,h) 11 to 15,9367,10221,134189,135621,256,2.4,812,7.8,14240,2249,11991,1.7,10.5,17106,5701,11405,4.2,12.6,-2866,-2.1,21,0,542,542,2855
2013,22,i) 16 to 20,7188,7724,105639,109124,209,2.7,490,6.3,9720,1266,8454,1.2,8.9,16691,7439,9252,6.8,15.3,-6971,-6.4,17.8,0,351,351,6895
2013,22,j) 21 to 25,5139,6367,103919,103268,163,2.5,383,5.9,10572,1779,8793,1.7,10.2,9270,2480,6790,2.4,9,1302,1.2,18,0,223,223,1207
2013,22,k) 26+,10028,14296,301734,299233,392,2.7,733,5.1,35715,6065,29650,2,11.9,30712,8702,22010,2.9,10.3,5003,1.6,20.6,0,441,459,4573
2013,22,l) Left Censored,7665,21808,676991,665665,956,4.4,903,4.1,76733,17327,59406,2.6,11.5,54081,10345,43736,1.6,8.1,22652,3.4,16.2,0,204,206,2450
2013,23,a) 0,1688,1705,8130,4089,1680,197.1,0,0,8083,,,,197.7,0,0,0,0,0,8083,197.7,0,1,,,
2013,23,b) 1,1381,1389,8335,8718,1,0.1,406,25.5,1540,,,,17.7,2306,1413,893,16.2,26.5,-766,-8.8,35.4,1,252,252,1086
2013,23,c) 2,1194,1226,8209,8342,64,4.9,232,17.8,1226,286,940,3.4,14.7,1491,716,775,8.6,17.9,-265,-3.2,29.4,0,153,153,549
2013,23,d) 3,1019,1062,7133,7226,43,3.9,149,13.4,950,142,808,2,13.1,1135,508,627,7,15.7,-185,-2.6,26.2,0,105,105,386
2013,23,e) 4,989,1022,7851,7967,40,3.7,150,14,1049,134,915,1.7,13.2,1281,762,519,9.6,16.1,-232,-2.9,26.4,0,102,102,603
2013,23,f) 5,1105,1156,7585,7697,48,4,159,13.2,1062,152,910,2,13.8,1285,635,650,8.2,16.7,-223,-2.9,27.6,0,117,117,532
2013,23,g) 6 to 10,4926,5109,39400,39511,201,3.8,544,10.4,4788,558,4230,1.4,12.1,5009,2263,2746,5.7,12.7,-221,-0.6,24.2,0,330,332,1720
2013,23,h) 11 to 15,3910,4173,37796,38398,146,3.4,353,8.3,3989,886,3103,2.3,10.4,5193,1683,3510,4.4,13.5,-1204,-3.1,20.8,0,210,220,1268
2013,23,i) 16 to 20,2832,3016,27666,27999,113,3.7,228,7.4,3033,764,2269,2.7,10.8,3698,1344,2354,4.8,13.2,-665,-2.4,21.6,0,134,134,966
2013,23,j) 21 to 25,2195,2649,28516,28475,90,3.4,169,6.3,3012,568,2444,2,10.6,2930,923,2007,3.2,10.3,82,0.3,20.6,0,91,91,440
2013,23,k) 26+,3632,5257,93261,93457,183,3.4,304,5.7,10198,2692,7506,2.9,10.9,10591,4116,6475,4.4,11.3,-393,-0.4,21.8,0,155,156,1824
2013,23,l) Left Censored,2896,6756,203830,205141,259,3.8,277,4.1,15384,2929,12455,1.4,7.5,18006,4495,13511,2.2,8.8,-2622,-1.3,15,0,76,76,1798
2013,24,a) 0,6615,6640,35823,18014,6546,197.2,0,0,35619,35619,0,197.7,197.7,0,0,0,0,0,35619,197.7,0,0,,,
2013,24,b) 1,5314,5343,36776,37293,9,0.1,1384,23,9950,114,9836,0.3,26.7,10983,6203,4780,16.6,29.5,-1033,-2.8,53.4,0,979,979,5025
2013,24,c) 2,4454,4528,35738,37611,181,3.8,753,15.8,6217,495,5722,1.3,16.5,9963,5875,4088,15.6,26.5,-3746,-10,33,0,525,526,4963
2013,24,d) 3,3836,4019,32627,32703,145,3.5,529,12.6,5227,476,4751,1.5,16,5379,2687,2692,8.2,16.4,-152,-0.4,32,0,370,370,2101
2013,24,e) 4,3758,3860,34656,34805,141,3.5,467,11.7,4961,456,4505,1.3,14.3,5259,2464,2795,7.1,15.1,-298,-0.8,28.6,0,331,331,1921
2013,24,f) 5,3922,4192,39124,39448,142,3.3,471,10.9,5810,794,5016,2,14.7,6457,2065,4392,5.2,16.4,-647,-1.7,29.4,0,323,323,1685
2013,24,g) 6 to 10,17458,18106,186610,185072,624,3.4,1830,9.8,26386,2697,23689,1.5,14.3,23310,7966,15344,4.3,12.6,3076,1.7,25.2,0,1212,1212,5880
2013,24,h) 11 to 15,12886,14078,173546,175596,430,3,1150,8,19556,2569,16987,1.5,11.1,23656,9596,14060,5.5,13.5,-4100,-2.4,22.2,0,743,747,6099
2013,24,i) 16 to 20,9477,10135,134183,134482,300,2.9,736,7.1,13880,2144,11736,1.6,10.3,14478,4598,9880,3.4,10.8,-598,-0.5,20.6,0,469,471,3183
2013,24,j) 21 to 25,7583,9158,159970,160611,299,3.2,613,6.6,15456,3518,11938,2.2,9.6,16738,4900,11838,3.1,10.4,-1282,-0.8,19.2,0,315,319,2143
2013,24,k) 26+,11111,15986,357894,357825,527,3.3,853,5.3,38249,6126,32123,1.7,10.7,38110,9082,29028,2.5,10.7,139,0,21.4,0,474,483,5407
2013,24,l) Left Censored,8863,25621,956904,949346,1685,6.6,1361,5.4,103562,43906,59656,4.6,10.9,88446,20518,67928,2.2,9.3,15116,1.6,18.6,0,257,268,5109
2013,25,a) 0,8074,8095,39756,19997,8008,197.9,0,0,39518,39518,0,197.6,197.6,0,0,0,0,0,39518,197.6,0,0,,,
2013,25,b) 1,6440,6521,43584,44089,6,0.1,1841,24.7,10050,50,10000,0.1,22.8,11060,6873,4187,15.6,25.1,-1010,-2.3,45.6,0,1202,1202,5427
2013,25,c) 2,5528,5625,44023,43986,238,4,911,15.4,8374,1242,7132,2.8,19,8299,4234,4065,9.6,18.9,75,0.1,37.8,0,646,646,3226
2013,25,d) 3,4725,4778,40732,40098,198,4,697,13.9,6810,748,6062,1.9,17,5541,2632,2909,6.6,13.8,1269,3.2,27.6,0,497,497,2155
2013,25,e) 4,4343,4478,37674,37611,207,4.5,564,12.2,5749,1180,4569,3.1,15.3,5622,2515,3107,6.7,14.9,127,0.4,29.8,0,388,388,1832
2013,25,f) 5,4683,4901,41919,42068,189,3.7,562,11.1,5789,599,5190,1.4,13.8,6086,2630,3456,6.3,14.5,-297,-0.7,27.6,0,396,396,1987
2013,25,g) 6 to 10,20468,21168,229512,223631,771,3.6,2031,9.4,39509,16569,22940,7.4,17.7,27747,10816,16931,4.8,12.4,11762,5.3,24.8,0,1280,1281,7450
2013,25,h) 11 to 15,15719,16817,213815,215070,537,3.1,1267,7.4,22714,3333,19381,1.5,10.6,25224,9769,15455,4.5,11.7,-2510,-1.1,21.2,0,816,823,8089
2013,25,i) 16 to 20,11935,12687,159217,161741,375,2.9,932,7.2,16222,2635,13587,1.6,10,21269,6188,15081,3.8,13.2,-5047,-3.2,20,0,584,586,3738
2013,25,j) 21 to 25,9408,11272,198507,197593,371,3.3,704,6.2,19932,5786,14146,2.9,10.1,18104,5239,12865,2.7,9.2,1828,0.9,18.4,0,353,377,2137
2013,25,k) 26+,16176,23374,614217,608433,747,3.2,1169,5,56517,11913,44604,2,9.3,44948,11606,33342,1.9,7.4,11569,1.9,14.8,0,605,626,3873
2013,25,l) Left Censored,14784,34604,1396509,1389118,1467,4.2,1536,4.4,122631,22936,99695,1.7,8.8,107851,25375,82476,1.8,7.8,14780,1,15.6,0,444,465,8756
2013,26,a) 0,9950,9986,61740,31162,9863,197.5,0,0,61157,61157,0,196.3,196.3,0,0,0,0,0,61157,196.3,0,0,,,
2013,26,b) 1,7885,8076,64441,66149,13,0.1,2304,25,13552,218,13334,0.3,20.5,16967,9339,7628,14.1,25.6,-3415,-5.1,41,0,1574,1574,7438
2013,26,c) 2,6847,7088,64656,64298,259,3.4,1207,16,12246,948,11298,1.5,19,11529,5590,5939,8.7,17.9,717,1.1,35.8,0,881,881,4177
2013,26,d) 3,5620,5717,57814,57196,196,3.2,884,14.6,11065,1465,9600,2.6,19.3,9829,4582,5247,8,17.2,1236,2.1,34.4,0,656,656,3671
2013,26,e) 4,5579,5688,58472,58781,188,3.2,699,11.8,9664,1135,8529,1.9,16.4,10282,4248,6034,7.2,17.5,-618,-1.1,32.8,0,516,518,3135
2013,26,f) 5,5806,6155,63541,64072,235,3.7,721,11.3,8911,1706,7205,2.7,13.9,9972,5189,4783,8.1,15.6,-1061,-1.7,27.8,0,519,519,4477
2013,26,g) 6 to 10,24563,25562,269046,270452,891,3.4,2629,10,36889,5666,31223,2.1,13.6,39700,15066,24634,5.6,14.7,-2811,-1.1,27.2,0,1794,1795,11754
2013,26,h) 11 to 15,18870,20563,242700,243642,647,3.1,1743,8.3,28598,4328,24270,1.8,11.7,30482,10301,20181,4.2,12.5,-1884,-0.8,23.4,0,1090,1092,7429
2013,26,i) 16 to 20,15551,16709,210735,209948,521,3.1,1252,7.4,23047,4134,18913,2,11,21472,7346,14126,3.5,10.2,1575,0.8,20.4,0,763,772,4883
2013,26,j) 21 to 25,12123,14830,234653,232794,441,2.9,948,6.3,27236,4829,22407,2.1,11.7,23517,6681,16836,2.9,10.1,3719,1.6,20.2,0,544,544,3878
2013,26,k) 26+,20499,29186,585318,584356,795,2.7,1407,4.8,58174,11786,46388,2,10,56249,10853,45396,1.9,9.6,1925,0.4,19.2,0,808,811,5582
2013,26,l) Left Censored,16837,44160,1617716,1610567,1661,3.7,2128,4.8,149622,30492,119130,1.9,9.3,135324,28020,107304,1.7,8.4,14298,0.9,16.8,0,532,539,7530
2013,27,a) 0,6323,6362,35404,17830,6271,197.1,0,0,35148,35148,0,197.1,197.1,0,0,0,0,0,35148,197.1,0,0,,,
2013,27,b) 1,4961,5003,40000,37462,14,0.2,1481,25.8,14090,285,13805,0.8,37.6,9014,5544,3470,14.8,24.1,5076,13.5,48.2,0,950,950,4502
2013,27,c) 2,4455,4582,34626,35721,207,4.3,803,16.5,6184,869,5315,2.4,17.3,8374,5623,2751,15.7,23.4,-2190,-6.1,34.6,0,565,565,4898
2013,27,d) 3,3850,3975,35932,35822,213,5.2,553,13.4,6647,820,5827,2.3,18.6,6427,2500,3927,7,17.9,220,0.7,35.8,0,362,362,1771
2013,27,e) 4,3805,3894,36965,38571,148,3.6,545,13.4,4403,539,3864,1.4,11.4,7614,2871,4743,7.4,19.7,-3211,-8.3,22.8,0,365,365,2463
2013,27,f) 5,3946,4128,36664,36813,173,4.1,473,11.1,5263,547,4716,1.5,14.3,5560,2180,3380,5.9,15.1,-297,-0.8,28.6,0,321,322,1727
2013,27,g) 6 to 10,17872,18848,179863,180973,779,4,1820,9.4,22423,2829,19594,1.6,12.4,24642,9282,15360,5.1,13.6,-2219,-1.2,24.8,0,1132,1132,7340
2013,27,h) 11 to 15,13803,15056,180193,179388,535,3.5,1149,7.5,18985,3072,15913,1.7,10.6,17374,5856,11518,3.3,9.7,1611,0.9,19.4,0,687,688,4045
2013,27,i) 16 to 20,10208,11454,142586,143418,307,2.6,823,7,13564,1681,11883,1.2,9.5,15227,4614,10613,3.2,10.6,-1663,-1.1,19,0,489,489,3241
2013,27,j) 21 to 25,7624,8999,148334,147308,261,2.9,528,5.8,16225,3223,13002,2.2,11,14173,3994,10179,2.7,9.6,2052,1.4,19.2,0,309,309,2645
2013,27,k) 26+,12026,17868,441609,437504,495,2.7,852,4.7,42197,7686,34511,1.8,9.6,33987,7553,26434,1.7,7.8,8210,1.8,15.6,0,461,465,3730
2013,27,l) Left Censored,11209,27961,1187469,1190029,1178,4.2,983,3.5,106495,23419,83076,2,8.9,111614,18038,93576,1.5,9.4,-5119,-0.5,17.8,0,281,281,7057
2013,28,a) 0,2648,2652,16235,8163,2616,197.3,0,0,16145,,,,197.8,0,0,0,0,0,16145,197.8,0,1,,,
2013,28,b) 1,2047,2058,13055,14062,5,0.2,570,24.4,2909,,,,20.7,4923,2695,2228,19.2,35,-2014,-14.3,41.4,1,455,455,2378
2013,28,c) 2,1769,1841,14037,14879,72,3.7,319,16.3,2427,405,2022,2.7,16.3,4110,2179,1931,14.6,27.6,-1683,-11.3,32.6,0,260,260,2000
2013,28,d) 3,1611,1690,14674,14501,64,3.6,234,13.2,3157,307,2850,2.1,21.8,2811,1457,1354,10,19.4,346,2.4,38.8,0,196,196,1326
2013,28,e) 4,1561,1601,12749,13004,49,2.9,229,13.6,1686,154,1532,1.2,13,2195,1041,1154,8,16.9,-509,-3.9,26,0,186,186,909
2013,28,f) 5,1644,1821,15922,16146,68,3.6,206,11,2138,176,1962,1.1,13.2,2585,923,1662,5.7,16,-447,-2.8,26.4,0,164,164,794
2013,28,g) 6 to 10,6925,7401,67858,68832,211,2.8,790,10.3,8704,948,7756,1.4,12.6,10651,4052,6599,5.9,15.5,-1947,-2.9,25.2,0,584,588,3384
2013,28,h) 11 to 15,5244,5691,59833,61254,149,2.6,440,7.6,6433,762,5671,1.2,10.5,9274,2323,6951,3.8,15.1,-2841,-4.6,21,0,324,324,1786
2013,28,i) 16 to 20,3931,4310,52435,52788,100,2.3,296,6.7,5118,703,4415,1.3,9.7,5824,1979,3845,3.7,11,-706,-1.3,19.4,0,215,216,1646
2013,28,j) 21 to 25,2850,3384,57637,57884,81,2.4,198,5.8,5169,334,4835,0.6,8.9,5662,1455,4207,2.5,9.8,-493,-0.9,17.8,0,141,141,841
2013,28,k) 26+,5599,7992,160817,160569,166,2.1,342,4.2,13003,1784,11219,1.1,8.1,12507,2335,10172,1.5,7.8,496,0.3,15.6,0,225,227,1404
2013,28,l) Left Censored,4824,13781,408458,407250,492,3.6,478,3.5,32034,6354,25680,1.6,7.9,29618,3842,25776,0.9,7.3,2416,0.6,14.6,0,121,134,1486
2013,29,a) 0,8979,9031,39387,19836,8934,197.9,0,0,39103,,,,197.1,0,0,0,0,0,39103,197.1,0,1,,,
2013,29,b) 1,5816,5854,38025,39993,19,0.3,1871,27.6,9137,,,,22.8,13072,8364,4708,20.9,32.7,-3935,-9.9,45.6,1,1421,1421,6899
2013,29,c) 2,4662,4857,32780,33566,159,3,1004,19.1,5932,651,5281,1.9,17.7,7504,4104,3400,12.2,22.4,-1572,-4.7,35.4,0,766,767,3444
2013,29,d) 3,3988,4123,31893,32081,194,4.5,632,14.6,5362,727,4635,2.3,16.7,5737,2819,2918,8.8,17.9,-375,-1.2,33.4,0,490,490,2361
2013,29,e) 4,3703,3896,34574,35159,147,3.6,525,12.9,4372,423,3949,1.2,12.4,5542,2111,3431,6,15.8,-1170,-3.4,24.8,0,388,388,1706
2013,29,f) 5,3838,4120,35562,37357,145,3.4,556,12.9,4711,545,4166,1.5,12.6,8300,2849,5451,7.6,22.2,-3589,-9.6,25.2,0,429,429,2526
2013,29,g) 6 to 10,17514,18391,169518,171941,626,3.3,2067,10.9,20572,2482,18090,1.4,12,25418,9729,15689,5.7,14.8,-4846,-2.8,24,0,1453,1460,6748
2013,29,h) 11 to 15,12355,13632,156107,157232,402,2.9,1156,8.3,16263,2744,13519,1.7,10.3,18512,6300,12212,4,11.8,-2249,-1.5,20.6,0,770,776,4941
2013,29,i) 16 to 20,9412,10396,138048,136923,308,2.9,818,7.7,17522,2423,15099,1.8,12.8,15272,4884,10388,3.6,11.2,2250,1.6,22.4,0,545,553,3208
2013,29,j) 21 to 25,7318,9077,144771,145290,238,2.6,612,6.6,13883,2967,10916,2,9.6,14920,4680,10240,3.2,10.3,-1037,-0.7,19.2,0,363,364,2489
2013,29,k) 26+,12716,19319,438756,434100,495,2.5,911,4.7,44007,10181,33826,2.3,10.1,34695,8856,25839,2,8,9312,2.1,16,0,560,587,3956
2013,29,l) Left Censored,11181,30695,1101155,1093258,1381,4.5,1274,4.2,102514,18041,84473,1.7,9.4,86720,18079,68641,1.7,7.9,15794,1.5,15.8,0,322,327,3568
2013,30,a) 0,1913,1916,8147,4109,1891,197.4,0,0,8077,,,,196.6,0,0,0,0,0,8077,196.6,0,1,,,
2013,30,b) 1,1485,1494,7307,7682,2,0.1,436,25.5,1495,,,,19.5,2244,1445,799,18.8,29.2,-749,-9.7,39,1,291,291,1138
2013,30,c) 2,1205,1223,7301,7326,56,4.3,221,17.1,1325,128,1197,1.7,18.1,1374,679,695,9.3,18.8,-49,-0.7,36.2,0,153,153,556
2013,30,d) 3,1040,1052,6151,6363,49,4.4,186,16.7,928,120,808,1.9,14.6,1351,597,754,9.4,21.2,-423,-6.6,29.2,0,128,128,486
2013,30,e) 4,1095,1123,6734,6664,49,4.2,143,12.3,1076,108,968,1.6,16.1,935,424,511,6.4,14,141,2.1,28,0,100,100,337
2013,30,f) 5,1189,1255,7744,7769,79,6.1,156,12.1,1222,289,933,3.7,15.7,1272,484,788,6.2,16.4,-50,-0.7,31.4,0,86,86,349
2013,30,g) 6 to 10,5403,5542,43144,43460,302,5.3,639,11.2,4960,759,4201,1.7,11.4,5591,2323,3268,5.3,12.9,-631,-1.5,22.8,0,384,384,1579
2013,30,h) 11 to 15,3680,3885,31747,31765,167,4.2,337,8.5,3776,784,2992,2.5,11.9,3812,1329,2483,4.2,12,-36,-0.1,23.8,0,211,211,999
2013,30,i) 16 to 20,2667,2771,24692,24467,87,3.1,197,7,3362,619,2743,2.5,13.7,2912,1202,1710,4.9,11.9,450,1.8,23.8,0,123,123,1026
2013,30,j) 21 to 25,1735,1917,20151,20225,59,3,124,6.4,1845,361,1484,1.8,9.1,1992,530,1462,2.6,9.8,-147,-0.7,18.2,0,77,77,345
2013,30,k) 26+,2882,3953,64395,64234,112,2.8,199,5,5922,1044,4878,1.6,9.2,5600,1266,4334,2,8.7,322,0.5,17.4,0,104,105,549
2013,30,l) Left Censored,2308,5191,124077,120683,246,4.8,195,3.8,14890,5910,8980,4.9,12.3,8102,1253,6849,1,6.7,6788,5.6,13.4,0,63,69,538
2013,31,a) 0,2321,2324,11186,5631,2287,196.8,0,0,11110,,,,197.3,0,0,0,0,0,11110,197.3,0,1,,,
2013,31,b) 1,1890,1896,11268,11798,1,0,484,22.6,2337,,,,19.8,3396,2261,1135,19.2,28.8,-1059,-9,39.6,1,346,346,1946
2013,31,c) 2,1588,1620,11675,11487,61,3.5,296,17.2,2594,193,2401,1.7,22.6,2217,1182,1035,10.3,19.3,377,3.3,38.6,0,208,208,970
2013,31,d) 3,1432,1461,10432,10711,45,2.9,207,13.5,1411,275,1136,2.6,13.2,1968,1069,899,10,18.4,-557,-5.2,26.4,0,139,141,884
2013,31,e) 4,1416,1440,10717,10579,37,2.5,184,12.2,1801,147,1654,1.4,17,1525,613,912,5.8,14.4,276,2.6,28.8,0,128,128,487
2013,31,f) 5,1430,1489,11712,12151,51,3.3,155,10.1,1409,134,1275,1.1,11.6,2286,690,1596,5.7,18.8,-877,-7.2,23.2,0,114,114,593
2013,31,g) 6 to 10,6260,6488,52233,52747,198,3,595,8.9,5883,742,5141,1.4,11.2,6910,2446,4464,4.6,13.1,-1027,-1.9,22.4,0,400,401,1934
2013,31,h) 11 to 15,4786,5215,58570,58738,162,3.1,365,6.9,5231,652,4579,1.1,8.9,5566,1738,3828,3,9.5,-335,-0.6,17.8,0,252,252,1384
2013,31,i) 16 to 20,3547,3858,44518,45518,110,2.8,243,6.2,4734,628,4106,1.4,10.4,6733,1085,5648,2.4,14.8,-1999,-4.4,20.8,0,155,156,921
2013,31,j) 21 to 25,2671,3258,57251,58442,100,3,264,7.9,6577,1234,5343,2.1,11.3,8959,2736,6223,4.7,15.3,-2382,-4,22.6,0,156,157,1202
2013,31,k) 26+,4945,7106,140547,143043,160,2.2,330,4.6,13447,2094,11353,1.5,9.4,18439,6275,12164,4.4,12.9,-4992,-3.5,18.8,0,194,196,1619
2013,31,l) Left Censored,4944,11097,358974,357199,505,4.6,414,3.7,31011,7400,23611,2.1,8.7,27461,4669,22792,1.3,7.7,3550,1,15.4,0,162,165,1976
2013,32,a) 0,4365,4396,28880,14540,4348,197.8,0,0,28681,,,,197.3,0,0,0,0,0,28681,197.3,0,1,,,
2013,32,b) 1,3081,3106,25376,26682,8,0.2,1130,30.8,6539,,,,24.5,9150,6110,3040,22.9,34.3,-2611,-9.8,49,1,826,827,5253
2013,32,c) 2,2655,2694,26113,25832,119,4,640,21.7,5587,600,4987,2.3,21.6,5024,2695,2329,10.4,19.4,563,2.2,38.8,0,482,488,2267
2013,32,d) 3,2246,2316,27739,31704,87,3.5,395,16.1,4893,722,4171,2.3,15.4,12823,2800,10023,8.8,40.4,-7930,-25,30.8,0,296,296,2397
2013,32,e) 4,2098,2217,19735,20339,92,3.9,337,14.5,3223,706,2517,3.5,15.8,4430,2023,2407,9.9,21.8,-1207,-6,31.6,0,268,268,1811
2013,32,f) 5,2215,2325,24025,24280,93,3.9,293,12.1,3788,758,3030,3.1,15.6,4298,1786,2512,7.4,17.7,-510,-2.1,31.2,0,219,220,1510
2013,32,g) 6 to 10,8491,8936,97995,100908,338,3.7,989,10.7,12548,1274,11274,1.3,12.4,18373,9379,8994,9.3,18.2,-5825,-5.8,24.8,0,692,703,8117
2013,32,h) 11 to 15,4987,5598,92280,92742,259,4.5,520,9.1,9903,1765,8138,1.9,10.7,10827,4139,6688,4.5,11.7,-924,-1,21.4,0,353,355,2637
2013,32,i) 16 to 20,2903,3420,65770,64990,136,3.9,297,8.5,9905,2135,7770,3.3,15.2,8345,2925,5420,4.5,12.8,1560,2.4,25.6,0,210,211,2053
2013,32,j) 21 to 25,1943,2564,53420,53367,82,3.1,208,7.9,4896,1185,3711,2.2,9.2,4790,1418,3372,2.7,9,106,0.2,18,0,127,127,799
2013,32,k) 26+,3224,5755,170886,168377,264,4.6,292,5.1,22343,4759,17584,2.8,13.3,17324,3616,13708,2.1,10.3,5019,3,20.6,0,153,167,1684
2013,32,l) Left Censored,2746,9239,407772,405539,524,5.7,454,4.9,41399,13094,28305,3.2,10.2,36933,10256,26677,2.5,9.1,4466,1.1,18.2,0,48,57,1034
2013,33,a) 0,1611,1621,8347,4184,1608,198.4,0,0,8327,8327,0,199,199,0,0,0,0,0,8327,199,0,0,,,
2013,33,b) 1,1336,1341,8650,10268,4,0.3,389,25.4,2169,35,2134,0.3,21.1,5405,1663,3742,16.2,52.6,-3236,-31.5,42.2,0,287,287,1427
2013,33,c) 2,1149,1157,7552,7408,36,2.9,200,16.2,1803,157,1646,2.1,24.3,1515,892,623,12,20.5,288,3.8,41,0,152,152,644
2013,33,d) 3,1027,1062,9329,9357,33,2.9,163,14.5,1536,118,1418,1.3,16.4,1591,899,692,9.6,17,-55,-0.6,32.8,0,123,123,745
2013,33,e) 4,967,1011,6967,7082,52,5,123,11.8,1053,204,849,2.9,14.9,1283,529,754,7.5,18.1,-230,-3.2,29.8,0,100,100,480
2013,33,f) 5,1058,1096,11757,11693,44,3.8,152,13.3,1880,568,1312,4.9,16.1,1752,918,834,7.9,15,128,1.1,30,0,121,121,812
2013,33,g) 6 to 10,4601,4789,42688,42690,162,3.3,451,9.2,5241,726,4515,1.7,12.3,5244,1858,3386,4.4,12.3,-3,0,24.6,0,311,311,1419
2013,33,h) 11 to 15,3505,3758,39060,39865,130,3.4,278,7.3,3631,544,3087,1.4,9.1,5241,1801,3440,4.5,13.1,-1610,-4,18.2,0,189,192,1262
2013,33,i) 16 to 20,2903,3040,32688,32894,93,3,232,7.5,3395,443,2952,1.3,10.3,3806,1193,2613,3.6,11.6,-411,-1.3,20.6,0,162,162,1036
2013,33,j) 21 to 25,2208,2542,36829,36893,54,2.1,153,5.9,3707,1270,2437,3.4,10,3835,1086,2749,2.9,10.4,-128,-0.4,20,0,88,88,480
2013,33,k) 26+,3536,4779,89979,90252,134,2.8,271,5.6,8068,1660,6408,1.8,8.9,8613,2555,6058,2.8,9.5,-545,-0.6,17.8,0,121,122,604
2013,33,l) Left Censored,2991,7140,249208,248922,399,5.6,316,4.5,21137,4445,16692,1.8,8.5,20565,3911,16654,1.6,8.3,572,0.2,16.6,0,68,68,992
2013,34,a) 0,13016,13054,74887,37611,12905,197.7,0,0,74553,74553,0,198.2,198.2,0,0,0,0,0,74553,198.2,0,0,,,
2013,34,b) 1,10206,10242,66622,67985,13,0.1,3170,26.8,15876,272,15604,0.4,23.4,18601,11531,7070,17,27.4,-2725,-4,46.8,0,2205,2205,9068
2013,34,c) 2,8604,8688,65480,72720,344,3.7,1630,17.6,12481,1140,11341,1.6,17.2,26960,13946,13014,19.2,37.1,-14479,-19.9,34.4,0,1188,1188,12575
2013,34,d) 3,7120,7266,70006,68367,311,4,1216,15.8,18685,1462,17223,2.1,27.3,15407,8442,6965,12.3,22.5,3278,4.8,45,0,871,871,6796
2013,34,e) 4,6699,6808,61197,60300,272,3.8,936,13.2,12008,916,11092,1.5,19.9,10214,4310,5904,7.1,16.9,1794,3,33.8,0,682,682,3537
2013,34,f) 5,6989,7154,66117,68630,306,4.1,975,13.1,8396,1173,7223,1.7,12.2,13422,5212,8210,7.6,19.6,-5026,-7.4,24.4,0,672,673,4004
2013,34,g) 6 to 10,29919,30744,292999,293440,1249,3.9,3439,10.9,42632,6200,36432,2.1,14.5,43514,19356,24158,6.6,14.8,-882,-0.3,29,0,2365,2371,13194
2013,34,h) 11 to 15,22090,23453,287577,287042,730,3,2096,8.7,35939,5463,30476,1.9,12.5,34869,12647,22222,4.4,12.1,1070,0.4,24.2,0,1335,1365,9328
2013,34,i) 16 to 20,16506,17416,216744,216719,578,3.3,1344,7.6,24977,4402,20575,2,11.5,24926,7267,17659,3.4,11.5,51,0,23,0,916,916,5290
2013,34,j) 21 to 25,12271,13753,203114,204198,434,3.1,917,6.6,19751,3725,16026,1.8,9.7,21918,7087,14831,3.5,10.7,-2167,-1,19.4,0,592,593,4102
2013,34,k) 26+,19655,26156,579589,578068,809,3.1,1558,5.9,54304,11266,43038,1.9,9.4,51262,15109,36153,2.6,8.9,3042,0.5,17.8,0,915,920,7187
2013,34,l) Left Censored,15982,38788,1475961,1472390,2123,5.5,1986,5.1,158041,31026,127015,2.1,10.7,150899,36229,114670,2.5,10.2,7142,0.5,20.4,0,532,545,5466
2013,35,a) 0,2114,2125,13778,6920,2098,197.5,0,0,13716,,,,198.2,0,0,0,0,0,13716,198.2,0,1,,,
2013,35,b) 1,1727,1749,12797,13342,1,0,552,27.3,3682,,,,27.6,4771,3132,1639,23.5,35.8,-1089,-8.2,55.2,1,420,420,2778
2013,35,c) 2,1436,1462,11456,11630,58,3.7,252,16.3,2049,336,1713,2.9,17.6,2396,1309,1087,11.3,20.6,-347,-3,35.2,0,200,200,1133
2013,35,d) 3,1188,1211,9478,9985,53,4.2,186,14.6,1547,207,1340,2.1,15.5,2561,993,1568,9.9,25.6,-1014,-10.1,31,0,133,133,748
2013,35,e) 4,1246,1266,10995,10875,44,3.3,195,14.6,1872,119,1753,1.1,17.2,1631,832,799,7.7,15,241,2.2,30,0,154,154,692
2013,35,f) 5,1329,1395,12043,12890,56,3.9,181,12.5,1401,228,1173,1.8,10.9,3095,1671,1424,13,24,-1694,-13.1,21.8,0,136,136,1524
2013,35,g) 6 to 10,5610,5855,61626,63651,230,3.8,644,10.7,5977,856,5121,1.3,9.4,10026,3114,6912,4.9,15.8,-4049,-6.4,18.8,0,456,456,2412
2013,35,h) 11 to 15,4026,4403,50961,53214,125,2.8,379,8.4,4588,619,3969,1.2,8.6,9093,1774,7319,3.3,17.1,-4505,-8.5,17.2,0,265,265,1334
2013,35,i) 16 to 20,3143,3426,39540,38977,128,3.7,285,8.2,5499,1969,3530,5.1,14.1,4373,1056,3317,2.7,11.2,1126,2.9,22.4,0,177,179,731
2013,35,j) 21 to 25,2238,2813,38144,38494,94,3.3,225,7.9,4057,478,3579,1.2,10.5,4757,2176,2581,5.7,12.4,-700,-1.9,21,0,128,134,881
2013,35,k) 26+,4015,5782,114694,115953,156,2.7,291,5,9312,1250,8062,1.1,8,11829,1999,9830,1.7,10.2,-2517,-2.2,16,0,171,184,1160
2013,35,l) Left Censored,3042,8193,220673,218101,355,4.3,354,4.3,27097,6401,20696,2.9,12.4,21952,6118,15834,2.8,10.1,5145,2.3,20.2,0,85,86,972
2013,36,a) 0,33484,33605,165884,83373,33276,198,0,0,165022,165022,0,197.9,197.9,0,0,0,0,0,165022,197.9,0,0,,,
2013,36,b) 1,26940,27046,157578,162585,15,0,7737,25,37665,709,36956,0.4,23.2,47678,28255,19423,17.4,29.3,-10013,-6.1,46.4,0,5334,5334,21300
2013,36,c) 2,23664,23911,165134,168549,982,3.8,4502,17.6,29862,3998,25864,2.4,17.7,36691,19150,17541,11.4,21.8,-6829,-4.1,35.4,0,3194,3240,14595
2013,36,d) 3,20455,20961,161675,161936,873,3.9,3360,15.2,28299,3068,25231,1.9,17.5,28821,15197,13624,9.4,17.8,-522,-0.3,35,0,2407,2410,11565
2013,36,e) 4,18189,18431,143536,145806,771,4,2692,13.9,22418,3173,19245,2.2,15.4,26958,13139,13819,9,18.5,-4540,-3.1,30.8,0,1891,1893,9859
2013,36,f) 5,17625,18170,151850,152536,778,4.1,2357,12.5,22273,2746,19527,1.8,14.6,23644,10821,12823,7.1,15.5,-1371,-0.9,29.2,0,1611,1611,7408
2013,36,g) 6 to 10,69023,71142,646072,652440,2598,3.5,7860,10.7,85180,12739,72441,2,13.1,97916,42398,55518,6.5,15,-12736,-1.9,26.2,0,5198,5227,29277
2013,36,h) 11 to 15,47451,50545,636795,637490,1582,3.1,4394,8.5,71424,10468,60956,1.6,11.2,72813,27012,45801,4.2,11.4,-1389,-0.2,22.4,0,2686,2723,17609
2013,36,i) 16 to 20,33787,35599,446414,449718,1014,2.8,2659,7.3,46539,7864,38675,1.7,10.3,53147,16575,36572,3.7,11.8,-6608,-1.5,20.6,0,1739,1744,11186
2013,36,j) 21 to 25,26941,30575,437059,438284,1010,3.3,2074,6.7,45230,9605,35625,2.2,10.3,47680,13674,34006,3.1,10.9,-2450,-0.6,20.6,0,1232,1234,8347
2013,36,k) 26+,42188,57002,1278024,1275180,1613,2.8,3261,5.6,136500,35609,100891,2.8,10.7,130813,39841,90972,3.1,10.3,5687,0.4,20.6,0,1859,1885,14694
2013,36,l) Left Censored,35394,81894,3289469,3273748,3524,4.3,4855,5.9,306798,70920,235878,2.2,9.4,275356,60250,215106,1.8,8.4,31442,1,16.8,0,1262,1283,17997
2013,37,a) 0,11162,11214,59082,29708,11083,197.7,0,0,58748,58748,0,197.8,197.8,0,0,0,0,0,58748,197.8,0,0,,,
2013,37,b) 1,8671,8730,54773,58173,10,0.1,2619,26.1,13364,191,13173,0.3,23,20164,13028,7136,22.4,34.7,-6800,-11.7,46,0,1960,1960,10515
2013,37,c) 2,7622,7750,59943,60294,320,3.9,1437,17.4,11120,1266,9854,2.1,18.4,11821,6511,5310,10.8,19.6,-701,-1.2,36.8,0,1094,1094,5282
2013,37,d) 3,6731,6920,66610,67334,251,3.5,1070,14.7,10585,1576,9009,2.3,15.7,12032,6053,5979,9,17.9,-1447,-2.2,31.4,0,796,798,4851
2013,37,e) 4,6100,6328,51678,52914,242,3.7,827,12.6,7621,934,6687,1.8,14.4,10093,4593,5500,8.7,19.1,-2472,-4.7,28.8,0,625,625,3765
2013,37,f) 5,6572,6970,61473,61597,286,3.9,895,12.4,9388,1008,8380,1.6,15.2,9635,4502,5133,7.3,15.6,-247,-0.4,30.4,0,641,641,3650
2013,37,g) 6 to 10,27682,29243,277956,280038,1069,3.6,3056,10.2,35295,4799,30496,1.7,12.6,39459,15614,23845,5.6,14.1,-4164,-1.5,25.2,0,2167,2174,12207
2013,37,h) 11 to 15,19157,21076,320888,315743,684,3.2,1740,8.1,44366,4078,40288,1.3,14.1,34075,10899,23176,3.5,10.8,10291,3.3,21.6,0,1204,1210,7977
2013,37,i) 16 to 20,13486,15147,184802,185802,518,3.4,1126,7.3,18812,3743,15069,2,10.1,20811,6643,14168,3.6,11.2,-1999,-1.1,20.2,0,752,753,4964
2013,37,j) 21 to 25,9889,12525,221257,218494,476,3.8,809,6.4,27248,10063,17185,4.6,12.5,21721,4808,16913,2.2,9.9,5527,2.6,19.8,0,510,511,2731
2013,37,k) 26+,17295,26680,578840,571892,923,3.4,1350,5,72367,19185,53182,3.4,12.7,58471,20107,38364,3.5,10.2,13896,2.5,20.4,0,740,745,5464
2013,37,l) Left Censored,12860,43838,1477276,1483656,2185,5,1807,4.1,139575,36498,103077,2.5,9.4,152335,25819,126516,1.7,10.3,-12760,-0.9,18.8,0,409,420,4452
2013,38,a) 0,1508,1513,8808,4424,1500,198.3,0,0,8769,8769,0,198.2,198.2,0,0,0,0,0,8769,198.2,0,0,,,
2013,38,b) 1,1213,1232,9747,9732,11,0.8,364,25.8,2962,181,2781,1.9,30.4,2931,1665,1266,17.1,30.1,31,0.3,60.2,0,271,271,1314
2013,38,c) 2,826,844,5936,5963,33,3.7,142,15.8,1248,157,1091,2.6,20.9,1301,704,597,11.8,21.8,-53,-0.9,41.8,0,101,101,601
2013,38,d) 3,625,649,5586,5629,22,3.3,80,11.8,810,65,745,1.2,14.4,895,457,438,8.1,15.9,-85,-1.5,28.8,0,53,53,367
2013,38,e) 4,647,663,5712,5837,19,2.7,81,11.7,747,149,598,2.6,12.8,997,479,518,8.2,17.1,-250,-4.3,25.6,0,60,60,403
2013,38,f) 5,634,655,6396,6303,18,2.6,77,11.3,1200,155,1045,2.5,19,1014,550,464,8.7,16.1,186,2.9,32.2,0,56,56,490
2013,38,g) 6 to 10,2622,2744,25872,26175,76,2.7,245,8.7,3255,423,2832,1.6,12.4,3860,1298,2562,5,14.7,-605,-2.3,24.8,0,167,167,954
2013,38,h) 11 to 15,1797,2001,21434,21901,65,3.2,149,7.3,2255,314,1941,1.4,10.3,3188,1017,2171,4.6,14.6,-933,-4.3,20.6,0,98,98,850
2013,38,i) 16 to 20,1460,1527,18301,18311,49,3.2,107,6.9,1742,175,1567,1,9.5,1761,512,1249,2.8,9.6,-19,-0.1,19,0,72,72,434
2013,38,j) 21 to 25,1148,1285,17873,17712,42,3.2,83,6.4,2182,197,1985,1.1,12.3,1860,405,1455,2.3,10.5,322,1.8,21,0,56,56,313
2013,38,k) 26+,2365,3230,53143,52465,113,3.5,140,4.3,6689,1104,5585,2.1,12.7,5332,2137,3195,4.1,10.2,1357,2.5,20.4,0,92,92,1062
2013,38,l) Left Censored,2356,4911,158258,155197,238,4.9,158,3.2,19829,5075,14754,3.3,12.8,13706,3530,10176,2.3,8.8,6123,4,17.6,0,53,53,1034
2013,39,a) 0,9956,10038,65945,33290,9936,198,0,0,65311,65311,0,196.2,196.2,0,0,0,0,0,65311,196.2,0,0,,,
2013,39,b) 1,8085,8180,63932,66004,27,0.3,2303,24.7,16319,792,15527,1.2,24.7,20463,12734,7729,19.3,31,-4144,-6.3,49.4,0,1653,1657,10744
2013,39,c) 2,6851,7038,66054,64780,269,3.6,1205,16.1,14488,1004,13484,1.5,22.4,11940,5782,6158,8.9,18.4,2548,4,36.8,0,933,933,4716
2013,39,d) 3,5779,6147,75827,74590,160,2.5,870,13.4,13709,779,12930,1,18.4,11235,5191,6044,7,15.1,2474,3.3,30.2,0,664,664,4357
2013,39,e) 4,5649,5864,60110,59792,179,2.9,702,11.5,9779,1069,8710,1.8,16.4,9142,3674,5468,6.1,15.3,637,1.1,30.6,0,527,527,3093
2013,39,f) 5,6036,6399,65362,66654,239,3.6,716,10.8,8193,1006,7187,1.5,12.3,10776,3575,7201,5.4,16.2,-2583,-3.9,24.6,0,541,541,2896
2013,39,g) 6 to 10,26307,27805,305028,309394,876,3.1,2733,9.5,36004,5792,30212,1.9,11.6,44736,18060,26676,5.8,14.5,-8732,-2.9,23.2,0,1973,1977,14177
2013,39,h) 11 to 15,20754,23098,290210,294321,670,2.8,1840,7.8,29666,3745,25921,1.3,10.1,37887,13444,24443,4.6,12.9,-8221,-2.8,20.2,0,1178,1181,9755
2013,39,i) 16 to 20,17158,19517,266673,268523,575,2.9,1361,6.9,31426,7129,24297,2.7,11.7,35125,12152,22973,4.5,13.1,-3699,-1.4,23.4,0,870,873,9247
2013,39,j) 21 to 25,13584,16825,293550,284280,553,3.2,1069,6.3,48215,6413,41802,2.3,17,29674,8888,20786,3.1,10.4,18541,6.6,20.8,0,670,676,5307
2013,39,k) 26+,23908,36383,797177,793038,1209,3.3,1824,5,86923,21768,65155,2.7,11,78645,22625,56020,2.9,9.9,8278,1.1,19.8,0,917,937,7695
2013,39,l) Left Censored,22683,61279,2232457,2225392,2677,4.4,2709,4.4,210536,39574,170962,1.8,9.5,196406,38435,157971,1.7,8.8,14130,0.7,17.6,0,713,730,7934
2013,40,a) 0,4844,4906,28764,14545,4858,198,0,0,28438,28438,0,195.5,195.5,0,0,0,0,0,28438,195.5,0,0,,,
2013,40,b) 1,3850,3881,25640,26609,5,0.1,1061,24.1,6187,25,6162,0.1,23.3,8125,4948,3177,18.6,30.5,-1938,-7.2,46.6,0,812,812,4353
2013,40,c) 2,3224,3296,25182,26068,133,3.8,577,16.5,4548,570,3978,2.2,17.4,6319,3253,3066,12.5,24.2,-1771,-6.8,34.8,0,437,450,2917
2013,40,d) 3,2694,2788,25149,26486,91,3.1,419,14.3,3449,558,2891,2.1,13,6122,2787,3335,10.5,23.1,-2673,-10.1,26,0,316,316,2443
2013,40,e) 4,2748,2855,25851,26122,87,2.9,391,13.1,3718,442,3276,1.7,14.2,4259,1931,2328,7.4,16.3,-541,-2.1,28.4,0,276,276,1631
2013,40,f) 5,2852,2955,25742,26143,101,3.3,332,10.9,3257,357,2900,1.4,12.5,4058,1545,2513,5.9,15.5,-801,-3,25,0,251,251,1268
2013,40,g) 6 to 10,11443,12068,123680,125418,370,3,1147,9.3,15093,1904,13189,1.5,12,18569,6950,11619,5.5,14.8,-3476,-2.8,24,0,814,816,5558
2013,40,h) 11 to 15,8140,8995,102769,103018,220,2.4,668,7.3,12373,1366,11007,1.3,12,12871,4285,8586,4.2,12.5,-498,-0.5,24,0,454,454,3440
2013,40,i) 16 to 20,5962,6652,73658,73017,198,2.9,461,6.8,9461,2009,7452,2.8,13,8178,2427,5751,3.3,11.2,1283,1.8,22.4,0,301,301,1403
2013,40,j) 21 to 25,4438,5484,84500,86736,227,4.1,330,6,8592,2696,5896,3.1,9.9,13064,5341,7723,6.2,15.1,-4472,-5.2,19.8,0,210,210,4300
2013,40,k) 26+,8543,12364,260461,258613,350,2.8,590,4.7,25382,5463,19919,2.1,9.8,21686,5681,16005,2.2,8.4,3696,1.4,16.8,0,375,390,3875
2013,40,l) Left Censored,6249,17209,514731,506714,705,4.1,609,3.6,56240,13118,43122,2.6,11.1,40205,8888,31317,1.8,7.9,16035,3.2,15.8,0,171,171,1616
2013,41,a) 0,5822,5839,27149,13657,5784,198.1,0,0,26985,26985,0,197.6,197.6,0,0,0,0,0,26985,197.6,0,0,,,
2013,41,b) 1,4578,4602,26378,27419,8,0.2,1331,25.3,6523,71,6452,0.3,23.8,8605,6153,2452,22.4,31.4,-2082,-7.6,47.6,0,908,908,4908
2013,41,c) 2,3985,4083,24779,24781,175,4,725,16.7,4785,589,4196,2.4,19.3,4789,2481,2308,10,19.3,-4,0,38.6,0,542,542,2019
2013,41,d) 3,3407,3530,26722,26056,171,4.7,478,13,5311,718,4593,2.8,20.4,3980,2225,1755,8.5,15.3,1331,5.1,30.6,0,349,354,1746
2013,41,e) 4,3258,3333,23367,23244,157,4.5,461,13.3,4018,542,3476,2.3,17.3,3772,1942,1830,8.4,16.2,246,1.1,32.4,0,333,333,1523
2013,41,f) 5,3607,3759,25446,25763,176,4.5,455,11.7,3896,565,3331,2.2,15.1,4530,1930,2600,7.5,17.6,-634,-2.5,30.2,0,331,331,1573
2013,41,g) 6 to 10,14845,15764,126071,125245,819,5.1,1517,9.5,18356,2841,15515,2.3,14.7,16703,6343,10360,5.1,13.3,1653,1.4,26.6,0,1051,1052,4575
2013,41,h) 11 to 15,10322,11152,108527,109231,430,3.8,907,8,12892,2017,10875,1.8,11.8,14299,4343,9956,4,13.1,-1407,-1.3,23.6,0,578,578,3182
2013,41,i) 16 to 20,7655,8347,96005,94311,300,3.5,610,7.2,12760,2390,10370,2.5,13.5,9371,3012,6359,3.2,9.9,3389,3.6,19.8,0,356,356,2156
2013,41,j) 21 to 25,5287,6214,85316,84950,247,3.9,386,6.1,9007,1388,7619,1.6,10.6,8274,2610,5664,3.1,9.7,733,0.9,19.4,0,260,260,1912
2013,41,k) 26+,8577,12688,265098,261722,389,3,591,4.6,30014,3349,26665,1.3,11.5,23262,4356,18906,1.7,8.9,6752,2.6,17.8,0,368,368,2245
2013,41,l) Left Censored,6430,17685,576132,569376,777,4.4,754,4.3,57388,14644,42744,2.6,10.1,43875,9076,34799,1.6,7.7,13513,2.4,15.4,0,165,167,2194
2013,42,a) 0,12688,12775,74034,37178,12635,197.8,0,0,73713,73713,0,198.3,198.3,0,0,0,0,0,73713,198.3,0,0,,,
2013,42,b) 1,10273,10330,68566,72506,14,0.1,2728,23.3,16061,248,15813,0.3,22.2,23940,14281,9659,19.7,33,-7879,-10.8,44.4,0,1941,1941,12000
2013,42,c) 2,8952,9132,75164,75306,316,3.3,1555,16,14518,1780,12738,2.4,19.3,14801,7452,7349,9.9,19.7,-283,-0.4,38.6,0,1154,1155,6207
2013,42,d) 3,7463,7840,72159,72801,221,2.7,1071,13,10723,848,9875,1.2,14.7,12007,5838,6169,8,16.5,-1284,-1.8,29.4,0,804,804,4772
2013,42,e) 4,7535,7736,68484,68452,251,3.1,933,11.6,10335,1231,9104,1.8,15.1,10271,4357,5914,6.4,15,64,0.1,30,0,692,692,3550
2013,42,f) 5,7873,8240,70925,71854,283,3.3,920,10.8,9619,999,8620,1.4,13.4,11476,4610,6866,6.4,16,-1857,-2.6,26.8,0,638,639,3855
2013,42,g) 6 to 10,34430,36154,363636,371469,1080,2.9,3378,9.1,39345,4495,34850,1.2,10.6,55010,21584,33426,5.8,14.8,-15665,-4.2,21.2,0,2290,2296,17147
2013,42,h) 11 to 15,26698,29114,350605,358518,764,2.6,2244,7.5,34375,5169,29206,1.4,9.6,50201,18630,31571,5.2,14,-15826,-4.4,19.2,0,1455,1465,13594
2013,42,i) 16 to 20,19826,21916,306093,308752,574,2.6,1462,6.6,34540,7591,26949,2.5,11.2,39857,13520,26337,4.4,12.9,-5317,-1.7,22.4,0,950,950,9135
2013,42,j) 21 to 25,16964,20166,292760,293545,590,2.9,1152,5.6,30061,7682,22379,2.6,10.2,31630,7595,24035,2.6,10.8,-1569,-0.6,20.4,0,737,739,5343
2013,42,k) 26+,28158,41604,941446,938584,1351,3.2,2020,4.8,98882,21267,77615,2.3,10.5,93157,20022,73135,2.1,9.9,5725,0.6,19.8,0,1195,1212,10343
2013,42,l) Left Censored,25271,67472,2458430,2457359,3339,5,2979,4.4,217575,55432,162143,2.3,8.9,215432,40694,174738,1.7,8.8,2143,0.1,17.6,0,778,785,11137
2013,44,a) 0,1276,1284,6735,3380,1269,197.7,0,0,6711,,,,198.6,0,0,0,0,0,6711,198.6,0,1,,,
2013,44,b) 1,986,987,6172,6412,1,0.1,337,29.2,1525,,,,23.8,2005,1363,642,21.3,31.3,-480,-7.5,47.6,1,231,231,1038
2013,44,c) 2,845,859,6856,6841,37,4,168,18.3,1152,193,959,2.8,16.8,1122,667,455,9.8,16.4,30,0.4,32.8,0,116,116,558
2013,44,d) 3,747,771,8194,7291,34,4.2,121,14.9,2672,52,2620,0.7,36.6,865,509,356,7,11.9,1807,24.7,23.8,0,83,83,379
2013,44,e) 4,648,660,5180,5131,35,5.1,95,13.9,1042,114,928,2.2,20.3,943,501,442,9.8,18.4,99,1.9,36.8,0,68,68,387
2013,44,f) 5,745,762,7035,7130,30,3.8,101,12.7,898,117,781,1.6,12.6,1088,573,515,8,15.3,-190,-2.7,25.2,0,61,61,161
2013,44,g) 6 to 10,3475,3609,35380,35147,135,3.6,414,11.1,5296,580,4716,1.7,15.1,4829,2137,2692,6.1,13.7,467,1.4,27.4,0,260,260,1640
2013,44,h) 11 to 15,2635,2916,26813,26991,93,3.1,252,8.4,2819,603,2216,2.2,10.4,3175,1009,2166,3.7,11.8,-356,-1.4,20.8,0,152,153,717
2013,44,i) 16 to 20,1994,2045,22329,22455,64,3.1,150,7.2,2263,189,2074,0.8,10.1,2515,652,1863,2.9,11.2,-252,-1.1,20.2,0,88,88,409
2013,44,j) 21 to 25,1775,1948,27544,27937,54,2.7,119,6,2650,722,1928,2.6,9.5,3435,1225,2210,4.4,12.3,-785,-2.8,19,0,67,67,561
2013,44,k) 26+,2826,3529,65624,64800,70,2,185,5.2,6141,884,5257,1.4,9.5,4492,994,3498,1.5,6.9,1649,2.6,13.8,0,116,116,545
2013,44,l) Left Censored,2988,5482,196288,197199,244,4.5,230,4.2,13770,2543,11227,1.3,7,15591,3311,12280,1.7,7.9,-1821,-0.9,14,0,84,84,1226
2013,45,a) 0,5026,5047,29931,15028,4984,197.5,0,0,29807,,,,198.3,0,0,0,0,0,29807,198.3,0,1,,,
2013,45,b) 1,3956,3994,26208,27346,2,0,1074,23.7,6292,,,,23,8568,5184,3384,19,31.3,-2276,-8.3,46,1,800,800,4270
2013,45,c) 2,3408,3497,28290,28879,140,3.8,608,16.4,4607,783,3824,2.7,16,5784,3115,2669,10.8,20,-1177,-4,32,0,484,484,2670
2013,45,d) 3,2970,3059,24369,24530,104,3.2,460,14.3,3889,398,3491,1.6,15.9,4211,2136,2075,8.7,17.2,-322,-1.3,31.8,0,366,366,1840
2013,45,e) 4,2824,2979,30761,31020,99,3.2,401,12.9,3842,320,3522,1,12.4,4360,1888,2472,6.1,14.1,-518,-1.7,24.8,0,299,299,1614
2013,45,f) 5,2944,3095,24420,24723,112,3.5,377,11.7,3553,524,3029,2.1,14.4,4159,1725,2434,7,16.8,-606,-2.4,28.8,0,294,294,1379
2013,45,g) 6 to 10,12873,13507,134326,134849,484,3.5,1329,9.6,17606,2573,15033,1.9,13.1,18652,6594,12058,4.9,13.8,-1046,-0.7,26.2,0,972,974,5217
2013,45,h) 11 to 15,9247,10151,128906,131228,269,2.6,845,8.1,13015,1514,11501,1.2,9.9,17659,5086,12573,3.9,13.5,-4644,-3.6,19.8,0,574,583,3570
2013,45,i) 16 to 20,6430,6982,104119,102751,230,3.2,479,6.8,11151,2148,9003,2.1,10.9,8415,2081,6334,2,8.2,2736,2.7,16.4,0,316,316,1366
2013,45,j) 21 to 25,4752,5966,92549,92163,213,3.5,379,6.3,10198,2996,7202,3.3,11.1,9425,2455,6970,2.7,10.2,773,0.9,20.4,0,235,238,1250
2013,45,k) 26+,8226,12749,263765,261093,364,2.8,641,5,29708,4684,25024,1.8,11.4,24364,6082,18282,2.3,9.3,5344,2.1,18.6,0,330,356,2350
2013,45,l) Left Censored,6606,21017,675513,669956,915,4.4,839,4,66763,15155,51608,2.3,10,55649,9983,45666,1.5,8.3,11114,1.7,16.6,0,194,201,1555
2013,46,a) 0,1220,1224,5455,2756,1206,197.1,0,0,5398,,,,195.9,0,0,0,0,0,5398,195.9,0,1,,,
2013,46,b) 1,989,991,5328,6195,3,0.3,284,25.1,1096,,,,17.7,2830,2025,805,32.7,45.7,-1734,-28,35.4,1,195,195,1762
2013,46,c) 2,780,794,6922,7049,32,3.8,144,17,910,79,831,1.1,12.9,1164,370,794,5.2,16.5,-254,-3.6,25.8,0,89,89,247
2013,46,d) 3,712,752,5813,5867,23,2.9,103,13.1,775,89,686,1.5,13.2,882,382,500,6.5,15,-107,-1.8,26.4,0,75,75,323
2013,46,e) 4,778,789,6475,6451,25,3.1,90,11,950,68,882,1.1,14.7,901,362,539,5.6,14,49,0.7,28,0,66,66,306
2013,46,f) 5,767,796,5485,5693,19,2.3,89,10.8,508,48,460,0.8,8.9,924,383,541,6.7,16.2,-416,-7.3,17.8,0,57,57,326
2013,46,g) 6 to 10,3334,3464,28790,28572,102,2.9,313,8.8,4094,589,3505,2.1,14.3,3658,1198,2460,4.2,12.8,436,1.5,25.6,0,217,217,948
2013,46,h) 11 to 15,2578,2750,26658,26895,81,2.9,203,7.2,2933,429,2504,1.6,10.9,3407,1335,2072,5,12.7,-474,-1.8,21.8,0,137,137,1160
2013,46,i) 16 to 20,1838,1954,21084,21477,46,2.3,144,7.2,2005,376,1629,1.8,9.3,2791,945,1846,4.4,13,-786,-3.7,18.6,0,97,97,772
2013,46,j) 21 to 25,1340,1483,19783,20153,43,2.9,91,6.1,1708,243,1465,1.2,8.5,2448,800,1648,4,12.1,-740,-3.6,17,0,53,53,357
2013,46,k) 26+,2330,3230,45856,45824,76,2.3,136,4.2,4143,738,3405,1.6,9,4079,777,3302,1.7,8.9,64,0.1,17.8,0,78,78,480
2013,46,l) Left Censored,2431,4996,155780,154742,149,3,164,3.3,15493,3481,12012,2.2,10,13416,4542,8874,2.9,8.7,2077,1.3,17.4,0,65,65,495
2013,47,a) 0,6337,6348,40367,20265,6292,198.2,0,0,40204,40204,0,198.4,198.4,0,0,0,0,0,40204,198.4,0,0,,,
2013,47,b) 1,4908,4957,41364,42014,8,0.1,1494,26.2,12965,53,12912,0.1,30.9,14265,8763,5502,20.9,34,-1300,-3.1,61.8,0,1201,1201,7624
2013,47,c) 2,4164,4230,43981,41544,132,2.9,856,18.8,12891,646,12245,1.6,31,8016,4635,3381,11.2,19.3,4875,11.7,38.6,0,695,696,4064
2013,47,d) 3,3643,3841,44213,43605,140,3.5,570,14.1,7847,1166,6681,2.7,18,6630,3014,3616,6.9,15.2,1217,2.8,30.4,0,447,449,2178
2013,47,e) 4,3254,3462,33038,34638,122,3.4,484,13.3,4896,421,4475,1.2,14.1,8096,3577,4519,10.3,23.4,-3200,-9.3,28.2,0,393,393,3010
2013,47,f) 5,3656,3960,36227,36482,152,3.7,429,10.5,4721,693,4028,1.9,12.9,5231,2037,3194,5.6,14.3,-510,-1.4,25.8,0,330,330,1618
2013,47,g) 6 to 10,14929,16069,169031,170340,587,3.6,1554,9.4,22153,3297,18856,1.9,13,24771,10058,14713,5.9,14.5,-2618,-1.5,26,0,1163,1165,8252
2013,47,h) 11 to 15,10474,11980,164917,167081,339,2.8,943,7.7,18008,2482,15526,1.5,10.8,22336,7764,14572,4.6,13.4,-4328,-2.6,21.6,0,648,648,5944
2013,47,i) 16 to 20,8374,9457,127338,125838,303,3.2,667,6.9,15678,3646,12032,2.9,12.5,12677,4026,8651,3.2,10.1,3001,2.4,20.2,0,459,459,2892
2013,47,j) 21 to 25,6458,8563,156160,158648,340,3.9,549,6.4,16202,3591,12611,2.3,10.2,21177,4488,16689,2.8,13.3,-4975,-3.1,20.4,0,309,329,2191
2013,47,k) 26+,11860,18471,416341,415919,562,3,905,4.9,38434,5916,32518,1.4,9.2,37590,7713,29877,1.9,9,844,0.2,18,0,509,530,3809
2013,47,l) Left Censored,9298,29412,1122785,1106333,1372,4.7,1290,4.4,128607,30869,97738,2.8,11.6,95702,18255,77447,1.7,8.7,32905,2.9,17.4,0,282,289,2397
2013,48,a) 0,33528,33737,216212,108692,33401,198,0,0,215040,215040,0,197.8,197.8,0,0,0,0,0,215040,197.8,0,0,,,
2013,48,b) 1,26563,26882,210014,213483,56,0.2,7289,23.9,56930,938,55992,0.4,26.7,63867,40210,23657,18.8,29.9,-6937,-3.2,53.4,0,5622,5622,32950
2013,48,c) 2,22017,22731,213658,212435,845,3.5,3989,16.5,47152,7351,39801,3.5,22.2,44705,22648,22057,10.7,21,2447,1.2,42,0,3110,3117,19057
2013,48,d) 3,18256,19033,211494,212456,664,3.3,2770,13.9,36938,3704,33234,1.7,17.4,38861,18918,19943,8.9,18.3,-1923,-0.9,34.8,0,2132,2139,15456
2013,48,e) 4,16925,17798,193308,192376,719,3.9,2331,12.6,32242,3299,28943,1.7,16.8,30377,14848,15529,7.7,15.8,1865,1,31.6,0,1744,1753,12016
2013,48,f) 5,17254,18146,194537,194523,615,3.3,2062,11,31968,4004,27964,2.1,16.4,31940,12766,19174,6.6,16.4,28,0,32.8,0,1563,1563,10250
2013,48,g) 6 to 10,67446,72111,885429,894333,2259,3,7071,9.5,122143,15805,106338,1.8,13.7,139950,57435,82515,6.4,15.6,-17807,-1.9,27.4,0,5106,5121,40332
2013,48,h) 11 to 15,44384,50446,760875,768286,1621,3.2,3852,7.5,91249,14802,76447,1.9,11.9,106070,32381,73689,4.2,13.8,-14821,-1.9,23.8,0,2719,2733,22687
2013,48,i) 16 to 20,32343,37174,617047,618216,1197,3.2,2709,7.2,67880,10601,57279,1.7,11,70218,22637,47581,3.7,11.4,-2338,-0.4,22,0,1793,1801,15898
2013,48,j) 21 to 25,23364,31180,580055,574976,1150,3.7,1888,6,74402,24092,50310,4.2,12.9,64244,18540,45704,3.2,11.2,10158,1.7,22.4,0,1167,1174,9986
2013,48,k) 26+,39006,65582,1518121,1495140,2445,3.7,3263,5,197801,46325,151476,3.1,13.2,151839,44913,106926,3,10.2,45962,3,20.4,0,1743,1771,15332
2013,48,l) Left Censored,23317,99696,3912816,3866616,6079,6.1,4959,5,479318,119660,359658,3.1,12.4,386917,92166,294751,2.4,10,92401,2.4,20,0,722,778,12505
2013,49,a) 0,4730,4765,26061,13413,4709,197.6,0,0,25296,25296,0,188.6,188.6,0,0,0,0,0,25296,188.6,0,0,,,
2013,49,b) 1,3661,3714,32695,31544,18,0.4,1150,26.9,9532,339,9193,1.1,30.2,7230,4825,2405,15.3,22.9,2302,7.3,45.8,0,833,833,4111
2013,49,c) 2,3009,3090,26570,26086,136,4.1,556,17,6971,2559,4412,9.8,26.7,6003,3534,2469,13.5,23,968,3.7,46,0,390,390,2430
2013,49,d) 3,2702,2788,23457,23414,132,4.6,390,13.4,3982,464,3518,2,17,3896,1703,2193,7.3,16.6,86,0.4,33.2,0,270,275,1467
2013,49,e) 4,2377,2445,20636,20484,121,4.8,340,13.4,3826,604,3222,2.9,18.7,3522,1643,1879,8,17.2,304,1.5,34.4,0,238,238,1278
2013,49,f) 5,2633,2753,22053,21696,127,4.5,327,11.5,4452,987,3465,4.5,20.5,3738,1590,2148,7.3,17.2,714,3.3,34.4,0,223,223,1279
2013,49,g) 6 to 10,10570,10923,112631,113175,472,4.2,1198,10.7,17271,1624,15647,1.4,15.3,18359,8186,10173,7.2,16.2,-1088,-0.9,30.6,0,768,773,6101
2013,49,h) 11 to 15,6648,7131,102980,101740,266,3.7,602,8.3,14218,3960,10258,3.9,14,11738,4908,6830,4.8,11.5,2480,2.5,23,0,350,352,3180
2013,49,i) 16 to 20,4159,4587,75525,75547,162,3.5,321,6.9,8197,1711,6486,2.3,10.9,8241,2313,5928,3.1,10.9,-44,0,21.8,0,180,180,1129
2013,49,j) 21 to 25,2613,3235,74240,74546,112,3.4,188,5.8,6619,1075,5544,1.4,8.9,7231,1539,5692,2.1,9.7,-612,-0.8,17.8,0,99,99,995
2013,49,k) 26+,3935,6019,158089,159206,204,3.4,295,4.9,15143,2749,12394,1.7,9.5,17376,5771,11605,3.6,10.9,-2233,-1.4,19,0,133,133,1114
2013,49,l) Left Censored,3286,10331,414281,411584,694,6.8,524,5.1,48147,15184,32963,3.7,11.7,42752,12512,30240,3,10.4,5395,1.3,20.8,0,88,90,7506
2013,50,a) 0,853,854,4746,2382,845,197.9,0,0,4728,,,,198.5,0,0,0,0,0,4728,198.5,0,1,,,
2013,50,b) 1,760,771,4062,4100,1,0.1,221,25.1,1013,,,,24.7,1088,,373,,26.5,-75,-1.8,49.4,1,151,151,
2013,50,c) 2,628,632,4117,4178,18,2.7,110,16.3,759,44,715,1.1,18.2,881,478,403,11.4,21.1,-122,-2.9,36.4,0,79,79,382
2013,50,d) 3,514,519,3334,3405,19,3.5,81,14.8,504,52,452,1.5,14.8,646,390,256,11.5,19,-142,-4.2,29.6,0,55,55,349
2013,50,e) 4,535,546,3491,7623,29,5.2,69,12.3,503,116,387,1.5,6.6,8767,,351,,115,-8264,-108.4,13.2,1,49,49,
2013,50,f) 5,549,570,3990,3982,26,4.4,64,10.9,593,47,546,1.2,14.9,576,257,319,6.5,14.5,17,0.4,29,0,45,45,211
2013,50,g) 6 to 10,2608,2672,18977,20784,100,3.6,278,10.1,2239,231,2008,1.1,10.8,5852,4348,1504,20.9,28.2,-3613,-17.4,21.6,0,184,184,4110
2013,50,h) 11 to 15,2128,2236,26118,26031,56,2.4,168,7.3,2100,307,1793,1.2,8.1,1925,602,1323,2.3,7.4,175,0.7,14.8,0,99,99,313
2013,50,i) 16 to 20,1703,1809,15337,15383,50,2.7,118,6.4,1638,296,1342,1.9,10.6,1730,468,1262,3,11.2,-92,-0.6,21.2,0,76,76,381
2013,50,j) 21 to 25,1459,1550,15413,15685,34,2.1,109,6.9,1290,99,1191,0.6,8.2,1834,510,1324,3.3,11.7,-544,-3.5,16.4,0,70,70,393
2013,50,k) 26+,2273,2927,55487,55004,77,2.6,134,4.5,5728,1318,4410,2.4,10.4,4762,858,3904,1.6,8.7,966,1.7,17.4,0,87,87,653
2013,50,l) Left Censored,1843,3598,102112,102669,129,3.6,147,4.1,7922,1537,6385,1.5,7.7,9035,1761,7274,1.7,8.8,-1113,-1.1,15.4,0,28,28,189
2013,51,a) 0,9780,9844,51282,25867,9728,197.6,0,0,50830,50830,0,196.5,196.5,0,0,0,0,0,50830,196.5,0,0,,,
2013,51,b) 1,7761,7813,50521,51921,12,0.1,2111,23.8,13080,354,12726,0.7,25.2,15880,8963,6917,17.3,30.6,-2800,-5.4,50.4,0,1535,1536,7441
2013,51,c) 2,6719,6835,51657,51596,252,3.5,1123,15.5,10098,1016,9082,2,19.6,9976,4397,5579,8.5,19.3,122,0.3,38.6,0,835,835,3629
2013,51,d) 3,5619,5856,54713,54186,239,3.9,821,13.4,9134,743,8391,1.4,16.9,8079,3723,4356,6.9,14.9,1055,2,29.8,0,610,610,3014
2013,51,e) 4,5645,5820,47939,48056,225,3.7,674,11.2,7655,906,6749,1.9,15.9,7888,2920,4968,6.1,16.4,-233,-0.5,31.8,0,479,480,2123
2013,51,f) 5,5879,6118,56515,56972,235,3.7,713,11.3,8042,741,7301,1.3,14.1,8955,3228,5727,5.7,15.7,-913,-1.6,28.2,0,514,517,2230
2013,51,g) 6 to 10,24645,25656,258849,260540,829,3.1,2717,10.3,33277,3376,29901,1.3,12.8,36658,13097,23561,5,14.1,-3381,-1.3,25.6,0,1869,1872,10265
2013,51,h) 11 to 15,16920,18726,236687,239393,554,2.9,1540,8,26416,3945,22471,1.6,11,31828,8293,23535,3.5,13.3,-5412,-2.3,22,0,991,992,5777
2013,51,i) 16 to 20,12702,13980,177909,180118,453,3.2,995,7,20390,4478,15912,2.5,11.3,24808,9177,15631,5.1,13.8,-4418,-2.5,22.6,0,674,674,7784
2013,51,j) 21 to 25,9692,11976,198074,200697,440,3.6,807,6.7,21284,6384,14900,3.2,10.6,26530,8503,18027,4.2,13.2,-5246,-2.6,21.2,0,452,454,2618
2013,51,k) 26+,15262,23359,522130,517429,784,3.3,1188,5.1,58732,13804,44928,2.7,11.4,49330,11222,38108,2.2,9.5,9402,1.9,19,0,614,620,5665
2013,51,l) Left Censored,11563,39953,1381982,1372247,2610,6.6,2016,5.1,154447,49975,104472,3.6,11.3,134978,26763,108215,2,9.8,19469,1.5,19.6,0,336,346,4981
2013,53,a) 0,10158,10178,44063,22230,10026,197,0,0,43667,43667,0,196.4,196.4,0,0,0,0,0,43667,196.4,0,0,,,
2013,53,b) 1,7526,7596,45442,46423,32,0.4,2437,27.7,11651,129,11522,0.3,25.1,13612,8494,5118,18.3,29.3,-1961,-4.2,50.2,0,1742,1742,6913
2013,53,c) 2,6679,6791,45065,46380,311,4.3,1244,17.3,8437,946,7491,2,18.2,11066,5881,5185,12.7,23.9,-2629,-5.7,36.4,0,901,901,5009
2013,53,d) 3,5575,5754,41228,41110,297,4.9,884,14.7,8039,1553,6486,3.8,19.6,7803,3834,3969,9.3,19,236,0.6,38,0,634,634,2914
2013,53,e) 4,5367,5488,41440,41391,239,4.2,712,12.5,6561,787,5774,1.9,15.9,6463,2821,3642,6.8,15.6,98,0.3,31.2,0,503,503,2059
2013,53,f) 5,5851,6127,45645,45330,334,5.3,786,12.4,7811,1369,6442,3,17.2,7180,3137,4043,6.9,15.8,631,1.4,31.6,0,572,572,2436
2013,53,g) 6 to 10,24258,25481,210919,211118,1158,4.4,2694,10.3,30637,4834,25803,2.3,14.5,31034,13427,17607,6.4,14.7,-397,-0.2,29,0,1854,1868,10680
2013,53,h) 11 to 15,16587,17990,199706,200005,701,3.8,1512,8.3,24718,4670,20048,2.3,12.4,25315,8310,17005,4.2,12.7,-597,-0.3,24.8,0,973,982,6480
2013,53,i) 16 to 20,11750,13063,158616,156671,546,4.1,1043,7.9,21701,5794,15907,3.7,13.9,17812,5827,11985,3.7,11.4,3889,2.5,22.8,0,666,668,3768
2013,53,j) 21 to 25,8506,10127,158837,157208,416,4.1,697,6.8,20220,5175,15045,3.3,12.9,16962,4790,12172,3,10.8,3258,2.1,21.6,0,412,413,1998
2013,53,k) 26+,13192,19699,471552,466047,677,3.4,1038,5.2,47923,9590,38333,2.1,10.3,36913,9719,27194,2.1,7.9,11010,2.4,15.8,0,594,613,3719
2013,53,l) Left Censored,9324,27448,919535,911736,1360,5,1327,4.8,94022,24843,69179,2.7,10.3,78423,24802,53621,2.7,8.6,15599,1.7,17.2,0,260,267,3574
2013,54,a) 0,1325,1326,9084,4559,1315,198.3,0,0,9050,9050,0,198.5,198.5,0,0,0,0,0,9050,198.5,0,0,,,
2013,54,b) 1,1134,1141,7824,9298,0,0,381,28.6,1595,0,1595,0,17.2,4542,2136,2406,23,48.8,-2947,-31.6,34.4,0,291,291,1944
2013,54,c) 2,1016,1056,8221,8721,35,3.1,193,17.2,1035,93,942,1.1,11.9,2035,812,1223,9.3,23.3,-1000,-11.4,23.8,0,157,157,739
2013,54,d) 3,836,903,10217,10446,30,3.2,116,12.3,1297,382,915,3.7,12.4,1754,514,1240,4.9,16.8,-457,-4.4,24.8,0,84,84,373
2013,54,e) 4,831,872,7557,7806,23,2.5,102,11.3,941,113,828,1.4,12.1,1438,418,1020,5.4,18.4,-497,-6.3,24.2,0,74,74,328
2013,54,f) 5,866,920,7287,7612,22,2.3,111,11.6,969,120,849,1.6,12.7,1618,468,1150,6.1,21.3,-649,-8.6,25.4,0,80,80,369
2013,54,g) 6 to 10,4165,4479,43895,44916,115,2.5,491,10.6,5267,561,4706,1.2,11.7,7309,2690,4619,6,16.3,-2042,-4.6,23.4,0,348,348,1934
2013,54,h) 11 to 15,3108,3361,36946,37984,74,2.1,320,9.2,4191,884,3307,2.3,11,6266,2529,3737,6.7,16.5,-2075,-5.5,22,0,190,197,1735
2013,54,i) 16 to 20,2549,2732,30366,30865,58,2.1,208,7.4,2881,249,2632,0.8,9.3,3879,1620,2259,5.2,12.6,-998,-3.3,18.6,0,144,145,1406
2013,54,j) 21 to 25,2076,2460,35757,36396,71,2.8,184,7.3,3169,496,2673,1.4,8.7,4447,1101,3346,3,12.2,-1278,-3.5,17.4,0,124,124,527
2013,54,k) 26+,4018,6024,111596,111092,156,2.6,294,4.8,10534,1042,9492,0.9,9.5,9526,2361,7165,2.1,8.6,1008,0.9,17.2,0,181,181,1468
2013,54,l) Left Censored,3889,9599,260765,260441,434,4.5,373,3.9,24432,6552,17880,2.5,9.4,23783,6491,17292,2.5,9.1,649,0.3,18.2,0,103,104,586
2013,55,a) 0,5600,5629,32692,16430,5569,197.9,0,0,32525,,,,198,0,0,0,0,0,32525,198,0,1,,,
2013,55,b) 1,4348,4381,29651,29889,2,0,1268,25.3,7525,,,,25.2,8000,4769,3231,16,26.8,-475,-1.6,50.4,1,881,881,3811
2013,55,c) 2,3844,4035,30849,30419,197,4.7,617,14.6,5861,741,5120,2.4,19.3,5000,2290,2710,7.5,16.4,861,2.9,32.8,0,450,450,1769
2013,55,d) 3,3304,3430,31754,32233,127,3.5,478,13.3,4417,512,3905,1.6,13.7,5375,2143,3232,6.6,16.7,-958,-3,27.4,0,341,341,1712
2013,55,e) 4,3325,3452,27430,27904,102,2.8,440,12.2,3355,294,3061,1.1,12,4303,1694,2609,6.1,15.4,-948,-3.4,24,0,314,314,1372
2013,55,f) 5,3519,3721,32119,32295,131,3.4,420,10.9,4103,620,3483,1.9,12.7,4454,1610,2844,5,13.8,-351,-1.1,25.4,0,307,307,1331
2013,55,g) 6 to 10,15887,16677,166469,169482,554,3.2,1647,9.6,19498,2316,17182,1.4,11.5,25524,11791,13733,7,15.1,-6026,-3.6,23,0,1100,1108,8849
2013,55,h) 11 to 15,12678,14056,175004,175441,417,2.9,1049,7.3,17523,2639,14884,1.5,10,18397,5248,13149,3,10.5,-874,-0.5,20,0,653,653,3489
2013,55,i) 16 to 20,10067,10872,130757,131344,345,3.1,752,6.8,12598,1714,10884,1.3,9.6,13773,4551,9222,3.5,10.5,-1175,-0.9,19.2,0,454,471,3326
2013,55,j) 21 to 25,7670,8932,133365,133234,239,2.6,582,6.4,12172,1964,10208,1.5,9.1,11910,3080,8830,2.3,8.9,262,0.2,17.8,0,367,372,2095
2013,55,k) 26+,12778,18868,408703,405647,532,2.8,996,5.2,43922,8726,35196,2.2,10.8,37810,9702,28108,2.4,9.3,6112,1.5,18.6,0,522,526,4617
2013,55,l) Left Censored,12372,30281,1193540,1193135,1130,3.7,1248,4.1,91216,17204,74012,1.4,7.6,90406,17591,72815,1.5,7.6,810,0,15.2,0,374,384,5453
2013,56,a) 0,1121,1123,4829,2425,1110,197.7,0,0,4808,,,,198.3,0,0,0,0,0,4808,198.3,0,1,,,
2013,56,b) 1,904,906,4590,4714,2,0.2,296,28.1,1166,,,,24.7,1414,,448,,30,-248,-5.3,49.4,1,208,208,
2013,56,c) 2,743,753,4640,4752,37,4.6,157,19.4,916,166,750,3.5,19.3,1139,526,613,11.1,24,-223,-4.7,38.6,0,113,113,395
2013,56,d) 3,630,637,3993,4157,13,1.9,107,15.7,590,28,562,0.7,14.2,918,512,406,12.3,22.1,-328,-7.9,28.4,0,82,82,278
2013,56,e) 4,642,671,4417,4436,23,3.3,80,11.5,658,122,536,2.8,14.8,695,,424,,15.7,-37,-0.9,29.6,1,49,49,
2013,56,f) 5,718,755,6263,6433,30,3.8,89,11.4,905,90,815,1.4,14.1,1245,332,913,5.2,19.4,-340,-5.3,28.2,0,59,59,223
2013,56,g) 6 to 10,2865,2959,21213,21811,118,3.9,346,11.3,2824,626,2198,2.9,12.9,4020,1701,2319,7.8,18.4,-1196,-5.5,25.8,0,239,239,1347
2013,56,h) 11 to 15,2095,2186,18303,18707,59,2.6,184,8.2,2016,302,1714,1.6,10.8,2823,1066,1757,5.7,15.1,-807,-4.3,21.6,0,125,125,926
2013,56,i) 16 to 20,1446,1545,12552,12796,55,3.5,121,7.7,1371,213,1158,1.7,10.7,1859,551,1308,4.3,14.5,-488,-3.8,21.4,0,72,72,450
2013,56,j) 21 to 25,935,1028,14832,14991,28,2.7,82,7.8,1229,95,1134,0.6,8.2,1546,571,975,3.8,10.3,-317,-2.1,16.4,0,57,57,372
2013,56,k) 26+,1812,2401,39122,39115,56,2.3,134,5.5,3675,610,3065,1.6,9.4,3660,1037,2623,2.7,9.4,15,0,18.8,0,84,85,609
2013,56,l) Left Censored,1518,3229,75709,74255,159,5,119,3.7,10385,2676,7709,3.6,14,7476,1465,6011,2,10.1,2909,3.9,20.2,0,40,42,384
2014,01,a) 0,4224,4315,31215,15608,4315,200,0,0,31215,31215,0,200,200,0,0,0,0,0,31215,200,0,0,,,
2014,01,b) 1,3424,3482,28267,29563,6,0.2,940,23.8,6678,246,6432,0.8,22.6,9270,4994,4276,16.9,31.4,-2592,-8.8,45.2,0,780,780,4330
2014,01,c) 2,3018,3096,25807,25103,121,3.6,563,17,6164,1033,5131,4.1,24.6,4755,2475,2280,9.9,18.9,1409,5.7,37.8,0,457,457,2073
2014,01,d) 3,2680,2773,27473,26298,114,3.9,404,13.8,6706,1048,5658,4,25.5,4356,2041,2315,7.8,16.6,2350,8.9,33.2,0,330,330,1700
2014,01,e) 4,2360,2478,22810,24159,91,3.5,318,12.3,2870,444,2426,1.8,11.9,5568,3184,2384,13.2,23,-2698,-11.1,23.8,0,251,251,2960
2014,01,f) 5,2396,2599,25418,24850,91,3.4,297,11,5416,2604,2812,10.5,21.8,4280,1913,2367,7.7,17.2,1136,4.6,34.4,0,227,227,1406
2014,01,g) 6 to 10,11476,12192,128599,130594,424,3.4,1162,9.3,15128,3189,11939,2.4,11.6,19117,6480,12637,5,14.6,-3989,-3,23.2,0,881,882,4382
2014,01,h) 11 to 15,8573,9374,130776,130740,288,3,675,7.1,14481,1503,12978,1.1,11.1,14408,4107,10301,3.1,11,73,0.1,22,0,500,501,3215
2014,01,i) 16 to 20,6952,7705,96365,96443,239,3,554,7,10306,2033,8273,2.1,10.7,10462,2759,7703,2.9,10.8,-156,-0.1,21.4,0,402,402,1855
2014,01,j) 21 to 25,5035,6153,94166,95591,174,2.8,381,6.1,9389,1531,7858,1.6,9.8,12238,2282,9956,2.4,12.8,-2849,-3,19.6,0,276,277,1615
2014,01,k) 26+,9655,14803,322014,319509,617,4.2,664,4.5,30262,6057,24205,1.9,9.5,25252,5390,19862,1.7,7.9,5010,1.6,15.8,0,418,429,3343
2014,01,l) Left Censored,6846,21292,662030,668292,882,4.2,715,3.4,56661,13882,42779,2.1,8.5,69184,15416,53768,2.3,10.4,-12523,-1.9,17,0,213,220,4113
2014,02,a) 0,956,960,3709,1855,960,200,0,0,3709,,,,199.9,0,0,0,0,0,3709,199.9,0,1,,,
2014,02,b) 1,734,734,3662,4213,0,0,261,30.2,936,0,936,0,22.2,2038,1057,981,25.1,48.4,-1102,-26.2,44.4,0,180,180,877
2014,02,c) 2,670,686,4699,4681,50,7,110,15.4,933,132,801,2.8,19.9,896,384,512,8.2,19.1,37,0.8,38.2,0,74,74,267
2014,02,d) 3,566,580,3790,3838,35,5.7,98,16,671,73,598,1.9,17.5,766,391,375,10.2,20,-95,-2.5,35,0,74,74,322
2014,02,e) 4,507,527,3806,4097,27,4.8,88,15.8,590,57,533,1.4,14.4,1172,814,358,19.9,28.6,-582,-14.2,28.8,0,61,61,175
2014,02,f) 5,504,538,4242,4308,26,4.6,76,13.5,660,198,462,4.6,15.3,791,377,414,8.8,18.4,-131,-3.1,30.6,0,51,51,236
2014,02,g) 6 to 10,2466,2553,21515,21884,135,5.1,296,11.2,2888,413,2475,1.9,13.2,3625,1427,2198,6.5,16.6,-737,-3.4,26.4,0,187,188,1157
2014,02,h) 11 to 15,1845,1987,24772,25396,90,4.4,180,8.9,2671,443,2228,1.7,10.5,3918,630,3288,2.5,15.4,-1247,-4.9,21,0,122,123,474
2014,02,i) 16 to 20,1342,1447,15348,15454,71,4.8,107,7.3,1468,245,1223,1.6,9.5,1679,349,1330,2.3,10.9,-211,-1.4,19,0,62,62,204
2014,02,j) 21 to 25,944,1068,11978,12328,32,2.9,93,8.5,1993,,,,16.2,2693,398,2295,3.2,21.8,-700,-5.6,32.4,1,57,57,171
2014,02,k) 26+,1948,2934,67364,66247,115,3.9,151,5.1,8554,2153,6401,3.2,12.9,6320,1283,5037,1.9,9.5,2234,3.4,19,0,71,73,364
2014,02,l) Left Censored,1186,3386,100952,100087,241,7.3,116,3.5,12386,5299,7087,5.3,12.4,10656,1867,8789,1.9,10.6,1730,1.8,21.2,0,17,17,73
2014,04,a) 0,7519,7620,52198,26099,7620,200,0,0,52198,52198,0,200,200,0,0,0,0,0,52198,200,0,0,,,
2014,04,b) 1,5728,5757,41564,43721,8,0.1,1869,27.9,10516,,,,24.1,14830,8755,6075,20,33.9,-4314,-9.8,48.2,1,1450,1450,7129
2014,04,c) 2,5100,5156,43573,44397,266,4.8,1094,19.6,9025,1589,7436,3.6,20.3,10672,6033,4639,13.6,24,-1647,-3.7,40.6,0,860,860,4457
2014,04,d) 3,4651,4775,42643,42640,234,4.6,762,15.1,8606,1911,6695,4.5,20.2,8600,4024,4576,9.4,20.2,6,0,40.4,0,579,579,2997
2014,04,e) 4,3794,3927,52039,48272,171,4.2,548,13.3,18180,1300,16880,2.7,37.7,10645,4319,6326,8.9,22.1,7535,15.6,44.2,0,414,414,3517
2014,04,f) 5,3652,3886,38901,40189,191,4.7,546,13.4,6111,864,5247,2.1,15.2,8687,5034,3653,12.5,21.6,-2576,-6.4,30.4,0,419,419,4072
2014,04,g) 6 to 10,18358,19382,210615,210681,964,4.8,2117,10.6,29909,4736,25173,2.2,14.2,30040,12026,18014,5.7,14.3,-131,-0.1,28.4,0,1557,1560,9086
2014,04,h) 11 to 15,11673,12787,179560,179119,608,4.7,1100,8.4,24556,4538,20018,2.5,13.7,23673,8028,15645,4.5,13.2,883,0.5,26.4,0,753,759,4659
2014,04,i) 16 to 20,8039,9190,147735,147941,347,3.7,678,7.2,16599,2622,13977,1.8,11.2,17011,5175,11836,3.5,11.5,-412,-0.3,22.4,0,459,465,4099
2014,04,j) 21 to 25,5220,7288,132654,131063,268,3.6,377,5.1,15866,,,,12.1,12683,2856,9827,2.2,9.7,3183,2.4,19.4,1,250,250,1480
2014,04,k) 26+,8794,14705,372173,378101,615,4.2,811,5.5,42342,11909,30433,3.1,11.2,54198,8950,45248,2.4,14.3,-11856,-3.1,22.4,0,382,410,2866
2014,04,l) Left Censored,5102,22596,884344,872107,1615,7.2,987,4.4,110536,31146,79390,3.6,12.7,86062,22355,63707,2.6,9.9,24474,2.8,19.8,0,131,139,1970
2014,05,a) 0,2984,3017,19464,9732,3017,200,0,0,19464,19464,0,200,200,0,0,0,0,0,19464,200,0,0,,,
2014,05,b) 1,2441,2475,16097,16507,9,0.3,692,24.6,4186,,,,25.4,5005,2963,2042,17.9,30.3,-819,-4.9,50.8,1,571,571,2688
2014,05,c) 2,2052,2085,15519,15568,92,4.1,438,19.4,2836,307,2529,2,18.2,2933,1663,1270,10.7,18.8,-97,-0.6,36.4,0,371,371,1352
2014,05,d) 3,1936,1979,16303,16903,60,2.8,335,15.8,2628,273,2355,1.6,15.5,3827,1796,2031,10.6,22.6,-1199,-7.1,31,0,272,272,1509
2014,05,e) 4,1676,1761,16024,16474,59,3.2,249,13.4,2252,346,1906,2.1,13.7,3152,1596,1556,9.7,19.1,-900,-5.4,27.4,0,198,198,1395
2014,05,f) 5,1609,1698,15416,15958,67,3.8,225,12.7,1979,439,1540,2.8,12.4,3063,1226,1837,7.7,19.2,-1084,-6.8,24.8,0,172,172,980
2014,05,g) 6 to 10,7911,8464,78634,78097,371,4.3,811,9.3,11165,1624,9541,2.1,14.3,10091,3729,6362,4.8,12.9,1074,1.4,25.8,0,608,609,2450
2014,05,h) 11 to 15,5809,6328,60318,61263,202,3.1,488,7.5,6480,1169,5311,1.9,10.6,8369,2779,5590,4.5,13.7,-1889,-3.1,21.2,0,366,374,1864
2014,05,i) 16 to 20,4461,5145,58450,62439,139,2.6,368,7,5487,661,4826,1.1,8.8,13465,8440,5025,13.5,21.6,-7978,-12.8,17.6,0,273,273,1436
2014,05,j) 21 to 25,3157,3681,51500,51024,94,2.5,254,6.8,5569,,,,10.9,4617,1529,3088,3,9,952,1.9,18,1,185,186,1038
2014,05,k) 26+,6064,8778,190099,189780,256,2.9,408,4.6,19079,3422,15657,1.8,10.1,18441,3695,14746,1.9,9.7,638,0.4,19.4,0,256,267,1949
2014,05,l) Left Censored,4685,13446,448914,442495,552,4.1,449,3.4,43758,9914,33844,2.2,9.9,30920,6082,24838,1.4,7,12838,2.9,14,0,118,132,2030
2014,06,a) 0,55434,56043,324873,162437,56043,200,0,0,324873,324873,0,200,200,0,0,0,0,0,324873,200,0,0,,,
2014,06,b) 1,41354,41723,286676,298136,26,0.1,12069,25.3,78781,487,78294,0.2,26.4,101701,50269,51432,16.9,34.1,-22920,-7.7,52.8,0,9359,9359,40815
2014,06,c) 2,35950,36387,283017,281954,2024,5.2,6985,18,67841,10960,56881,3.9,24.1,65715,37257,28458,13.2,23.3,2126,0.8,46.6,0,5456,5457,28933
2014,06,d) 3,31128,31936,272982,277236,1638,4.9,5182,15.4,50725,8623,42102,3.1,18.3,59232,30398,28834,11,21.4,-8507,-3.1,36.6,0,3971,3974,24216
2014,06,e) 4,26400,27403,247558,253365,1499,5.2,3869,13.5,46442,7811,38631,3.1,18.3,58055,21303,36752,8.4,22.9,-11613,-4.6,36.6,0,2863,2865,16227
2014,06,f) 5,25654,26490,251239,253323,1284,4.7,3357,12.2,44291,7277,37014,2.9,17.5,48459,18200,30259,7.2,19.1,-4168,-1.6,35,0,2559,2559,13781
2014,06,g) 6 to 10,121459,127357,1285093,1282158,6350,4.8,13615,10.4,198350,34700,163650,2.7,15.5,192480,80302,112178,6.3,15,5870,0.5,30,0,9734,9743,58382
2014,06,h) 11 to 15,81900,88050,1083558,1083619,3931,4.4,7439,8.3,144827,23546,121281,2.2,13.4,144949,50275,94674,4.6,13.4,-122,0,26.8,0,5235,5247,35933
2014,06,i) 16 to 20,53769,60274,931845,924581,2627,4.3,4750,7.7,121344,27574,93770,3,13.1,106815,33002,73813,3.6,11.6,14529,1.5,23.2,0,3275,3294,21216
2014,06,j) 21 to 25,39565,48038,826911,833266,1752,3.6,3347,6.9,94718,18984,75734,2.3,11.4,107427,38937,68490,4.7,12.9,-12709,-1.5,22.8,0,2293,2318,27772
2014,06,k) 26+,70296,105960,2696084,2665746,4263,4,6396,6,331579,78569,253010,2.9,12.4,270902,74832,196070,2.8,10.2,60677,2.2,20.4,0,3619,3670,29455
2014,06,l) Left Censored,35902,127689,5017251,5000639,7328,5.8,5785,4.6,533523,132556,400967,2.7,10.7,500299,131358,368941,2.6,10,33224,0.7,20,0,1379,1425,18299
2014,08,a) 0,9648,9749,49369,24685,9749,200,0,0,49369,49369,0,200,200,0,0,0,0,0,49369,200,0,0,,,
2014,08,b) 1,7153,7210,43145,43408,6,0.1,2272,27.2,12240,181,12059,0.4,28.2,12766,8044,4722,18.5,29.4,-526,-1.2,56.4,0,1693,1693,6670
2014,08,c) 2,6120,6165,43749,43854,336,5.1,1179,17.9,9771,1259,8512,2.9,22.3,9980,5839,4141,13.3,22.8,-209,-0.5,44.6,0,892,892,4085
2014,08,d) 3,5420,5508,43397,43240,258,4.4,882,15.2,8370,1275,7095,2.9,19.4,8055,4533,3522,10.5,18.6,315,0.8,37.2,0,670,670,3906
2014,08,e) 4,4688,4849,39884,40381,316,6.3,692,13.7,6546,1417,5129,3.5,16.2,7541,3874,3667,9.6,18.7,-995,-2.5,32.4,0,500,500,2920
2014,08,f) 5,4559,4672,40380,40054,210,4.3,589,12.1,6478,682,5796,1.7,16.2,5826,2736,3090,6.8,14.5,652,1.7,29,0,428,430,2178
2014,08,g) 6 to 10,21891,22467,199275,198230,1189,5.2,2400,10.4,31625,4103,27522,2.1,16,29534,12238,17296,6.2,14.9,2091,1.1,29.8,0,1634,1634,8492
2014,08,h) 11 to 15,15045,16083,168910,167117,769,4.7,1432,8.7,24618,4611,20007,2.8,14.7,21031,8409,12622,5,12.6,3587,2.1,25.2,0,952,953,4893
2014,08,i) 16 to 20,10489,11651,162095,176118,509,4.3,872,7.4,20329,3896,16433,2.2,11.5,48374,6667,41707,3.8,27.5,-28045,-16,23,0,564,567,4034
2014,08,j) 21 to 25,6882,8433,135353,135526,315,3.7,560,6.5,13998,2849,11149,2.1,10.3,14344,4337,10007,3.2,10.6,-346,-0.3,20.6,0,346,346,2916
2014,08,k) 26+,10822,16280,382616,377631,672,4.1,892,5.4,47321,11996,35325,3.2,12.5,37350,8818,28532,2.3,9.9,9971,2.6,19.8,0,535,540,3642
2014,08,l) Left Censored,6661,22160,836502,822477,1506,6.9,959,4.4,113888,35361,78527,4.3,13.8,85838,17178,68660,2.1,10.4,28050,3.4,20.8,0,189,194,1596
2014,09,a) 0,3727,3802,23233,11617,3802,200,0,0,23233,23233,0,200,200,0,0,0,0,0,23233,200,0,0,,,
2014,09,b) 1,3191,3200,25315,26016,4,0.1,882,24.2,4599,17,4582,0.1,17.7,6000,3517,2483,13.5,23.1,-1401,-5.4,35.4,0,674,674,2880
2014,09,c) 2,2764,2777,20181,20678,130,4.4,521,17.5,3558,452,3106,2.2,17.2,4552,2731,1821,13.2,22,-994,-4.8,34.4,0,387,387,2197
2014,09,d) 3,2343,2365,19711,19579,103,4.1,393,15.7,3725,583,3142,3,19,3461,1895,1566,9.7,17.7,264,1.3,35.4,0,302,302,1443
2014,09,e) 4,2104,2197,21066,21340,103,4.5,321,13.9,2539,292,2247,1.4,11.9,3087,1369,1718,6.4,14.5,-548,-2.6,23.8,0,236,236,1033
2014,09,f) 5,2059,2097,19369,19516,99,4.6,246,11.3,2721,533,2188,2.7,13.9,3015,1378,1637,7.1,15.4,-294,-1.5,27.8,0,203,203,1246
2014,09,g) 6 to 10,9895,10321,103052,102642,489,4.6,1068,10.1,14550,2171,12379,2.1,14.2,13730,5715,8015,5.6,13.4,820,0.8,26.8,0,749,764,4418
2014,09,h) 11 to 15,7518,8009,108938,108693,288,3.5,634,7.7,11525,1676,9849,1.5,10.6,11035,3846,7189,3.5,10.2,490,0.4,20.4,0,438,439,2395
2014,09,i) 16 to 20,6325,6859,81443,81609,239,3.4,470,6.7,8591,1759,6832,2.2,10.5,8923,2966,5957,3.6,10.9,-332,-0.4,21,0,315,318,1860
2014,09,j) 21 to 25,5181,5786,81445,81875,191,3.3,362,6.2,7623,1117,6506,1.4,9.3,8482,2628,5854,3.2,10.4,-859,-1.1,18.6,0,240,240,1214
2014,09,k) 26+,9726,13224,270875,273632,439,3.3,739,5.5,23621,4870,18751,1.8,8.6,29134,6747,22387,2.5,10.6,-5513,-2,17.2,0,399,399,2509
2014,09,l) Left Censored,8463,18937,713378,721152,861,4.6,774,4.1,60182,13673,46509,1.9,8.3,75730,18038,57692,2.5,10.5,-15548,-2.2,16.6,0,251,256,2151
2014,10,a) 0,1314,1318,10716,5358,1318,200,0,0,10716,10716,0,200,200,0,0,0,0,0,10716,200,0,0,,,
2014,10,b) 1,949,950,7264,7237,0,0,270,24.9,1842,0,1842,0,25.5,1787,863,924,11.9,24.7,55,0.8,49.4,0,214,214,742
2014,10,c) 2,837,843,6337,6314,47,5.2,155,17.3,1192,311,881,4.9,18.9,1146,516,630,8.2,18.2,46,0.7,36.4,0,112,112,392
2014,10,d) 3,702,704,5000,5033,31,4.2,104,14,796,98,698,1.9,15.8,861,475,386,9.4,17.1,-65,-1.3,31.6,0,79,79,376
2014,10,e) 4,572,580,4912,4887,32,5.3,80,13.2,854,144,710,2.9,17.5,804,448,356,9.2,16.5,50,1,33,0,69,69,427
2014,10,f) 5,607,624,5956,6174,28,4.4,66,10.3,754,68,686,1.1,12.2,1190,311,879,5,19.3,-436,-7.1,24.4,0,53,53,257
2014,10,g) 6 to 10,2825,2923,28738,29351,107,3.5,331,10.9,3598,735,2863,2.5,12.3,4823,2469,2354,8.4,16.4,-1225,-4.1,24.6,0,235,235,1920
2014,10,h) 11 to 15,2082,2198,24412,24357,89,4,192,8.5,3062,426,2636,1.7,12.6,2951,988,1963,4.1,12.1,111,0.5,24.2,0,140,143,571
2014,10,i) 16 to 20,1567,1764,26394,25078,60,3.3,137,7.6,4756,716,4040,2.9,19,2124,657,1467,2.6,8.5,2632,10.5,17,0,99,99,421
2014,10,j) 21 to 25,1191,1360,19196,19114,58,4.2,106,7.7,2087,565,1522,3,10.9,1922,580,1342,3,10.1,165,0.8,20.2,0,71,71,473
2014,10,k) 26+,2166,2945,59646,59495,87,2.9,135,4.5,5443,805,4638,1.4,9.1,5140,1070,4070,1.8,8.6,303,0.5,17.2,0,68,70,448
2014,10,l) Left Censored,2253,5349,193583,195210,277,5.2,290,5.4,24601,5672,18929,2.9,12.6,27855,6326,21529,3.2,14.3,-3254,-1.7,25.2,0,33,33,245
2014,11,a) 0,971,981,7590,3795,981,200,0,0,7590,7590,0,200,200,0,0,0,0,0,7590,200,0,0,,,
2014,11,b) 1,804,805,6786,6960,1,0.1,229,24.9,1790,,,,25.7,2138,1170,968,16.8,30.7,-348,-5,51.4,1,173,173,890
2014,11,c) 2,678,688,6731,6482,32,4.4,111,15.3,1610,153,1457,2.4,24.8,1111,455,656,7,17.1,499,7.7,34.2,0,95,95,355
2014,11,d) 3,643,654,7262,7410,29,4.2,108,15.6,1099,140,959,1.9,14.8,1395,731,664,9.9,18.8,-296,-4,29.6,0,81,81,349
2014,11,e) 4,566,579,7759,8142,25,4.1,73,12.1,995,146,849,1.8,12.2,1760,1047,713,12.9,21.6,-765,-9.4,24.4,0,57,57,916
2014,11,f) 5,510,518,6033,5984,19,3.5,57,10.6,1024,127,897,2.1,17.1,926,338,588,5.6,15.5,98,1.6,31,0,37,37,270
2014,11,g) 6 to 10,2409,2473,38344,38123,79,3.1,231,9.1,4798,714,4084,1.9,12.6,4355,1314,3041,3.4,11.4,443,1.2,22.8,0,175,175,1010
2014,11,h) 11 to 15,1842,1961,36531,36338,73,3.7,141,7.1,3959,614,3345,1.7,10.9,3573,985,2588,2.7,9.8,386,1.1,19.6,0,97,97,630
2014,11,i) 16 to 20,1424,1577,27811,27837,67,4.2,95,6,2969,835,2134,3,10.7,3021,835,2186,3,10.9,-52,-0.2,21.4,0,56,56,686
2014,11,j) 21 to 25,1130,1312,26406,26299,49,3.7,68,5.1,3218,,,,12.2,3003,1109,1894,4.2,11.4,215,0.8,22.8,1,41,41,274
2014,11,k) 26+,2398,3169,101278,99977,138,4.3,187,5.9,9269,2348,6921,2.3,9.3,6667,1543,5124,1.5,6.7,2602,2.6,13.4,0,100,101,406
2014,11,l) Left Censored,2718,5940,231118,232813,417,7.1,255,4.4,20328,4903,15425,2.1,8.7,23717,4040,19677,1.7,10.2,-3389,-1.5,17.4,0,40,41,1060
2014,12,a) 0,35624,35922,183089,91545,35922,200,0,0,183089,183089,0,200,200,0,0,0,0,0,183089,200,0,0,,,
2014,12,b) 1,27227,27320,170428,174861,29,0.1,8880,28,45482,1438,44044,0.8,26,54347,35262,19085,20.2,31.1,-8865,-5.1,52,0,7103,7103,30054
2014,12,c) 2,23938,24240,177242,176556,1294,4.9,5100,19.5,45449,4261,41188,2.4,25.7,44076,27371,16705,15.5,25,1373,0.7,50,0,4018,4018,21750
2014,12,d) 3,20732,21264,187806,187918,1118,4.9,3817,16.9,36101,3705,32396,2,19.2,36324,16940,19384,9,19.3,-223,-0.1,38.4,0,2992,2992,13596
2014,12,e) 4,17381,17901,141104,144518,911,4.8,2771,14.7,22352,3840,18512,2.7,15.5,29179,15337,13842,10.6,20.2,-6827,-4.7,31,0,2087,2088,11847
2014,12,f) 5,15501,15923,125967,126535,789,4.7,2199,13.2,20561,3969,16592,3.1,16.2,21697,11221,10476,8.9,17.1,-1136,-0.9,32.4,0,1658,1658,8654
2014,12,g) 6 to 10,73087,75427,625859,636463,4148,5.3,8688,11.2,88214,15777,72437,2.5,13.9,109422,46595,62827,7.3,17.2,-21208,-3.3,27.8,0,6249,6259,33873
2014,12,h) 11 to 15,45632,48839,500959,499198,2350,4.7,4285,8.6,70959,12721,58238,2.5,14.2,67437,28400,39037,5.7,13.5,3522,0.7,27,0,3025,3036,21545
2014,12,i) 16 to 20,31198,34867,486736,481512,1615,4.6,2793,7.9,80636,13348,67288,2.8,16.7,70188,20435,49753,4.2,14.6,10448,2.1,29.2,0,1795,1803,12405
2014,12,j) 21 to 25,22696,28134,530714,524626,1067,3.7,1811,6.4,59744,8607,51137,1.6,11.4,47568,12784,34784,2.4,9.1,12176,2.3,18.2,0,1237,1240,8225
2014,12,k) 26+,32289,50635,1179830,1179423,2166,4.2,2843,5.6,140232,39458,100774,3.3,11.9,139417,31374,108043,2.7,11.8,815,0.1,23.6,0,1622,1655,13343
2014,12,l) Left Censored,15799,70861,2731427,2717746,4920,7,3378,4.8,285061,81972,203089,3,10.5,257699,87340,170359,3.2,9.5,27362,1,19,0,565,584,8456
2014,13,a) 0,12244,12361,76859,38430,12361,200,0,0,76859,76859,0,200,200,0,0,0,0,0,76859,200,0,0,,,
2014,13,b) 1,9346,9375,61953,63653,4,0,2959,27.3,15947,,,,25.1,19346,11643,7703,18.3,30.4,-3399,-5.3,50.2,1,2322,2322,9882
2014,13,c) 2,8420,8545,65767,65995,425,4.6,1624,17.8,12863,1458,11405,2.2,19.5,13319,7154,6165,10.8,20.2,-456,-0.7,39,0,1296,1296,6024
2014,13,d) 3,7386,7528,59021,59537,381,4.8,1195,15.1,10567,1646,8921,2.8,17.7,11598,5723,5875,9.6,19.5,-1031,-1.8,35.4,0,928,928,4511
2014,13,e) 4,6541,6709,59066,60137,313,4.5,943,13.4,8693,1223,7470,2,14.5,10834,4693,6141,7.8,18,-2141,-3.5,29,0,732,732,3565
2014,13,f) 5,6030,6740,73270,73588,408,5.9,834,12,13768,3673,10095,5,18.7,14403,6170,8233,8.4,19.6,-635,-0.9,37.4,0,621,621,5226
2014,13,g) 6 to 10,29101,30469,304156,311553,1442,4.6,3338,10.6,48156,6921,41235,2.2,15.5,62949,37377,25572,12,20.2,-14793,-4.7,31,0,2437,2440,12941
2014,13,h) 11 to 15,19786,21508,260290,264742,908,4.1,1817,8.3,34927,4910,30017,1.9,13.2,43830,21343,22487,8.1,16.6,-8903,-3.4,26.4,0,1259,1261,8937
2014,13,i) 16 to 20,14348,16310,229400,229199,698,4.2,1238,7.5,29657,5295,24362,2.3,12.9,29255,9350,19905,4.1,12.8,402,0.1,25.6,0,833,843,4375
2014,13,j) 21 to 25,9390,11886,194416,193991,436,3.6,734,6.1,21023,,,,10.8,20173,5488,14685,2.8,10.4,850,0.4,20.8,1,493,495,3480
2014,13,k) 26+,15673,24535,597659,592195,1282,5.2,1338,5.4,64971,14911,50060,2.5,11,54043,13786,40257,2.3,9.1,10928,1.9,18.2,0,703,712,5056
2014,13,l) Left Censored,10375,39600,1485009,1475608,2246,5.7,1435,3.7,150871,34299,116572,2.3,10.2,132070,27411,104659,1.9,9,18801,1.2,18,0,317,328,3353
2014,15,a) 0,1405,1419,9998,4999,1419,200,0,0,9998,9998,0,200,200,0,0,0,0,0,9998,200,0,0,,,
2014,15,b) 1,1076,1088,8065,8130,4,0.3,292,23.7,2046,,,,25.2,2175,1367,808,16.8,26.8,-129,-1.6,50.4,1,232,232,1236
2014,15,c) 2,949,957,7686,7564,42,4.1,184,17.9,1880,342,1538,4.5,24.9,1635,938,697,12.4,21.6,245,3.3,43.2,0,148,148,761
2014,15,d) 3,861,875,9107,9507,44,4.8,124,13.6,1297,165,1132,1.7,13.6,2097,738,1359,7.8,22.1,-800,-8.5,27.2,0,97,97,660
2014,15,e) 4,740,764,7871,8176,23,2.8,111,13.7,1226,49,1177,0.6,15,1836,1179,657,14.4,22.5,-610,-7.5,30,0,82,82,753
2014,15,f) 5,761,773,9386,9344,27,3.4,90,11.2,1156,192,964,2.1,12.4,1072,300,772,3.2,11.5,84,0.9,23,0,70,70,258
2014,15,g) 6 to 10,3771,3945,40717,41080,158,3.9,378,9.3,4432,922,3510,2.2,10.8,5157,1920,3237,4.7,12.6,-725,-1.8,21.6,0,299,299,1571
2014,15,h) 11 to 15,2859,3120,34256,34744,95,3,255,8,3170,357,2813,1,9.1,4145,1525,2620,4.4,11.9,-975,-2.8,18.2,0,173,173,941
2014,15,i) 16 to 20,2140,2380,38260,38226,68,2.8,177,7.3,3293,333,2960,0.9,8.6,3224,847,2377,2.2,8.4,69,0.2,16.8,0,118,119,607
2014,15,j) 21 to 25,1703,2051,27908,28079,60,2.9,133,6.4,2358,,,,8.4,2699,528,2171,1.9,9.6,-341,-1.2,16.8,1,102,102,413
2014,15,k) 26+,3496,4988,103640,102604,129,2.6,211,4.2,8740,1559,7181,1.5,8.5,6668,1608,5060,1.6,6.5,2072,2,13,0,130,134,785
2014,15,l) Left Censored,2664,6569,213288,209793,346,5.3,212,3.3,20939,4557,16382,2.2,10,13949,2575,11374,1.2,6.6,6990,3.4,13.2,0,65,65,399
2014,16,a) 0,2516,2542,11381,5691,2542,200,0,0,11381,11381,0,200,200,0,0,0,0,0,11381,200,0,0,,,
2014,16,b) 1,1825,1828,10667,10714,0,0,530,25.3,2834,0,2834,0,26.5,2927,1774,1153,16.6,27.3,-93,-0.8,53,0,408,408,1553
2014,16,c) 2,1590,1594,9735,9684,101,6,274,16.3,1964,260,1704,2.7,20.3,1861,892,969,9.2,19.2,103,1.1,38.4,0,215,215,729
2014,16,d) 3,1369,1416,12772,11916,76,5.1,211,14.2,3423,301,3122,2.5,28.7,1711,921,790,7.7,14.4,1712,14.3,28.8,0,170,170,701
2014,16,e) 4,1188,1214,9178,9151,68,5.4,160,12.7,1502,218,1284,2.4,16.4,1448,754,694,8.2,15.8,54,0.6,31.6,0,106,106,618
2014,16,f) 5,1205,1243,10205,10246,53,4.1,134,10.4,1158,163,995,1.6,11.3,1239,497,742,4.9,12.1,-81,-0.8,22.6,0,103,103,449
2014,16,g) 6 to 10,6742,6965,58558,57679,412,5.8,747,10.5,8796,1561,7235,2.7,15.2,7037,2767,4270,4.8,12.2,1759,3,24.4,0,520,521,1905
2014,16,h) 11 to 15,4222,4521,58200,57796,194,4.2,409,8.8,6643,745,5898,1.3,11.5,5834,1978,3856,3.4,10.1,809,1.4,20.2,0,286,286,1276
2014,16,i) 16 to 20,3099,3348,36936,36108,129,3.8,238,7,5448,672,4776,1.9,15.1,3792,928,2864,2.6,10.5,1656,4.6,21,0,165,165,680
2014,16,j) 21 to 25,1993,2302,29821,29358,88,3.8,146,6.3,3728,610,3118,2.1,12.7,2802,663,2139,2.3,9.5,926,3.2,19,0,99,99,497
2014,16,k) 26+,3154,4547,92695,91759,140,3.1,226,4.9,11087,2606,8481,2.8,12.1,9215,1913,7302,2.1,10,1872,2.1,20,0,135,135,1142
2014,16,l) Left Censored,2468,6599,189473,190442,341,5.2,241,3.7,20819,4402,16417,2.3,10.9,22756,10515,12241,5.5,11.9,-1937,-1,21.8,0,47,59,606
2014,17,a) 0,15062,15235,87137,43569,15235,200,0,0,87137,87137,0,200,200,0,0,0,0,0,87137,200,0,0,,,
2014,17,b) 1,12070,12140,73550,77350,13,0.1,3707,26.5,16793,224,16569,0.3,21.7,24392,15437,8955,20,31.5,-7599,-9.8,43.4,0,2742,2742,13219
2014,17,c) 2,10854,10929,77268,77996,619,5.3,2095,18,14582,2431,12151,3.1,18.7,16037,7800,8237,10,20.6,-1455,-1.9,37.4,0,1556,1556,5803
2014,17,d) 3,9877,10184,82366,82948,503,4.7,1588,14.8,13831,1811,12020,2.2,16.7,14995,7626,7369,9.2,18.1,-1164,-1.4,33.4,0,1162,1162,5554
2014,17,e) 4,8291,8617,98260,95891,421,4.7,1152,12.8,20575,3474,17101,3.6,21.5,15836,6842,8994,7.1,16.5,4739,5,33,0,842,842,4562
2014,17,f) 5,8068,8348,72947,73507,446,5.2,1062,12.3,9876,1771,8105,2.4,13.4,10996,4708,6288,6.4,15,-1120,-1.6,26.8,0,757,757,3563
2014,17,g) 6 to 10,38012,39511,370583,371089,1818,4.5,4188,10.3,52523,8853,43670,2.4,14.2,53534,21754,31780,5.9,14.4,-1011,-0.2,28.4,0,2831,2839,15869
2014,17,h) 11 to 15,26824,29249,374572,376033,1174,3.9,2411,8.1,42847,5397,37450,1.4,11.4,45768,16600,29168,4.4,12.2,-2921,-0.8,22.8,0,1626,1627,11770
2014,17,i) 16 to 20,21405,23599,322125,318840,938,3.9,1809,7.5,44265,12980,31285,4.1,13.9,37695,15155,22540,4.8,11.8,6570,2.1,23.6,0,1192,1202,9073
2014,17,j) 21 to 25,16372,19466,311676,312786,748,3.8,1252,6.3,37472,7594,29878,2.4,12,39692,10112,29580,3.2,12.7,-2220,-0.7,24,0,832,833,4837
2014,17,k) 26+,28267,40545,1025297,1018860,1352,3.3,2187,5.3,103491,19272,84219,1.9,10.2,90616,26838,63778,2.6,8.9,12875,1.3,17.8,0,1251,1262,12637
2014,17,l) Left Censored,22833,59690,2362760,2350947,2917,4.9,2396,4,243477,87948,155529,3.7,10.4,219850,66969,152881,2.8,9.4,23627,1,18.8,0,724,755,10155
2014,18,a) 0,5929,6037,36577,18289,6037,200,0,0,36577,36577,0,200,200,0,0,0,0,0,36577,200,0,0,,,
2014,18,b) 1,4779,4834,36007,37812,11,0.2,1428,25.8,8400,194,8206,0.5,22.2,12009,7794,4215,20.6,31.8,-3609,-9.6,44.4,0,1100,1100,6617
2014,18,c) 2,4182,4214,33736,36136,158,3.5,828,18.2,5733,504,5229,1.4,15.9,10533,7609,2924,21.1,29.1,-4800,-13.2,31.8,0,664,664,5118
2014,18,d) 3,3843,3962,35814,36072,161,3.9,593,14.2,5617,608,5009,1.7,15.6,6132,2987,3145,8.3,17,-515,-1.4,31.2,0,462,462,2550
2014,18,e) 4,3246,3430,33087,33316,157,4.4,465,13,5374,653,4721,2,16.1,5832,2487,3345,7.5,17.5,-458,-1.4,32.2,0,335,335,1911
2014,18,f) 5,3233,3392,32647,33080,167,4.7,417,11.9,5026,990,4036,3,15.2,5892,2683,3209,8.1,17.8,-866,-2.6,30.4,0,321,321,2290
2014,18,g) 6 to 10,16209,17053,177187,177179,682,3.9,1721,9.8,22690,3898,18792,2.2,12.8,22673,10003,12670,5.6,12.8,17,0,25.6,0,1244,1258,8203
2014,18,h) 11 to 15,11869,12833,163121,164309,389,3,1039,7.9,18202,2095,16107,1.3,11.1,20578,6926,13652,4.2,12.5,-2376,-1.4,22.2,0,744,746,4326
2014,18,i) 16 to 20,9586,11049,161202,159552,373,3.3,787,7,17546,2115,15431,1.3,11,14246,4708,9538,3,8.9,3300,2.1,17.8,0,565,568,3187
2014,18,j) 21 to 25,7654,9369,149415,148581,277,2.9,568,6,15569,2482,13087,1.7,10.5,13900,3456,10444,2.3,9.4,1669,1.1,18.8,0,380,381,2199
2014,18,k) 26+,13973,21354,492535,485357,797,3.7,1037,4.8,57074,8497,48577,1.8,11.8,42717,10082,32635,2.1,8.8,14357,3,17.6,0,597,602,4660
2014,18,l) Left Censored,11722,32412,1240322,1232115,1330,4.1,1266,3.9,119022,26098,92924,2.1,9.7,102608,20367,82241,1.7,8.3,16414,1.4,16.6,0,363,365,4241
2014,19,a) 0,3012,3052,20923,10462,3052,200,0,0,20923,20923,0,200,200,0,0,0,0,0,20923,200,0,0,,,
2014,19,b) 1,2430,2454,15971,16114,4,0.1,661,23.8,3603,,,,22.4,3889,2512,1377,15.6,24.1,-286,-1.7,44.8,1,511,511,2116
2014,19,c) 2,2283,2299,15076,15326,109,4.5,379,15.6,2426,289,2137,1.9,15.8,2926,1317,1609,8.6,19.1,-500,-3.3,31.6,0,297,297,1112
2014,19,d) 3,2119,2173,17673,17831,87,3.8,268,11.8,2578,422,2156,2.4,14.5,2894,1345,1549,7.5,16.2,-316,-1.7,29,0,202,202,1027
2014,19,e) 4,1890,1929,14545,14611,81,4.1,200,10.1,2013,390,1623,2.7,13.8,2144,919,1225,6.3,14.7,-131,-0.9,27.6,0,157,157,802
2014,19,f) 5,1751,1838,14189,16202,61,3.2,193,10.1,1766,178,1588,1.1,10.9,5792,4713,1079,29.1,35.7,-4026,-24.8,21.8,0,140,140,498
2014,19,g) 6 to 10,9107,9605,85614,86204,344,3.5,905,9.2,10370,1868,8502,2.2,12,11549,4659,6890,5.4,13.4,-1179,-1.4,24,0,656,662,3516
2014,19,h) 11 to 15,6638,7290,78051,78858,250,3.4,548,7.4,8296,936,7360,1.2,10.5,9910,4016,5894,5.1,12.6,-1614,-2.1,21,0,386,386,3064
2014,19,i) 16 to 20,5464,6005,66529,66769,211,3.5,424,6.9,6612,1425,5187,2.1,9.9,7092,2387,4705,3.6,10.6,-480,-0.7,19.8,0,292,292,1635
2014,19,j) 21 to 25,4123,4708,69640,69888,105,2.2,297,6.2,5859,,,,8.4,6354,2320,4034,3.3,9.1,-495,-0.7,16.8,1,210,210,1043
2014,19,k) 26+,8242,12540,250150,248863,297,2.3,517,4.1,19641,4613,15028,1.9,7.9,17067,3625,13442,1.5,6.9,2574,1,13.8,0,327,332,2001
2014,19,l) Left Censored,7995,18633,655258,656291,626,3.4,641,3.4,45352,8962,36390,1.4,6.9,47417,10986,36431,1.7,7.2,-2065,-0.3,13.8,0,206,225,2019
2014,20,a) 0,3349,3380,20818,10409,3380,200,0,0,20818,20818,0,200,200,0,0,0,0,0,20818,200,0,0,,,
2014,20,b) 1,2536,2544,18633,19830,3,0.1,717,24.7,4203,,,,21.2,6597,4079,2518,20.6,33.3,-2394,-12.1,42.4,1,584,584,3382
2014,20,c) 2,2281,2300,15596,15960,113,4.6,424,17.3,2793,395,2398,2.5,17.5,3520,2107,1413,13.2,22.1,-727,-4.6,35,0,336,336,1731
2014,20,d) 3,1963,2043,16970,16925,102,4.8,303,14.1,3044,805,2239,4.8,18,2953,1625,1328,9.6,17.4,91,0.6,34.8,0,246,246,1359
2014,20,e) 4,1687,1723,15618,15658,82,4.6,229,12.7,2263,328,1935,2.1,14.5,2342,958,1384,6.1,15,-79,-0.5,29,0,173,173,779
2014,20,f) 5,1749,1805,15026,15519,99,5.3,224,12,2211,300,1911,1.9,14.2,3197,1575,1622,10.1,20.6,-986,-6.4,28.4,0,173,173,1412
2014,20,g) 6 to 10,8662,9031,85955,87326,350,3.8,907,9.7,10380,1561,8819,1.8,11.9,13122,4858,8264,5.6,15,-2742,-3.1,23.8,0,658,662,3667
2014,20,h) 11 to 15,6593,7007,81407,80948,258,3.6,532,7.4,10400,1608,8792,2,12.8,9482,4552,4930,5.6,11.7,918,1.1,23.4,0,379,379,2810
2014,20,i) 16 to 20,5150,5711,68699,68661,198,3.4,381,6.6,7554,1639,5915,2.4,11,7478,2492,4986,3.6,10.9,76,0.1,21.8,0,268,269,1556
2014,20,j) 21 to 25,3763,4580,76739,75422,162,3.5,252,5.4,8614,,,,11.4,5979,1372,4607,1.8,7.9,2635,3.5,15.8,1,192,192,1007
2014,20,k) 26+,7391,10740,206934,205577,316,2.9,577,5.3,23426,6062,17364,2.9,11.4,20711,5297,15414,2.6,10.1,2715,1.3,20.2,0,320,339,2041
2014,20,l) Left Censored,6578,16073,536435,533560,736,4.6,562,3.5,50456,15454,35002,2.9,9.5,44705,9377,35328,1.8,8.4,5751,1.1,16.8,0,159,162,2092
2014,21,a) 0,4702,4803,30802,15401,4803,200,0,0,30802,30802,0,200,200,0,0,0,0,0,30802,200,0,0,,,
2014,21,b) 1,3472,3504,20340,22258,0,0,905,22.9,4537,0,4537,0,20.4,8372,5605,2767,25.2,37.6,-3835,-17.2,40.8,0,732,732,5164
2014,21,c) 2,2778,2813,20328,21218,126,4.2,524,17.4,3729,478,3251,2.3,17.6,5509,2562,2947,12.1,26,-1780,-8.4,35.2,0,426,426,2138
2014,21,d) 3,2537,2631,18790,19714,97,3.5,377,13.6,2698,393,2305,2,13.7,4546,2525,2021,12.8,23.1,-1848,-9.4,27.4,0,304,304,2188
2014,21,e) 4,2124,2239,20467,21663,108,4.6,311,13.3,2804,890,1914,4.1,12.9,5196,3000,2196,13.8,24,-2392,-11.1,25.8,0,255,255,2733
2014,21,f) 5,2003,2061,20338,19911,73,3.4,238,11.1,3711,467,3244,2.3,18.6,2856,1252,1604,6.3,14.3,855,4.3,28.6,0,187,187,1076
2014,21,g) 6 to 10,9908,10596,99747,100624,466,4.3,1108,10.1,13875,2167,11708,2.2,13.8,15628,6876,8752,6.8,15.5,-1753,-1.7,27.6,0,814,814,4545
2014,21,h) 11 to 15,7634,8295,97956,100069,254,3,678,8,10070,1492,8578,1.5,10.1,14295,4205,10090,4.2,14.3,-4225,-4.2,20.2,0,505,511,3160
2014,21,i) 16 to 20,6162,6844,93075,92818,210,3,499,7.1,12053,1998,10055,2.2,13,11538,2902,8636,3.1,12.4,515,0.6,24.8,0,360,362,2145
2014,21,j) 21 to 25,4642,5774,89773,89423,161,2.7,348,5.9,11507,1337,10170,1.5,12.9,10807,2284,8523,2.6,12.1,700,0.8,24.2,0,244,248,1596
2014,21,k) 26+,8672,13311,295430,293345,526,3.9,715,5.3,36321,7898,28423,2.7,12.4,32151,8386,23765,2.9,11,4170,1.4,22,0,392,404,3194
2014,21,l) Left Censored,6982,20248,713561,708320,885,4.4,684,3.4,70884,19999,50885,2.8,10,60401,12986,47415,1.8,8.5,10483,1.5,17,0,180,181,1556
2014,22,a) 0,4752,4869,34454,17227,4869,200,0,0,34454,34454,0,200,200,0,0,0,0,0,34454,200,0,0,,,
2014,22,b) 1,3788,3817,29885,31594,0,0,1073,24.6,7190,0,7190,0,22.8,10608,6284,4324,19.9,33.6,-3418,-10.8,45.6,0,870,870,5302
2014,22,c) 2,3583,3617,30770,30761,159,4.1,616,16,6426,722,5704,2.3,20.9,6407,2998,3409,9.7,20.8,19,0.1,41.6,0,504,504,2679
2014,22,d) 3,3002,3047,28450,28791,114,3.5,456,14.2,5034,716,4318,2.5,17.5,5715,3103,2612,10.8,19.8,-681,-2.3,35,0,375,375,2567
2014,22,e) 4,2837,2984,29548,29635,136,4.4,347,11.2,4492,660,3832,2.2,15.2,4665,1907,2758,6.4,15.7,-173,-0.5,30.4,0,260,260,1409
2014,22,f) 5,2693,2834,29303,29238,149,5.1,335,11.4,4872,888,3984,3,16.7,4741,1413,3328,4.8,16.2,131,0.5,32.4,0,261,261,1030
2014,22,g) 6 to 10,12856,13670,158512,159613,537,3.8,1296,9.2,19292,3339,15953,2.1,12.1,21493,7875,13618,4.9,13.5,-2201,-1.4,24.2,0,1000,1002,6026
2014,22,h) 11 to 15,9237,10031,129202,129777,317,3.1,756,7.4,14515,2972,11543,2.3,11.2,15666,5160,10506,4,12.1,-1151,-0.9,22.4,0,582,585,4135
2014,22,i) 16 to 20,7357,8141,111358,111942,240,2.9,576,6.9,12713,1626,11087,1.5,11.4,13880,5006,8874,4.5,12.4,-1167,-1,22.8,0,411,412,2168
2014,22,j) 21 to 25,5315,6473,101995,100576,192,2.9,349,5.3,13257,2392,10865,2.4,13.2,10418,3047,7371,3,10.4,2839,2.8,20.8,0,247,247,1640
2014,22,k) 26+,10524,14898,322642,323731,383,2.5,699,4.6,31453,6901,24552,2.1,9.7,33631,8356,25275,2.6,10.4,-2178,-0.7,19.4,0,420,434,3784
2014,22,l) Left Censored,7443,21611,676184,673142,1005,4.7,827,3.8,68590,16285,52305,2.4,10.2,62506,15239,47267,2.3,9.3,6084,0.9,18.6,0,196,205,1910
2014,23,a) 0,1749,1802,10504,5252,1802,200,0,0,10504,10504,0,200,200,0,0,0,0,0,10504,200,0,0,,,
2014,23,b) 1,1289,1306,7013,7559,0,0,399,26.5,1638,0,1638,0,21.7,2730,1653,1077,21.9,36.1,-1092,-14.4,43.4,0,283,283,1353
2014,23,c) 2,1197,1205,7444,7643,57,4.4,238,18.4,1141,134,1007,1.8,14.9,1539,778,761,10.2,20.1,-398,-5.2,29.8,0,175,175,506
2014,23,d) 3,1081,1114,7614,7913,62,5.3,175,15,1059,120,939,1.5,13.4,1657,964,693,12.2,20.9,-598,-7.5,26.8,0,121,121,813
2014,23,e) 4,926,969,6811,6986,35,3.4,130,12.8,860,102,758,1.5,12.3,1210,561,649,8,17.3,-350,-5,24.6,0,95,95,408
2014,23,f) 5,932,966,7687,7771,50,5,108,10.9,1085,189,896,2.4,14,1253,553,700,7.1,16.1,-168,-2.1,28,0,71,71,216
2014,23,g) 6 to 10,4984,5171,39130,39407,260,4.9,528,10,4577,662,3915,1.7,11.6,5131,2014,3117,5.1,13,-554,-1.4,23.2,0,321,321,1382
2014,23,h) 11 to 15,3798,4023,34448,34658,191,4.7,313,7.7,3656,579,3077,1.7,10.5,4075,1244,2831,3.6,11.8,-419,-1.3,21,0,203,203,991
2014,23,i) 16 to 20,2974,3218,33366,33101,112,3.4,207,6.3,4611,1471,3140,4.4,13.9,4080,1171,2909,3.5,12.3,531,1.6,24.6,0,127,127,725
2014,23,j) 21 to 25,2178,2586,29056,28923,78,3,152,5.8,2979,553,2426,1.9,10.3,2712,763,1949,2.6,9.4,267,0.9,18.8,0,105,106,592
2014,23,k) 26+,3911,5621,97763,97500,203,3.6,280,4.9,9819,2833,6986,2.9,10.1,9293,1912,7381,2,9.5,526,0.6,19,0,161,161,1062
2014,23,l) Left Censored,2815,6665,202872,202434,298,4.5,279,4.2,16162,4501,11661,2.2,8,15286,3851,11435,1.9,7.6,876,0.4,15.2,0,75,85,1421
2014,24,a) 0,6534,6628,36609,18305,6628,200,0,0,36609,36609,0,200,200,0,0,0,0,0,36609,200,0,0,,,
2014,24,b) 1,5160,5198,36205,35928,14,0.2,1453,24.6,9888,147,9741,0.4,27.5,9334,5461,3873,15.2,26,554,1.5,52,0,1127,1127,4449
2014,24,c) 2,4683,4730,37426,36984,249,4.9,858,17,8412,792,7620,2.1,22.7,7527,4055,3472,11,20.4,885,2.3,40.8,0,660,660,3373
2014,24,d) 3,4020,4106,38366,37056,176,4.1,603,14,8454,719,7735,1.9,22.8,5833,3092,2741,8.3,15.7,2621,7.1,31.4,0,460,460,2466
2014,24,e) 4,3528,3720,32233,32463,179,4.6,479,12.4,4909,954,3955,2.9,15.1,5369,2490,2879,7.7,16.5,-460,-1.4,30.2,0,343,343,1754
2014,24,f) 5,3472,3586,34512,34600,149,4,434,11.6,4681,588,4093,1.7,13.5,4856,2006,2850,5.8,14,-175,-0.5,27,0,315,315,1350
2014,24,g) 6 to 10,17358,18087,201791,195745,772,4.2,1776,9.6,37217,4139,33078,2.1,19,25124,8632,16492,4.4,12.8,12093,6.2,25.6,0,1314,1315,6668
2014,24,h) 11 to 15,12765,13734,169029,170670,474,3.4,1118,8,18382,3450,14932,2,10.8,21663,7343,14320,4.3,12.7,-3281,-1.9,21.6,0,746,750,5680
2014,24,i) 16 to 20,9799,10801,136744,137221,417,3.8,771,7,14249,2588,11661,1.9,10.4,15203,4227,10976,3.1,11.1,-954,-0.7,20.8,0,513,513,3142
2014,24,j) 21 to 25,7437,8806,147379,148467,326,3.6,603,6.7,12563,1640,10923,1.1,8.5,14739,3897,10842,2.6,9.9,-2176,-1.4,17,0,396,396,2354
2014,24,k) 26+,11992,17216,385909,388995,568,3.3,973,5.6,32349,6076,26273,1.6,8.3,38521,9525,28996,2.4,9.9,-6172,-1.6,16.6,0,529,542,5219
2014,24,l) Left Censored,8573,25640,956882,952552,1689,6.7,1019,4,96292,25295,70997,2.7,10.1,87631,17003,70628,1.8,9.2,8661,0.9,18.4,0,264,271,4006
2014,25,a) 0,8225,8272,51787,25894,8272,200,0,0,51787,51787,0,200,200,0,0,0,0,0,51787,200,0,0,,,
2014,25,b) 1,6294,6319,40797,40505,5,0.1,1784,24.7,11055,121,10934,0.3,27.3,10471,6182,4289,15.3,25.9,584,1.4,51.8,0,1306,1306,4802
2014,25,c) 2,5769,5850,44109,43698,321,5.2,991,16,8324,805,7519,1.8,19,7502,3571,3931,8.2,17.2,822,1.8,34.4,0,713,713,2590
2014,25,d) 3,5030,5124,43569,43526,213,4,714,13.3,7471,694,6777,1.6,17.2,7384,3484,3900,8,17,87,0.2,34,0,546,546,2517
2014,25,e) 4,4324,4386,40426,40150,178,3.9,570,12.4,6058,845,5213,2.1,15.1,5505,2468,3037,6.1,13.7,553,1.4,27.4,0,442,442,2026
2014,25,f) 5,4054,4165,37985,37766,182,4.2,486,11.3,6276,696,5580,1.8,16.6,5838,2441,3397,6.5,15.5,438,1.1,31,0,367,367,1788
2014,25,g) 6 to 10,20559,21259,228201,228027,865,4,2000,9.2,28073,3636,24437,1.6,12.3,27724,10358,17366,4.5,12.2,349,0.1,24.4,0,1397,1404,7640
2014,25,h) 11 to 15,15531,16486,202870,203565,608,3.6,1230,7.3,22947,5179,17768,2.5,11.3,24336,8102,16234,4,12,-1389,-0.7,22.6,0,802,805,4905
2014,25,i) 16 to 20,12418,13310,179282,177107,438,3.2,912,6.7,19330,3164,16166,1.8,10.9,14980,4174,10806,2.4,8.5,4350,2.4,17,0,578,578,2531
2014,25,j) 21 to 25,9059,10540,175447,175949,246,2.3,587,5.5,16743,1774,14969,1,9.5,17746,5969,11777,3.4,10.1,-1003,-0.6,19,0,374,382,2812
2014,25,k) 26+,17450,25258,658503,663027,786,3.1,1287,5,54315,11860,42455,1.8,8.2,63362,12411,50951,1.9,9.6,-9047,-1.4,16.4,0,708,728,5033
2014,25,l) Left Censored,14330,34100,1380281,1382092,1518,4.5,1290,3.8,115130,24121,91009,1.7,8.3,118753,32217,86536,2.3,8.6,-3623,-0.3,16.6,0,448,464,14041
2014,26,a) 0,9660,9686,57183,28592,9686,200,0,0,57183,57183,0,200,200,0,0,0,0,0,57183,200,0,0,,,
2014,26,b) 1,7759,7792,65270,63552,1,0,2187,24.6,20006,,,,31.5,16569,9898,6671,15.6,26.1,3437,5.4,52.2,1,1635,1635,7734
2014,26,c) 2,6931,7125,63132,63470,348,4.6,1294,17,10824,1234,9590,1.9,17.1,11499,5714,5785,9,18.1,-675,-1,34.2,0,990,990,4813
2014,26,d) 3,6158,6397,59901,61739,264,3.9,943,14,10625,1125,9500,1.8,17.2,14301,6143,8158,9.9,23.2,-3676,-6,34.4,0,717,717,5489
2014,26,e) 4,5160,5268,59087,58413,214,3.9,667,12.1,12087,899,11188,1.5,20.7,10738,5656,5082,9.7,18.4,1349,2.3,36.8,0,507,507,4705
2014,26,f) 5,5119,5237,56351,57703,193,3.5,656,12,7455,1379,6076,2.4,12.9,10159,5186,4973,9,17.6,-2704,-4.7,25.8,0,496,496,4559
2014,26,g) 6 to 10,24636,25517,273137,274603,1000,3.8,2607,9.9,41059,6156,34903,2.2,15,43990,22393,21597,8.2,16,-2931,-1,30,0,1887,1887,12347
2014,26,h) 11 to 15,18615,20344,251617,248500,828,4,1522,7.4,34408,5650,28758,2.3,13.8,28174,8155,20019,3.3,11.3,6234,2.5,22.6,0,1064,1067,6532
2014,26,i) 16 to 20,15762,17137,227927,227338,596,3.4,1262,7.2,23146,3731,19415,1.6,10.2,21968,8235,13733,3.6,9.7,1178,0.5,19.4,0,817,824,5030
2014,26,j) 21 to 25,12045,14284,214197,213598,450,3.1,887,6.1,23081,,,,10.8,21883,6581,15302,3.1,10.2,1198,0.6,20.4,1,592,596,3568
2014,26,k) 26+,21849,31215,631775,627291,956,3,1613,5.1,62779,11895,50884,1.9,10,53811,13186,40625,2.1,8.6,8968,1.4,17.2,0,914,934,6482
2014,26,l) Left Censored,16286,43587,1628532,1617277,1991,4.6,1673,3.9,156241,29556,126685,1.8,9.7,133730,32079,101651,2,8.3,22511,1.4,16.6,0,551,567,6599
2014,27,a) 0,6452,6540,74097,37049,6540,200,0,0,74097,74097,0,200,200,0,0,0,0,0,74097,200,0,0,,,
2014,27,b) 1,4979,5022,35158,36082,10,0.2,1353,23.8,8021,312,7709,0.9,22.2,9869,6234,3635,17.3,27.4,-1848,-5.2,44.4,0,991,991,5310
2014,27,c) 2,4461,4504,34712,36754,237,5,738,15.5,6968,1025,5943,2.8,19,11051,7242,3809,19.7,30.1,-4083,-11.1,38,0,523,523,6688
2014,27,d) 3,4064,4175,34478,34485,214,4.9,604,13.8,5671,746,4925,2.2,16.4,5685,2672,3013,7.7,16.5,-14,-0.1,32.8,0,452,452,2279
2014,27,e) 4,3520,3638,35343,35364,163,4.3,483,12.7,5415,635,4780,1.8,15.3,5457,2464,2993,7,15.4,-42,-0.1,30.6,0,336,336,1528
2014,27,f) 5,3520,3612,39804,38397,161,4.3,439,11.7,8506,593,7913,1.5,22.2,5691,3266,2425,8.5,14.8,2815,7.4,29.6,0,315,315,2974
2014,27,g) 6 to 10,17524,18403,180218,180690,810,4.3,1857,9.8,23665,2524,21141,1.4,13.1,24608,10405,14203,5.8,13.6,-943,-0.5,26.2,0,1251,1253,7933
2014,27,h) 11 to 15,13873,14853,172245,172287,597,3.9,1158,7.7,17357,2271,15086,1.3,10.1,17440,5505,11935,3.2,10.1,-83,0,20.2,0,728,741,4046
2014,27,i) 16 to 20,10639,12062,155306,154454,427,3.5,817,6.7,16757,2551,14206,1.7,10.8,15053,5880,9173,3.8,9.7,1704,1.1,19.4,0,539,540,4146
2014,27,j) 21 to 25,7706,9244,149994,149544,271,2.9,547,5.8,14271,2227,12044,1.5,9.5,13371,4215,9156,2.8,8.9,900,0.6,17.8,0,339,346,2863
2014,27,k) 26+,12816,18929,474204,471519,562,2.9,850,4.5,44556,10135,34421,2.1,9.4,39186,9911,29275,2.1,8.3,5370,1.1,16.6,0,498,510,4064
2014,27,l) Left Censored,10918,27630,1194315,1188040,1097,4,900,3.3,110123,40559,69564,3.4,9.3,97573,19792,77781,1.7,8.2,12550,1.1,16.4,0,267,285,4686
2014,28,a) 0,2596,2631,17728,8864,2631,200,0,0,17728,17728,0,200,200,0,0,0,0,0,17728,200,0,0,,,
2014,28,b) 1,2062,2064,14637,15390,0,0,586,24.9,3043,0,3043,0,19.8,4549,2764,1785,18,29.6,-1506,-9.8,39.6,0,481,481,2390
2014,28,c) 2,1804,1813,12681,12863,76,3.9,324,16.7,2439,523,1916,4.1,19,2803,1447,1356,11.2,21.8,-364,-2.8,38,0,266,266,1211
2014,28,d) 3,1598,1677,14424,14281,57,3.2,226,12.8,2584,258,2326,1.8,18.1,2298,1185,1113,8.3,16.1,286,2,32.2,0,201,201,1118
2014,28,e) 4,1462,1539,13900,14292,44,2.7,193,12,1798,257,1541,1.8,12.6,2582,744,1838,5.2,18.1,-784,-5.5,25.2,0,167,167,634
2014,28,f) 5,1443,1484,12283,12413,59,3.8,175,11.3,1645,278,1367,2.2,13.3,1904,836,1068,6.7,15.3,-259,-2,26.6,0,140,140,672
2014,28,g) 6 to 10,6787,7318,68240,69408,272,3.6,782,10.3,8472,1561,6911,2.2,12.2,10808,4427,6381,6.4,15.6,-2336,-3.4,24.4,0,629,629,3264
2014,28,h) 11 to 15,5243,5658,60731,61468,185,3.2,424,7.3,6431,1123,5308,1.8,10.5,7905,3324,4581,5.4,12.9,-1474,-2.4,21,0,328,328,1972
2014,28,i) 16 to 20,4041,4508,53274,53504,133,2.9,303,6.6,5028,900,4128,1.7,9.4,5487,1550,3937,2.9,10.3,-459,-0.9,18.8,0,238,238,1191
2014,28,j) 21 to 25,2901,3390,55200,54898,91,2.6,204,5.9,5240,827,4413,1.5,9.5,4636,1035,3601,1.9,8.4,604,1.1,16.8,0,153,154,680
2014,28,k) 26+,5897,8387,175181,173991,269,3.2,392,4.6,16908,2401,14507,1.4,9.7,14527,3560,10967,2,8.3,2381,1.4,16.6,0,248,251,1963
2014,28,l) Left Censored,4681,13692,401147,401098,592,4.3,440,3.2,32972,8993,23979,2.2,8.2,32874,6140,26734,1.5,8.2,98,0,16.4,0,113,114,778
2014,29,a) 0,9879,9968,39789,19895,9968,200,0,0,39789,39789,0,200,200,0,0,0,0,0,39789,200,0,0,,,
2014,29,b) 1,6738,6796,35274,37233,6,0.1,2245,28.4,8112,,,,21.8,12030,7852,4178,21.1,32.3,-3918,-10.5,43.6,1,1844,1844,7017
2014,29,c) 2,5001,5036,39047,38527,239,4.4,1066,19.6,8982,914,8068,2.4,23.3,7941,4588,3353,11.9,20.6,1041,2.7,41.2,0,859,859,3918
2014,29,d) 3,4105,4292,32273,32462,200,4.4,755,16.5,5305,764,4541,2.4,16.3,5682,2784,2898,8.6,17.5,-377,-1.2,32.6,0,622,622,2410
2014,29,e) 4,3583,3721,31296,31381,163,4.2,564,14.4,4709,584,4125,1.9,15,4878,2256,2622,7.2,15.5,-169,-0.5,30,0,452,452,1908
2014,29,f) 5,3371,3560,32861,33409,151,4.1,483,13,4456,490,3966,1.5,13.3,5551,2801,2750,8.4,16.6,-1095,-3.3,26.6,0,368,368,2197
2014,29,g) 6 to 10,17169,18055,173900,174150,735,3.9,1998,10.7,25210,3656,21554,2.1,14.5,25709,9073,16636,5.2,14.8,-499,-0.3,29,0,1507,1508,6868
2014,29,h) 11 to 15,12420,13500,153015,151896,493,3.6,1047,7.6,18191,2698,15493,1.8,12,15952,5064,10888,3.3,10.5,2239,1.5,21,0,767,768,3967
2014,29,i) 16 to 20,9698,10918,148657,148663,414,3.7,742,6.7,15356,3506,11850,2.4,10.3,15368,4542,10826,3.1,10.3,-12,0,20.6,0,524,526,3550
2014,29,j) 21 to 25,7196,8906,137421,136156,264,2.9,559,6.2,15248,,,,11.2,12717,3736,8981,2.7,9.3,2531,1.9,18.6,1,391,391,2356
2014,29,k) 26+,13482,20306,472236,471649,580,2.8,1010,4.9,40650,7724,32926,1.6,8.6,39475,8853,30622,1.9,8.4,1175,0.2,16.8,0,614,626,4557
2014,29,l) Left Censored,10800,30674,1108385,1100387,1685,5.5,1077,3.5,98120,24129,73991,2.2,8.9,82123,12658,69465,1.2,7.5,15997,1.4,15,0,318,325,3653
2014,30,a) 0,1828,1858,8542,4271,1858,200,0,0,8542,8542,0,200,200,0,0,0,0,0,8542,200,0,0,,,
2014,30,b) 1,1480,1483,7106,7645,0,0,438,25.7,1427,0,1427,0,18.7,2505,1324,1181,17.3,32.8,-1078,-14.1,37.4,0,321,321,1071
2014,30,c) 2,1279,1287,6724,7018,70,5,279,20.1,1287,225,1062,3.2,18.3,1874,1176,698,16.8,26.7,-587,-8.4,36.6,0,206,206,1017
2014,30,d) 3,1081,1097,7042,7359,53,4.6,180,15.5,1034,103,931,1.4,14.1,1667,1001,666,13.6,22.7,-633,-8.6,28.2,0,120,120,429
2014,30,e) 4,950,960,5772,5950,48,4.8,136,13.5,733,107,626,1.8,12.3,1088,571,517,9.6,18.3,-355,-6,24.6,0,86,86,441
2014,30,f) 5,1032,1061,6846,6762,58,5.3,119,10.9,1087,112,975,1.7,16.1,919,367,552,5.4,13.6,168,2.5,27.2,0,80,80,187
2014,30,g) 6 to 10,5417,5590,47638,46104,324,5.6,621,10.8,8475,822,7653,1.8,18.4,5406,2200,3206,4.8,11.7,3069,6.7,23.4,0,393,394,1479
2014,30,h) 11 to 15,3667,3836,31282,31489,147,3.7,332,8.5,3342,443,2899,1.4,10.6,3755,1076,2679,3.4,11.9,-413,-1.3,21.2,0,211,211,822
2014,30,i) 16 to 20,2839,2958,26622,26370,112,3.7,224,7.4,3374,691,2683,2.6,12.8,2869,963,1906,3.7,10.9,505,1.9,21.8,0,147,147,663
2014,30,j) 21 to 25,1800,2003,21467,21494,73,3.6,119,5.9,2211,360,1851,1.7,10.3,2265,657,1608,3.1,10.5,-54,-0.2,20.6,0,84,84,348
2014,30,k) 26+,3053,4177,66514,66760,173,4.1,231,5.5,5262,1126,4136,1.7,7.9,5753,1614,4139,2.4,8.6,-491,-0.7,15.8,0,147,149,1213
2014,30,l) Left Censored,2267,5133,122747,122821,210,4.1,179,3.5,12604,1757,10847,1.4,10.3,12751,4887,7864,4,10.4,-147,-0.1,20.6,0,44,51,478
2014,31,a) 0,2315,2366,13403,6702,2366,200,0,0,13403,13403,0,200,200,0,0,0,0,0,13403,200,0,0,,,
2014,31,b) 1,1884,1902,11026,11055,16,0.8,439,20.8,2943,321,2622,2.9,26.6,3001,1756,1245,15.9,27.1,-58,-0.5,53.2,0,322,322,1487
2014,31,c) 2,1702,1708,11328,11303,79,4.4,272,15.1,2035,209,1826,1.8,18,1985,1004,981,8.9,17.6,50,0.4,35.2,0,199,199,792
2014,31,d) 3,1453,1483,10835,11250,72,4.7,202,13,1692,184,1508,1.6,15,2521,1686,835,15,22.4,-829,-7.4,30,0,167,167,1455
2014,31,e) 4,1334,1363,10517,10511,61,4.3,165,11.7,1742,242,1500,2.3,16.6,1730,873,857,8.3,16.5,12,0.1,33,0,126,126,714
2014,31,f) 5,1312,1329,9791,10135,47,3.4,150,10.9,1041,95,946,0.9,10.3,1729,699,1030,6.9,17.1,-688,-6.8,20.6,0,103,103,516
2014,31,g) 6 to 10,6370,6582,54205,54443,230,3.4,520,7.7,6877,688,6189,1.3,12.6,7353,3015,4338,5.5,13.5,-476,-0.9,25.2,0,387,388,2140
2014,31,h) 11 to 15,4687,5024,55665,56055,172,3.4,362,7.1,4621,489,4132,0.9,8.2,5400,1646,3754,2.9,9.6,-779,-1.4,16.4,0,249,249,1150
2014,31,i) 16 to 20,3768,4237,50168,49951,150,3.5,243,5.7,5273,1186,4087,2.4,10.6,4838,1056,3782,2.1,9.7,435,0.9,19.4,0,165,166,792
2014,31,j) 21 to 25,2696,3170,51298,51145,100,3.1,153,4.8,4376,843,3533,1.6,8.6,4070,1244,2826,2.4,8,306,0.6,16,0,103,104,383
2014,31,k) 26+,5233,7506,152812,152699,184,2.4,352,4.6,13912,2893,11019,1.9,9.1,13685,4208,9477,2.8,9,227,0.1,18,0,204,204,1121
2014,31,l) Left Censored,4785,10886,354859,355013,423,3.9,400,3.7,27050,4094,22956,1.2,7.6,27358,7822,19536,2.2,7.7,-308,-0.1,15.2,0,117,127,1482
2014,32,a) 0,4547,4667,32458,16229,4667,200,0,0,32458,32458,0,200,200,0,0,0,0,0,32458,200,0,0,,,
2014,32,b) 1,3296,3320,28174,28334,2,0.1,1066,27.7,7245,,,,25.6,7564,4607,2957,16.3,26.7,-319,-1.1,51.2,1,857,857,4011
2014,32,c) 2,2685,2707,26371,25835,169,5.8,565,19.4,6377,869,5508,3.4,24.7,5304,2811,2493,10.9,20.5,1073,4.2,41,0,450,450,2244
2014,32,d) 3,2352,2391,25528,25805,134,5.3,433,17,4706,711,3995,2.8,18.2,5259,3013,2246,11.7,20.4,-553,-2.2,36.4,0,359,359,2753
2014,32,e) 4,2040,2110,27729,27920,119,5.4,330,14.9,3795,779,3016,2.8,13.6,4176,2115,2061,7.6,15,-381,-1.4,27.2,0,262,262,1429
2014,32,f) 5,1928,2063,22321,22135,99,4.6,250,11.7,4213,650,3563,2.9,19,3841,1423,2418,6.4,17.4,372,1.6,34.8,0,192,192,1081
2014,32,g) 6 to 10,8730,9136,103617,104439,409,4.3,1048,11.1,13748,2138,11610,2,13.2,15392,7098,8294,6.8,14.7,-1644,-1.5,26.4,0,758,761,5204
2014,32,h) 11 to 15,5131,5638,90853,90634,271,4.7,511,8.9,10324,1554,8770,1.7,11.4,9886,4176,5710,4.6,10.9,438,0.5,21.8,0,357,361,3100
2014,32,i) 16 to 20,3189,3946,73407,73051,156,3.9,307,7.6,8475,1871,6604,2.6,11.6,7762,3345,4417,4.6,10.6,713,1,21.2,0,192,192,1507
2014,32,j) 21 to 25,1969,2623,59072,58427,122,4.6,188,7.1,5969,,,,10.2,4679,1178,3501,2,8,1290,2.2,16,1,122,126,623
2014,32,k) 26+,3405,5975,179200,179145,285,4.8,296,4.9,19655,3362,16293,1.9,11,19544,6466,13078,3.6,10.9,111,0.1,21.8,0,144,145,798
2014,32,l) Left Censored,2689,9134,407686,401938,577,6.4,434,4.8,45744,15675,30069,3.9,11.4,34248,11898,22350,3,8.5,11496,2.9,17,0,47,51,2112
2014,33,a) 0,1562,1598,9238,4619,1598,200,0,0,9238,9238,0,200,200,0,0,0,0,0,9238,200,0,0,,,
2014,33,b) 1,1248,1258,7944,8115,0,0,362,25.2,1770,0,1770,0,21.8,2111,1186,925,14.6,26,-341,-4.2,43.6,0,279,279,1005
2014,33,c) 2,1168,1174,8339,8503,48,3.8,217,17.2,1611,130,1481,1.5,18.9,1938,829,1109,9.7,22.8,-327,-3.9,37.8,0,178,178,712
2014,33,d) 3,1037,1045,7762,7655,39,3.5,151,13.7,1808,609,1199,8,23.6,1594,846,748,11.1,20.8,214,2.8,41.6,0,123,123,441
2014,33,e) 4,959,996,8819,9081,39,3.8,106,10.3,1208,184,1024,2,13.3,1732,550,1182,6.1,19.1,-524,-5.8,26.6,0,86,86,457
2014,33,f) 5,884,927,6907,6938,23,2.4,107,11,1147,46,1101,0.7,16.5,1208,475,733,6.8,17.4,-61,-0.9,33,0,81,81,373
2014,33,g) 6 to 10,4632,4828,45950,45982,194,3.9,458,9.2,5846,937,4909,2,12.7,5910,2326,3584,5.1,12.9,-64,-0.2,25.4,0,356,357,1900
2014,33,h) 11 to 15,3407,3575,37701,37456,138,3.8,274,7.5,4041,667,3374,1.8,10.8,3551,1435,2116,3.8,9.5,490,1.3,19,0,189,190,1070
2014,33,i) 16 to 20,2995,3242,36572,36562,93,2.8,204,6.2,3319,523,2796,1.4,9.1,3298,1045,2253,2.9,9,21,0.1,18,0,135,135,704
2014,33,j) 21 to 25,2162,2460,33541,33019,70,2.8,104,4.2,3778,692,3086,2.1,11.4,2734,504,2230,1.5,8.3,1044,3.1,16.6,0,72,72,392
2014,33,k) 26+,3853,5223,101329,100445,222,4.2,291,5.5,12069,2692,9377,2.7,12,10300,3477,6823,3.5,10.3,1769,1.7,20.6,0,177,192,1781
2014,33,l) Left Censored,2873,7037,246828,247183,348,5,304,4.3,17360,5262,12098,2.1,7,18070,2722,15348,1.1,7.3,-710,-0.3,14,0,80,85,839
2014,34,a) 0,12868,13020,73065,36533,13020,200,0,0,73065,73065,0,200,200,0,0,0,0,0,73065,200,0,0,,,
2014,34,b) 1,9790,9825,73334,74879,0,0,3221,28.2,16184,0,16184,0,21.6,19274,11276,7998,15.1,25.7,-3090,-4.1,43.2,0,2483,2483,9371
2014,34,c) 2,8823,8857,62377,64433,484,5.1,1867,19.6,12239,1740,10499,2.7,19,16351,10366,5985,16.1,25.4,-4112,-6.4,38,0,1435,1435,7875
2014,34,d) 3,7733,7847,63177,64340,407,4.9,1254,15.2,10523,1440,9083,2.2,16.4,12849,5603,7246,8.7,20,-2326,-3.6,32.8,0,968,968,4515
2014,34,e) 4,6435,6597,58508,64081,347,5,1006,14.5,9371,2047,7324,3.2,14.6,20517,6293,14224,9.8,32,-11146,-17.4,29.2,0,780,780,4938
2014,34,f) 5,6136,6256,59486,60380,278,4.3,827,12.7,9398,1479,7919,2.4,15.6,11186,4567,6619,7.6,18.5,-1788,-2.9,31.2,0,627,627,3706
2014,34,g) 6 to 10,29821,30503,300515,301689,1390,4.4,3437,10.9,45598,10856,34742,3.6,15.1,47946,19509,28437,6.5,15.9,-2348,-0.8,30.2,0,2525,2527,14994
2014,34,h) 11 to 15,21630,22949,267439,271408,941,4,2047,8.7,29710,5162,24548,1.9,10.9,37647,11260,26387,4.1,13.9,-7937,-3,21.8,0,1427,1432,8461
2014,34,i) 16 to 20,17204,18427,236029,236488,674,3.6,1438,7.6,27165,7382,19783,3.1,11.5,28083,10275,17808,4.3,11.9,-918,-0.4,23,0,999,999,6056
2014,34,j) 21 to 25,11959,13092,186413,187213,395,3,947,7.1,20965,3974,16991,2.1,11.2,22565,7679,14886,4.1,12.1,-1600,-0.9,22.4,0,619,620,5089
2014,34,k) 26+,21158,28301,632425,633402,998,3.5,1650,5.8,61288,10755,50533,1.7,9.7,63242,18225,45017,2.9,10,-1954,-0.3,19.4,0,1012,1026,8267
2014,34,l) Left Censored,15446,38053,1439550,1449269,1850,4.9,1791,4.7,131154,34448,96706,2.4,9,150591,29245,121346,2,10.4,-19437,-1.4,18,0,546,583,6403
2014,35,a) 0,2013,2024,12357,6179,2024,200,0,0,12357,12357,0,200,200,0,0,0,0,0,12357,200,0,0,,,
2014,35,b) 1,1625,1639,13200,13146,4,0.2,480,25.6,3275,,,,24.9,3167,1713,1454,13,24.1,108,0.8,48.2,1,397,397,1498
2014,35,c) 2,1511,1531,12325,12555,79,4.8,294,17.9,2223,267,1956,2.1,17.7,2683,1261,1422,10,21.4,-460,-3.7,35.4,0,235,235,1039
2014,35,d) 3,1296,1325,11201,11223,50,3.6,187,13.4,1728,174,1554,1.6,15.4,1772,755,1017,6.7,15.8,-44,-0.4,30.8,0,157,157,637
2014,35,e) 4,1091,1115,9331,9446,54,4.6,149,12.8,1505,276,1229,2.9,15.9,1734,1041,693,11,18.4,-229,-2.5,31.8,0,121,121,862
2014,35,f) 5,1166,1198,10821,10715,65,5.3,132,10.7,1607,224,1383,2.1,15,1394,477,917,4.5,13,213,2,26,0,97,97,336
2014,35,g) 6 to 10,5557,5801,61999,63043,269,4.5,718,11.9,6126,1236,4890,2,9.7,8213,3172,5041,5,13,-2087,-3.3,19.4,0,535,535,2443
2014,35,h) 11 to 15,3997,4336,46068,46335,154,3.5,367,8.3,5628,790,4838,1.7,12.1,6162,2415,3747,5.2,13.3,-534,-1.2,24.2,0,277,277,1549
2014,35,i) 16 to 20,3178,3562,45205,45805,149,4.1,281,7.7,4705,926,3779,2,10.3,5905,1218,4687,2.7,12.9,-1200,-2.6,20.6,0,204,204,888
2014,35,j) 21 to 25,2281,2791,33453,33809,122,4.3,186,6.6,3217,,,,9.5,3928,946,2982,2.8,11.6,-711,-2.1,19,1,131,131,614
2014,35,k) 26+,4208,5976,121785,122561,165,2.7,340,5.6,9565,1314,8251,1.1,7.8,11116,3173,7943,2.6,9.1,-1551,-1.3,15.6,0,190,190,1091
2014,35,l) Left Censored,2952,8217,216223,218059,403,4.9,264,3.2,21336,7855,13481,3.6,9.8,25008,2752,22256,1.3,11.5,-3672,-1.7,19.6,0,58,59,424
2014,36,a) 0,33134,33468,183526,91763,33468,200,0,0,183526,183526,0,200,200,0,0,0,0,0,183526,200,0,0,,,
2014,36,b) 1,26188,26347,160934,165323,55,0.2,7303,24.4,40877,748,40129,0.5,24.7,49654,27609,22045,16.7,30,-8777,-5.3,49.4,0,5419,5419,20803
2014,36,c) 2,23578,23676,153355,155401,1329,5.2,4699,18.5,31355,5620,25735,3.6,20.2,35447,19748,15699,12.7,22.8,-4092,-2.6,40.4,0,3526,3526,14338
2014,36,d) 3,21319,21554,179450,174203,1134,5,3489,15.3,40419,4660,35759,2.7,23.2,29925,15428,14497,8.9,17.2,10494,6,34.4,0,2616,2616,12045
2014,36,e) 4,18439,18952,155845,156691,904,4.5,2903,14.6,26253,3434,22819,2.2,16.8,27945,12052,15893,7.7,17.8,-1692,-1,33.6,0,2109,2109,8872
2014,36,f) 5,16715,16938,143407,143103,783,4.4,2262,12.8,22578,3190,19388,2.2,15.8,21970,10560,11410,7.4,15.4,608,0.4,30.8,0,1622,1622,6885
2014,36,g) 6 to 10,70142,72152,657227,662411,3178,4.3,8263,11.1,87559,15849,71710,2.4,13.2,97926,41830,56096,6.3,14.8,-10367,-1.6,26.4,0,5785,5800,30748
2014,36,h) 11 to 15,47370,49864,583338,587749,1894,3.7,4425,8.7,66877,11729,55148,2,11.4,75699,27461,48238,4.7,12.9,-8822,-1.5,22.8,0,3028,3033,19625
2014,36,i) 16 to 20,35396,38255,527202,526905,1378,3.5,2790,7.2,62158,12919,49239,2.5,11.8,61563,23452,38111,4.5,11.7,595,0.1,23.4,0,1882,1890,12891
2014,36,j) 21 to 25,26124,29147,402423,404131,889,3,1947,6.6,42437,6996,35441,1.7,10.5,45852,17029,28823,4.2,11.3,-3415,-0.8,21,0,1273,1274,10954
2014,36,k) 26+,45496,61797,1381701,1386531,2057,3.3,3359,5.4,122674,26179,96495,1.9,8.8,132334,32502,99832,2.3,9.5,-9660,-0.7,17.6,0,2059,2079,16207
2014,36,l) Left Censored,34037,80310,3290675,3274521,3761,4.7,3682,4.6,312642,92123,220519,2.8,9.5,280333,58532,221801,1.8,8.6,32309,0.9,17.2,0,1366,1392,21370
2014,37,a) 0,11005,11101,64576,32288,11101,200,0,0,64576,64576,0,200,200,0,0,0,0,0,64576,200,0,0,,,
2014,37,b) 1,8612,8668,57876,58513,5,0.1,2550,25.7,15535,,,,26.5,16808,10775,6033,18.4,28.7,-1273,-2.2,53,1,2004,2004,9073
2014,37,c) 2,7535,7600,55407,55115,382,4.7,1518,18.6,11936,1740,10196,3.2,21.7,11352,6222,5130,11.3,20.6,584,1.1,41.2,0,1190,1190,5084
2014,37,d) 3,6820,6943,56703,58156,301,4.1,1114,15.2,9983,1287,8696,2.2,17.2,12889,7991,4898,13.7,22.2,-2906,-5,34.4,0,849,849,5733
2014,37,e) 4,6036,6264,65043,65197,274,4.1,963,14.6,11327,1658,9669,2.5,17.4,11635,5171,6464,7.9,17.8,-308,-0.4,34.8,0,759,759,4170
2014,37,f) 5,5578,5782,51488,51731,232,3.8,744,12.3,7794,1494,6300,2.9,15.1,8280,3987,4293,7.7,16,-486,-0.9,30.2,0,569,569,3225
2014,37,g) 6 to 10,27799,29278,275325,278748,1209,4,3120,10.3,34986,4748,30238,1.7,12.6,41832,18011,23821,6.5,15,-6846,-2.4,25.2,0,2260,2272,11994
2014,37,h) 11 to 15,19125,20804,249382,251774,753,3.5,1742,8.2,26135,4750,21385,1.9,10.4,30918,10117,20801,4,12.3,-4783,-1.9,20.8,0,1249,1253,7495
2014,37,i) 16 to 20,14237,16268,212080,241905,590,3.6,1165,7,22372,4198,18174,1.7,9.2,82021,56884,25137,23.5,33.9,-59649,-24.7,18.4,0,827,834,5753
2014,37,j) 21 to 25,9862,12255,201291,199870,428,3.4,760,6.1,23012,,,,11.5,20170,4468,15702,2.2,10.1,2842,1.4,20.2,1,497,498,2490
2014,37,k) 26+,18328,28276,638815,635430,1094,3.8,1509,5.3,62676,13579,49097,2.1,9.9,55906,11769,44137,1.9,8.8,6770,1.1,17.6,0,833,851,4765
2014,37,l) Left Censored,12377,43407,1467304,1463158,2109,4.9,1569,3.6,141581,33589,107992,2.3,9.7,133288,32784,100504,2.2,9.1,8293,0.6,18.2,0,419,439,8263
2014,38,a) 0,1486,1501,8918,4459,1501,200,0,0,8918,8918,0,200,200,0,0,0,0,0,8918,200,0,0,,,
2014,38,b) 1,1190,1193,9571,9220,0,0,324,23.9,3260,0,3260,0,35.4,2557,1400,1157,15.2,27.7,703,7.7,55.4,0,262,262,1063
2014,38,c) 2,1030,1052,9533,9530,47,4.1,222,19.5,2217,235,1982,2.5,23.3,2211,1337,874,14,23.2,6,0.1,46.4,0,176,176,1206
2014,38,d) 3,761,779,5617,5768,31,3.8,95,11.7,912,176,736,3.1,15.8,1214,542,672,9.4,21,-302,-5.2,31.6,0,64,64,440
2014,38,e) 4,578,601,5384,5485,23,3.7,71,11.4,822,130,692,2.4,15,1023,457,566,8.3,18.7,-201,-3.7,30,0,54,54,422
2014,38,f) 5,610,626,5821,5764,25,3.9,61,9.5,813,138,675,2.4,14.1,699,211,488,3.7,12.1,114,2,24.2,0,42,42,159
2014,38,g) 6 to 10,2683,2799,28978,28575,114,4,273,9.5,4476,618,3858,2.2,15.7,3669,1332,2337,4.7,12.8,807,2.9,25.6,0,203,203,1051
2014,38,h) 11 to 15,1805,1987,19864,19906,91,4.5,143,7.1,2199,249,1950,1.3,11,2283,678,1605,3.4,11.5,-84,-0.5,22,0,100,100,511
2014,38,i) 16 to 20,1453,1591,19782,19650,46,2.8,101,6.2,1909,150,1759,0.8,9.7,1645,389,1256,2,8.4,264,1.3,16.8,0,73,73,282
2014,38,j) 21 to 25,1163,1289,16943,17356,44,3.4,89,6.8,1850,328,1522,1.9,10.7,2676,1531,1145,8.8,15.4,-826,-4.7,21.4,0,55,55,232
2014,38,k) 26+,2469,3364,60809,60224,98,2.9,175,5.1,5978,1646,4332,2.7,9.9,4807,1120,3687,1.9,8,1171,1.9,16,0,92,92,471
2014,38,l) Left Censored,2309,4936,157377,156286,263,5.4,166,3.4,18505,5784,12721,3.7,11.8,16322,4060,12262,2.6,10.4,2183,1.4,20.8,0,60,64,490
2014,39,a) 0,9516,9675,70116,35058,9675,200,0,0,70116,70116,0,200,200,0,0,0,0,0,70116,200,0,0,,,
2014,39,b) 1,7746,7827,61688,63347,10,0.1,2213,24.8,14941,,,,23.6,18258,11432,6826,18,28.8,-3317,-5.2,47.2,1,1720,1720,9955
2014,39,c) 2,7072,7165,59456,61127,328,4.3,1312,17.1,11470,2141,9329,3.5,18.8,14812,6543,8269,10.7,24.2,-3342,-5.4,37.6,0,1025,1025,5413
2014,39,d) 3,6140,6323,60619,60481,232,3.5,941,14.1,10270,1734,8536,2.9,17,9994,4765,5229,7.9,16.5,276,0.5,33,0,731,731,3952
2014,39,e) 4,5320,5719,74822,75046,234,3.9,655,11,10029,1270,8759,1.7,13.4,10476,3569,6907,4.8,14,-447,-0.6,26.8,0,499,499,2870
2014,39,f) 5,5193,5437,60672,60328,251,4.4,659,11.7,9959,1613,8346,2.7,16.5,9271,4286,4985,7.1,15.4,688,1.1,30.8,0,499,499,3101
2014,39,g) 6 to 10,26102,27516,316449,316222,1007,3.6,2659,9.4,46035,6226,39809,2,14.6,45580,20311,25269,6.4,14.4,455,0.2,28.8,0,1860,1867,15410
2014,39,h) 11 to 15,20382,22293,269428,273892,757,3.3,1685,7.4,29091,4704,24387,1.7,10.6,38019,12377,25642,4.5,13.9,-8928,-3.3,21.2,0,1183,1192,8727
2014,39,i) 16 to 20,17281,20128,266135,268391,713,3.5,1334,6.5,26826,4967,21859,1.9,10,31337,8177,23160,3,11.7,-4511,-1.7,20,0,896,913,4988
2014,39,j) 21 to 25,13593,16547,274392,270343,454,2.7,974,5.8,36979,,,,13.7,28880,8849,20031,3.3,10.7,8099,3,21.4,1,656,666,6279
2014,39,k) 26+,25382,38407,910134,897834,1331,3.4,1980,5.1,105661,19757,85904,2.2,11.8,81061,18603,62458,2.1,9,24600,2.8,18,0,1101,1115,8170
2014,39,l) Left Censored,22013,60997,2229443,2222832,2781,4.6,2113,3.5,197770,51407,146363,2.3,8.9,184547,35273,149274,1.6,8.3,13223,0.6,16.6,0,694,738,7469
2014,40,a) 0,4744,4916,32486,16243,4916,200,0,0,32486,32486,0,200,200,0,0,0,0,0,32486,200,0,0,,,
2014,40,b) 1,3812,3868,30234,29391,3,0.1,1041,23.7,8599,,,,29.3,6912,3842,3070,13.1,23.5,1687,5.8,47,1,833,833,3057
2014,40,c) 2,3355,3382,25415,25490,138,3.8,628,17.3,4930,535,4395,2.1,19.3,5080,2591,2489,10.2,19.9,-150,-0.6,38.6,0,503,503,2151
2014,40,d) 3,2886,2955,25360,25439,113,3.6,462,14.8,4717,380,4337,1.5,18.5,4875,2767,2108,10.9,19.2,-158,-0.7,37,0,357,357,2029
2014,40,e) 4,2434,2529,23063,24006,112,4.2,366,13.8,3076,547,2529,2.3,12.8,4962,2640,2322,11,20.7,-1886,-7.9,25.6,0,276,276,2277
2014,40,f) 5,2519,2613,23370,24309,109,4,336,12.3,3190,490,2700,2,13.1,5067,3036,2031,12.5,20.8,-1877,-7.7,26.2,0,259,259,2703
2014,40,g) 6 to 10,11648,12203,123776,125793,439,3.5,1229,9.8,15560,2009,13551,1.6,12.4,19594,8161,11433,6.5,15.6,-4034,-3.2,24.8,0,919,921,6118
2014,40,h) 11 to 15,8017,8782,96713,97907,317,3.5,722,8,10768,2072,8696,2.1,11,13155,4396,8759,4.5,13.4,-2387,-2.4,22,0,537,537,3222
2014,40,i) 16 to 20,6168,6993,91423,88335,231,3.2,497,7,18296,1866,16430,2.1,20.7,12119,4946,7173,5.6,13.7,6177,7,27.4,0,369,370,2910
2014,40,j) 21 to 25,4529,5581,81042,81813,171,3,333,5.9,7970,,,,9.7,9511,2286,7225,2.8,11.6,-1541,-1.9,19.4,1,226,226,1534
2014,40,k) 26+,8928,12786,265604,264775,387,3,649,5,27134,6146,20988,2.3,10.2,25476,6635,18841,2.5,9.6,1658,0.6,19.2,0,413,418,3662
2014,40,l) Left Censored,6064,17188,521073,520566,703,4.1,537,3.1,45161,9098,36063,1.7,8.7,44146,9215,34931,1.8,8.5,1015,0.2,17,0,166,170,3120
2014,41,a) 0,6046,6158,29750,14875,6158,200,0,0,29750,29750,0,200,200,0,0,0,0,0,29750,200,0,0,,,
2014,41,b) 1,4522,4541,25217,26177,3,0.1,1306,25.2,6195,31,6164,0.1,23.7,8115,5443,2672,20.8,31,-1920,-7.3,47.4,0,1008,1008,4726
2014,41,c) 2,4047,4072,26367,26379,231,5.3,764,17.6,5258,740,4518,2.8,19.9,5281,2926,2355,11.1,20,-23,-0.1,39.8,0,601,602,2347
2014,41,d) 3,3636,3719,24839,24689,192,4.9,552,14.2,4456,739,3717,3,18,4155,2090,2065,8.5,16.8,301,1.2,33.6,0,431,431,1505
2014,41,e) 4,3131,3264,27103,26883,136,4,406,11.9,4110,408,3702,1.5,15.3,3669,1662,2007,6.2,13.6,441,1.7,27.2,0,302,302,1298
2014,41,f) 5,3030,3103,24152,23677,139,4.3,365,11.3,4223,402,3821,1.7,17.8,3273,1329,1944,5.6,13.8,950,4,27.6,0,275,275,1042
2014,41,g) 6 to 10,15119,15868,127707,127653,699,4.3,1635,10,18106,3324,14782,2.6,14.2,17997,7625,10372,6,14.1,109,0.1,28.2,0,1144,1145,5678
2014,41,h) 11 to 15,10310,11127,110722,110385,448,3.9,928,8.2,13920,1871,12049,1.7,12.6,13246,4558,8688,4.1,12,674,0.6,24,0,651,656,3387
2014,41,i) 16 to 20,7956,8766,106243,105675,342,3.8,669,7.5,10573,1297,9276,1.2,10,9436,2669,6767,2.5,8.9,1137,1.1,17.8,0,471,473,1823
2014,41,j) 21 to 25,5368,6342,81101,80314,221,3.4,411,6.4,9054,2219,6835,2.8,11.3,7479,1931,5548,2.4,9.3,1575,2,18.6,0,275,278,1218
2014,41,k) 26+,9124,13389,284704,284293,437,3.2,698,5.2,30805,5389,25416,1.9,10.8,29982,6708,23274,2.4,10.5,823,0.3,21,0,413,418,2177
2014,41,l) Left Censored,6271,17613,590899,579599,926,5.3,601,3.4,76846,12239,64607,2.1,13.3,54245,11430,42815,2,9.4,22601,3.9,18.8,0,143,147,1169
2014,42,a) 0,12460,12715,81708,40854,12715,200,0,0,81708,81708,0,200,200,0,0,0,0,0,81708,200,0,0,,,
2014,42,b) 1,10010,10101,66771,70478,8,0.1,2690,23.5,15757,188,15569,0.3,22.4,23170,12525,10645,17.8,32.9,-7413,-10.5,44.8,0,2093,2093,10403
2014,42,c) 2,9057,9113,68320,68160,396,4.1,1615,16.6,14350,1779,12571,2.6,21.1,14030,8059,5971,11.8,20.6,320,0.5,41.2,0,1230,1230,6710
2014,42,d) 3,8079,8256,72286,73625,338,3.9,1211,13.9,12277,1184,11093,1.6,16.7,14955,8728,6227,11.9,20.3,-2678,-3.6,33.4,0,961,961,6362
2014,42,e) 4,6855,7237,68770,69641,301,4,883,11.7,9796,2198,7598,3.2,14.1,11538,5313,6225,7.6,16.6,-1742,-2.5,28.2,0,679,679,4203
2014,42,f) 5,6970,7143,66834,67664,253,3.4,814,11,8074,747,7327,1.1,11.9,9733,4078,5655,6,14.4,-1659,-2.5,23.8,0,616,619,3379
2014,42,g) 6 to 10,34253,35918,351095,354647,1313,3.5,3451,9.3,43140,7519,35621,2.1,12.2,50243,18614,31629,5.2,14.2,-7103,-2,24.4,0,2483,2490,14576
2014,42,h) 11 to 15,26197,28087,343146,343820,923,3.2,2135,7.4,37797,8789,29008,2.6,11,39144,12888,26256,3.7,11.4,-1347,-0.4,22,0,1485,1508,9453
2014,42,i) 16 to 20,20665,23334,334476,332076,766,3.2,1564,6.6,36689,8511,28178,2.6,11,31889,10192,21697,3.1,9.6,4800,1.4,19.2,0,1040,1046,6351
2014,42,j) 21 to 25,16455,19483,284840,285167,595,3,1133,5.7,29365,5567,23798,2,10.3,30018,9049,20969,3.2,10.5,-653,-0.2,20.6,0,779,781,4952
2014,42,k) 26+,30108,44158,989133,990310,1348,3,2214,5,84157,16539,67618,1.7,8.5,86511,20361,66150,2.1,8.7,-2354,-0.2,17,0,1322,1344,8381
2014,42,l) Left Censored,24517,66575,2484086,2466084,3174,4.8,2575,3.9,240066,64663,175403,2.6,9.7,204062,40513,163549,1.6,8.3,36004,1.4,16.6,0,765,787,7313
2014,44,a) 0,1252,1256,8189,4095,1256,200,0,0,8189,8189,0,200,200,0,0,0,0,0,8189,200,0,0,,,
2014,44,b) 1,989,997,6415,6577,0,0,289,25.3,1592,0,1592,0,24.2,1915,1202,713,18.3,29.1,-323,-4.9,48.4,0,214,214,994
2014,44,c) 2,864,869,6160,6217,47,5.1,166,17.9,1276,388,888,6.2,20.5,1390,785,605,12.6,22.4,-114,-1.9,41,0,118,118,573
2014,44,d) 3,761,772,7505,7124,40,4.9,122,15,1596,673,923,9.4,22.4,834,382,452,5.4,11.7,762,10.7,23.4,0,98,98,309
2014,44,e) 4,689,715,6689,7439,36,4.8,93,12.5,928,123,805,1.7,12.5,2428,1881,547,25.3,32.6,-1500,-20.1,25,0,66,66,1759
2014,44,f) 5,602,611,4800,4982,27,4.3,75,11.8,688,108,580,2.2,13.8,1052,371,681,7.4,21.1,-364,-7.3,27.6,0,54,54,224
2014,44,g) 6 to 10,3359,3479,35448,35497,158,4.4,389,10.8,4503,454,4049,1.3,12.7,4601,2173,2428,6.1,13,-98,-0.3,25.4,0,263,263,1744
2014,44,h) 11 to 15,2622,2773,26078,26367,122,4.3,233,8.2,2640,484,2156,1.8,10,3217,1024,2193,3.9,12.2,-577,-2.2,20,0,151,151,715
2014,44,i) 16 to 20,2057,2272,27644,27111,87,3.8,168,7.3,3309,601,2708,2.2,12.2,2243,584,1659,2.2,8.3,1066,3.9,16.6,0,110,110,458
2014,44,j) 21 to 25,1712,1839,25884,25603,51,2.7,111,5.9,2689,375,2314,1.5,10.5,2126,524,1602,2,8.3,563,2.2,16.6,0,64,64,189
2014,44,k) 26+,3061,3836,69041,69526,100,2.6,201,5.2,5147,976,4171,1.4,7.4,6117,1340,4777,1.9,8.8,-970,-1.4,14.8,0,128,128,983
2014,44,l) Left Censored,2887,5333,196966,195596,202,3.8,244,4.6,18004,3352,14652,1.7,9.2,15263,3709,11554,1.9,7.8,2741,1.4,15.6,0,95,97,1778
2014,45,a) 0,5090,5141,31532,15766,5141,200,0,0,31532,31532,0,200,200,0,0,0,0,0,31532,200,0,0,,,
2014,45,b) 1,3869,3889,25912,26853,2,0,1141,25.6,6287,,,,23.4,8168,5363,2805,20,30.4,-1881,-7,46.8,1,903,903,4719
2014,45,c) 2,3467,3508,25592,26087,149,4,635,16.9,4761,557,4204,2.1,18.3,5751,2919,2832,11.2,22,-990,-3.7,36.6,0,517,517,2181
2014,45,d) 3,3000,3084,27349,27838,108,3.3,518,15.7,4250,467,3783,1.7,15.3,5228,2831,2397,10.2,18.8,-978,-3.5,30.6,0,411,411,2121
2014,45,e) 4,2663,2758,24932,24683,109,3.7,407,14,4116,574,3542,2.3,16.7,3618,1679,1939,6.8,14.7,498,2,29.4,0,304,304,1317
2014,45,f) 5,2585,2739,29522,29972,106,3.7,336,11.8,3343,387,2956,1.3,11.2,4243,1956,2287,6.5,14.2,-900,-3,22.4,0,269,269,1484
2014,45,g) 6 to 10,12833,13420,131388,131183,567,4.1,1371,9.9,18780,3465,15315,2.6,14.3,18369,8047,10322,6.1,14,411,0.3,28,0,1033,1034,6328
2014,45,h) 11 to 15,9279,10014,129063,129459,342,3.3,797,7.8,13221,2445,10776,1.9,10.2,14013,5365,8648,4.1,10.8,-792,-0.6,20.4,0,559,561,3992
2014,45,i) 16 to 20,6795,7591,114819,114739,292,3.8,563,7.3,11841,1547,10294,1.3,10.3,11681,4421,7260,3.9,10.2,160,0.1,20.4,0,396,400,2307
2014,45,j) 21 to 25,4673,5766,85993,86832,176,3,384,6.5,7775,,,,9,9452,2990,6462,3.4,10.9,-1677,-1.9,18,1,260,261,2134
2014,45,k) 26+,8755,13554,288131,285395,449,3.3,648,4.7,28961,6750,22211,2.4,10.1,23488,5218,18270,1.8,8.2,5473,1.9,16.4,0,384,398,2932
2014,45,l) Left Censored,6390,20828,680843,676369,994,4.8,692,3.3,63737,15442,48295,2.3,9.4,54788,8857,45931,1.3,8.1,8949,1.3,16.2,0,195,205,1382
2014,46,a) 0,1193,1216,8101,4051,1216,200,0,0,8101,8101,0,200,200,0,0,0,0,0,8101,200,0,0,,,
2014,46,b) 1,930,935,5274,5370,0,0,293,27.1,1349,0,1349,0,25.1,1540,931,609,17.3,28.7,-191,-3.6,50.2,0,219,219,737
2014,46,c) 2,861,863,4849,5113,32,3.4,163,17.6,753,78,675,1.5,14.7,1280,764,516,14.9,25,-527,-10.3,29.4,0,115,115,600
2014,46,d) 3,704,718,6322,6624,35,4.6,112,14.8,615,73,542,1.1,9.3,1219,446,773,6.7,18.4,-604,-9.1,18.6,0,93,93,372
2014,46,e) 4,659,698,5935,5873,32,4.4,84,11.6,944,85,859,1.4,16.1,819,334,485,5.7,13.9,125,2.2,27.8,0,58,58,224
2014,46,f) 5,717,729,5744,6064,23,3,84,11.1,730,87,643,1.4,12,1370,299,1071,4.9,22.6,-640,-10.6,24,0,58,58,185
2014,46,g) 6 to 10,3320,3431,28246,28390,134,3.8,358,10.1,3483,450,3033,1.6,12.3,3771,1446,2325,5.1,13.3,-288,-1,24.6,0,253,254,1077
2014,46,h) 11 to 15,2559,2708,26718,27040,88,3.2,206,7.4,2450,225,2225,0.8,9.1,3094,1046,2048,3.9,11.4,-644,-2.3,18.2,0,148,149,790
2014,46,i) 16 to 20,1929,2077,23813,23739,59,2.8,128,6.1,2988,612,2376,2.6,12.6,2840,1501,1339,6.3,12,148,0.6,24,0,82,88,1337
2014,46,j) 21 to 25,1357,1493,17295,17069,49,3.2,95,6.3,1805,513,1292,3,10.6,1352,371,981,2.2,7.9,453,2.7,15.8,0,70,70,284
2014,46,k) 26+,2470,3397,50899,50993,74,2.2,142,4.1,4597,541,4056,1.1,9,4785,1461,3324,2.9,9.4,-188,-0.4,18,0,88,88,1019
2014,46,l) Left Censored,2364,4924,155818,155048,139,2.8,117,2.4,11877,1626,10251,1,7.7,10337,1904,8433,1.2,6.7,1540,1,13.4,0,53,53,335
2014,47,a) 0,6032,6118,39564,19782,6118,200,0,0,39564,39564,0,200,200,0,0,0,0,0,39564,200,0,0,,,
2014,47,b) 1,4935,4946,37403,38843,1,0,1400,24.8,9612,,,,24.7,12492,5791,6701,14.9,32.2,-2880,-7.5,49.4,1,1180,1180,4892
2014,47,c) 2,4244,4297,46420,43775,177,3.8,834,18,12112,2556,9556,5.8,27.7,6822,3444,3378,7.9,15.6,5290,12.1,31.2,0,680,680,2915
2014,47,d) 3,3709,3760,39748,41231,156,3.9,620,15.5,6078,910,5168,2.2,14.7,9044,4884,4160,11.8,21.9,-2966,-7.2,29.4,0,516,516,3906
2014,47,e) 4,3297,3485,43632,43863,149,4.1,492,13.5,7830,2510,5320,5.7,17.9,8292,2850,5442,6.5,18.9,-462,-1,35.8,0,399,399,2365
2014,47,f) 5,2977,3182,32930,32955,111,3.3,388,11.7,5187,659,4528,2,15.7,5237,2470,2767,7.5,15.9,-50,-0.2,31.4,0,321,321,1897
2014,47,g) 6 to 10,14975,16245,170171,171057,755,4.5,1644,9.9,24300,3891,20409,2.3,14.2,26072,9755,16317,5.7,15.2,-1772,-1,28.4,0,1251,1252,7133
2014,47,h) 11 to 15,10352,11608,162814,163370,393,3.3,960,8.1,17788,2825,14963,1.7,10.9,18900,6440,12460,3.9,11.6,-1112,-0.7,21.8,0,732,736,4505
2014,47,i) 16 to 20,8596,9861,135503,136913,357,3.6,740,7.4,16289,3871,12418,2.8,11.9,19109,5350,13759,3.9,14,-2820,-2.1,23.8,0,522,524,3552
2014,47,j) 21 to 25,6340,8286,149936,147387,248,2.9,500,5.9,19398,,,,13.2,14299,3488,10811,2.4,9.7,5099,3.5,19.4,1,347,347,2357
2014,47,k) 26+,12590,19887,460717,455263,837,4.2,1008,5,48530,9118,39412,2,10.7,37621,6990,30631,1.5,8.3,10909,2.4,16.6,0,573,581,3303
2014,47,l) Left Censored,9033,29339,1110513,1109759,1547,5.3,986,3.4,102127,24569,77558,2.2,9.2,100618,21877,78741,2,9.1,1509,0.1,18.2,0,252,253,3315
2014,48,a) 0,33706,34362,235879,117940,34362,200,0,0,235879,235879,0,200,200,0,0,0,0,0,235879,200,0,0,,,
2014,48,b) 1,26342,26699,207116,210809,161,0.5,7186,23.8,57986,2291,55695,1.1,27.5,65371,36353,29018,17.2,31,-7385,-3.5,55,0,5855,5855,31316
2014,48,c) 2,23231,23549,211381,209858,1027,4.1,4354,17.3,47943,6335,41608,3,22.8,44896,23531,21365,11.2,21.4,3047,1.4,42.8,0,3547,3549,18336
2014,48,d) 3,19851,20600,215551,214880,885,4.1,3006,13.9,40068,4591,35477,2.1,18.6,38726,18554,20172,8.6,18,1342,0.6,36,0,2447,2450,15496
2014,48,e) 4,16572,17342,210489,210737,698,3.8,2382,13.1,40144,4152,35992,2,19,40640,21952,18688,10.4,19.3,-496,-0.3,38,0,1871,1875,12579
2014,48,f) 5,15628,16781,188907,191582,1037,6,1987,11.5,32099,6064,26035,3.2,16.8,37448,12403,25045,6.5,19.5,-5349,-2.7,33.6,0,1548,1549,9865
2014,48,g) 6 to 10,69165,73506,908550,908630,2757,3.6,7125,9.4,133252,21873,111379,2.4,14.7,133411,52969,80442,5.8,14.7,-159,0,29.4,0,5418,5457,39333
2014,48,h) 11 to 15,45249,50900,756442,760212,1992,3.8,3899,7.5,89970,17952,72018,2.4,11.8,97510,33302,64208,4.4,12.8,-7540,-1,23.6,0,2796,2810,21946
2014,48,i) 16 to 20,33479,39050,624338,627178,1364,3.4,2686,6.8,75604,18351,57253,2.9,12.1,81284,28080,53204,4.5,13,-5680,-0.9,24.2,0,1889,1913,13084
2014,48,j) 21 to 25,23779,31132,560011,558261,1116,3.5,1932,6.1,62653,12086,50567,2.2,11.2,59153,16420,42733,2.9,10.6,3500,0.6,21.2,0,1304,1311,9231
2014,48,k) 26+,41089,69154,1677229,1666440,3040,4.4,3592,5.2,198009,54654,143355,3.3,11.9,176431,53315,123116,3.2,10.6,21578,1.3,21.2,0,2032,2052,23717
2014,48,l) Left Censored,22539,100145,3932124,3912278,6491,6.6,4203,4.2,454785,136219,318566,3.5,11.6,415093,100574,314519,2.6,10.6,39692,1,21.2,0,727,797,11138
2014,49,a) 0,4683,4760,29867,14934,4760,200,0,0,29867,29867,0,200,200,0,0,0,0,0,29867,200,0,0,,,
2014,49,b) 1,3598,3639,25906,25744,6,0.1,1130,26.9,7818,,,,30.4,7494,4587,2907,17.8,29.1,324,1.3,58.2,1,860,860,4053
2014,49,c) 2,3155,3214,32117,30188,150,4.3,643,18.6,9239,660,8579,2.2,30.6,5380,3042,2338,10.1,17.8,3859,12.8,35.6,0,491,491,2658
2014,49,d) 3,2718,2801,27474,26999,152,5.2,433,14.7,4936,909,4027,3.4,18.3,3985,1949,2036,7.2,14.8,951,3.5,29.6,0,347,347,1569
2014,49,e) 4,2459,2533,22879,23133,112,4.2,368,13.8,3712,377,3335,1.6,16,4219,2473,1746,10.7,18.2,-507,-2.2,32,0,270,270,1914
2014,49,f) 5,2191,2290,21069,20782,139,5.9,292,12.3,3535,583,2952,2.8,17,2960,1364,1596,6.6,14.2,575,2.8,28.4,0,215,215,1121
2014,49,g) 6 to 10,10993,11356,112126,111768,667,5.8,1148,9.9,19209,2701,16508,2.4,17.2,18492,5618,12874,5,16.5,717,0.7,33,0,778,779,4345
2014,49,h) 11 to 15,7056,7449,96682,95796,349,4.6,574,7.6,13403,2225,11178,2.3,14,11631,4295,7336,4.5,12.1,1772,1.9,24.2,0,394,394,3398
2014,49,i) 16 to 20,4480,5013,86411,85385,211,4.2,341,6.7,9636,1298,8338,1.5,11.3,7584,2577,5007,3,8.9,2052,2.4,17.8,0,223,223,1904
2014,49,j) 21 to 25,2725,3279,86544,86376,122,3.7,213,6.4,7966,,,,9.2,7630,1836,5794,2.1,8.8,336,0.4,17.6,1,120,121,901
2014,49,k) 26+,4216,6376,164397,165162,215,3.3,318,4.9,17408,5500,11908,3.3,10.5,18938,2798,16140,1.7,11.5,-1530,-1,21,0,157,157,958
2014,49,l) Left Censored,3210,10262,411639,414440,619,6.1,472,4.6,36609,10852,25757,2.6,8.8,42210,8712,33498,2.1,10.2,-5601,-1.4,17.6,0,89,92,1138
2014,50,a) 0,918,923,4403,2202,923,200,0,0,4403,4403,0,200,200,0,0,0,0,0,4403,200,0,0,,,
2014,50,b) 1,663,664,4440,4589,0,0,189,24.9,755,0,755,0,16.5,1053,693,360,15.1,22.9,-298,-6.4,33,0,142,142,605
2014,50,c) 2,674,685,3976,4075,33,4.5,120,16.5,772,86,686,2.1,18.9,969,627,342,15.4,23.8,-197,-4.9,37.8,0,82,82,502
2014,50,d) 3,585,589,3791,3921,28,4.6,73,11.9,612,168,444,4.3,15.6,872,184,688,4.7,22.2,-260,-6.6,31.2,0,56,56,149
2014,50,e) 4,482,487,3174,3387,23,4.6,57,11.3,326,54,272,1.6,9.6,751,450,301,13.3,22.2,-425,-12.6,19.2,0,43,43,218
2014,50,f) 5,489,500,3349,3429,19,3.6,68,13,501,39,462,1.1,14.6,660,404,256,11.8,19.2,-159,-4.6,29.2,0,57,57,358
2014,50,g) 6 to 10,2531,2596,19428,19297,92,3.4,256,9.6,2732,262,2470,1.4,14.2,2470,938,1532,4.9,12.8,262,1.4,25.6,0,173,174,638
2014,50,h) 11 to 15,2111,2167,24104,24236,90,4.1,155,7,1918,578,1340,2.4,7.9,2182,791,1391,3.3,9,-264,-1.1,15.8,0,108,109,661
2014,50,i) 16 to 20,1709,1837,17265,17342,53,2.8,147,7.8,1590,177,1413,1,9.2,1743,667,1076,3.8,10.1,-153,-0.9,18.4,0,112,112,564
2014,50,j) 21 to 25,1428,1541,15686,15670,43,2.7,111,7,1905,188,1717,1.2,12.2,1872,787,1085,5,11.9,33,0.3,23.8,0,68,68,605
2014,50,k) 26+,2451,3170,59782,58673,130,4.1,165,5.2,6702,1950,4752,3.3,11.4,4483,872,3611,1.5,7.6,2219,3.8,15.2,0,93,97,579
2014,50,l) Left Censored,1797,3499,100374,100625,110,3.1,133,3.8,6748,1051,5697,1,6.7,7250,1034,6216,1,7.2,-502,-0.5,13.4,0,36,39,395
2014,51,a) 0,9761,9916,56673,28337,9916,200,0,0,56673,56673,0,200,200,0,0,0,0,0,56673,200,0,0,,,
2014,51,b) 1,7697,7876,49848,50590,117,1.3,2088,23.6,13020,695,12325,1.4,25.7,14504,6537,7967,12.9,28.7,-1484,-3,51.4,0,1620,1620,5185
2014,51,c) 2,6800,6853,48921,49356,290,4,1255,17.1,9584,948,8636,1.9,19.4,10453,5356,5097,10.9,21.2,-869,-1.8,38.8,0,986,986,4314
2014,51,d) 3,6068,6205,52831,52874,245,3.7,911,13.9,9502,929,8573,1.8,18,9587,4038,5549,7.6,18.1,-85,-0.1,36,0,690,690,3020
2014,51,e) 4,5133,5380,53536,54189,263,4.7,717,12.8,7927,1209,6718,2.2,14.6,9232,4710,4522,8.7,17,-1305,-2.4,29.2,0,560,560,2436
2014,51,f) 5,5219,5433,47428,47693,258,4.6,639,11.4,6888,967,5921,2,14.4,7417,2890,4527,6.1,15.6,-529,-1.2,28.8,0,497,497,2391
2014,51,g) 6 to 10,24904,25841,259187,260246,1037,3.9,2715,10.2,33827,5177,28650,2,13,35945,12593,23352,4.8,13.8,-2118,-0.8,26,0,1952,1953,9253
2014,51,h) 11 to 15,16673,18228,232442,233926,677,3.6,1506,8.1,27201,5178,22023,2.2,11.6,30168,10565,19603,4.5,12.9,-2967,-1.3,23.2,0,1069,1079,6495
2014,51,i) 16 to 20,13103,14716,199646,195516,548,3.7,1084,7.2,30381,12185,18196,6.2,15.5,22120,5675,16445,2.9,11.3,8261,4.2,22.6,0,766,775,3856
2014,51,j) 21 to 25,9511,11759,186116,186506,479,4,751,6.3,20221,4706,15515,2.5,10.8,21000,5904,15096,3.2,11.3,-779,-0.5,21.6,0,491,497,2990
2014,51,k) 26+,16463,25041,557362,557732,817,3.2,1259,5,57320,12234,45086,2.2,10.3,58060,11497,46563,2.1,10.4,-740,-0.1,20.6,0,763,766,4640
2014,51,l) Left Censored,11183,39608,1373352,1372731,2101,5.3,1570,4,138987,42124,96863,3.1,10.1,137746,27230,110516,2,10,1241,0.1,20,0,364,389,4354
2014,53,a) 0,10294,10363,50110,25055,10363,200,0,0,50110,50110,0,200,200,0,0,0,0,0,50110,200,0,0,,,
2014,53,b) 1,7760,7791,43227,44385,12,0.1,2403,26.7,11073,,,,24.9,13389,8928,4461,20.1,30.2,-2316,-5.3,49.8,1,1817,1817,7410
2014,53,c) 2,6620,6682,42522,42580,358,5,1279,17.9,9350,1366,7984,3.2,22,9466,5389,4077,12.7,22.2,-116,-0.2,44,0,959,975,4501
2014,53,d) 3,6035,6129,44906,44658,318,4.9,960,14.9,8254,922,7332,2.1,18.5,7757,3902,3855,8.7,17.4,497,1.1,34.8,0,710,710,2788
2014,53,e) 4,5159,5371,41232,40927,280,5,662,11.9,7232,1094,6138,2.7,17.7,6622,2858,3764,7,16.2,610,1.5,32.4,0,499,499,2167
2014,53,f) 5,5019,5117,41210,41133,254,4.8,602,11.4,6673,972,5701,2.4,16.2,6519,3184,3335,7.7,15.8,154,0.4,31.6,0,431,431,2027
2014,53,g) 6 to 10,24714,25807,219635,218472,1258,4.7,2735,10.3,32440,5056,27384,2.3,14.8,30113,11977,18136,5.5,13.8,2327,1,27.6,0,1956,1969,8829
2014,53,h) 11 to 15,16613,17940,190712,190469,762,4.2,1575,8.6,24296,3061,21235,1.6,12.8,23810,9678,14132,5.1,12.5,486,0.3,25,0,1037,1038,6931
2014,53,i) 16 to 20,12323,13801,179930,178225,595,4.2,1025,7.3,22302,5034,17268,2.8,12.5,18891,5908,12983,3.3,10.6,3411,1.9,21.2,0,682,682,3885
2014,53,j) 21 to 25,8770,10475,150527,151417,396,3.7,644,6.1,15706,,,,10.4,17486,4132,13354,2.7,11.5,-1780,-1.1,20.8,1,442,442,2954
2014,53,k) 26+,13970,20777,515898,510759,788,3.8,1092,5.2,48795,8204,40591,1.6,9.6,38517,7972,30545,1.6,7.5,10278,2.1,15,0,701,713,4611
2014,53,l) Left Censored,9050,27266,928718,920749,1340,4.9,1020,3.8,95354,22562,72792,2.5,10.4,79415,19546,59869,2.1,8.6,15939,1.8,17.2,0,260,276,3047
2014,54,a) 0,1290,1322,9385,4693,1322,200,0,0,9385,9385,0,200,200,0,0,0,0,0,9385,200,0,0,,,
2014,54,b) 1,990,991,7487,8313,0,0,335,28.9,1688,0,1688,0,20.3,3339,2057,1282,24.7,40.2,-1651,-19.9,40.6,0,283,283,1736
2014,54,c) 2,965,972,7642,7805,49,4.6,220,20.8,1314,129,1185,1.7,16.8,1640,880,760,11.3,21,-326,-4.2,33.6,0,170,170,620
2014,54,d) 3,896,933,7445,7649,30,3,150,15.1,1164,150,1014,2,15.2,1572,807,765,10.6,20.6,-408,-5.4,30.4,0,107,107,588
2014,54,e) 4,750,818,9707,9970,27,3.1,114,13.2,1029,96,933,1,10.3,1554,601,953,6,15.6,-525,-5.3,20.6,0,89,89,471
2014,54,f) 5,746,787,7357,7371,27,3.3,109,13.2,1124,91,1033,1.2,15.2,1151,512,639,6.9,15.6,-27,-0.4,30.4,0,80,80,308
2014,54,g) 6 to 10,4012,4265,49998,47079,158,3.6,470,10.6,12025,567,11458,1.2,25.5,6187,1989,4198,4.2,13.1,5838,12.4,26.2,0,340,341,1476
2014,54,h) 11 to 15,2999,3232,33937,34452,101,3,308,9.2,3712,670,3042,1.9,10.8,4742,1511,3231,4.4,13.8,-1030,-3,21.6,0,233,233,1190
2014,54,i) 16 to 20,2586,2883,34046,35066,118,4,219,7.5,2987,722,2265,2.1,8.5,5026,1544,3482,4.4,14.3,-2039,-5.8,17,0,148,148,893
2014,54,j) 21 to 25,2020,2408,31798,31904,84,3.4,145,5.9,3417,570,2847,1.8,10.7,3628,864,2764,2.7,11.4,-211,-0.7,21.4,0,98,98,492
2014,54,k) 26+,4212,6242,118923,118728,151,2.4,327,5.2,10161,1033,9128,0.9,8.6,9771,2481,7290,2.1,8.2,390,0.4,16.4,0,207,214,1515
2014,54,l) Left Censored,3760,9427,251049,254458,348,3.7,354,3.8,20638,6829,13809,2.7,8.1,27456,8393,19063,3.3,10.8,-6818,-2.7,16.2,0,116,121,1098
2014,55,a) 0,5635,5778,38200,19100,5778,200,0,0,38200,38200,0,200,200,0,0,0,0,0,38200,200,0,0,,,
2014,55,b) 1,4399,4437,30632,31666,7,0.1,1200,23.8,7092,,,,22.4,9160,5980,3180,18.9,28.9,-2068,-6.5,44.8,1,929,929,5167
2014,55,c) 2,3903,3937,30164,29882,195,4.7,643,15.5,5879,567,5312,1.9,19.7,5315,2891,2424,9.7,17.8,564,1.9,35.6,0,497,497,2467
2014,55,d) 3,3484,3666,30034,30381,129,3.4,480,12.5,4659,487,4172,1.6,15.3,5353,2326,3027,7.7,17.6,-694,-2.3,30.6,0,370,370,1974
2014,55,e) 4,3036,3161,30817,31257,147,4.5,413,12.5,4487,619,3868,2,14.4,5366,2545,2821,8.1,17.2,-879,-2.8,28.8,0,303,303,1839
2014,55,f) 5,3054,3192,27753,27618,121,3.6,378,11.4,4221,874,3347,3.2,15.3,3950,1620,2330,5.9,14.3,271,1,28.6,0,287,287,1356
2014,55,g) 6 to 10,15823,16572,163152,162861,673,4,1526,9,21624,3265,18359,2,13.3,21041,7667,13374,4.7,12.9,583,0.4,25.8,0,1082,1089,5934
2014,55,h) 11 to 15,12401,13559,167747,167960,447,3.2,1015,7.3,18461,3675,14786,2.2,11,18887,7747,11140,4.6,11.2,-426,-0.2,22,0,666,675,4644
2014,55,i) 16 to 20,10164,11242,149240,149296,336,2.9,777,6.8,14555,2564,11991,1.7,9.7,14667,4687,9980,3.1,9.8,-112,-0.1,19.4,0,545,559,3119
2014,55,j) 21 to 25,7820,8973,131641,130620,253,2.8,572,6.3,13656,,,,10.5,11613,3567,8046,2.7,8.9,2043,1.6,17.8,1,379,380,2496
2014,55,k) 26+,13562,19809,437490,435436,517,2.6,984,4.9,42855,6850,36005,1.6,9.8,38747,8427,30320,1.9,8.9,4108,0.9,17.8,0,559,563,4326
2014,55,l) Left Censored,12006,29882,1189568,1187908,1063,3.6,906,3,91968,19165,72803,1.6,7.7,88648,17241,71407,1.5,7.5,3320,0.2,15,0,343,353,5928
2014,56,a) 0,1100,1118,5064,2532,1118,200,0,0,5064,,,,200,0,0,0,0,0,5064,200,0,1,,,
2014,56,b) 1,860,863,4758,4794,1,0.1,262,26.4,1071,,,,22.3,1143,663,480,13.8,23.8,-72,-1.5,44.6,1,201,201,559
2014,56,c) 2,818,821,4785,4683,43,5,128,14.8,1043,148,895,3.2,22.3,839,357,482,7.6,17.9,204,4.4,35.8,0,96,96,256
2014,56,d) 3,681,700,5219,4930,47,6.5,100,13.8,1159,215,944,4.4,23.5,580,248,332,5,11.8,579,11.7,23.6,0,77,77,204
2014,56,e) 4,576,582,4228,4123,25,4.1,79,13,855,65,790,1.6,20.7,645,307,338,7.4,15.6,210,5.1,31.2,0,60,60,249
2014,56,f) 5,606,633,4066,4235,28,4.3,64,9.8,544,65,479,1.5,12.8,881,398,483,9.4,20.8,-337,-8,25.6,0,51,51,376
2014,56,g) 6 to 10,2920,3009,22826,22919,119,3.8,311,10,3281,528,2753,2.3,14.3,3466,1167,2299,5.1,15.1,-185,-0.8,28.6,0,217,217,833
2014,56,h) 11 to 15,2085,2174,17943,17958,80,3.6,179,8.1,2252,383,1869,2.1,12.5,2281,656,1625,3.7,12.7,-29,-0.2,25,0,119,119,417
2014,56,i) 16 to 20,1540,1663,15255,15024,58,3.4,114,6.7,2084,600,1484,4,13.9,1621,457,1164,3,10.8,463,3.1,21.6,0,76,76,324
2014,56,j) 21 to 25,935,1018,13989,14141,27,2.6,82,7.8,1034,,,,7.3,1338,410,928,2.9,9.5,-304,-2.2,14.6,1,61,63,325
2014,56,k) 26+,1915,2558,42166,41810,91,3.5,111,4.3,4245,571,3674,1.4,10.2,3532,533,2999,1.3,8.4,713,1.8,16.8,0,79,79,397
2014,56,l) Left Censored,1474,3183,72155,73710,164,5.1,167,5.2,7612,1359,6253,1.8,10.3,10721,2644,8077,3.6,14.5,-3109,-4.2,20.6,0,35,35,158
